"Datum";"Region";"PCR_Pos";"Ag_Neg";"Ag_Pos";"Total";"Pocet.potvrdenych";"Potvrdenych";"newcases";"date";"positive"
2022-01-11;"Banskobystrický kraj";327;0;0;0;92410;157370;327;2022-01-11;157370
2022-01-10;"Banskobystrický kraj";219;0;0;0;NA;157370;219;2022-01-10;157043
2022-01-09;"Banskobystrický kraj";54;2410;29;2439;NA;157370;83;2022-01-09;156824
2022-01-08;"Banskobystrický kraj";177;969;35;1004;NA;157370;212;2022-01-08;156741
2022-01-07;"Banskobystrický kraj";320;2817;78;2895;NA;157370;398;2022-01-07;156529
2022-01-06;"Banskobystrický kraj";101;985;21;1006;NA;157370;122;2022-01-06;156131
2022-01-05;"Banskobystrický kraj";376;2830;65;2895;NA;157370;441;2022-01-05;156009
2022-01-04;"Banskobystrický kraj";458;4192;72;4264;NA;157370;530;2022-01-04;155568
2022-01-03;"Banskobystrický kraj";420;8160;114;8274;NA;157370;534;2022-01-03;155038
2022-01-02;"Banskobystrický kraj";117;2239;95;2334;NA;157370;212;2022-01-02;154504
2022-01-01;"Banskobystrický kraj";33;80;4;84;NA;157370;37;2022-01-01;154292
2021-12-31;"Banskobystrický kraj";316;1802;68;1870;NA;157370;384;2021-12-31;154255
2021-12-30;"Banskobystrický kraj";308;2816;88;2904;NA;157370;396;2021-12-30;153871
2021-12-29;"Banskobystrický kraj";390;2448;83;2531;NA;157370;473;2021-12-29;153475
2021-12-28;"Banskobystrický kraj";492;2973;96;3069;NA;157370;588;2021-12-28;153002
2021-12-27;"Banskobystrický kraj";397;4991;203;5194;NA;157370;600;2021-12-27;152414
2021-12-26;"Banskobystrický kraj";76;1174;61;1235;NA;157370;137;2021-12-26;151814
2021-12-25;"Banskobystrický kraj";107;373;45;418;NA;157370;152;2021-12-25;151677
2021-12-24;"Banskobystrický kraj";116;213;10;223;NA;157370;126;2021-12-24;151525
2021-12-23;"Banskobystrický kraj";429;3474;107;3581;NA;157370;536;2021-12-23;151399
2021-12-22;"Banskobystrický kraj";393;3344;106;3450;NA;157370;499;2021-12-22;150863
2021-12-21;"Banskobystrický kraj";508;4162;88;4250;NA;157370;596;2021-12-21;150364
2021-12-20;"Banskobystrický kraj";424;7595;186;7781;NA;157370;610;2021-12-20;149768
2021-12-19;"Banskobystrický kraj";39;2681;87;2768;NA;157370;126;2021-12-19;149158
2021-12-18;"Banskobystrický kraj";333;1036;67;1103;NA;157370;400;2021-12-18;149032
2021-12-17;"Banskobystrický kraj";465;3792;102;3894;NA;157370;567;2021-12-17;148632
2021-12-16;"Banskobystrický kraj";499;4258;116;4374;NA;157370;615;2021-12-16;148065
2021-12-15;"Banskobystrický kraj";554;4758;102;4860;NA;157370;656;2021-12-15;147450
2021-12-14;"Banskobystrický kraj";729;4607;108;4715;NA;157370;837;2021-12-14;146794
2021-12-13;"Banskobystrický kraj";470;8151;222;8373;NA;157370;692;2021-12-13;145957
2021-12-12;"Banskobystrický kraj";161;3332;101;3433;NA;157370;262;2021-12-12;145265
2021-12-11;"Banskobystrický kraj";568;1166;82;1248;NA;157370;650;2021-12-11;145003
2021-12-10;"Banskobystrický kraj";731;4031;185;4216;NA;157370;916;2021-12-10;144353
2021-12-09;"Banskobystrický kraj";652;4354;139;4493;NA;157370;791;2021-12-09;143437
2021-12-08;"Banskobystrický kraj";1087;4100;169;4269;NA;157370;1256;2021-12-08;142646
2021-12-07;"Banskobystrický kraj";1104;5404;201;5605;NA;157370;1305;2021-12-07;141390
2021-12-06;"Banskobystrický kraj";647;9093;318;9411;NA;157370;965;2021-12-06;140085
2021-12-05;"Banskobystrický kraj";217;3421;152;3573;NA;157370;369;2021-12-05;139120
2021-12-04;"Banskobystrický kraj";654;1334;131;1465;NA;157370;785;2021-12-04;138751
2021-12-03;"Banskobystrický kraj";1117;5054;246;5300;NA;157370;1363;2021-12-03;137966
2021-12-02;"Banskobystrický kraj";1710;5255;258;5513;NA;157370;1968;2021-12-02;136603
2021-12-01;"Banskobystrický kraj";947;4680;259;4939;NA;157370;1206;2021-12-01;134635
2021-11-30;"Banskobystrický kraj";1266;6543;245;6788;NA;157370;1511;2021-11-30;133429
2021-11-29;"Banskobystrický kraj";591;10650;468;11118;NA;157370;1059;2021-11-29;131918
2021-11-28;"Banskobystrický kraj";418;4289;216;4505;NA;157370;634;2021-11-28;130859
2021-11-27;"Banskobystrický kraj";827;1781;208;1989;NA;157370;1035;2021-11-27;130225
2021-11-26;"Banskobystrický kraj";963;4771;354;5125;NA;157370;1317;2021-11-26;129190
2021-11-25;"Banskobystrický kraj";1110;5911;350;6261;NA;157370;1460;2021-11-25;127873
2021-11-24;"Banskobystrický kraj";1387;5947;325;6272;NA;157370;1712;2021-11-24;126413
2021-11-23;"Banskobystrický kraj";1436;6082;377;6459;NA;157370;1813;2021-11-23;124701
2021-11-22;"Banskobystrický kraj";489;8727;579;9306;NA;157370;1068;2021-11-22;122888
2021-11-21;"Banskobystrický kraj";408;4109;305;4414;NA;157370;713;2021-11-21;121820
2021-11-20;"Banskobystrický kraj";985;1758;199;1957;NA;157370;1184;2021-11-20;121107
2021-11-19;"Banskobystrický kraj";1006;4886;470;5356;NA;157370;1476;2021-11-19;119923
2021-11-18;"Banskobystrický kraj";979;8037;618;8655;NA;157370;1597;2021-11-18;118447
2021-11-17;"Banskobystrický kraj";772;1051;147;1198;NA;157370;919;2021-11-17;116850
2021-11-16;"Banskobystrický kraj";1130;5473;453;5926;NA;157370;1583;2021-11-16;115931
2021-11-15;"Banskobystrický kraj";749;7873;588;8461;NA;157370;1337;2021-11-15;114348
2021-11-14;"Banskobystrický kraj";311;2629;302;2931;NA;157370;613;2021-11-14;113011
2021-11-13;"Banskobystrický kraj";761;1471;214;1685;NA;157370;975;2021-11-13;112398
2021-11-12;"Banskobystrický kraj";972;5019;434;5453;NA;157370;1406;2021-11-12;111423
2021-11-11;"Banskobystrický kraj";1023;5571;345;5916;NA;157370;1368;2021-11-11;110017
2021-11-10;"Banskobystrický kraj";950;4699;333;5032;NA;157370;1283;2021-11-10;108649
2021-11-09;"Banskobystrický kraj";921;4603;283;4886;NA;157370;1204;2021-11-09;107366
2021-11-08;"Banskobystrický kraj";519;7234;488;7722;NA;157370;1007;2021-11-08;106162
2021-11-07;"Banskobystrický kraj";460;2479;258;2737;NA;157370;718;2021-11-07;105155
2021-11-06;"Banskobystrický kraj";505;1344;170;1514;NA;157370;675;2021-11-06;104437
2021-11-05;"Banskobystrický kraj";997;4773;342;5115;NA;157370;1339;2021-11-05;103762
2021-11-04;"Banskobystrický kraj";1086;4811;248;5059;NA;157370;1334;2021-11-04;102423
2021-11-03;"Banskobystrický kraj";976;4825;330;5155;NA;157370;1306;2021-11-03;101089
2021-11-02;"Banskobystrický kraj";538;5709;492;6201;NA;157370;1030;2021-11-02;99783
2021-11-01;"Banskobystrický kraj";390;1178;132;1310;NA;157370;522;2021-11-01;98753
2021-10-31;"Banskobystrický kraj";150;1700;210;1910;NA;157370;360;2021-10-31;98231
2021-10-30;"Banskobystrický kraj";449;1508;140;1648;NA;157370;589;2021-10-30;97871
2021-10-29;"Banskobystrický kraj";780;4166;286;4452;NA;157370;1066;2021-10-29;97282
2021-10-28;"Banskobystrický kraj";744;4169;247;4416;NA;157370;991;2021-10-28;96216
2021-10-27;"Banskobystrický kraj";664;4577;233;4810;NA;157370;897;2021-10-27;95225
2021-10-26;"Banskobystrický kraj";700;3673;187;3860;NA;157370;887;2021-10-26;94328
2021-10-25;"Banskobystrický kraj";376;5478;257;5735;NA;157370;633;2021-10-25;93441
2021-10-24;"Banskobystrický kraj";161;1707;143;1850;NA;157370;304;2021-10-24;92808
2021-10-23;"Banskobystrický kraj";238;1286;79;1365;NA;157370;317;2021-10-23;92504
2021-10-22;"Banskobystrický kraj";530;3816;185;4001;NA;157370;715;2021-10-22;92187
2021-10-21;"Banskobystrický kraj";416;4128;140;4268;NA;157370;556;2021-10-21;91472
2021-10-20;"Banskobystrický kraj";387;3615;123;3738;NA;157370;510;2021-10-20;90916
2021-10-19;"Banskobystrický kraj";419;4094;103;4197;NA;157370;522;2021-10-19;90406
2021-10-18;"Banskobystrický kraj";162;5286;175;5461;NA;157370;337;2021-10-18;89884
2021-10-17;"Banskobystrický kraj";26;1555;71;1626;NA;157370;97;2021-10-17;89547
2021-10-16;"Banskobystrický kraj";162;1387;50;1437;NA;157370;212;2021-10-16;89450
2021-10-15;"Banskobystrický kraj";187;3693;81;3774;NA;157370;268;2021-10-15;89238
2021-10-14;"Banskobystrický kraj";198;3705;47;3752;NA;157370;245;2021-10-14;88970
2021-10-13;"Banskobystrický kraj";217;3068;55;3123;NA;157370;272;2021-10-13;88725
2021-10-12;"Banskobystrický kraj";301;3743;59;3802;NA;157370;360;2021-10-12;88453
2021-10-11;"Banskobystrický kraj";128;4734;96;4830;NA;157370;224;2021-10-11;88093
2021-10-10;"Banskobystrický kraj";26;1815;53;1868;NA;157370;79;2021-10-10;87869
2021-10-09;"Banskobystrický kraj";73;1122;27;1149;NA;157370;100;2021-10-09;87790
2021-10-08;"Banskobystrický kraj";239;3027;61;3088;NA;157370;300;2021-10-08;87690
2021-10-07;"Banskobystrický kraj";179;3437;42;3479;NA;157370;221;2021-10-07;87390
2021-10-06;"Banskobystrický kraj";136;3862;48;3910;NA;157370;184;2021-10-06;87169
2021-10-05;"Banskobystrický kraj";209;2979;54;3033;NA;157370;263;2021-10-05;86985
2021-10-04;"Banskobystrický kraj";126;3725;64;3789;NA;157370;190;2021-10-04;86722
2021-10-03;"Banskobystrický kraj";11;1407;34;1441;NA;157370;45;2021-10-03;86532
2021-10-02;"Banskobystrický kraj";66;1042;26;1068;NA;157370;92;2021-10-02;86487
2021-10-01;"Banskobystrický kraj";158;3228;51;3279;NA;157370;209;2021-10-01;86395
2021-09-30;"Banskobystrický kraj";120;3362;30;3392;NA;157370;150;2021-09-30;86186
2021-09-29;"Banskobystrický kraj";118;2626;40;2666;NA;157370;158;2021-09-29;86036
2021-09-28;"Banskobystrický kraj";112;3061;45;3106;NA;157370;157;2021-09-28;85878
2021-09-27;"Banskobystrický kraj";90;4456;72;4528;NA;157370;162;2021-09-27;85721
2021-09-26;"Banskobystrický kraj";17;1498;31;1529;NA;157370;48;2021-09-26;85559
2021-09-25;"Banskobystrický kraj";17;1481;7;1488;NA;157370;24;2021-09-25;85511
2021-09-24;"Banskobystrický kraj";98;4254;32;4286;NA;157370;130;2021-09-24;85487
2021-09-23;"Banskobystrický kraj";63;3019;13;3032;NA;157370;76;2021-09-23;85357
2021-09-22;"Banskobystrický kraj";75;2442;19;2461;NA;157370;94;2021-09-22;85281
2021-09-21;"Banskobystrický kraj";125;2976;20;2996;NA;157370;145;2021-09-21;85187
2021-09-20;"Banskobystrický kraj";45;3951;30;3981;NA;157370;75;2021-09-20;85042
2021-09-19;"Banskobystrický kraj";6;1456;24;1480;NA;157370;30;2021-09-19;84967
2021-09-18;"Banskobystrický kraj";44;1318;15;1333;NA;157370;59;2021-09-18;84937
2021-09-17;"Banskobystrický kraj";73;3485;32;3517;NA;157370;105;2021-09-17;84878
2021-09-16;"Banskobystrický kraj";95;3019;29;3048;NA;157370;124;2021-09-16;84773
2021-09-15;"Banskobystrický kraj";22;394;1;395;NA;157370;23;2021-09-15;84649
2021-09-14;"Banskobystrický kraj";95;2508;28;2536;NA;157370;123;2021-09-14;84626
2021-09-13;"Banskobystrický kraj";29;3206;28;3234;NA;157370;57;2021-09-13;84503
2021-09-12;"Banskobystrický kraj";7;958;15;973;NA;157370;22;2021-09-12;84446
2021-09-11;"Banskobystrický kraj";31;865;11;876;NA;157370;42;2021-09-11;84424
2021-09-10;"Banskobystrický kraj";59;2250;24;2274;NA;157370;83;2021-09-10;84382
2021-09-09;"Banskobystrický kraj";46;2011;17;2028;NA;157370;63;2021-09-09;84299
2021-09-08;"Banskobystrický kraj";46;1713;27;1740;NA;157370;73;2021-09-08;84236
2021-09-07;"Banskobystrický kraj";27;1422;21;1443;NA;157370;48;2021-09-07;84163
2021-09-06;"Banskobystrický kraj";26;2570;13;2583;NA;157370;39;2021-09-06;84115
2021-09-05;"Banskobystrický kraj";9;742;2;744;NA;157370;11;2021-09-05;84076
2021-09-04;"Banskobystrický kraj";14;745;10;755;NA;157370;24;2021-09-04;84065
2021-09-03;"Banskobystrický kraj";49;2116;22;2138;NA;157370;71;2021-09-03;84041
2021-09-02;"Banskobystrický kraj";19;1730;25;1755;NA;157370;44;2021-09-02;83970
2021-09-01;"Banskobystrický kraj";6;230;6;236;NA;157370;12;2021-09-01;83926
2021-08-31;"Banskobystrický kraj";18;1406;13;1419;NA;157370;31;2021-08-31;83914
2021-08-30;"Banskobystrický kraj";23;1867;10;1877;NA;157370;33;2021-08-30;83883
2021-08-29;"Banskobystrický kraj";0;351;5;356;NA;157370;5;2021-08-29;83850
2021-08-28;"Banskobystrický kraj";9;827;5;832;NA;157370;14;2021-08-28;83845
2021-08-27;"Banskobystrický kraj";7;1608;12;1620;NA;157370;19;2021-08-27;83831
2021-08-26;"Banskobystrický kraj";7;1161;2;1163;NA;157370;9;2021-08-26;83812
2021-08-25;"Banskobystrický kraj";6;1052;1;1053;NA;157370;7;2021-08-25;83803
2021-08-24;"Banskobystrický kraj";12;1117;1;1118;NA;157370;13;2021-08-24;83796
2021-08-23;"Banskobystrický kraj";7;1368;5;1373;NA;157370;12;2021-08-23;83783
2021-08-22;"Banskobystrický kraj";0;773;2;775;NA;157370;2;2021-08-22;83771
2021-08-21;"Banskobystrický kraj";3;793;1;794;NA;157370;4;2021-08-21;83769
2021-08-20;"Banskobystrický kraj";5;1616;4;1620;NA;157370;9;2021-08-20;83765
2021-08-19;"Banskobystrický kraj";4;1092;3;1095;NA;157370;7;2021-08-19;83756
2021-08-18;"Banskobystrický kraj";1;1044;1;1045;NA;157370;2;2021-08-18;83749
2021-08-17;"Banskobystrický kraj";12;890;0;890;NA;157370;12;2021-08-17;83747
2021-08-16;"Banskobystrický kraj";7;1321;3;1324;NA;157370;10;2021-08-16;83735
2021-08-15;"Banskobystrický kraj";0;366;3;369;NA;157370;3;2021-08-15;83725
2021-08-14;"Banskobystrický kraj";6;435;1;436;NA;157370;7;2021-08-14;83722
2021-08-13;"Banskobystrický kraj";11;898;0;898;NA;157370;11;2021-08-13;83715
2021-08-12;"Banskobystrický kraj";10;951;1;952;NA;157370;11;2021-08-12;83704
2021-08-11;"Banskobystrický kraj";7;575;3;578;NA;157370;10;2021-08-11;83693
2021-08-10;"Banskobystrický kraj";7;678;2;680;NA;157370;9;2021-08-10;83683
2021-08-09;"Banskobystrický kraj";9;1064;0;1064;NA;157370;9;2021-08-09;83674
2021-08-08;"Banskobystrický kraj";4;335;1;336;NA;157370;5;2021-08-08;83665
2021-08-07;"Banskobystrický kraj";0;308;4;312;NA;157370;4;2021-08-07;83660
2021-08-06;"Banskobystrický kraj";5;929;2;931;NA;157370;7;2021-08-06;83656
2021-08-05;"Banskobystrický kraj";2;838;1;839;NA;157370;3;2021-08-05;83649
2021-08-04;"Banskobystrický kraj";2;579;1;580;NA;157370;3;2021-08-04;83646
2021-08-03;"Banskobystrický kraj";4;743;0;743;NA;157370;4;2021-08-03;83643
2021-08-02;"Banskobystrický kraj";6;934;0;934;NA;157370;6;2021-08-02;83639
2021-08-01;"Banskobystrický kraj";0;271;0;271;NA;157370;0;2021-08-01;83633
2021-07-31;"Banskobystrický kraj";1;370;4;374;NA;157370;5;2021-07-31;83633
2021-07-30;"Banskobystrický kraj";27;928;2;930;NA;157370;29;2021-07-30;83628
2021-07-29;"Banskobystrický kraj";2;890;1;891;NA;157370;3;2021-07-29;83599
2021-07-28;"Banskobystrický kraj";4;520;1;521;NA;157370;5;2021-07-28;83596
2021-07-27;"Banskobystrický kraj";15;1092;0;1092;NA;157370;15;2021-07-27;83591
2021-07-26;"Banskobystrický kraj";2;911;1;912;NA;157370;3;2021-07-26;83576
2021-07-25;"Banskobystrický kraj";0;367;1;368;NA;157370;1;2021-07-25;83573
2021-07-24;"Banskobystrický kraj";2;298;0;298;NA;157370;2;2021-07-24;83572
2021-07-23;"Banskobystrický kraj";7;840;0;840;NA;157370;7;2021-07-23;83570
2021-07-22;"Banskobystrický kraj";5;727;3;730;NA;157370;8;2021-07-22;83563
2021-07-21;"Banskobystrický kraj";2;560;0;560;NA;157370;2;2021-07-21;83555
2021-07-20;"Banskobystrický kraj";6;885;2;887;NA;157370;8;2021-07-20;83553
2021-07-19;"Banskobystrický kraj";1;854;3;857;NA;157370;4;2021-07-19;83545
2021-07-18;"Banskobystrický kraj";0;377;1;378;NA;157370;1;2021-07-18;83541
2021-07-17;"Banskobystrický kraj";1;324;0;324;NA;157370;1;2021-07-17;83540
2021-07-16;"Banskobystrický kraj";3;974;1;975;NA;157370;4;2021-07-16;83539
2021-07-15;"Banskobystrický kraj";1;1038;0;1038;NA;157370;1;2021-07-15;83535
2021-07-14;"Banskobystrický kraj";3;765;0;765;NA;157370;3;2021-07-14;83534
2021-07-13;"Banskobystrický kraj";2;695;0;695;NA;157370;2;2021-07-13;83531
2021-07-12;"Banskobystrický kraj";1;1057;0;1057;NA;157370;1;2021-07-12;83529
2021-07-11;"Banskobystrický kraj";0;446;0;446;NA;157370;0;2021-07-11;83528
2021-07-10;"Banskobystrický kraj";2;368;0;368;NA;157370;2;2021-07-10;83528
2021-07-09;"Banskobystrický kraj";3;1209;0;1209;NA;157370;3;2021-07-09;83526
2021-07-08;"Banskobystrický kraj";0;1083;1;1084;NA;157370;1;2021-07-08;83523
2021-07-07;"Banskobystrický kraj";1;798;0;798;NA;157370;1;2021-07-07;83522
2021-07-06;"Banskobystrický kraj";6;1365;0;1365;NA;157370;6;2021-07-06;83521
2021-07-05;"Banskobystrický kraj";2;392;1;393;NA;157370;3;2021-07-05;83515
2021-07-04;"Banskobystrický kraj";0;318;0;318;NA;157370;0;2021-07-04;83512
2021-07-03;"Banskobystrický kraj";1;413;1;414;NA;157370;2;2021-07-03;83512
2021-07-02;"Banskobystrický kraj";3;1045;0;1045;NA;157370;3;2021-07-02;83510
2021-07-01;"Banskobystrický kraj";0;705;1;706;NA;157370;1;2021-07-01;83507
2021-06-30;"Banskobystrický kraj";3;7607;1;7608;NA;157370;4;2021-06-30;83506
2021-06-29;"Banskobystrický kraj";2;4642;1;4643;NA;157370;3;2021-06-29;83502
2021-06-28;"Banskobystrický kraj";3;5695;1;5696;NA;157370;4;2021-06-28;83499
2021-06-27;"Banskobystrický kraj";0;4369;5;4374;NA;157370;5;2021-06-27;83495
2021-06-26;"Banskobystrický kraj";0;4289;4;4293;NA;157370;4;2021-06-26;83490
2021-06-25;"Banskobystrický kraj";2;6717;2;6719;NA;157370;4;2021-06-25;83486
2021-06-24;"Banskobystrický kraj";6;4585;2;4587;NA;157370;8;2021-06-24;83482
2021-06-23;"Banskobystrický kraj";4;4947;0;4947;NA;157370;4;2021-06-23;83474
2021-06-22;"Banskobystrický kraj";7;4527;0;4527;NA;157370;7;2021-06-22;83470
2021-06-21;"Banskobystrický kraj";6;5836;8;5844;NA;157370;14;2021-06-21;83463
2021-06-20;"Banskobystrický kraj";0;5055;7;5062;NA;157370;7;2021-06-20;83449
2021-06-19;"Banskobystrický kraj";0;5639;4;5643;NA;157370;4;2021-06-19;83442
2021-06-18;"Banskobystrický kraj";4;7642;1;7643;NA;157370;5;2021-06-18;83438
2021-06-17;"Banskobystrický kraj";2;5245;3;5248;NA;157370;5;2021-06-17;83433
2021-06-16;"Banskobystrický kraj";10;5951;5;5956;NA;157370;15;2021-06-16;83428
2021-06-15;"Banskobystrický kraj";9;5576;6;5582;NA;157370;15;2021-06-15;83413
2021-06-14;"Banskobystrický kraj";8;6922;7;6929;NA;157370;15;2021-06-14;83398
2021-06-13;"Banskobystrický kraj";0;6407;7;6414;NA;157370;7;2021-06-13;83383
2021-06-12;"Banskobystrický kraj";3;6338;6;6344;NA;157370;9;2021-06-12;83376
2021-06-11;"Banskobystrický kraj";5;9693;15;9708;NA;157370;20;2021-06-11;83367
2021-06-10;"Banskobystrický kraj";10;5726;8;5734;NA;157370;18;2021-06-10;83347
2021-06-09;"Banskobystrický kraj";9;5720;4;5724;NA;157370;13;2021-06-09;83329
2021-06-08;"Banskobystrický kraj";15;5645;10;5655;NA;157370;25;2021-06-08;83316
2021-06-07;"Banskobystrický kraj";4;7582;21;7603;NA;157370;25;2021-06-07;83291
2021-06-06;"Banskobystrický kraj";1;7497;12;7509;NA;157370;13;2021-06-06;83266
2021-06-05;"Banskobystrický kraj";15;7531;9;7540;NA;157370;24;2021-06-05;83253
2021-06-04;"Banskobystrický kraj";2;9352;14;9366;NA;157370;16;2021-06-04;83229
2021-06-03;"Banskobystrický kraj";8;6507;24;6531;NA;157370;32;2021-06-03;83213
2021-06-02;"Banskobystrický kraj";7;6837;6;6843;NA;157370;13;2021-06-02;83181
2021-06-01;"Banskobystrický kraj";12;7146;14;7160;NA;157370;26;2021-06-01;83168
2021-05-31;"Banskobystrický kraj";4;9546;31;9577;NA;157370;35;2021-05-31;83142
2021-05-30;"Banskobystrický kraj";3;8959;19;8978;NA;157370;22;2021-05-30;83107
2021-05-29;"Banskobystrický kraj";11;9763;18;9781;NA;157370;29;2021-05-29;83085
2021-05-28;"Banskobystrický kraj";13;11905;27;11932;NA;157370;40;2021-05-28;83056
2021-05-27;"Banskobystrický kraj";7;8760;12;8772;NA;157370;19;2021-05-27;83016
2021-05-26;"Banskobystrický kraj";18;7905;17;7922;NA;157370;35;2021-05-26;82997
2021-05-25;"Banskobystrický kraj";27;8951;30;8981;NA;157370;57;2021-05-25;82962
2021-05-24;"Banskobystrický kraj";9;12469;44;12513;NA;157370;53;2021-05-24;82905
2021-05-23;"Banskobystrický kraj";0;9798;27;9825;NA;157370;27;2021-05-23;82852
2021-05-22;"Banskobystrický kraj";20;9608;26;9634;NA;157370;46;2021-05-22;82825
2021-05-21;"Banskobystrický kraj";22;12796;25;12821;NA;157370;47;2021-05-21;82779
2021-05-20;"Banskobystrický kraj";14;8994;25;9019;NA;157370;39;2021-05-20;82732
2021-05-19;"Banskobystrický kraj";42;8608;21;8629;NA;157370;63;2021-05-19;82693
2021-05-18;"Banskobystrický kraj";27;9450;25;9475;NA;157370;52;2021-05-18;82630
2021-05-17;"Banskobystrický kraj";11;13399;33;13432;NA;157370;44;2021-05-17;82578
2021-05-16;"Banskobystrický kraj";15;14072;26;14098;NA;157370;41;2021-05-16;82534
2021-05-15;"Banskobystrický kraj";11;15356;29;15385;NA;157370;40;2021-05-15;82493
2021-05-14;"Banskobystrický kraj";35;18939;45;18984;NA;157370;80;2021-05-14;82453
2021-05-13;"Banskobystrický kraj";37;10605;40;10645;NA;157370;77;2021-05-13;82373
2021-05-12;"Banskobystrický kraj";31;10857;45;10902;NA;157370;76;2021-05-12;82296
2021-05-11;"Banskobystrický kraj";42;11325;48;11373;NA;157370;90;2021-05-11;82220
2021-05-10;"Banskobystrický kraj";28;17621;68;17689;NA;157370;96;2021-05-10;82130
2021-05-09;"Banskobystrický kraj";25;21902;68;21970;NA;157370;93;2021-05-09;82034
2021-05-08;"Banskobystrický kraj";11;14285;26;14311;NA;157370;37;2021-05-08;81941
2021-05-07;"Banskobystrický kraj";41;21806;78;21884;NA;157370;119;2021-05-07;81904
2021-05-06;"Banskobystrický kraj";36;12251;70;12321;NA;157370;106;2021-05-06;81785
2021-05-05;"Banskobystrický kraj";34;12592;63;12655;NA;157370;97;2021-05-05;81679
2021-05-04;"Banskobystrický kraj";83;13888;47;13935;NA;157370;130;2021-05-04;81582
2021-05-03;"Banskobystrický kraj";30;20872;80;20952;NA;157370;110;2021-05-03;81452
2021-05-02;"Banskobystrický kraj";6;33040;60;33100;NA;157370;66;2021-05-02;81342
2021-05-01;"Banskobystrický kraj";54;36900;67;36967;NA;157370;121;2021-05-01;81276
2021-04-30;"Banskobystrický kraj";38;34957;86;35043;NA;157370;124;2021-04-30;81155
2021-04-29;"Banskobystrický kraj";55;16839;68;16907;NA;157370;123;2021-04-29;81031
2021-04-28;"Banskobystrický kraj";66;17959;67;18026;NA;157370;133;2021-04-28;80908
2021-04-27;"Banskobystrický kraj";70;19152;73;19225;NA;157370;143;2021-04-27;80775
2021-04-26;"Banskobystrický kraj";34;28517;101;28618;NA;157370;135;2021-04-26;80632
2021-04-25;"Banskobystrický kraj";14;40601;106;40707;NA;157370;120;2021-04-25;80497
2021-04-24;"Banskobystrický kraj";40;51944;98;52042;NA;157370;138;2021-04-24;80377
2021-04-23;"Banskobystrický kraj";78;37922;88;38010;NA;157370;166;2021-04-23;80239
2021-04-22;"Banskobystrický kraj";51;17415;57;17472;NA;157370;108;2021-04-22;80073
2021-04-21;"Banskobystrický kraj";76;19218;94;19312;NA;157370;170;2021-04-21;79965
2021-04-20;"Banskobystrický kraj";116;21234;98;21332;NA;157370;214;2021-04-20;79795
2021-04-19;"Banskobystrický kraj";48;31408;105;31513;NA;157370;153;2021-04-19;79581
2021-04-18;"Banskobystrický kraj";16;43375;90;43465;NA;157370;106;2021-04-18;79428
2021-04-17;"Banskobystrický kraj";42;64939;92;65031;NA;157370;134;2021-04-17;79322
2021-04-16;"Banskobystrický kraj";72;37307;100;37407;NA;157370;172;2021-04-16;79188
2021-04-15;"Banskobystrický kraj";67;20127;83;20210;NA;157370;150;2021-04-15;79016
2021-04-14;"Banskobystrický kraj";69;21260;86;21346;NA;157370;155;2021-04-14;78866
2021-04-13;"Banskobystrický kraj";130;23076;77;23153;NA;157370;207;2021-04-13;78711
2021-04-12;"Banskobystrický kraj";60;32272;130;32402;NA;157370;190;2021-04-12;78504
2021-04-11;"Banskobystrický kraj";0;41367;88;41455;NA;157370;88;2021-04-11;78314
2021-04-10;"Banskobystrický kraj";56;64728;141;64869;NA;157370;197;2021-04-10;78226
2021-04-09;"Banskobystrický kraj";106;31570;118;31688;NA;157370;224;2021-04-09;78029
2021-04-08;"Banskobystrický kraj";132;19000;148;19148;NA;157370;280;2021-04-08;77805
2021-04-07;"Banskobystrický kraj";226;25121;94;25215;NA;157370;320;2021-04-07;77525
2021-04-06;"Banskobystrický kraj";93;42496;187;42683;NA;157370;280;2021-04-06;77205
2021-04-05;"Banskobystrický kraj";15;11797;87;11884;NA;157370;102;2021-04-05;76925
2021-04-04;"Banskobystrický kraj";24;19683;79;19762;NA;157370;103;2021-04-04;76823
2021-04-03;"Banskobystrický kraj";5;72553;211;72764;NA;157370;216;2021-04-03;76720
2021-04-02;"Banskobystrický kraj";71;13455;66;13521;NA;157370;137;2021-04-02;76504
2021-04-01;"Banskobystrický kraj";171;39407;200;39607;NA;157370;371;2021-04-01;76367
2021-03-31;"Banskobystrický kraj";147;25543;161;25704;NA;157370;308;2021-03-31;75996
2021-03-30;"Banskobystrický kraj";167;21442;159;21601;NA;157370;326;2021-03-30;75688
2021-03-29;"Banskobystrický kraj";119;29492;218;29710;NA;157370;337;2021-03-29;75362
2021-03-28;"Banskobystrický kraj";25;40610;189;40799;NA;157370;214;2021-03-28;75025
2021-03-27;"Banskobystrický kraj";85;63414;260;63674;NA;157370;345;2021-03-27;74811
2021-03-26;"Banskobystrický kraj";122;43671;240;43911;NA;157370;362;2021-03-26;74466
2021-03-25;"Banskobystrický kraj";120;21598;240;21838;NA;157370;360;2021-03-25;74104
2021-03-24;"Banskobystrický kraj";200;19337;227;19564;NA;157370;427;2021-03-24;73744
2021-03-23;"Banskobystrický kraj";241;21541;257;21798;NA;157370;498;2021-03-23;73317
2021-03-22;"Banskobystrický kraj";65;30480;274;30754;NA;157370;339;2021-03-22;72819
2021-03-21;"Banskobystrický kraj";31;40039;280;40319;NA;157370;311;2021-03-21;72480
2021-03-20;"Banskobystrický kraj";119;67926;383;68309;NA;157370;502;2021-03-20;72169
2021-03-19;"Banskobystrický kraj";240;44038;306;44344;NA;157370;546;2021-03-19;71667
2021-03-18;"Banskobystrický kraj";160;22469;273;22742;NA;157370;433;2021-03-18;71121
2021-03-17;"Banskobystrický kraj";262;21573;245;21818;NA;157370;507;2021-03-17;70688
2021-03-16;"Banskobystrický kraj";340;23349;224;23573;NA;157370;564;2021-03-16;70181
2021-03-15;"Banskobystrický kraj";95;32306;366;32672;NA;157370;461;2021-03-15;69617
2021-03-14;"Banskobystrický kraj";39;39212;218;39430;NA;157370;257;2021-03-14;69156
2021-03-13;"Banskobystrický kraj";209;67463;395;67858;NA;157370;604;2021-03-13;68899
2021-03-12;"Banskobystrický kraj";206;41444;330;41774;NA;157370;536;2021-03-12;68295
2021-03-11;"Banskobystrický kraj";228;21338;274;21612;NA;157370;502;2021-03-11;67759
2021-03-10;"Banskobystrický kraj";260;20400;238;20638;NA;157370;498;2021-03-10;67257
2021-03-09;"Banskobystrický kraj";352;21790;284;22074;NA;157370;636;2021-03-09;66759
2021-03-08;"Banskobystrický kraj";191;31471;427;31898;NA;157370;618;2021-03-08;66123
2021-03-07;"Banskobystrický kraj";60;39191;295;39486;NA;157370;355;2021-03-07;65505
2021-03-06;"Banskobystrický kraj";164;70897;410;71307;NA;157370;574;2021-03-06;65150
2021-03-05;"Banskobystrický kraj";221;42336;389;42725;NA;157370;610;2021-03-05;64576
2021-03-04;"Banskobystrický kraj";226;22009;334;22343;NA;157370;560;2021-03-04;63966
2021-03-03;"Banskobystrický kraj";317;21949;331;22280;NA;157370;648;2021-03-03;63406
2021-03-02;"Banskobystrický kraj";291;23160;354;23514;NA;157370;645;2021-03-02;62758
2021-03-01;"Banskobystrický kraj";151;31773;434;32207;NA;157370;585;2021-03-01;62113
2021-02-28;"Banskobystrický kraj";45;38665;336;39001;NA;157370;381;2021-02-28;61528
2021-02-27;"Banskobystrický kraj";289;66667;529;67196;NA;157370;818;2021-02-27;61147
2021-02-26;"Banskobystrický kraj";326;39674;468;40142;NA;157370;794;2021-02-26;60329
2021-02-25;"Banskobystrický kraj";375;18081;366;18447;NA;157370;741;2021-02-25;59535
2021-02-24;"Banskobystrický kraj";332;16735;373;17108;NA;157370;705;2021-02-24;58794
2021-02-23;"Banskobystrický kraj";462;19932;439;20371;NA;157370;901;2021-02-23;58089
2021-02-22;"Banskobystrický kraj";67;28643;598;29241;NA;157370;665;2021-02-22;57188
2021-02-21;"Banskobystrický kraj";68;37619;444;38063;NA;157370;512;2021-02-21;56523
2021-02-20;"Banskobystrický kraj";280;68851;598;69449;NA;157370;878;2021-02-20;56011
2021-02-19;"Banskobystrický kraj";420;39888;511;40399;NA;157370;931;2021-02-19;55133
2021-02-18;"Banskobystrický kraj";241;18618;396;19014;NA;157370;637;2021-02-18;54202
2021-02-17;"Banskobystrický kraj";415;16740;389;17129;NA;157370;804;2021-02-17;53565
2021-02-16;"Banskobystrický kraj";338;19731;368;20099;NA;157370;706;2021-02-16;52761
2021-02-15;"Banskobystrický kraj";118;35835;591;36426;NA;157370;709;2021-02-15;52055
2021-02-14;"Banskobystrický kraj";60;31894;386;32280;NA;157370;446;2021-02-14;51346
2021-02-13;"Banskobystrický kraj";202;53889;492;54381;NA;157370;694;2021-02-13;50900
2021-02-12;"Banskobystrický kraj";312;37270;533;37803;NA;157370;845;2021-02-12;50206
2021-02-11;"Banskobystrický kraj";305;21196;386;21582;NA;157370;691;2021-02-11;49361
2021-02-10;"Banskobystrický kraj";333;14790;344;15134;NA;157370;677;2021-02-10;48670
2021-02-09;"Banskobystrický kraj";329;18504;362;18866;NA;157370;691;2021-02-09;47993
2021-02-08;"Banskobystrický kraj";103;49716;695;50411;NA;157370;798;2021-02-08;47302
2021-02-07;"Banskobystrický kraj";70;37659;335;37994;NA;157370;405;2021-02-07;46504
2021-02-06;"Banskobystrický kraj";178;69388;570;69958;NA;157370;748;2021-02-06;46099
2021-02-05;"Banskobystrický kraj";282;24577;363;24940;NA;157370;645;2021-02-05;45351
2021-02-04;"Banskobystrický kraj";240;14367;430;14797;NA;157370;670;2021-02-04;44706
2021-02-03;"Banskobystrický kraj";350;9459;255;9714;NA;157370;605;2021-02-03;44036
2021-02-02;"Banskobystrický kraj";277;15741;334;16075;NA;157370;611;2021-02-02;43431
2021-02-01;"Banskobystrický kraj";75;24346;489;24835;NA;157370;564;2021-02-01;42820
2021-01-31;"Banskobystrický kraj";34;19983;201;20184;NA;157370;235;2021-01-31;42256
2021-01-30;"Banskobystrický kraj";163;63896;525;64421;NA;157370;688;2021-01-30;42021
2021-01-29;"Banskobystrický kraj";196;17368;274;17642;NA;157370;470;2021-01-29;41333
2021-01-28;"Banskobystrický kraj";218;15613;382;15995;NA;157370;600;2021-01-28;40863
2021-01-27;"Banskobystrický kraj";191;8132;200;8332;NA;157370;391;2021-01-27;40263
2021-01-26;"Banskobystrický kraj";238;19795;283;20078;NA;157370;521;2021-01-26;39872
2021-01-25;"Banskobystrický kraj";82;33666;412;34078;NA;157370;494;2021-01-25;39351
2021-01-24;"Banskobystrický kraj";38;35587;278;35865;NA;157370;316;2021-01-24;38857
2021-01-23;"Banskobystrický kraj";142;89058;523;89581;NA;157370;665;2021-01-23;38541
2021-01-22;"Banskobystrický kraj";175;25887;355;26242;NA;157370;530;2021-01-22;37876
2021-01-21;"Banskobystrický kraj";194;17063;279;17342;NA;157370;473;2021-01-21;37346
2021-01-20;"Banskobystrický kraj";231;9142;186;9328;NA;157370;417;2021-01-20;36873
2021-01-19;"Banskobystrický kraj";213;10708;311;11019;NA;157370;524;2021-01-19;36456
2021-01-18;"Banskobystrický kraj";94;7402;401;7803;NA;157370;495;2021-01-18;35932
2021-01-17;"Banskobystrický kraj";110;8154;77;8231;NA;157370;187;2021-01-17;35437
2021-01-16;"Banskobystrický kraj";58;2274;57;2331;NA;157370;115;2021-01-16;35250
2021-01-15;"Banskobystrický kraj";164;7673;217;7890;NA;157370;381;2021-01-15;35135
2021-01-14;"Banskobystrický kraj";220;5760;325;6085;NA;157370;545;2021-01-14;34754
2021-01-13;"Banskobystrický kraj";235;5974;217;6191;NA;157370;452;2021-01-13;34209
2021-01-12;"Banskobystrický kraj";194;6600;290;6890;NA;157370;484;2021-01-12;33757
2021-01-11;"Banskobystrický kraj";76;8231;481;8712;NA;157370;557;2021-01-11;33273
2021-01-10;"Banskobystrický kraj";110;433;4;437;NA;157370;114;2021-01-10;32716
2021-01-09;"Banskobystrický kraj";297;2378;81;2459;NA;157370;378;2021-01-09;32602
2021-01-08;"Banskobystrický kraj";435;9805;443;10248;NA;157370;878;2021-01-08;32224
2021-01-07;"Banskobystrický kraj";127;6322;366;6688;NA;157370;493;2021-01-07;31346
2021-01-06;"Banskobystrický kraj";305;3374;185;3559;NA;157370;490;2021-01-06;30853
2021-01-05;"Banskobystrický kraj";372;7349;533;7882;NA;157370;905;2021-01-05;30363
2021-01-04;"Banskobystrický kraj";130;7087;700;7787;NA;157370;830;2021-01-04;29458
2021-01-03;"Banskobystrický kraj";199;320;19;339;NA;157370;218;2021-01-03;28628
2021-01-02;"Banskobystrický kraj";123;702;85;787;NA;157370;208;2021-01-02;28410
2021-01-01;"Banskobystrický kraj";220;1958;132;2090;NA;157370;352;2021-01-01;28202
2020-12-31;"Banskobystrický kraj";499;7679;633;8312;NA;157370;1132;2020-12-31;27850
2020-12-30;"Banskobystrický kraj";593;7407;541;7948;NA;157370;1134;2020-12-30;26718
2020-12-29;"Banskobystrický kraj";240;7876;660;8536;NA;157370;900;2020-12-29;25584
2020-12-28;"Banskobystrický kraj";131;6120;720;6840;NA;157370;851;2020-12-28;24684
2020-12-27;"Banskobystrický kraj";116;541;25;566;NA;157370;141;2020-12-27;23833
2020-12-26;"Banskobystrický kraj";61;295;35;330;NA;157370;96;2020-12-26;23692
2020-12-25;"Banskobystrický kraj";65;888;10;898;NA;157370;75;2020-12-25;23596
2020-12-24;"Banskobystrický kraj";452;3685;135;3820;NA;157370;587;2020-12-24;23521
2020-12-23;"Banskobystrický kraj";368;9892;473;10365;NA;157370;841;2020-12-23;22934
2020-12-22;"Banskobystrický kraj";307;8468;619;9087;NA;157370;926;2020-12-22;22093
2020-12-21;"Banskobystrický kraj";286;4922;455;5377;NA;157370;741;2020-12-21;21167
2020-12-20;"Banskobystrický kraj";155;250;14;264;NA;157370;169;2020-12-20;20426
2020-12-19;"Banskobystrický kraj";170;3084;138;3222;NA;157370;308;2020-12-19;20257
2020-12-18;"Banskobystrický kraj";432;5959;331;6290;NA;157370;763;2020-12-18;19949
2020-12-17;"Banskobystrický kraj";468;8753;653;9406;NA;157370;1121;2020-12-17;19186
2020-12-16;"Banskobystrický kraj";379;10184;567;10751;NA;157370;946;2020-12-16;18065
2020-12-15;"Banskobystrický kraj";336;5281;425;5706;NA;157370;761;2020-12-15;17119
2020-12-14;"Banskobystrický kraj";148;4012;259;4271;NA;157370;407;2020-12-14;16358
2020-12-13;"Banskobystrický kraj";122;142;1;143;NA;157370;123;2020-12-13;15951
2020-12-12;"Banskobystrický kraj";137;2714;138;2852;NA;157370;275;2020-12-12;15828
2020-12-11;"Banskobystrický kraj";468;6633;362;6995;NA;157370;830;2020-12-11;15553
2020-12-10;"Banskobystrický kraj";280;5501;369;5870;NA;157370;649;2020-12-10;14723
2020-12-09;"Banskobystrický kraj";323;3941;205;4146;NA;157370;528;2020-12-09;14074
2020-12-08;"Banskobystrický kraj";256;3782;272;4054;NA;157370;528;2020-12-08;13546
2020-12-07;"Banskobystrický kraj";175;2633;177;2810;NA;157370;352;2020-12-07;13018
2020-12-06;"Banskobystrický kraj";121;507;11;518;NA;157370;132;2020-12-06;12666
2020-12-05;"Banskobystrický kraj";109;1099;34;1133;NA;157370;143;2020-12-05;12534
2020-12-04;"Banskobystrický kraj";339;3828;174;4002;NA;157370;513;2020-12-04;12391
2020-12-03;"Banskobystrický kraj";240;3193;234;3427;NA;157370;474;2020-12-03;11878
2020-12-02;"Banskobystrický kraj";217;4442;186;4628;NA;157370;403;2020-12-02;11404
2020-12-01;"Banskobystrický kraj";215;2702;134;2836;NA;157370;349;2020-12-01;11001
2020-11-30;"Banskobystrický kraj";74;4314;241;4555;NA;157370;315;2020-11-30;10652
2020-11-29;"Banskobystrický kraj";19;208;7;215;NA;157370;26;2020-11-29;10337
2020-11-28;"Banskobystrický kraj";81;1408;55;1463;NA;157370;136;2020-11-28;10311
2020-11-27;"Banskobystrický kraj";219;2566;123;2689;NA;157370;342;2020-11-27;10175
2020-11-26;"Banskobystrický kraj";208;2124;93;2217;NA;157370;301;2020-11-26;9833
2020-11-25;"Banskobystrický kraj";170;1952;86;2038;NA;157370;256;2020-11-25;9532
2020-11-24;"Banskobystrický kraj";166;2566;69;2635;NA;157370;235;2020-11-24;9276
2020-11-23;"Banskobystrický kraj";66;10147;193;10340;NA;157370;259;2020-11-23;9041
2020-11-22;"Banskobystrický kraj";38;104;1;105;NA;157370;39;2020-11-22;8782
2020-11-21;"Banskobystrický kraj";52;904;14;918;NA;157370;66;2020-11-21;8743
2020-11-20;"Banskobystrický kraj";127;2005;107;2112;NA;157370;234;2020-11-20;8677
2020-11-19;"Banskobystrický kraj";170;1218;82;1300;NA;157370;252;2020-11-19;8443
2020-11-18;"Banskobystrický kraj";153;698;65;763;NA;157370;218;2020-11-18;8191
2020-11-17;"Banskobystrický kraj";52;578;35;613;NA;157370;87;2020-11-17;7973
2020-11-16;"Banskobystrický kraj";106;470;25;495;NA;157370;131;2020-11-16;7886
2020-11-15;"Banskobystrický kraj";52;301;4;305;NA;157370;56;2020-11-15;7755
2020-11-14;"Banskobystrický kraj";73;305;2;307;NA;157370;75;2020-11-14;7699
2020-11-13;"Banskobystrický kraj";157;552;11;563;NA;157370;168;2020-11-13;7624
2020-11-12;"Banskobystrický kraj";218;952;44;996;NA;157370;262;2020-11-12;7456
2020-11-11;"Banskobystrický kraj";224;437;9;446;NA;157370;233;2020-11-11;7194
2020-11-10;"Banskobystrický kraj";263;463;18;481;NA;157370;281;2020-11-10;6961
2020-11-09;"Banskobystrický kraj";80;2678;31;2709;NA;157370;111;2020-11-09;6680
2020-11-08;"Banskobystrický kraj";82;981;16;997;NA;157370;98;2020-11-08;6569
2020-11-07;"Banskobystrický kraj";164;8828;94;8922;NA;157370;258;2020-11-07;6471
2020-11-06;"Banskobystrický kraj";227;2496;16;2512;NA;157370;243;2020-11-06;6213
2020-11-05;"Banskobystrický kraj";240;290;33;323;NA;157370;273;2020-11-05;5970
2020-11-04;"Banskobystrický kraj";254;1366;13;1379;NA;157370;267;2020-11-04;5697
2020-11-03;"Banskobystrický kraj";246;1332;4;1336;NA;157370;250;2020-11-03;5430
2020-11-02;"Banskobystrický kraj";90;2909;65;2974;NA;157370;155;2020-11-02;5180
2020-11-01;"Banskobystrický kraj";101;2671;42;2713;NA;157370;143;2020-11-01;5025
2020-10-31;"Banskobystrický kraj";199;13516;116;13632;NA;157370;315;2020-10-31;4882
2020-10-30;"Banskobystrický kraj";254;2829;20;2849;NA;157370;274;2020-10-30;4567
2020-10-29;"Banskobystrický kraj";372;969;42;1011;NA;157370;414;2020-10-29;4293
2020-10-28;"Banskobystrický kraj";285;302;30;332;NA;157370;315;2020-10-28;3879
2020-10-27;"Banskobystrický kraj";266;654;40;694;NA;157370;306;2020-10-27;3564
2020-10-26;"Banskobystrický kraj";38;234;29;263;NA;157370;67;2020-10-26;3258
2020-10-25;"Banskobystrický kraj";50;140;11;151;NA;157370;61;2020-10-25;3191
2020-10-24;"Banskobystrický kraj";315;114;12;126;NA;157370;327;2020-10-24;3130
2020-10-23;"Banskobystrický kraj";231;230;29;259;NA;157370;260;2020-10-23;2803
2020-10-22;"Banskobystrický kraj";264;253;24;277;NA;157370;288;2020-10-22;2543
2020-10-21;"Banskobystrický kraj";209;266;3;269;NA;157370;212;2020-10-21;2255
2020-10-20;"Banskobystrický kraj";210;66;3;69;NA;157370;213;2020-10-20;2043
2020-10-19;"Banskobystrický kraj";27;73;12;85;NA;157370;39;2020-10-19;1830
2020-10-18;"Banskobystrický kraj";49;0;0;0;NA;157370;49;2020-10-18;1791
2020-10-17;"Banskobystrický kraj";91;0;0;0;NA;157370;91;2020-10-17;1742
2020-10-16;"Banskobystrický kraj";224;37;3;40;NA;157370;227;2020-10-16;1651
2020-10-15;"Banskobystrický kraj";133;29;1;30;NA;157370;134;2020-10-15;1424
2020-10-14;"Banskobystrický kraj";139;31;1;32;NA;157370;140;2020-10-14;1290
2020-10-13;"Banskobystrický kraj";151;169;11;180;NA;157370;162;2020-10-13;1150
2020-10-12;"Banskobystrický kraj";11;110;4;114;NA;157370;15;2020-10-12;988
2020-10-11;"Banskobystrický kraj";14;0;0;0;NA;157370;14;2020-10-11;973
2020-10-10;"Banskobystrický kraj";53;0;0;0;NA;157370;53;2020-10-10;959
2020-10-09;"Banskobystrický kraj";128;0;0;0;NA;157370;128;2020-10-09;906
2020-10-08;"Banskobystrický kraj";99;0;0;0;NA;157370;99;2020-10-08;778
2020-10-07;"Banskobystrický kraj";124;0;0;0;NA;157370;124;2020-10-07;679
2020-10-06;"Banskobystrický kraj";68;0;0;0;NA;157370;68;2020-10-06;555
2020-10-05;"Banskobystrický kraj";49;0;0;0;NA;157370;49;2020-10-05;487
2020-10-04;"Banskobystrický kraj";8;0;0;0;NA;157370;8;2020-10-04;438
2020-10-03;"Banskobystrický kraj";37;0;0;0;NA;157370;37;2020-10-03;430
2020-10-02;"Banskobystrický kraj";74;0;0;0;NA;157370;74;2020-10-02;393
2020-10-01;"Banskobystrický kraj";49;16;0;16;NA;157370;49;2020-10-01;319
2020-09-30;"Banskobystrický kraj";60;0;0;0;NA;157370;60;2020-09-30;270
2020-09-29;"Banskobystrický kraj";24;0;0;0;NA;157370;24;2020-09-29;210
2020-09-28;"Banskobystrický kraj";0;0;0;0;NA;157370;0;2020-09-28;186
2020-09-27;"Banskobystrický kraj";20;0;0;0;NA;157370;20;2020-09-27;186
2020-09-26;"Banskobystrický kraj";24;0;0;0;NA;157370;24;2020-09-26;166
2020-09-25;"Banskobystrický kraj";29;0;0;0;NA;157370;29;2020-09-25;142
2020-09-24;"Banskobystrický kraj";25;0;0;0;NA;157370;25;2020-09-24;113
2020-09-23;"Banskobystrický kraj";17;0;0;0;NA;157370;17;2020-09-23;88
2020-09-22;"Banskobystrický kraj";25;0;0;0;NA;157370;25;2020-09-22;71
2020-09-21;"Banskobystrický kraj";3;0;0;0;NA;157370;3;2020-09-21;46
2020-09-20;"Banskobystrický kraj";0;0;0;0;NA;157370;0;2020-09-20;43
2020-09-19;"Banskobystrický kraj";3;0;0;0;NA;157370;3;2020-09-19;43
2020-09-18;"Banskobystrický kraj";24;0;0;0;NA;157370;24;2020-09-18;40
2020-09-17;"Banskobystrický kraj";14;0;0;0;NA;157370;14;2020-09-17;16
2020-09-16;"Banskobystrický kraj";6;0;0;0;NA;157370;6;2020-09-16;2
2020-09-15;"Banskobystrický kraj";2;0;0;0;NA;157370;2;2020-09-15;-4
2020-09-14;"Banskobystrický kraj";13;0;0;0;NA;157370;13;2020-09-14;-6
2020-09-13;"Banskobystrický kraj";1;0;0;0;NA;157370;1;2020-09-13;-19
2020-09-12;"Banskobystrický kraj";5;0;0;0;NA;157370;5;2020-09-12;-20
2020-09-11;"Banskobystrický kraj";19;0;0;0;NA;157370;19;2020-09-11;-25
2020-09-10;"Banskobystrický kraj";11;0;0;0;NA;157370;11;2020-09-10;-44
2020-09-09;"Banskobystrický kraj";13;0;0;0;NA;157370;13;2020-09-09;-55
2020-09-08;"Banskobystrický kraj";5;0;0;0;NA;157370;5;2020-09-08;-68
2020-09-07;"Banskobystrický kraj";2;0;0;0;NA;157370;2;2020-09-07;-73
2020-09-06;"Banskobystrický kraj";0;0;0;0;NA;157370;0;2020-09-06;-75
2020-09-05;"Banskobystrický kraj";0;0;0;0;NA;157370;0;2020-09-05;-75
2020-09-04;"Banskobystrický kraj";9;0;0;0;NA;157370;9;2020-09-04;-75
2020-09-03;"Banskobystrický kraj";5;0;0;0;NA;157370;5;2020-09-03;-84
2020-09-02;"Banskobystrický kraj";6;0;0;0;NA;157370;6;2020-09-02;-89
2020-09-01;"Banskobystrický kraj";2;0;0;0;NA;157370;2;2020-09-01;-95
2020-08-31;"Banskobystrický kraj";6;0;0;0;NA;157370;6;2020-08-31;-97
2020-08-30;"Banskobystrický kraj";0;0;0;0;NA;157370;0;2020-08-30;-103
2020-08-29;"Banskobystrický kraj";1;0;0;0;NA;157370;1;2020-08-29;-103
2020-08-28;"Banskobystrický kraj";3;0;0;0;NA;157370;3;2020-08-28;-104
2020-08-27;"Banskobystrický kraj";1;0;0;0;NA;157370;1;2020-08-27;-107
2020-08-26;"Banskobystrický kraj";2;0;0;0;NA;157370;2;2020-08-26;-108
2020-08-25;"Banskobystrický kraj";2;0;0;0;NA;157370;2;2020-08-25;-110
2020-08-24;"Banskobystrický kraj";0;0;0;0;NA;157370;0;2020-08-24;-112
2020-08-23;"Banskobystrický kraj";0;0;0;0;NA;157370;0;2020-08-23;-112
2020-08-22;"Banskobystrický kraj";0;0;0;0;NA;157370;0;2020-08-22;-112
2020-08-21;"Banskobystrický kraj";4;0;0;0;NA;157370;4;2020-08-21;-112
2020-08-20;"Banskobystrický kraj";1;0;0;0;NA;157370;1;2020-08-20;-116
2020-08-19;"Banskobystrický kraj";4;0;0;0;NA;157370;4;2020-08-19;-117
2020-08-18;"Banskobystrický kraj";0;0;0;0;NA;157370;0;2020-08-18;-121
2020-08-17;"Banskobystrický kraj";1;0;0;0;NA;157370;1;2020-08-17;-121
2020-08-16;"Banskobystrický kraj";0;0;0;0;NA;157370;0;2020-08-16;-122
2020-08-15;"Banskobystrický kraj";0;0;0;0;NA;157370;0;2020-08-15;-122
2020-08-14;"Banskobystrický kraj";5;0;0;0;NA;157370;5;2020-08-14;-122
2020-08-13;"Banskobystrický kraj";0;0;0;0;NA;157370;0;2020-08-13;-127
2020-08-12;"Banskobystrický kraj";0;0;0;0;NA;157370;0;2020-08-12;-127
2020-08-11;"Banskobystrický kraj";2;0;0;0;NA;157370;2;2020-08-11;-127
2020-08-10;"Banskobystrický kraj";3;0;0;0;NA;157370;3;2020-08-10;-129
2020-08-09;"Banskobystrický kraj";0;0;0;0;NA;157370;0;2020-08-09;-132
2020-08-08;"Banskobystrický kraj";2;0;0;0;NA;157370;2;2020-08-08;-132
2020-08-07;"Banskobystrický kraj";1;0;0;0;NA;157370;1;2020-08-07;-134
2020-08-06;"Banskobystrický kraj";1;0;0;0;NA;157370;1;2020-08-06;-135
2020-08-05;"Banskobystrický kraj";0;0;0;0;NA;157370;0;2020-08-05;-136
2020-08-04;"Banskobystrický kraj";3;0;0;0;NA;157370;3;2020-08-04;-136
2020-08-03;"Banskobystrický kraj";0;0;0;0;NA;157370;0;2020-08-03;-139
2020-08-02;"Banskobystrický kraj";0;0;0;0;NA;157370;0;2020-08-02;-139
2020-08-01;"Banskobystrický kraj";1;0;0;0;NA;157370;1;2020-08-01;-139
2020-07-31;"Banskobystrický kraj";2;0;0;0;NA;157370;2;2020-07-31;-140
2020-07-30;"Banskobystrický kraj";1;0;0;0;NA;157370;1;2020-07-30;-142
2020-07-29;"Banskobystrický kraj";0;0;0;0;NA;157370;0;2020-07-29;-143
2020-07-28;"Banskobystrický kraj";2;0;0;0;NA;157370;2;2020-07-28;-143
2020-07-27;"Banskobystrický kraj";3;0;0;0;NA;157370;3;2020-07-27;-145
2020-07-26;"Banskobystrický kraj";0;0;0;0;NA;157370;0;2020-07-26;-148
2020-07-25;"Banskobystrický kraj";0;0;0;0;NA;157370;0;2020-07-25;-148
2020-07-24;"Banskobystrický kraj";9;0;0;0;NA;157370;9;2020-07-24;-148
2020-07-23;"Banskobystrický kraj";0;0;0;0;NA;157370;0;2020-07-23;-157
2020-07-22;"Banskobystrický kraj";3;0;0;0;NA;157370;3;2020-07-22;-157
2020-07-21;"Banskobystrický kraj";3;0;0;0;NA;157370;3;2020-07-21;-160
2020-07-20;"Banskobystrický kraj";1;0;0;0;NA;157370;1;2020-07-20;-163
2020-07-19;"Banskobystrický kraj";1;0;0;0;NA;157370;1;2020-07-19;-164
2020-07-18;"Banskobystrický kraj";0;0;0;0;NA;157370;0;2020-07-18;-165
2020-07-17;"Banskobystrický kraj";2;0;0;0;NA;157370;2;2020-07-17;-165
2020-07-16;"Banskobystrický kraj";1;0;0;0;NA;157370;1;2020-07-16;-167
2020-07-15;"Banskobystrický kraj";4;0;0;0;NA;157370;4;2020-07-15;-168
2020-07-14;"Banskobystrický kraj";2;0;0;0;NA;157370;2;2020-07-14;-172
2020-07-13;"Banskobystrický kraj";1;0;0;0;NA;157370;1;2020-07-13;-174
2020-07-12;"Banskobystrický kraj";0;0;0;0;NA;157370;0;2020-07-12;-175
2020-07-11;"Banskobystrický kraj";0;0;0;0;NA;157370;0;2020-07-11;-175
2020-07-10;"Banskobystrický kraj";3;0;0;0;NA;157370;3;2020-07-10;-175
2020-07-09;"Banskobystrický kraj";9;0;0;0;NA;157370;9;2020-07-09;-178
2020-07-08;"Banskobystrický kraj";0;0;0;0;NA;157370;0;2020-07-08;-187
2020-07-07;"Banskobystrický kraj";4;0;0;0;NA;157370;4;2020-07-07;-187
2020-07-06;"Banskobystrický kraj";0;0;0;0;NA;157370;0;2020-07-06;-191
2020-07-05;"Banskobystrický kraj";0;0;0;0;NA;157370;0;2020-07-05;-191
2020-07-04;"Banskobystrický kraj";1;0;0;0;NA;157370;1;2020-07-04;-191
2020-07-03;"Banskobystrický kraj";4;0;0;0;NA;157370;4;2020-07-03;-192
2020-07-02;"Banskobystrický kraj";0;0;0;0;NA;157370;0;2020-07-02;-196
2020-07-01;"Banskobystrický kraj";1;0;0;0;NA;157370;1;2020-07-01;-196
2020-06-30;"Banskobystrický kraj";0;12;0;12;NA;157370;0;2020-06-30;-197
2020-06-29;"Banskobystrický kraj";0;0;0;0;NA;157370;0;2020-06-29;-197
2020-06-28;"Banskobystrický kraj";0;0;0;0;NA;157370;0;2020-06-28;-197
2020-06-27;"Banskobystrický kraj";0;0;0;0;NA;157370;0;2020-06-27;-197
2020-06-26;"Banskobystrický kraj";0;0;0;0;NA;157370;0;2020-06-26;-197
2020-06-25;"Banskobystrický kraj";1;0;0;0;NA;157370;1;2020-06-25;-197
2020-06-24;"Banskobystrický kraj";0;0;0;0;NA;157370;0;2020-06-24;-198
2020-06-23;"Banskobystrický kraj";6;0;0;0;NA;157370;6;2020-06-23;-198
2020-06-22;"Banskobystrický kraj";0;0;0;0;NA;157370;0;2020-06-22;-204
2020-06-21;"Banskobystrický kraj";0;0;0;0;NA;157370;0;2020-06-21;-204
2020-06-20;"Banskobystrický kraj";0;0;0;0;NA;157370;0;2020-06-20;-204
2020-06-19;"Banskobystrický kraj";2;0;0;0;NA;157370;2;2020-06-19;-204
2020-06-18;"Banskobystrický kraj";10;0;0;0;NA;157370;10;2020-06-18;-206
2020-06-17;"Banskobystrický kraj";1;0;0;0;NA;157370;1;2020-06-17;-216
2020-06-16;"Banskobystrický kraj";0;0;0;0;NA;157370;0;2020-06-16;-217
2020-06-14;"Banskobystrický kraj";2;0;0;0;NA;157370;2;2020-06-14;-217
2020-06-13;"Banskobystrický kraj";2;0;0;0;NA;157370;2;2020-06-13;-219
2020-06-12;"Banskobystrický kraj";0;0;0;0;NA;157370;0;2020-06-12;-221
2020-06-11;"Banskobystrický kraj";1;0;0;0;NA;157370;1;2020-06-11;-221
2020-06-10;"Banskobystrický kraj";0;0;0;0;NA;157370;0;2020-06-10;-222
2020-06-09;"Banskobystrický kraj";0;0;0;0;NA;157370;0;2020-06-09;-222
2020-06-08;"Banskobystrický kraj";0;0;0;0;NA;157370;0;2020-06-08;-222
2020-06-07;"Banskobystrický kraj";0;0;0;0;NA;157370;0;2020-06-07;-222
2020-06-05;"Banskobystrický kraj";2;0;0;0;NA;157370;2;2020-06-05;-222
2020-06-03;"Banskobystrický kraj";0;0;0;0;NA;157370;0;2020-06-03;-224
2020-06-02;"Banskobystrický kraj";0;0;0;0;NA;157370;0;2020-06-02;-224
2020-05-31;"Banskobystrický kraj";0;0;0;0;NA;157370;0;2020-05-31;-224
2020-05-29;"Banskobystrický kraj";0;0;0;0;NA;157370;0;2020-05-29;-224
2020-05-27;"Banskobystrický kraj";1;0;0;0;NA;157370;1;2020-05-27;-224
2020-05-26;"Banskobystrický kraj";0;0;0;0;NA;157370;0;2020-05-26;-225
2020-05-25;"Banskobystrický kraj";0;0;0;0;NA;157370;0;2020-05-25;-225
2020-05-24;"Banskobystrický kraj";0;0;0;0;NA;157370;0;2020-05-24;-225
2020-05-23;"Banskobystrický kraj";1;0;0;0;NA;157370;1;2020-05-23;-225
2020-05-22;"Banskobystrický kraj";0;0;0;0;NA;157370;0;2020-05-22;-226
2020-05-21;"Banskobystrický kraj";0;0;0;0;NA;157370;0;2020-05-21;-226
2020-05-20;"Banskobystrický kraj";1;0;0;0;NA;157370;1;2020-05-20;-226
2020-05-19;"Banskobystrický kraj";0;0;0;0;NA;157370;0;2020-05-19;-227
2020-05-17;"Banskobystrický kraj";0;0;0;0;NA;157370;0;2020-05-17;-227
2020-05-16;"Banskobystrický kraj";0;0;0;0;NA;157370;0;2020-05-16;-227
2020-05-15;"Banskobystrický kraj";0;0;0;0;NA;157370;0;2020-05-15;-227
2020-05-14;"Banskobystrický kraj";0;0;0;0;NA;157370;0;2020-05-14;-227
2020-05-13;"Banskobystrický kraj";0;0;0;0;NA;157370;0;2020-05-13;-227
2020-05-12;"Banskobystrický kraj";1;0;0;0;NA;157370;1;2020-05-12;-227
2020-05-11;"Banskobystrický kraj";0;0;0;0;NA;157370;0;2020-05-11;-228
2020-05-09;"Banskobystrický kraj";0;0;0;0;NA;157370;0;2020-05-09;-228
2020-05-07;"Banskobystrický kraj";2;0;0;0;NA;157370;2;2020-05-07;-228
2020-05-06;"Banskobystrický kraj";1;0;0;0;NA;157370;1;2020-05-06;-230
2020-05-05;"Banskobystrický kraj";2;0;0;0;NA;157370;2;2020-05-05;-231
2020-05-04;"Banskobystrický kraj";0;0;0;0;NA;157370;0;2020-05-04;-233
2020-05-03;"Banskobystrický kraj";0;0;0;0;NA;157370;0;2020-05-03;-233
2020-05-02;"Banskobystrický kraj";0;0;0;0;NA;157370;0;2020-05-02;-233
2020-05-01;"Banskobystrický kraj";0;0;0;0;NA;157370;0;2020-05-01;-233
2020-04-30;"Banskobystrický kraj";1;0;0;0;NA;157370;1;2020-04-30;-233
2020-04-29;"Banskobystrický kraj";1;0;0;0;NA;157370;1;2020-04-29;-234
2020-04-28;"Banskobystrický kraj";0;0;0;0;NA;157370;0;2020-04-28;-235
2020-04-27;"Banskobystrický kraj";0;0;0;0;NA;157370;0;2020-04-27;-235
2020-04-26;"Banskobystrický kraj";0;0;0;0;NA;157370;0;2020-04-26;-235
2020-04-25;"Banskobystrický kraj";2;0;0;0;NA;157370;2;2020-04-25;-235
2020-04-24;"Banskobystrický kraj";3;0;0;0;NA;157370;3;2020-04-24;-237
2020-04-23;"Banskobystrický kraj";2;0;0;0;NA;157370;2;2020-04-23;-240
2020-04-22;"Banskobystrický kraj";2;0;0;0;NA;157370;2;2020-04-22;-242
2020-04-21;"Banskobystrický kraj";2;0;0;0;NA;157370;2;2020-04-21;-244
2020-04-20;"Banskobystrický kraj";0;0;0;0;NA;157370;0;2020-04-20;-246
2020-04-19;"Banskobystrický kraj";0;0;0;0;NA;157370;0;2020-04-19;-246
2020-04-18;"Banskobystrický kraj";8;0;0;0;NA;157370;8;2020-04-18;-246
2020-04-17;"Banskobystrický kraj";2;0;0;0;NA;157370;2;2020-04-17;-254
2020-04-16;"Banskobystrický kraj";0;0;0;0;NA;157370;0;2020-04-16;-256
2020-04-15;"Banskobystrický kraj";10;0;0;0;NA;157370;10;2020-04-15;-256
2020-04-14;"Banskobystrický kraj";0;0;0;0;NA;157370;0;2020-04-14;-266
2020-04-13;"Banskobystrický kraj";2;0;0;0;NA;157370;2;2020-04-13;-266
2020-04-12;"Banskobystrický kraj";4;0;0;0;NA;157370;4;2020-04-12;-268
2020-04-11;"Banskobystrický kraj";1;0;0;0;NA;157370;1;2020-04-11;-272
2020-04-10;"Banskobystrický kraj";0;0;0;0;NA;157370;0;2020-04-10;-273
2020-04-09;"Banskobystrický kraj";2;0;0;0;NA;157370;2;2020-04-09;-273
2020-04-08;"Banskobystrický kraj";0;0;0;0;NA;157370;0;2020-04-08;-275
2020-04-07;"Banskobystrický kraj";4;0;0;0;NA;157370;4;2020-04-07;-275
2020-04-06;"Banskobystrický kraj";10;0;0;0;NA;157370;10;2020-04-06;-279
2020-04-05;"Banskobystrický kraj";9;0;0;0;NA;157370;9;2020-04-05;-289
2020-04-04;"Banskobystrický kraj";0;0;0;0;NA;157370;0;2020-04-04;-298
2020-04-03;"Banskobystrický kraj";2;0;0;0;NA;157370;2;2020-04-03;-298
2020-04-02;"Banskobystrický kraj";2;0;0;0;NA;157370;2;2020-04-02;-300
2020-04-01;"Banskobystrický kraj";5;0;0;0;NA;157370;5;2020-04-01;-302
2020-03-31;"Banskobystrický kraj";3;0;0;0;NA;157370;3;2020-03-31;-307
2020-03-30;"Banskobystrický kraj";1;0;0;0;NA;157370;1;2020-03-30;-310
2020-03-29;"Banskobystrický kraj";2;0;0;0;NA;157370;2;2020-03-29;-311
2020-03-28;"Banskobystrický kraj";1;0;0;0;NA;157370;1;2020-03-28;-313
2020-03-27;"Banskobystrický kraj";1;0;0;0;NA;157370;1;2020-03-27;-314
2020-03-26;"Banskobystrický kraj";1;0;0;0;NA;157370;1;2020-03-26;-315
2020-03-25;"Banskobystrický kraj";0;0;0;0;NA;157370;0;2020-03-25;-316
2020-03-24;"Banskobystrický kraj";1;0;0;0;NA;157370;1;2020-03-24;-316
2020-03-23;"Banskobystrický kraj";1;0;0;0;NA;157370;1;2020-03-23;-317
2020-03-22;"Banskobystrický kraj";0;0;0;0;NA;157370;0;2020-03-22;-318
2020-03-21;"Banskobystrický kraj";3;0;0;0;NA;157370;3;2020-03-21;-318
2020-03-20;"Banskobystrický kraj";0;0;0;0;NA;157370;0;2020-03-20;-321
2020-03-19;"Banskobystrický kraj";2;0;0;0;NA;157370;2;2020-03-19;-321
2020-03-18;"Banskobystrický kraj";1;0;0;0;NA;157370;1;2020-03-18;-323
2020-03-17;"Banskobystrický kraj";1;0;0;0;NA;157370;1;2020-03-17;-324
2020-03-16;"Banskobystrický kraj";0;0;0;0;NA;157370;0;2020-03-16;-325
2020-03-15;"Banskobystrický kraj";1;0;0;0;NA;157370;1;2020-03-15;-325
2020-03-14;"Banskobystrický kraj";0;0;0;0;NA;157370;0;2020-03-14;-326
2020-03-13;"Banskobystrický kraj";1;0;0;0;NA;157370;1;2020-03-13;-326
2020-03-12;"Banskobystrický kraj";0;0;0;0;NA;157370;0;2020-03-12;-327
2020-03-11;"Banskobystrický kraj";0;0;0;0;NA;157370;0;2020-03-11;-327
2020-03-09;"Banskobystrický kraj";0;0;0;0;NA;157370;0;2020-03-09;-327
2020-03-08;"Banskobystrický kraj";0;0;0;0;NA;157370;0;2020-03-08;-327
2020-03-07;"Banskobystrický kraj";0;0;0;0;NA;157370;0;2020-03-07;-327
2020-03-06;"Banskobystrický kraj";0;0;0;0;NA;157370;0;2020-03-06;-327
2022-01-11;"Bratislavský kraj";407;0;0;0;106610;173735;407;2022-01-11;173735
2022-01-10;"Bratislavský kraj";413;0;0;0;NA;173735;413;2022-01-10;173328
2022-01-09;"Bratislavský kraj";187;2199;46;2245;NA;173735;233;2022-01-09;172915
2022-01-08;"Bratislavský kraj";323;1730;45;1775;NA;173735;368;2022-01-08;172682
2022-01-07;"Bratislavský kraj";436;3325;87;3412;NA;173735;523;2022-01-07;172314
2022-01-06;"Bratislavský kraj";192;2160;51;2211;NA;173735;243;2022-01-06;171791
2022-01-05;"Bratislavský kraj";426;4016;69;4085;NA;173735;495;2022-01-05;171548
2022-01-04;"Bratislavský kraj";446;4465;100;4565;NA;173735;546;2022-01-04;171053
2022-01-03;"Bratislavský kraj";578;5226;126;5352;NA;173735;704;2022-01-03;170507
2022-01-02;"Bratislavský kraj";198;3137;80;3217;NA;173735;278;2022-01-02;169803
2022-01-01;"Bratislavský kraj";7;1103;36;1139;NA;173735;43;2022-01-01;169525
2021-12-31;"Bratislavský kraj";371;3443;92;3535;NA;173735;463;2021-12-31;169482
2021-12-30;"Bratislavský kraj";468;3589;119;3708;NA;173735;587;2021-12-30;169019
2021-12-29;"Bratislavský kraj";404;3598;85;3683;NA;173735;489;2021-12-29;168432
2021-12-28;"Bratislavský kraj";578;4327;121;4448;NA;173735;699;2021-12-28;167943
2021-12-27;"Bratislavský kraj";656;4640;108;4748;NA;173735;764;2021-12-27;167244
2021-12-26;"Bratislavský kraj";198;2549;83;2632;NA;173735;281;2021-12-26;166480
2021-12-25;"Bratislavský kraj";34;1160;53;1213;NA;173735;87;2021-12-25;166199
2021-12-24;"Bratislavský kraj";171;2214;55;2269;NA;173735;226;2021-12-24;166112
2021-12-23;"Bratislavský kraj";678;4095;115;4210;NA;173735;793;2021-12-23;165886
2021-12-22;"Bratislavský kraj";575;4913;118;5031;NA;173735;693;2021-12-22;165093
2021-12-21;"Bratislavský kraj";625;5628;167;5795;NA;173735;792;2021-12-21;164400
2021-12-20;"Bratislavský kraj";528;6081;157;6238;NA;173735;685;2021-12-20;163608
2021-12-19;"Bratislavský kraj";250;3042;98;3140;NA;173735;348;2021-12-19;162923
2021-12-18;"Bratislavský kraj";528;2654;103;2757;NA;173735;631;2021-12-18;162575
2021-12-17;"Bratislavský kraj";683;4917;145;5062;NA;173735;828;2021-12-17;161944
2021-12-16;"Bratislavský kraj";730;5491;161;5652;NA;173735;891;2021-12-16;161116
2021-12-15;"Bratislavský kraj";881;4884;158;5042;NA;173735;1039;2021-12-15;160225
2021-12-14;"Bratislavský kraj";869;5397;179;5576;NA;173735;1048;2021-12-14;159186
2021-12-13;"Bratislavský kraj";648;7506;236;7742;NA;173735;884;2021-12-13;158138
2021-12-12;"Bratislavský kraj";534;3474;129;3603;NA;173735;663;2021-12-12;157254
2021-12-11;"Bratislavský kraj";698;2377;153;2530;NA;173735;851;2021-12-11;156591
2021-12-10;"Bratislavský kraj";796;4728;186;4914;NA;173735;982;2021-12-10;155740
2021-12-09;"Bratislavský kraj";1040;4042;172;4214;NA;173735;1212;2021-12-09;154758
2021-12-08;"Bratislavský kraj";1172;4602;196;4798;NA;173735;1368;2021-12-08;153546
2021-12-07;"Bratislavský kraj";1236;5173;257;5430;NA;173735;1493;2021-12-07;152178
2021-12-06;"Bratislavský kraj";1434;8639;310;8949;NA;173735;1744;2021-12-06;150685
2021-12-05;"Bratislavský kraj";633;3874;197;4071;NA;173735;830;2021-12-05;148941
2021-12-04;"Bratislavský kraj";936;4332;195;4527;NA;173735;1131;2021-12-04;148111
2021-12-03;"Bratislavský kraj";1222;4351;269;4620;NA;173735;1491;2021-12-03;146980
2021-12-02;"Bratislavský kraj";2053;5097;311;5408;NA;173735;2364;2021-12-02;145489
2021-12-01;"Bratislavský kraj";1161;9051;295;9346;NA;173735;1456;2021-12-01;143125
2021-11-30;"Bratislavský kraj";1442;6508;355;6863;NA;173735;1797;2021-11-30;141669
2021-11-29;"Bratislavský kraj";863;8821;452;9273;NA;173735;1315;2021-11-29;139872
2021-11-28;"Bratislavský kraj";617;5102;295;5397;NA;173735;912;2021-11-28;138557
2021-11-27;"Bratislavský kraj";1026;3497;329;3826;NA;173735;1355;2021-11-27;137645
2021-11-26;"Bratislavský kraj";1346;5483;422;5905;NA;173735;1768;2021-11-26;136290
2021-11-25;"Bratislavský kraj";1415;6383;451;6834;NA;173735;1866;2021-11-25;134522
2021-11-24;"Bratislavský kraj";1286;6849;467;7316;NA;173735;1753;2021-11-24;132656
2021-11-23;"Bratislavský kraj";1651;6351;433;6784;NA;173735;2084;2021-11-23;130903
2021-11-22;"Bratislavský kraj";1197;8722;584;9306;NA;173735;1781;2021-11-22;128819
2021-11-21;"Bratislavský kraj";702;4324;320;4644;NA;173735;1022;2021-11-21;127038
2021-11-20;"Bratislavský kraj";1005;3514;360;3874;NA;173735;1365;2021-11-20;126016
2021-11-19;"Bratislavský kraj";1444;5927;549;6476;NA;173735;1993;2021-11-19;124651
2021-11-18;"Bratislavský kraj";1052;6358;548;6906;NA;173735;1600;2021-11-18;122658
2021-11-17;"Bratislavský kraj";832;2439;308;2747;NA;173735;1140;2021-11-17;121058
2021-11-16;"Bratislavský kraj";1067;5792;443;6235;NA;173735;1510;2021-11-16;119918
2021-11-15;"Bratislavský kraj";1014;6330;519;6849;NA;173735;1533;2021-11-15;118408
2021-11-14;"Bratislavský kraj";448;3202;335;3537;NA;173735;783;2021-11-14;116875
2021-11-13;"Bratislavský kraj";587;3251;313;3564;NA;173735;900;2021-11-13;116092
2021-11-12;"Bratislavský kraj";856;5723;357;6080;NA;173735;1213;2021-11-12;115192
2021-11-11;"Bratislavský kraj";787;6028;355;6383;NA;173735;1142;2021-11-11;113979
2021-11-10;"Bratislavský kraj";840;5903;385;6288;NA;173735;1225;2021-11-10;112837
2021-11-09;"Bratislavský kraj";939;5733;350;6083;NA;173735;1289;2021-11-09;111612
2021-11-08;"Bratislavský kraj";579;5641;404;6045;NA;173735;983;2021-11-08;110323
2021-11-07;"Bratislavský kraj";363;2836;244;3080;NA;173735;607;2021-11-07;109340
2021-11-06;"Bratislavský kraj";538;2901;243;3144;NA;173735;781;2021-11-06;108733
2021-11-05;"Bratislavský kraj";801;5640;318;5958;NA;173735;1119;2021-11-05;107952
2021-11-04;"Bratislavský kraj";768;5233;273;5506;NA;173735;1041;2021-11-04;106833
2021-11-03;"Bratislavský kraj";690;5120;290;5410;NA;173735;980;2021-11-03;105792
2021-11-02;"Bratislavský kraj";422;6356;327;6683;NA;173735;749;2021-11-02;104812
2021-11-01;"Bratislavský kraj";395;1733;136;1869;NA;173735;531;2021-11-01;104063
2021-10-31;"Bratislavský kraj";209;2280;163;2443;NA;173735;372;2021-10-31;103532
2021-10-30;"Bratislavský kraj";429;2138;118;2256;NA;173735;547;2021-10-30;103160
2021-10-29;"Bratislavský kraj";445;4757;219;4976;NA;173735;664;2021-10-29;102613
2021-10-28;"Bratislavský kraj";372;4777;179;4956;NA;173735;551;2021-10-28;101949
2021-10-27;"Bratislavský kraj";376;4522;164;4686;NA;173735;540;2021-10-27;101398
2021-10-26;"Bratislavský kraj";461;4492;188;4680;NA;173735;649;2021-10-26;100858
2021-10-25;"Bratislavský kraj";379;5347;192;5539;NA;173735;571;2021-10-25;100209
2021-10-24;"Bratislavský kraj";114;2369;91;2460;NA;173735;205;2021-10-24;99638
2021-10-23;"Bratislavský kraj";301;2666;91;2757;NA;173735;392;2021-10-23;99433
2021-10-22;"Bratislavský kraj";309;4466;122;4588;NA;173735;431;2021-10-22;99041
2021-10-21;"Bratislavský kraj";244;4544;101;4645;NA;173735;345;2021-10-21;98610
2021-10-20;"Bratislavský kraj";262;3897;95;3992;NA;173735;357;2021-10-20;98265
2021-10-19;"Bratislavský kraj";260;4116;68;4184;NA;173735;328;2021-10-19;97908
2021-10-18;"Bratislavský kraj";250;5014;114;5128;NA;173735;364;2021-10-18;97580
2021-10-17;"Bratislavský kraj";54;2460;73;2533;NA;173735;127;2021-10-17;97216
2021-10-16;"Bratislavský kraj";185;2687;63;2750;NA;173735;248;2021-10-16;97089
2021-10-15;"Bratislavský kraj";169;4200;64;4264;NA;173735;233;2021-10-15;96841
2021-10-14;"Bratislavský kraj";173;4714;61;4775;NA;173735;234;2021-10-14;96608
2021-10-13;"Bratislavský kraj";143;3671;76;3747;NA;173735;219;2021-10-13;96374
2021-10-12;"Bratislavský kraj";183;4037;78;4115;NA;173735;261;2021-10-12;96155
2021-10-11;"Bratislavský kraj";191;4798;88;4886;NA;173735;279;2021-10-11;95894
2021-10-10;"Bratislavský kraj";29;2176;43;2219;NA;173735;72;2021-10-10;95615
2021-10-09;"Bratislavský kraj";141;2419;34;2453;NA;173735;175;2021-10-09;95543
2021-10-08;"Bratislavský kraj";130;4511;63;4574;NA;173735;193;2021-10-08;95368
2021-10-07;"Bratislavský kraj";92;4137;61;4198;NA;173735;153;2021-10-07;95175
2021-10-06;"Bratislavský kraj";147;4028;68;4096;NA;173735;215;2021-10-06;95022
2021-10-05;"Bratislavský kraj";164;4468;70;4538;NA;173735;234;2021-10-05;94807
2021-10-04;"Bratislavský kraj";129;4653;79;4732;NA;173735;208;2021-10-04;94573
2021-10-03;"Bratislavský kraj";41;2144;42;2186;NA;173735;83;2021-10-03;94365
2021-10-02;"Bratislavský kraj";104;2605;40;2645;NA;173735;144;2021-10-02;94282
2021-10-01;"Bratislavský kraj";108;4818;57;4875;NA;173735;165;2021-10-01;94138
2021-09-30;"Bratislavský kraj";90;3854;60;3914;NA;173735;150;2021-09-30;93973
2021-09-29;"Bratislavský kraj";115;3508;58;3566;NA;173735;173;2021-09-29;93823
2021-09-28;"Bratislavský kraj";144;4003;48;4051;NA;173735;192;2021-09-28;93650
2021-09-27;"Bratislavský kraj";123;4427;70;4497;NA;173735;193;2021-09-27;93458
2021-09-26;"Bratislavský kraj";32;2194;31;2225;NA;173735;63;2021-09-26;93265
2021-09-25;"Bratislavský kraj";85;2742;38;2780;NA;173735;123;2021-09-25;93202
2021-09-24;"Bratislavský kraj";82;4212;59;4271;NA;173735;141;2021-09-24;93079
2021-09-23;"Bratislavský kraj";90;3975;51;4026;NA;173735;141;2021-09-23;92938
2021-09-22;"Bratislavský kraj";84;3757;63;3820;NA;173735;147;2021-09-22;92797
2021-09-21;"Bratislavský kraj";95;3574;39;3613;NA;173735;134;2021-09-21;92650
2021-09-20;"Bratislavský kraj";84;3937;31;3968;NA;173735;115;2021-09-20;92516
2021-09-19;"Bratislavský kraj";31;1850;28;1878;NA;173735;59;2021-09-19;92401
2021-09-18;"Bratislavský kraj";60;1989;19;2008;NA;173735;79;2021-09-18;92342
2021-09-17;"Bratislavský kraj";87;3443;27;3470;NA;173735;114;2021-09-17;92263
2021-09-16;"Bratislavský kraj";57;3781;43;3824;NA;173735;100;2021-09-16;92149
2021-09-15;"Bratislavský kraj";41;1104;21;1125;NA;173735;62;2021-09-15;92049
2021-09-14;"Bratislavský kraj";78;3518;31;3549;NA;173735;109;2021-09-14;91987
2021-09-13;"Bratislavský kraj";47;3191;28;3219;NA;173735;75;2021-09-13;91878
2021-09-12;"Bratislavský kraj";13;1713;21;1734;NA;173735;34;2021-09-12;91803
2021-09-11;"Bratislavský kraj";36;2064;13;2077;NA;173735;49;2021-09-11;91769
2021-09-10;"Bratislavský kraj";47;3628;18;3646;NA;173735;65;2021-09-10;91720
2021-09-09;"Bratislavský kraj";50;3010;30;3040;NA;173735;80;2021-09-09;91655
2021-09-08;"Bratislavský kraj";56;2925;20;2945;NA;173735;76;2021-09-08;91575
2021-09-07;"Bratislavský kraj";50;3272;18;3290;NA;173735;68;2021-09-07;91499
2021-09-06;"Bratislavský kraj";63;2821;29;2850;NA;173735;92;2021-09-06;91431
2021-09-05;"Bratislavský kraj";10;1682;14;1696;NA;173735;24;2021-09-05;91339
2021-09-04;"Bratislavský kraj";41;2612;11;2623;NA;173735;52;2021-09-04;91315
2021-09-03;"Bratislavský kraj";55;3016;14;3030;NA;173735;69;2021-09-03;91263
2021-09-02;"Bratislavský kraj";35;2423;23;2446;NA;173735;58;2021-09-02;91194
2021-09-01;"Bratislavský kraj";16;929;9;938;NA;173735;25;2021-09-01;91136
2021-08-31;"Bratislavský kraj";28;5197;22;5219;NA;173735;50;2021-08-31;91111
2021-08-30;"Bratislavský kraj";24;2403;13;2416;NA;173735;37;2021-08-30;91061
2021-08-29;"Bratislavský kraj";11;1016;6;1022;NA;173735;17;2021-08-29;91024
2021-08-28;"Bratislavský kraj";24;1714;11;1725;NA;173735;35;2021-08-28;91007
2021-08-27;"Bratislavský kraj";19;2850;9;2859;NA;173735;28;2021-08-27;90972
2021-08-26;"Bratislavský kraj";15;2382;19;2401;NA;173735;34;2021-08-26;90944
2021-08-25;"Bratislavský kraj";29;1888;10;1898;NA;173735;39;2021-08-25;90910
2021-08-24;"Bratislavský kraj";22;1785;4;1789;NA;173735;26;2021-08-24;90871
2021-08-23;"Bratislavský kraj";21;2183;7;2190;NA;173735;28;2021-08-23;90845
2021-08-22;"Bratislavský kraj";5;1383;8;1391;NA;173735;13;2021-08-22;90817
2021-08-21;"Bratislavský kraj";18;1681;4;1685;NA;173735;22;2021-08-21;90804
2021-08-20;"Bratislavský kraj";27;2747;19;2766;NA;173735;46;2021-08-20;90782
2021-08-19;"Bratislavský kraj";15;2122;9;2131;NA;173735;24;2021-08-19;90736
2021-08-18;"Bratislavský kraj";16;1659;11;1670;NA;173735;27;2021-08-18;90712
2021-08-17;"Bratislavský kraj";18;1608;5;1613;NA;173735;23;2021-08-17;90685
2021-08-16;"Bratislavský kraj";18;2559;12;2571;NA;173735;30;2021-08-16;90662
2021-08-15;"Bratislavský kraj";3;1169;6;1175;NA;173735;9;2021-08-15;90632
2021-08-14;"Bratislavský kraj";11;1519;4;1523;NA;173735;15;2021-08-14;90623
2021-08-13;"Bratislavský kraj";32;2634;7;2641;NA;173735;39;2021-08-13;90608
2021-08-12;"Bratislavský kraj";16;1824;9;1833;NA;173735;25;2021-08-12;90569
2021-08-11;"Bratislavský kraj";22;1621;5;1626;NA;173735;27;2021-08-11;90544
2021-08-10;"Bratislavský kraj";15;1630;7;1637;NA;173735;22;2021-08-10;90517
2021-08-09;"Bratislavský kraj";35;1927;9;1936;NA;173735;44;2021-08-09;90495
2021-08-08;"Bratislavský kraj";3;1152;4;1156;NA;173735;7;2021-08-08;90451
2021-08-07;"Bratislavský kraj";6;1572;9;1581;NA;173735;15;2021-08-07;90444
2021-08-06;"Bratislavský kraj";9;2510;10;2520;NA;173735;19;2021-08-06;90429
2021-08-05;"Bratislavský kraj";10;1651;7;1658;NA;173735;17;2021-08-05;90410
2021-08-04;"Bratislavský kraj";9;1578;0;1578;NA;173735;9;2021-08-04;90393
2021-08-03;"Bratislavský kraj";11;1507;5;1512;NA;173735;16;2021-08-03;90384
2021-08-02;"Bratislavský kraj";15;1749;11;1760;NA;173735;26;2021-08-02;90368
2021-08-01;"Bratislavský kraj";4;1224;8;1232;NA;173735;12;2021-08-01;90342
2021-07-31;"Bratislavský kraj";7;1623;2;1625;NA;173735;9;2021-07-31;90330
2021-07-30;"Bratislavský kraj";15;2540;7;2547;NA;173735;22;2021-07-30;90321
2021-07-29;"Bratislavský kraj";19;1790;7;1797;NA;173735;26;2021-07-29;90299
2021-07-28;"Bratislavský kraj";8;1538;11;1549;NA;173735;19;2021-07-28;90273
2021-07-27;"Bratislavský kraj";9;1476;5;1481;NA;173735;14;2021-07-27;90254
2021-07-26;"Bratislavský kraj";17;1806;7;1813;NA;173735;24;2021-07-26;90240
2021-07-25;"Bratislavský kraj";4;1411;2;1413;NA;173735;6;2021-07-25;90216
2021-07-24;"Bratislavský kraj";9;1732;3;1735;NA;173735;12;2021-07-24;90210
2021-07-23;"Bratislavský kraj";6;2400;3;2403;NA;173735;9;2021-07-23;90198
2021-07-22;"Bratislavský kraj";12;1944;6;1950;NA;173735;18;2021-07-22;90189
2021-07-21;"Bratislavský kraj";5;1860;6;1866;NA;173735;11;2021-07-21;90171
2021-07-20;"Bratislavský kraj";19;1559;1;1560;NA;173735;20;2021-07-20;90160
2021-07-19;"Bratislavský kraj";15;2259;3;2262;NA;173735;18;2021-07-19;90140
2021-07-18;"Bratislavský kraj";2;1462;3;1465;NA;173735;5;2021-07-18;90122
2021-07-17;"Bratislavský kraj";3;1870;2;1872;NA;173735;5;2021-07-17;90117
2021-07-16;"Bratislavský kraj";8;2834;4;2838;NA;173735;12;2021-07-16;90112
2021-07-15;"Bratislavský kraj";5;1677;0;1677;NA;173735;5;2021-07-15;90100
2021-07-14;"Bratislavský kraj";5;1904;3;1907;NA;173735;8;2021-07-14;90095
2021-07-13;"Bratislavský kraj";4;1584;4;1588;NA;173735;8;2021-07-13;90087
2021-07-12;"Bratislavský kraj";6;1780;5;1785;NA;173735;11;2021-07-12;90079
2021-07-11;"Bratislavský kraj";3;1896;3;1899;NA;173735;6;2021-07-11;90068
2021-07-10;"Bratislavský kraj";5;2240;3;2243;NA;173735;8;2021-07-10;90062
2021-07-09;"Bratislavský kraj";13;3546;7;3553;NA;173735;20;2021-07-09;90054
2021-07-08;"Bratislavský kraj";9;2433;4;2437;NA;173735;13;2021-07-08;90034
2021-07-07;"Bratislavský kraj";5;2792;4;2796;NA;173735;9;2021-07-07;90021
2021-07-06;"Bratislavský kraj";19;2771;4;2775;NA;173735;23;2021-07-06;90012
2021-07-05;"Bratislavský kraj";5;2481;5;2486;NA;173735;10;2021-07-05;89989
2021-07-04;"Bratislavský kraj";3;1824;2;1826;NA;173735;5;2021-07-04;89979
2021-07-03;"Bratislavský kraj";8;2205;5;2210;NA;173735;13;2021-07-03;89974
2021-07-02;"Bratislavský kraj";4;2227;4;2231;NA;173735;8;2021-07-02;89961
2021-07-01;"Bratislavský kraj";6;1809;5;1814;NA;173735;11;2021-07-01;89953
2021-06-30;"Bratislavský kraj";2;11548;11;11559;NA;173735;13;2021-06-30;89942
2021-06-29;"Bratislavský kraj";5;6831;7;6838;NA;173735;12;2021-06-29;89929
2021-06-28;"Bratislavský kraj";16;6654;24;6678;NA;173735;40;2021-06-28;89917
2021-06-27;"Bratislavský kraj";4;6689;11;6700;NA;173735;15;2021-06-27;89877
2021-06-26;"Bratislavský kraj";3;8741;6;8747;NA;173735;9;2021-06-26;89862
2021-06-25;"Bratislavský kraj";7;10285;15;10300;NA;173735;22;2021-06-25;89853
2021-06-24;"Bratislavský kraj";3;7384;16;7400;NA;173735;19;2021-06-24;89831
2021-06-23;"Bratislavský kraj";4;7346;12;7358;NA;173735;16;2021-06-23;89812
2021-06-22;"Bratislavský kraj";6;7244;10;7254;NA;173735;16;2021-06-22;89796
2021-06-21;"Bratislavský kraj";5;7641;9;7650;NA;173735;14;2021-06-21;89780
2021-06-20;"Bratislavský kraj";0;7369;5;7374;NA;173735;5;2021-06-20;89766
2021-06-19;"Bratislavský kraj";3;9226;4;9230;NA;173735;7;2021-06-19;89761
2021-06-18;"Bratislavský kraj";5;12763;9;12772;NA;173735;14;2021-06-18;89754
2021-06-17;"Bratislavský kraj";3;8625;13;8638;NA;173735;16;2021-06-17;89740
2021-06-16;"Bratislavský kraj";3;7105;4;7109;NA;173735;7;2021-06-16;89724
2021-06-15;"Bratislavský kraj";7;7309;17;7326;NA;173735;24;2021-06-15;89717
2021-06-14;"Bratislavský kraj";4;8231;9;8240;NA;173735;13;2021-06-14;89693
2021-06-13;"Bratislavský kraj";2;8791;11;8802;NA;173735;13;2021-06-13;89680
2021-06-12;"Bratislavský kraj";4;11152;11;11163;NA;173735;15;2021-06-12;89667
2021-06-11;"Bratislavský kraj";9;13644;21;13665;NA;173735;30;2021-06-11;89652
2021-06-10;"Bratislavský kraj";12;8637;15;8652;NA;173735;27;2021-06-10;89622
2021-06-09;"Bratislavský kraj";12;7596;12;7608;NA;173735;24;2021-06-09;89595
2021-06-08;"Bratislavský kraj";13;7907;29;7936;NA;173735;42;2021-06-08;89571
2021-06-07;"Bratislavský kraj";13;9247;43;9290;NA;173735;56;2021-06-07;89529
2021-06-06;"Bratislavský kraj";3;10350;20;10370;NA;173735;23;2021-06-06;89473
2021-06-05;"Bratislavský kraj";2;12692;15;12707;NA;173735;17;2021-06-05;89450
2021-06-04;"Bratislavský kraj";10;13846;31;13877;NA;173735;41;2021-06-04;89433
2021-06-03;"Bratislavský kraj";12;9615;19;9634;NA;173735;31;2021-06-03;89392
2021-06-02;"Bratislavský kraj";10;8684;17;8701;NA;173735;27;2021-06-02;89361
2021-06-01;"Bratislavský kraj";3;8812;25;8837;NA;173735;28;2021-06-01;89334
2021-05-31;"Bratislavský kraj";18;11248;32;11280;NA;173735;50;2021-05-31;89306
2021-05-30;"Bratislavský kraj";1;11758;17;11775;NA;173735;18;2021-05-30;89256
2021-05-29;"Bratislavský kraj";4;12245;8;12253;NA;173735;12;2021-05-29;89238
2021-05-28;"Bratislavský kraj";14;15865;23;15888;NA;173735;37;2021-05-28;89226
2021-05-27;"Bratislavský kraj";5;11321;18;11339;NA;173735;23;2021-05-27;89189
2021-05-26;"Bratislavský kraj";20;10709;17;10726;NA;173735;37;2021-05-26;89166
2021-05-25;"Bratislavský kraj";19;11864;31;11895;NA;173735;50;2021-05-25;89129
2021-05-24;"Bratislavský kraj";12;12966;23;12989;NA;173735;35;2021-05-24;89079
2021-05-23;"Bratislavský kraj";7;13074;24;13098;NA;173735;31;2021-05-23;89044
2021-05-22;"Bratislavský kraj";6;14044;22;14066;NA;173735;28;2021-05-22;89013
2021-05-21;"Bratislavský kraj";15;18996;22;19018;NA;173735;37;2021-05-21;88985
2021-05-20;"Bratislavský kraj";15;14112;17;14129;NA;173735;32;2021-05-20;88948
2021-05-19;"Bratislavský kraj";21;11958;24;11982;NA;173735;45;2021-05-19;88916
2021-05-18;"Bratislavský kraj";14;13005;33;13038;NA;173735;47;2021-05-18;88871
2021-05-17;"Bratislavský kraj";15;13854;29;13883;NA;173735;44;2021-05-17;88824
2021-05-16;"Bratislavský kraj";12;19797;32;19829;NA;173735;44;2021-05-16;88780
2021-05-15;"Bratislavský kraj";1;18113;30;18143;NA;173735;31;2021-05-15;88736
2021-05-14;"Bratislavský kraj";15;22228;30;22258;NA;173735;45;2021-05-14;88705
2021-05-13;"Bratislavský kraj";9;16211;17;16228;NA;173735;26;2021-05-13;88660
2021-05-12;"Bratislavský kraj";11;14638;28;14666;NA;173735;39;2021-05-12;88634
2021-05-11;"Bratislavský kraj";29;16741;32;16773;NA;173735;61;2021-05-11;88595
2021-05-10;"Bratislavský kraj";27;19991;64;20055;NA;173735;91;2021-05-10;88534
2021-05-09;"Bratislavský kraj";9;29358;32;29390;NA;173735;41;2021-05-09;88443
2021-05-08;"Bratislavský kraj";5;19451;24;19475;NA;173735;29;2021-05-08;88402
2021-05-07;"Bratislavský kraj";32;28211;65;28276;NA;173735;97;2021-05-07;88373
2021-05-06;"Bratislavský kraj";19;20079;52;20131;NA;173735;71;2021-05-06;88276
2021-05-05;"Bratislavský kraj";29;15526;31;15557;NA;173735;60;2021-05-05;88205
2021-05-04;"Bratislavský kraj";46;19143;53;19196;NA;173735;99;2021-05-04;88145
2021-05-03;"Bratislavský kraj";37;22322;64;22386;NA;173735;101;2021-05-03;88046
2021-05-02;"Bratislavský kraj";38;43064;75;43139;NA;173735;113;2021-05-02;87945
2021-05-01;"Bratislavský kraj";11;39905;40;39945;NA;173735;51;2021-05-01;87832
2021-04-30;"Bratislavský kraj";43;47403;82;47485;NA;173735;125;2021-04-30;87781
2021-04-29;"Bratislavský kraj";48;30257;96;30353;NA;173735;144;2021-04-29;87656
2021-04-28;"Bratislavský kraj";40;28905;78;28983;NA;173735;118;2021-04-28;87512
2021-04-27;"Bratislavský kraj";41;30168;52;30220;NA;173735;93;2021-04-27;87394
2021-04-26;"Bratislavský kraj";59;34733;97;34830;NA;173735;156;2021-04-26;87301
2021-04-25;"Bratislavský kraj";8;57615;74;57689;NA;173735;82;2021-04-25;87145
2021-04-24;"Bratislavský kraj";28;74858;66;74924;NA;173735;94;2021-04-24;87063
2021-04-23;"Bratislavský kraj";70;48614;62;48676;NA;173735;132;2021-04-23;86969
2021-04-22;"Bratislavský kraj";39;31037;72;31109;NA;173735;111;2021-04-22;86837
2021-04-21;"Bratislavský kraj";48;30442;62;30504;NA;173735;110;2021-04-21;86726
2021-04-20;"Bratislavský kraj";58;35216;63;35279;NA;173735;121;2021-04-20;86616
2021-04-19;"Bratislavský kraj";48;39500;80;39580;NA;173735;128;2021-04-19;86495
2021-04-18;"Bratislavský kraj";35;62300;76;62376;NA;173735;111;2021-04-18;86367
2021-04-17;"Bratislavský kraj";13;80359;111;80470;NA;173735;124;2021-04-17;86256
2021-04-16;"Bratislavský kraj";62;47296;80;47376;NA;173735;142;2021-04-16;86132
2021-04-15;"Bratislavský kraj";34;32176;74;32250;NA;173735;108;2021-04-15;85990
2021-04-14;"Bratislavský kraj";65;33961;88;34049;NA;173735;153;2021-04-14;85882
2021-04-13;"Bratislavský kraj";82;35512;82;35594;NA;173735;164;2021-04-13;85729
2021-04-12;"Bratislavský kraj";77;42286;115;42401;NA;173735;192;2021-04-12;85565
2021-04-11;"Bratislavský kraj";42;61151;123;61274;NA;173735;165;2021-04-11;85373
2021-04-10;"Bratislavský kraj";14;77874;167;78041;NA;173735;181;2021-04-10;85208
2021-04-09;"Bratislavský kraj";72;41556;97;41653;NA;173735;169;2021-04-09;85027
2021-04-08;"Bratislavský kraj";71;28866;95;28961;NA;173735;166;2021-04-08;84858
2021-04-07;"Bratislavský kraj";96;38061;101;38162;NA;173735;197;2021-04-07;84692
2021-04-06;"Bratislavský kraj";94;56204;179;56383;NA;173735;273;2021-04-06;84495
2021-04-05;"Bratislavský kraj";85;18538;85;18623;NA;173735;170;2021-04-05;84222
2021-04-04;"Bratislavský kraj";37;29225;75;29300;NA;173735;112;2021-04-04;84052
2021-04-03;"Bratislavský kraj";52;79865;220;80085;NA;173735;272;2021-04-03;83940
2021-04-02;"Bratislavský kraj";33;23790;104;23894;NA;173735;137;2021-04-02;83668
2021-04-01;"Bratislavský kraj";119;57388;159;57547;NA;173735;278;2021-04-01;83531
2021-03-31;"Bratislavský kraj";105;46371;177;46548;NA;173735;282;2021-03-31;83253
2021-03-30;"Bratislavský kraj";100;39599;144;39743;NA;173735;244;2021-03-30;82971
2021-03-29;"Bratislavský kraj";153;40364;178;40542;NA;173735;331;2021-03-29;82727
2021-03-28;"Bratislavský kraj";59;53372;137;53509;NA;173735;196;2021-03-28;82396
2021-03-27;"Bratislavský kraj";53;79834;240;80074;NA;173735;293;2021-03-27;82200
2021-03-26;"Bratislavský kraj";114;56108;191;56299;NA;173735;305;2021-03-26;81907
2021-03-25;"Bratislavský kraj";76;36859;172;37031;NA;173735;248;2021-03-25;81602
2021-03-24;"Bratislavský kraj";120;30567;201;30768;NA;173735;321;2021-03-24;81354
2021-03-23;"Bratislavský kraj";138;36438;190;36628;NA;173735;328;2021-03-23;81033
2021-03-22;"Bratislavský kraj";110;42756;220;42976;NA;173735;330;2021-03-22;80705
2021-03-21;"Bratislavský kraj";54;61299;212;61511;NA;173735;266;2021-03-21;80375
2021-03-20;"Bratislavský kraj";59;73300;228;73528;NA;173735;287;2021-03-20;80109
2021-03-19;"Bratislavský kraj";139;54576;257;54833;NA;173735;396;2021-03-19;79822
2021-03-18;"Bratislavský kraj";142;34611;192;34803;NA;173735;334;2021-03-18;79426
2021-03-17;"Bratislavský kraj";177;30482;217;30699;NA;173735;394;2021-03-17;79092
2021-03-16;"Bratislavský kraj";258;36798;287;37085;NA;173735;545;2021-03-16;78698
2021-03-15;"Bratislavský kraj";180;38226;255;38481;NA;173735;435;2021-03-15;78153
2021-03-14;"Bratislavský kraj";75;52611;275;52886;NA;173735;350;2021-03-14;77718
2021-03-13;"Bratislavský kraj";110;81405;341;81746;NA;173735;451;2021-03-13;77368
2021-03-12;"Bratislavský kraj";152;55233;312;55545;NA;173735;464;2021-03-12;76917
2021-03-11;"Bratislavský kraj";178;34678;286;34964;NA;173735;464;2021-03-11;76453
2021-03-10;"Bratislavský kraj";164;31061;280;31341;NA;173735;444;2021-03-10;75989
2021-03-09;"Bratislavský kraj";242;37687;267;37954;NA;173735;509;2021-03-09;75545
2021-03-08;"Bratislavský kraj";255;41199;348;41547;NA;173735;603;2021-03-08;75036
2021-03-07;"Bratislavský kraj";142;52812;301;53113;NA;173735;443;2021-03-07;74433
2021-03-06;"Bratislavský kraj";79;71821;415;72236;NA;173735;494;2021-03-06;73990
2021-03-05;"Bratislavský kraj";238;50653;293;50946;NA;173735;531;2021-03-05;73496
2021-03-04;"Bratislavský kraj";204;34544;344;34888;NA;173735;548;2021-03-04;72965
2021-03-03;"Bratislavský kraj";250;30527;364;30891;NA;173735;614;2021-03-03;72417
2021-03-02;"Bratislavský kraj";267;39735;388;40123;NA;173735;655;2021-03-02;71803
2021-03-01;"Bratislavský kraj";320;38222;432;38654;NA;173735;752;2021-03-01;71148
2021-02-28;"Bratislavský kraj";184;50323;323;50646;NA;173735;507;2021-02-28;70396
2021-02-27;"Bratislavský kraj";151;76580;464;77044;NA;173735;615;2021-02-27;69889
2021-02-26;"Bratislavský kraj";277;47326;401;47727;NA;173735;678;2021-02-26;69274
2021-02-25;"Bratislavský kraj";277;28769;405;29174;NA;173735;682;2021-02-25;68596
2021-02-24;"Bratislavský kraj";217;27095;412;27507;NA;173735;629;2021-02-24;67914
2021-02-23;"Bratislavský kraj";257;31297;395;31692;NA;173735;652;2021-02-23;67285
2021-02-22;"Bratislavský kraj";353;36607;483;37090;NA;173735;836;2021-02-22;66633
2021-02-21;"Bratislavský kraj";185;54150;396;54546;NA;173735;581;2021-02-21;65797
2021-02-20;"Bratislavský kraj";167;74814;550;75364;NA;173735;717;2021-02-20;65216
2021-02-19;"Bratislavský kraj";280;44882;416;45298;NA;173735;696;2021-02-19;64499
2021-02-18;"Bratislavský kraj";263;26379;371;26750;NA;173735;634;2021-02-18;63803
2021-02-17;"Bratislavský kraj";264;22820;316;23136;NA;173735;580;2021-02-17;63169
2021-02-16;"Bratislavský kraj";289;28262;352;28614;NA;173735;641;2021-02-16;62589
2021-02-15;"Bratislavský kraj";248;36893;396;37289;NA;173735;644;2021-02-15;61948
2021-02-14;"Bratislavský kraj";153;47948;323;48271;NA;173735;476;2021-02-14;61304
2021-02-13;"Bratislavský kraj";173;68589;515;69104;NA;173735;688;2021-02-13;60828
2021-02-12;"Bratislavský kraj";282;35729;327;36056;NA;173735;609;2021-02-12;60140
2021-02-11;"Bratislavský kraj";337;24565;285;24850;NA;173735;622;2021-02-11;59531
2021-02-10;"Bratislavský kraj";314;22944;356;23300;NA;173735;670;2021-02-10;58909
2021-02-09;"Bratislavský kraj";288;36565;454;37019;NA;173735;742;2021-02-09;58239
2021-02-08;"Bratislavský kraj";484;31896;397;32293;NA;173735;881;2021-02-08;57497
2021-02-07;"Bratislavský kraj";243;51290;425;51715;NA;173735;668;2021-02-07;56616
2021-02-06;"Bratislavský kraj";116;61682;501;62183;NA;173735;617;2021-02-06;55948
2021-02-05;"Bratislavský kraj";327;27033;375;27408;NA;173735;702;2021-02-05;55331
2021-02-04;"Bratislavský kraj";555;17260;348;17608;NA;173735;903;2021-02-04;54629
2021-02-03;"Bratislavský kraj";161;13020;352;13372;NA;173735;513;2021-02-03;53726
2021-02-02;"Bratislavský kraj";397;25947;480;26427;NA;173735;877;2021-02-02;53213
2021-02-01;"Bratislavský kraj";221;35541;513;36054;NA;173735;734;2021-02-01;52336
2021-01-31;"Bratislavský kraj";180;35693;425;36118;NA;173735;605;2021-01-31;51602
2021-01-30;"Bratislavský kraj";310;49588;521;50109;NA;173735;831;2021-01-30;50997
2021-01-29;"Bratislavský kraj";344;16568;344;16912;NA;173735;688;2021-01-29;50166
2021-01-28;"Bratislavský kraj";307;10715;297;11012;NA;173735;604;2021-01-28;49478
2021-01-27;"Bratislavský kraj";336;22222;345;22567;NA;173735;681;2021-01-27;48874
2021-01-26;"Bratislavský kraj";297;21894;300;22194;NA;173735;597;2021-01-26;48193
2021-01-25;"Bratislavský kraj";356;23335;249;23584;NA;173735;605;2021-01-25;47596
2021-01-24;"Bratislavský kraj";175;37903;404;38307;NA;173735;579;2021-01-24;46991
2021-01-23;"Bratislavský kraj";396;79453;690;80143;NA;173735;1086;2021-01-23;46412
2021-01-22;"Bratislavský kraj";199;42055;365;42420;NA;173735;564;2021-01-22;45326
2021-01-21;"Bratislavský kraj";255;105746;1317;107063;NA;173735;1572;2021-01-21;44762
2021-01-20;"Bratislavský kraj";360;27289;452;27741;NA;173735;812;2021-01-20;43190
2021-01-19;"Bratislavský kraj";375;15318;346;15664;NA;173735;721;2021-01-19;42378
2021-01-18;"Bratislavský kraj";357;12533;707;13240;NA;173735;1064;2021-01-18;41657
2021-01-17;"Bratislavský kraj";244;482;26;508;NA;173735;270;2021-01-17;40593
2021-01-16;"Bratislavský kraj";70;3016;156;3172;NA;173735;226;2021-01-16;40323
2021-01-15;"Bratislavský kraj";251;7896;256;8152;NA;173735;507;2021-01-15;40097
2021-01-14;"Bratislavský kraj";363;8523;273;8796;NA;173735;636;2021-01-14;39590
2021-01-13;"Bratislavský kraj";336;8490;327;8817;NA;173735;663;2021-01-13;38954
2021-01-12;"Bratislavský kraj";450;10509;455;10964;NA;173735;905;2021-01-12;38291
2021-01-11;"Bratislavský kraj";397;19863;364;20227;NA;173735;761;2021-01-11;37386
2021-01-10;"Bratislavský kraj";252;1507;79;1586;NA;173735;331;2021-01-10;36625
2021-01-09;"Bratislavský kraj";351;4721;277;4998;NA;173735;628;2021-01-09;36294
2021-01-08;"Bratislavský kraj";556;10045;436;10481;NA;173735;992;2021-01-08;35666
2021-01-07;"Bratislavský kraj";537;6872;352;7224;NA;173735;889;2021-01-07;34674
2021-01-06;"Bratislavský kraj";271;3329;216;3545;NA;173735;487;2021-01-06;33785
2021-01-05;"Bratislavský kraj";619;10635;814;11449;NA;173735;1433;2021-01-05;33298
2021-01-04;"Bratislavský kraj";601;8226;538;8764;NA;173735;1139;2021-01-04;31865
2021-01-03;"Bratislavský kraj";77;433;41;474;NA;173735;118;2021-01-03;30726
2021-01-02;"Bratislavský kraj";185;462;57;519;NA;173735;242;2021-01-02;30608
2021-01-01;"Bratislavský kraj";235;3277;131;3408;NA;173735;366;2021-01-01;30366
2020-12-31;"Bratislavský kraj";925;14135;519;14654;NA;173735;1444;2020-12-31;30000
2020-12-30;"Bratislavský kraj";650;9164;533;9697;NA;173735;1183;2020-12-30;28556
2020-12-29;"Bratislavský kraj";303;10108;699;10807;NA;173735;1002;2020-12-29;27373
2020-12-28;"Bratislavský kraj";255;7784;473;8257;NA;173735;728;2020-12-28;26371
2020-12-27;"Bratislavský kraj";160;709;76;785;NA;173735;236;2020-12-27;25643
2020-12-26;"Bratislavský kraj";75;480;27;507;NA;173735;102;2020-12-26;25407
2020-12-25;"Bratislavský kraj";114;503;38;541;NA;173735;152;2020-12-25;25305
2020-12-24;"Bratislavský kraj";536;3367;104;3471;NA;173735;640;2020-12-24;25153
2020-12-23;"Bratislavský kraj";416;12590;447;13037;NA;173735;863;2020-12-23;24513
2020-12-22;"Bratislavský kraj";327;14587;699;15286;NA;173735;1026;2020-12-22;23650
2020-12-21;"Bratislavský kraj";392;14972;1946;16918;NA;173735;2338;2020-12-21;22624
2020-12-20;"Bratislavský kraj";180;797;57;854;NA;173735;237;2020-12-20;20286
2020-12-19;"Bratislavský kraj";396;3314;130;3444;NA;173735;526;2020-12-19;20049
2020-12-18;"Bratislavský kraj";306;9938;345;10283;NA;173735;651;2020-12-18;19523
2020-12-17;"Bratislavský kraj";502;9739;386;10125;NA;173735;888;2020-12-17;18872
2020-12-16;"Bratislavský kraj";282;10201;418;10619;NA;173735;700;2020-12-16;17984
2020-12-15;"Bratislavský kraj";423;10450;454;10904;NA;173735;877;2020-12-15;17284
2020-12-14;"Bratislavský kraj";279;6793;261;7054;NA;173735;540;2020-12-14;16407
2020-12-13;"Bratislavský kraj";125;139;10;149;NA;173735;135;2020-12-13;15867
2020-12-12;"Bratislavský kraj";361;3886;157;4043;NA;173735;518;2020-12-12;15732
2020-12-11;"Bratislavský kraj";326;6824;235;7059;NA;173735;561;2020-12-11;15214
2020-12-10;"Bratislavský kraj";286;5279;166;5445;NA;173735;452;2020-12-10;14653
2020-12-09;"Bratislavský kraj";382;4778;177;4955;NA;173735;559;2020-12-09;14201
2020-12-08;"Bratislavský kraj";234;6243;207;6450;NA;173735;441;2020-12-08;13642
2020-12-07;"Bratislavský kraj";272;4639;152;4791;NA;173735;424;2020-12-07;13201
2020-12-06;"Bratislavský kraj";61;1625;52;1677;NA;173735;113;2020-12-06;12777
2020-12-05;"Bratislavský kraj";266;2221;41;2262;NA;173735;307;2020-12-05;12664
2020-12-04;"Bratislavský kraj";200;4954;99;5053;NA;173735;299;2020-12-04;12357
2020-12-03;"Bratislavský kraj";213;5672;95;5767;NA;173735;308;2020-12-03;12058
2020-12-02;"Bratislavský kraj";205;3462;103;3565;NA;173735;308;2020-12-02;11750
2020-12-01;"Bratislavský kraj";255;3889;172;4061;NA;173735;427;2020-12-01;11442
2020-11-30;"Bratislavský kraj";152;2153;121;2274;NA;173735;273;2020-11-30;11015
2020-11-29;"Bratislavský kraj";52;201;24;225;NA;173735;76;2020-11-29;10742
2020-11-28;"Bratislavský kraj";232;2624;33;2657;NA;173735;265;2020-11-28;10666
2020-11-27;"Bratislavský kraj";54;2540;64;2604;NA;173735;118;2020-11-27;10401
2020-11-26;"Bratislavský kraj";129;1976;60;2036;NA;173735;189;2020-11-26;10283
2020-11-25;"Bratislavský kraj";140;1770;47;1817;NA;173735;187;2020-11-25;10094
2020-11-24;"Bratislavský kraj";81;2988;67;3055;NA;173735;148;2020-11-24;9907
2020-11-23;"Bratislavský kraj";67;7083;58;7141;NA;173735;125;2020-11-23;9759
2020-11-22;"Bratislavský kraj";36;81;7;88;NA;173735;43;2020-11-22;9634
2020-11-21;"Bratislavský kraj";109;2126;47;2173;NA;173735;156;2020-11-21;9591
2020-11-20;"Bratislavský kraj";118;2876;48;2924;NA;173735;166;2020-11-20;9435
2020-11-19;"Bratislavský kraj";173;987;29;1016;NA;173735;202;2020-11-19;9269
2020-11-18;"Bratislavský kraj";118;616;75;691;NA;173735;193;2020-11-18;9067
2020-11-17;"Bratislavský kraj";108;928;23;951;NA;173735;131;2020-11-17;8874
2020-11-16;"Bratislavský kraj";82;651;9;660;NA;173735;91;2020-11-16;8743
2020-11-15;"Bratislavský kraj";47;236;0;236;NA;173735;47;2020-11-15;8652
2020-11-14;"Bratislavský kraj";53;1834;15;1849;NA;173735;68;2020-11-14;8605
2020-11-13;"Bratislavský kraj";94;2096;21;2117;NA;173735;115;2020-11-13;8537
2020-11-12;"Bratislavský kraj";141;1727;6;1733;NA;173735;147;2020-11-12;8422
2020-11-11;"Bratislavský kraj";159;1429;12;1441;NA;173735;171;2020-11-11;8275
2020-11-10;"Bratislavský kraj";136;805;14;819;NA;173735;150;2020-11-10;8104
2020-11-09;"Bratislavský kraj";70;616;8;624;NA;173735;78;2020-11-09;7954
2020-11-08;"Bratislavský kraj";82;869;6;875;NA;173735;88;2020-11-08;7876
2020-11-07;"Bratislavský kraj";88;4039;17;4056;NA;173735;105;2020-11-07;7788
2020-11-06;"Bratislavský kraj";281;6441;25;6466;NA;173735;306;2020-11-06;7683
2020-11-05;"Bratislavský kraj";175;476;11;487;NA;173735;186;2020-11-05;7377
2020-11-04;"Bratislavský kraj";65;411;10;421;NA;173735;75;2020-11-04;7191
2020-11-03;"Bratislavský kraj";251;1085;12;1097;NA;173735;263;2020-11-03;7116
2020-11-02;"Bratislavský kraj";202;3365;22;3387;NA;173735;224;2020-11-02;6853
2020-11-01;"Bratislavský kraj";227;8694;39;8733;NA;173735;266;2020-11-01;6629
2020-10-31;"Bratislavský kraj";173;22407;123;22530;NA;173735;296;2020-10-31;6363
2020-10-30;"Bratislavský kraj";158;17350;138;17488;NA;173735;296;2020-10-30;6067
2020-10-29;"Bratislavský kraj";262;116;4;120;NA;173735;266;2020-10-29;5771
2020-10-28;"Bratislavský kraj";220;260;15;275;NA;173735;235;2020-10-28;5505
2020-10-27;"Bratislavský kraj";256;145;4;149;NA;173735;260;2020-10-27;5270
2020-10-26;"Bratislavský kraj";123;229;11;240;NA;173735;134;2020-10-26;5010
2020-10-25;"Bratislavský kraj";152;33;2;35;NA;173735;154;2020-10-25;4876
2020-10-24;"Bratislavský kraj";170;221;6;227;NA;173735;176;2020-10-24;4722
2020-10-23;"Bratislavský kraj";151;144;8;152;NA;173735;159;2020-10-23;4546
2020-10-22;"Bratislavský kraj";192;204;15;219;NA;173735;207;2020-10-22;4387
2020-10-21;"Bratislavský kraj";66;90;6;96;NA;173735;72;2020-10-21;4180
2020-10-20;"Bratislavský kraj";183;97;4;101;NA;173735;187;2020-10-20;4108
2020-10-19;"Bratislavský kraj";148;80;3;83;NA;173735;151;2020-10-19;3921
2020-10-18;"Bratislavský kraj";75;92;0;92;NA;173735;75;2020-10-18;3770
2020-10-17;"Bratislavský kraj";136;0;0;0;NA;173735;136;2020-10-17;3695
2020-10-16;"Bratislavský kraj";103;14;1;15;NA;173735;104;2020-10-16;3559
2020-10-15;"Bratislavský kraj";135;6;1;7;NA;173735;136;2020-10-15;3455
2020-10-14;"Bratislavský kraj";127;4;0;4;NA;173735;127;2020-10-14;3319
2020-10-13;"Bratislavský kraj";86;108;8;116;NA;173735;94;2020-10-13;3192
2020-10-12;"Bratislavský kraj";46;0;0;0;NA;173735;46;2020-10-12;3098
2020-10-11;"Bratislavský kraj";80;0;0;0;NA;173735;80;2020-10-11;3052
2020-10-10;"Bratislavský kraj";55;0;0;0;NA;173735;55;2020-10-10;2972
2020-10-09;"Bratislavský kraj";148;0;0;0;NA;173735;148;2020-10-09;2917
2020-10-08;"Bratislavský kraj";100;0;0;0;NA;173735;100;2020-10-08;2769
2020-10-07;"Bratislavský kraj";107;0;0;0;NA;173735;107;2020-10-07;2669
2020-10-06;"Bratislavský kraj";108;0;0;0;NA;173735;108;2020-10-06;2562
2020-10-05;"Bratislavský kraj";30;0;0;0;NA;173735;30;2020-10-05;2454
2020-10-04;"Bratislavský kraj";49;0;0;0;NA;173735;49;2020-10-04;2424
2020-10-03;"Bratislavský kraj";82;0;0;0;NA;173735;82;2020-10-03;2375
2020-10-02;"Bratislavský kraj";101;0;0;0;NA;173735;101;2020-10-02;2293
2020-10-01;"Bratislavský kraj";72;0;0;0;NA;173735;72;2020-10-01;2192
2020-09-30;"Bratislavský kraj";91;0;0;0;NA;173735;91;2020-09-30;2120
2020-09-29;"Bratislavský kraj";74;0;0;0;NA;173735;74;2020-09-29;2029
2020-09-28;"Bratislavský kraj";29;0;0;0;NA;173735;29;2020-09-28;1955
2020-09-27;"Bratislavský kraj";48;0;0;0;NA;173735;48;2020-09-27;1926
2020-09-26;"Bratislavský kraj";86;0;0;0;NA;173735;86;2020-09-26;1878
2020-09-25;"Bratislavský kraj";97;0;0;0;NA;173735;97;2020-09-25;1792
2020-09-24;"Bratislavský kraj";73;0;0;0;NA;173735;73;2020-09-24;1695
2020-09-23;"Bratislavský kraj";55;0;0;0;NA;173735;55;2020-09-23;1622
2020-09-22;"Bratislavský kraj";81;0;0;0;NA;173735;81;2020-09-22;1567
2020-09-21;"Bratislavský kraj";32;0;0;0;NA;173735;32;2020-09-21;1486
2020-09-20;"Bratislavský kraj";25;0;0;0;NA;173735;25;2020-09-20;1454
2020-09-19;"Bratislavský kraj";59;0;0;0;NA;173735;59;2020-09-19;1429
2020-09-18;"Bratislavský kraj";42;0;0;0;NA;173735;42;2020-09-18;1370
2020-09-17;"Bratislavský kraj";52;0;0;0;NA;173735;52;2020-09-17;1328
2020-09-16;"Bratislavský kraj";32;0;0;0;NA;173735;32;2020-09-16;1276
2020-09-15;"Bratislavský kraj";26;0;0;0;NA;173735;26;2020-09-15;1244
2020-09-14;"Bratislavský kraj";24;0;0;0;NA;173735;24;2020-09-14;1218
2020-09-13;"Bratislavský kraj";11;0;0;0;NA;173735;11;2020-09-13;1194
2020-09-12;"Bratislavský kraj";24;0;0;0;NA;173735;24;2020-09-12;1183
2020-09-11;"Bratislavský kraj";50;0;0;0;NA;173735;50;2020-09-11;1159
2020-09-10;"Bratislavský kraj";47;0;0;0;NA;173735;47;2020-09-10;1109
2020-09-09;"Bratislavský kraj";40;0;0;0;NA;173735;40;2020-09-09;1062
2020-09-08;"Bratislavský kraj";58;0;0;0;NA;173735;58;2020-09-08;1022
2020-09-07;"Bratislavský kraj";39;0;0;0;NA;173735;39;2020-09-07;964
2020-09-06;"Bratislavský kraj";11;0;0;0;NA;173735;11;2020-09-06;925
2020-09-05;"Bratislavský kraj";37;0;0;0;NA;173735;37;2020-09-05;914
2020-09-04;"Bratislavský kraj";87;0;0;0;NA;173735;87;2020-09-04;877
2020-09-03;"Bratislavský kraj";51;0;0;0;NA;173735;51;2020-09-03;790
2020-09-02;"Bratislavský kraj";50;0;0;0;NA;173735;50;2020-09-02;739
2020-09-01;"Bratislavský kraj";16;0;0;0;NA;173735;16;2020-09-01;689
2020-08-31;"Bratislavský kraj";19;0;0;0;NA;173735;19;2020-08-31;673
2020-08-30;"Bratislavský kraj";9;0;0;0;NA;173735;9;2020-08-30;654
2020-08-29;"Bratislavský kraj";12;0;0;0;NA;173735;12;2020-08-29;645
2020-08-28;"Bratislavský kraj";35;0;0;0;NA;173735;35;2020-08-28;633
2020-08-27;"Bratislavský kraj";33;0;0;0;NA;173735;33;2020-08-27;598
2020-08-26;"Bratislavský kraj";27;0;0;0;NA;173735;27;2020-08-26;565
2020-08-25;"Bratislavský kraj";29;0;0;0;NA;173735;29;2020-08-25;538
2020-08-24;"Bratislavský kraj";6;0;0;0;NA;173735;6;2020-08-24;509
2020-08-23;"Bratislavský kraj";45;0;0;0;NA;173735;45;2020-08-23;503
2020-08-22;"Bratislavský kraj";13;0;0;0;NA;173735;13;2020-08-22;458
2020-08-21;"Bratislavský kraj";46;0;0;0;NA;173735;46;2020-08-21;445
2020-08-20;"Bratislavský kraj";41;0;0;0;NA;173735;41;2020-08-20;399
2020-08-19;"Bratislavský kraj";27;0;0;0;NA;173735;27;2020-08-19;358
2020-08-18;"Bratislavský kraj";47;0;0;0;NA;173735;47;2020-08-18;331
2020-08-17;"Bratislavský kraj";2;0;0;0;NA;173735;2;2020-08-17;284
2020-08-16;"Bratislavský kraj";3;0;0;0;NA;173735;3;2020-08-16;282
2020-08-15;"Bratislavský kraj";18;0;0;0;NA;173735;18;2020-08-15;279
2020-08-14;"Bratislavský kraj";16;0;0;0;NA;173735;16;2020-08-14;261
2020-08-13;"Bratislavský kraj";12;0;0;0;NA;173735;12;2020-08-13;245
2020-08-12;"Bratislavský kraj";10;0;0;0;NA;173735;10;2020-08-12;233
2020-08-11;"Bratislavský kraj";23;0;0;0;NA;173735;23;2020-08-11;223
2020-08-10;"Bratislavský kraj";2;0;0;0;NA;173735;2;2020-08-10;200
2020-08-09;"Bratislavský kraj";2;0;0;0;NA;173735;2;2020-08-09;198
2020-08-08;"Bratislavský kraj";1;0;0;0;NA;173735;1;2020-08-08;196
2020-08-07;"Bratislavský kraj";9;0;0;0;NA;173735;9;2020-08-07;195
2020-08-06;"Bratislavský kraj";15;0;0;0;NA;173735;15;2020-08-06;186
2020-08-05;"Bratislavský kraj";11;0;0;0;NA;173735;11;2020-08-05;171
2020-08-04;"Bratislavský kraj";21;0;0;0;NA;173735;21;2020-08-04;160
2020-08-03;"Bratislavský kraj";7;0;0;0;NA;173735;7;2020-08-03;139
2020-08-02;"Bratislavský kraj";0;0;0;0;NA;173735;0;2020-08-02;132
2020-08-01;"Bratislavský kraj";0;0;0;0;NA;173735;0;2020-08-01;132
2020-07-31;"Bratislavský kraj";14;0;0;0;NA;173735;14;2020-07-31;132
2020-07-30;"Bratislavský kraj";6;0;0;0;NA;173735;6;2020-07-30;118
2020-07-29;"Bratislavský kraj";7;0;0;0;NA;173735;7;2020-07-29;112
2020-07-28;"Bratislavský kraj";14;0;0;0;NA;173735;14;2020-07-28;105
2020-07-27;"Bratislavský kraj";3;0;0;0;NA;173735;3;2020-07-27;91
2020-07-26;"Bratislavský kraj";0;0;0;0;NA;173735;0;2020-07-26;88
2020-07-25;"Bratislavský kraj";8;0;0;0;NA;173735;8;2020-07-25;88
2020-07-24;"Bratislavský kraj";2;0;0;0;NA;173735;2;2020-07-24;80
2020-07-23;"Bratislavský kraj";8;0;0;0;NA;173735;8;2020-07-23;78
2020-07-22;"Bratislavský kraj";11;0;0;0;NA;173735;11;2020-07-22;70
2020-07-21;"Bratislavský kraj";8;0;0;0;NA;173735;8;2020-07-21;59
2020-07-20;"Bratislavský kraj";12;0;0;0;NA;173735;12;2020-07-20;51
2020-07-19;"Bratislavský kraj";0;0;0;0;NA;173735;0;2020-07-19;39
2020-07-18;"Bratislavský kraj";2;0;0;0;NA;173735;2;2020-07-18;39
2020-07-17;"Bratislavský kraj";2;0;0;0;NA;173735;2;2020-07-17;37
2020-07-16;"Bratislavský kraj";6;0;0;0;NA;173735;6;2020-07-16;35
2020-07-15;"Bratislavský kraj";3;0;0;0;NA;173735;3;2020-07-15;29
2020-07-14;"Bratislavský kraj";2;0;0;0;NA;173735;2;2020-07-14;26
2020-07-13;"Bratislavský kraj";2;0;0;0;NA;173735;2;2020-07-13;24
2020-07-12;"Bratislavský kraj";0;0;0;0;NA;173735;0;2020-07-12;22
2020-07-11;"Bratislavský kraj";0;0;0;0;NA;173735;0;2020-07-11;22
2020-07-10;"Bratislavský kraj";8;0;0;0;NA;173735;8;2020-07-10;22
2020-07-09;"Bratislavský kraj";2;0;0;0;NA;173735;2;2020-07-09;14
2020-07-08;"Bratislavský kraj";11;0;0;0;NA;173735;11;2020-07-08;12
2020-07-07;"Bratislavský kraj";5;0;0;0;NA;173735;5;2020-07-07;1
2020-07-06;"Bratislavský kraj";1;0;0;0;NA;173735;1;2020-07-06;-4
2020-07-05;"Bratislavský kraj";0;0;0;0;NA;173735;0;2020-07-05;-5
2020-07-04;"Bratislavský kraj";3;0;0;0;NA;173735;3;2020-07-04;-5
2020-07-03;"Bratislavský kraj";1;0;0;0;NA;173735;1;2020-07-03;-8
2020-07-02;"Bratislavský kraj";0;0;0;0;NA;173735;0;2020-07-02;-9
2020-07-01;"Bratislavský kraj";7;0;0;0;NA;173735;7;2020-07-01;-9
2020-06-30;"Bratislavský kraj";3;0;0;0;NA;173735;3;2020-06-30;-16
2020-06-29;"Bratislavský kraj";1;0;0;0;NA;173735;1;2020-06-29;-19
2020-06-28;"Bratislavský kraj";0;0;0;0;NA;173735;0;2020-06-28;-20
2020-06-27;"Bratislavský kraj";1;0;0;0;NA;173735;1;2020-06-27;-20
2020-06-26;"Bratislavský kraj";6;0;0;0;NA;173735;6;2020-06-26;-21
2020-06-25;"Bratislavský kraj";0;0;0;0;NA;173735;0;2020-06-25;-27
2020-06-24;"Bratislavský kraj";3;0;0;0;NA;173735;3;2020-06-24;-27
2020-06-23;"Bratislavský kraj";0;0;0;0;NA;173735;0;2020-06-23;-30
2020-06-22;"Bratislavský kraj";1;0;0;0;NA;173735;1;2020-06-22;-30
2020-06-21;"Bratislavský kraj";0;0;0;0;NA;173735;0;2020-06-21;-31
2020-06-20;"Bratislavský kraj";0;0;0;0;NA;173735;0;2020-06-20;-31
2020-06-19;"Bratislavský kraj";3;0;0;0;NA;173735;3;2020-06-19;-31
2020-06-18;"Bratislavský kraj";0;0;0;0;NA;173735;0;2020-06-18;-34
2020-06-17;"Bratislavský kraj";0;0;0;0;NA;173735;0;2020-06-17;-34
2020-06-16;"Bratislavský kraj";0;0;0;0;NA;173735;0;2020-06-16;-34
2020-06-14;"Bratislavský kraj";2;0;0;0;NA;173735;2;2020-06-14;-34
2020-06-13;"Bratislavský kraj";1;0;0;0;NA;173735;1;2020-06-13;-36
2020-06-12;"Bratislavský kraj";2;0;0;0;NA;173735;2;2020-06-12;-37
2020-06-11;"Bratislavský kraj";0;0;0;0;NA;173735;0;2020-06-11;-39
2020-06-10;"Bratislavský kraj";0;0;0;0;NA;173735;0;2020-06-10;-39
2020-06-09;"Bratislavský kraj";0;0;0;0;NA;173735;0;2020-06-09;-39
2020-06-08;"Bratislavský kraj";1;0;0;0;NA;173735;1;2020-06-08;-39
2020-06-07;"Bratislavský kraj";0;0;0;0;NA;173735;0;2020-06-07;-40
2020-06-05;"Bratislavský kraj";0;0;0;0;NA;173735;0;2020-06-05;-40
2020-06-03;"Bratislavský kraj";1;0;0;0;NA;173735;1;2020-06-03;-40
2020-06-02;"Bratislavský kraj";0;0;0;0;NA;173735;0;2020-06-02;-41
2020-05-31;"Bratislavský kraj";0;0;0;0;NA;173735;0;2020-05-31;-41
2020-05-29;"Bratislavský kraj";0;0;0;0;NA;173735;0;2020-05-29;-41
2020-05-27;"Bratislavský kraj";1;0;0;0;NA;173735;1;2020-05-27;-41
2020-05-26;"Bratislavský kraj";0;0;0;0;NA;173735;0;2020-05-26;-42
2020-05-25;"Bratislavský kraj";0;0;0;0;NA;173735;0;2020-05-25;-42
2020-05-24;"Bratislavský kraj";0;0;0;0;NA;173735;0;2020-05-24;-42
2020-05-23;"Bratislavský kraj";2;0;0;0;NA;173735;2;2020-05-23;-42
2020-05-22;"Bratislavský kraj";0;0;0;0;NA;173735;0;2020-05-22;-44
2020-05-21;"Bratislavský kraj";0;0;0;0;NA;173735;0;2020-05-21;-44
2020-05-20;"Bratislavský kraj";0;0;0;0;NA;173735;0;2020-05-20;-44
2020-05-19;"Bratislavský kraj";0;0;0;0;NA;173735;0;2020-05-19;-44
2020-05-17;"Bratislavský kraj";0;0;0;0;NA;173735;0;2020-05-17;-44
2020-05-16;"Bratislavský kraj";0;0;0;0;NA;173735;0;2020-05-16;-44
2020-05-15;"Bratislavský kraj";0;0;0;0;NA;173735;0;2020-05-15;-44
2020-05-14;"Bratislavský kraj";0;0;0;0;NA;173735;0;2020-05-14;-44
2020-05-13;"Bratislavský kraj";0;0;0;0;NA;173735;0;2020-05-13;-44
2020-05-12;"Bratislavský kraj";2;0;0;0;NA;173735;2;2020-05-12;-44
2020-05-11;"Bratislavský kraj";0;0;0;0;NA;173735;0;2020-05-11;-46
2020-05-09;"Bratislavský kraj";0;0;0;0;NA;173735;0;2020-05-09;-46
2020-05-07;"Bratislavský kraj";1;0;0;0;NA;173735;1;2020-05-07;-46
2020-05-06;"Bratislavský kraj";3;0;0;0;NA;173735;3;2020-05-06;-47
2020-05-05;"Bratislavský kraj";0;0;0;0;NA;173735;0;2020-05-05;-50
2020-05-04;"Bratislavský kraj";0;0;0;0;NA;173735;0;2020-05-04;-50
2020-05-03;"Bratislavský kraj";2;0;0;0;NA;173735;2;2020-05-03;-50
2020-05-02;"Bratislavský kraj";0;0;0;0;NA;173735;0;2020-05-02;-52
2020-05-01;"Bratislavský kraj";0;0;0;0;NA;173735;0;2020-05-01;-52
2020-04-30;"Bratislavský kraj";5;0;0;0;NA;173735;5;2020-04-30;-52
2020-04-29;"Bratislavský kraj";0;0;0;0;NA;173735;0;2020-04-29;-57
2020-04-28;"Bratislavský kraj";2;0;0;0;NA;173735;2;2020-04-28;-57
2020-04-27;"Bratislavský kraj";0;0;0;0;NA;173735;0;2020-04-27;-59
2020-04-26;"Bratislavský kraj";1;0;0;0;NA;173735;1;2020-04-26;-59
2020-04-25;"Bratislavský kraj";0;0;0;0;NA;173735;0;2020-04-25;-60
2020-04-24;"Bratislavský kraj";2;0;0;0;NA;173735;2;2020-04-24;-60
2020-04-23;"Bratislavský kraj";6;0;0;0;NA;173735;6;2020-04-23;-62
2020-04-22;"Bratislavský kraj";11;0;0;0;NA;173735;11;2020-04-22;-68
2020-04-21;"Bratislavský kraj";4;0;0;0;NA;173735;4;2020-04-21;-79
2020-04-20;"Bratislavský kraj";0;0;0;0;NA;173735;0;2020-04-20;-83
2020-04-19;"Bratislavský kraj";4;0;0;0;NA;173735;4;2020-04-19;-83
2020-04-18;"Bratislavský kraj";5;0;0;0;NA;173735;5;2020-04-18;-87
2020-04-17;"Bratislavský kraj";6;0;0;0;NA;173735;6;2020-04-17;-92
2020-04-16;"Bratislavský kraj";15;0;0;0;NA;173735;15;2020-04-16;-98
2020-04-15;"Bratislavský kraj";11;0;0;0;NA;173735;11;2020-04-15;-113
2020-04-14;"Bratislavský kraj";19;0;0;0;NA;173735;19;2020-04-14;-124
2020-04-13;"Bratislavský kraj";53;0;0;0;NA;173735;53;2020-04-13;-143
2020-04-12;"Bratislavský kraj";3;0;0;0;NA;173735;3;2020-04-12;-196
2020-04-11;"Bratislavský kraj";1;0;0;0;NA;173735;1;2020-04-11;-199
2020-04-10;"Bratislavský kraj";8;0;0;0;NA;173735;8;2020-04-10;-200
2020-04-09;"Bratislavský kraj";3;0;0;0;NA;173735;3;2020-04-09;-208
2020-04-08;"Bratislavský kraj";3;0;0;0;NA;173735;3;2020-04-08;-211
2020-04-07;"Bratislavský kraj";24;0;0;0;NA;173735;24;2020-04-07;-214
2020-04-06;"Bratislavský kraj";5;0;0;0;NA;173735;5;2020-04-06;-238
2020-04-05;"Bratislavský kraj";6;0;0;0;NA;173735;6;2020-04-05;-243
2020-04-04;"Bratislavský kraj";2;0;0;0;NA;173735;2;2020-04-04;-249
2020-04-03;"Bratislavský kraj";1;0;0;0;NA;173735;1;2020-04-03;-251
2020-04-02;"Bratislavský kraj";2;0;0;0;NA;173735;2;2020-04-02;-252
2020-04-01;"Bratislavský kraj";5;0;0;0;NA;173735;5;2020-04-01;-254
2020-03-31;"Bratislavský kraj";19;0;0;0;NA;173735;19;2020-03-31;-259
2020-03-30;"Bratislavský kraj";6;0;0;0;NA;173735;6;2020-03-30;-278
2020-03-29;"Bratislavský kraj";8;0;0;0;NA;173735;8;2020-03-29;-284
2020-03-28;"Bratislavský kraj";4;0;0;0;NA;173735;4;2020-03-28;-292
2020-03-27;"Bratislavský kraj";3;0;0;0;NA;173735;3;2020-03-27;-296
2020-03-26;"Bratislavský kraj";15;0;0;0;NA;173735;15;2020-03-26;-299
2020-03-25;"Bratislavský kraj";1;0;0;0;NA;173735;1;2020-03-25;-314
2020-03-24;"Bratislavský kraj";4;0;0;0;NA;173735;4;2020-03-24;-315
2020-03-23;"Bratislavský kraj";9;0;0;0;NA;173735;9;2020-03-23;-319
2020-03-22;"Bratislavský kraj";2;0;0;0;NA;173735;2;2020-03-22;-328
2020-03-21;"Bratislavský kraj";22;0;0;0;NA;173735;22;2020-03-21;-330
2020-03-20;"Bratislavský kraj";3;0;0;0;NA;173735;3;2020-03-20;-352
2020-03-19;"Bratislavský kraj";4;0;0;0;NA;173735;4;2020-03-19;-355
2020-03-18;"Bratislavský kraj";3;0;0;0;NA;173735;3;2020-03-18;-359
2020-03-17;"Bratislavský kraj";13;0;0;0;NA;173735;13;2020-03-17;-362
2020-03-16;"Bratislavský kraj";1;0;0;0;NA;173735;1;2020-03-16;-375
2020-03-15;"Bratislavský kraj";4;0;0;0;NA;173735;4;2020-03-15;-376
2020-03-14;"Bratislavský kraj";9;0;0;0;NA;173735;9;2020-03-14;-380
2020-03-13;"Bratislavský kraj";2;0;0;0;NA;173735;2;2020-03-13;-389
2020-03-12;"Bratislavský kraj";8;0;0;0;NA;173735;8;2020-03-12;-391
2020-03-11;"Bratislavský kraj";3;0;0;0;NA;173735;3;2020-03-11;-399
2020-03-09;"Bratislavský kraj";0;0;0;0;NA;173735;0;2020-03-09;-402
2020-03-08;"Bratislavský kraj";2;0;0;0;NA;173735;2;2020-03-08;-402
2020-03-07;"Bratislavský kraj";2;0;0;0;NA;173735;2;2020-03-07;-404
2020-03-06;"Bratislavský kraj";1;0;0;0;NA;173735;1;2020-03-06;-406
2022-01-11;"Košický kraj";349;0;0;0;120068;190248;349;2022-01-11;190248
2022-01-10;"Košický kraj";290;0;0;0;NA;190248;290;2022-01-10;189899
2022-01-09;"Košický kraj";230;3204;35;3239;NA;190248;265;2022-01-09;189609
2022-01-08;"Košický kraj";157;2244;54;2298;NA;190248;211;2022-01-08;189344
2022-01-07;"Košický kraj";388;4545;128;4673;NA;190248;516;2022-01-07;189133
2022-01-06;"Košický kraj";118;1576;55;1631;NA;190248;173;2022-01-06;188617
2022-01-05;"Košický kraj";354;5023;100;5123;NA;190248;454;2022-01-05;188444
2022-01-04;"Košický kraj";450;5270;84;5354;NA;190248;534;2022-01-04;187990
2022-01-03;"Košický kraj";439;7850;140;7990;NA;190248;579;2022-01-03;187456
2022-01-02;"Košický kraj";284;4614;109;4723;NA;190248;393;2022-01-02;186877
2022-01-01;"Košický kraj";28;357;18;375;NA;190248;46;2022-01-01;186484
2021-12-31;"Košický kraj";122;2999;86;3085;NA;190248;208;2021-12-31;186438
2021-12-30;"Košický kraj";401;3879;118;3997;NA;190248;519;2021-12-30;186230
2021-12-29;"Košický kraj";378;4194;111;4305;NA;190248;489;2021-12-29;185711
2021-12-28;"Košický kraj";509;4450;125;4575;NA;190248;634;2021-12-28;185222
2021-12-27;"Košický kraj";495;6782;205;6987;NA;190248;700;2021-12-27;184588
2021-12-26;"Košický kraj";109;2510;115;2625;NA;190248;224;2021-12-26;183888
2021-12-25;"Košický kraj";30;644;43;687;NA;190248;73;2021-12-25;183664
2021-12-24;"Košický kraj";95;1055;50;1105;NA;190248;145;2021-12-24;183591
2021-12-23;"Košický kraj";644;4432;131;4563;NA;190248;775;2021-12-23;183446
2021-12-22;"Košický kraj";224;4309;106;4415;NA;190248;330;2021-12-22;182671
2021-12-21;"Košický kraj";544;6491;138;6629;NA;190248;682;2021-12-21;182341
2021-12-20;"Košický kraj";464;8458;193;8651;NA;190248;657;2021-12-20;181659
2021-12-19;"Košický kraj";137;5447;177;5624;NA;190248;314;2021-12-19;181002
2021-12-18;"Košický kraj";414;2555;102;2657;NA;190248;516;2021-12-18;180688
2021-12-17;"Košický kraj";428;4832;145;4977;NA;190248;573;2021-12-17;180172
2021-12-16;"Košický kraj";476;5800;168;5968;NA;190248;644;2021-12-16;179599
2021-12-15;"Košický kraj";508;5956;172;6128;NA;190248;680;2021-12-15;178955
2021-12-14;"Košický kraj";957;5789;172;5961;NA;190248;1129;2021-12-14;178275
2021-12-13;"Košický kraj";679;9607;248;9855;NA;190248;927;2021-12-13;177146
2021-12-12;"Košický kraj";243;6657;198;6855;NA;190248;441;2021-12-12;176219
2021-12-11;"Košický kraj";519;2996;134;3130;NA;190248;653;2021-12-11;175778
2021-12-10;"Košický kraj";936;5465;185;5650;NA;190248;1121;2021-12-10;175125
2021-12-09;"Košický kraj";755;5735;198;5933;NA;190248;953;2021-12-09;174004
2021-12-08;"Košický kraj";1095;6574;275;6849;NA;190248;1370;2021-12-08;173051
2021-12-07;"Košický kraj";1212;6323;267;6590;NA;190248;1479;2021-12-07;171681
2021-12-06;"Košický kraj";904;10627;313;10940;NA;190248;1217;2021-12-06;170202
2021-12-05;"Košický kraj";404;7756;263;8019;NA;190248;667;2021-12-05;168985
2021-12-04;"Košický kraj";1007;3097;180;3277;NA;190248;1187;2021-12-04;168318
2021-12-03;"Košický kraj";1338;6065;271;6336;NA;190248;1609;2021-12-03;167131
2021-12-02;"Košický kraj";2209;5654;302;5956;NA;190248;2511;2021-12-02;165522
2021-12-01;"Košický kraj";1016;6448;387;6835;NA;190248;1403;2021-12-01;163011
2021-11-30;"Košický kraj";1125;8173;471;8644;NA;190248;1596;2021-11-30;161608
2021-11-29;"Košický kraj";993;14057;634;14691;NA;190248;1627;2021-11-29;160012
2021-11-28;"Košický kraj";972;10211;473;10684;NA;190248;1445;2021-11-28;158385
2021-11-27;"Košický kraj";1103;3566;219;3785;NA;190248;1322;2021-11-27;156940
2021-11-26;"Košický kraj";1395;6059;383;6442;NA;190248;1778;2021-11-26;155618
2021-11-25;"Košický kraj";1373;6875;476;7351;NA;190248;1849;2021-11-25;153840
2021-11-24;"Košický kraj";1194;6905;457;7362;NA;190248;1651;2021-11-24;151991
2021-11-23;"Košický kraj";1178;7185;488;7673;NA;190248;1666;2021-11-23;150340
2021-11-22;"Košický kraj";861;10709;741;11450;NA;190248;1602;2021-11-22;148674
2021-11-21;"Košický kraj";985;7394;657;8051;NA;190248;1642;2021-11-21;147072
2021-11-20;"Košický kraj";1083;2859;295;3154;NA;190248;1378;2021-11-20;145430
2021-11-19;"Košický kraj";1078;7774;570;8344;NA;190248;1648;2021-11-19;144052
2021-11-18;"Košický kraj";1061;9410;719;10129;NA;190248;1780;2021-11-18;142404
2021-11-17;"Košický kraj";1319;2824;262;3086;NA;190248;1581;2021-11-17;140624
2021-11-16;"Košický kraj";1484;7135;543;7678;NA;190248;2027;2021-11-16;139043
2021-11-15;"Košický kraj";902;10812;754;11566;NA;190248;1656;2021-11-15;137016
2021-11-14;"Košický kraj";715;5756;455;6211;NA;190248;1170;2021-11-14;135360
2021-11-13;"Košický kraj";869;2686;312;2998;NA;190248;1181;2021-11-13;134190
2021-11-12;"Košický kraj";1132;5616;410;6026;NA;190248;1542;2021-11-12;133009
2021-11-11;"Košický kraj";1035;6139;460;6599;NA;190248;1495;2021-11-11;131467
2021-11-10;"Košický kraj";933;6633;497;7130;NA;190248;1430;2021-11-10;129972
2021-11-09;"Košický kraj";967;5540;389;5929;NA;190248;1356;2021-11-09;128542
2021-11-08;"Košický kraj";701;7838;601;8439;NA;190248;1302;2021-11-08;127186
2021-11-07;"Košický kraj";691;4578;425;5003;NA;190248;1116;2021-11-07;125884
2021-11-06;"Košický kraj";996;2276;217;2493;NA;190248;1213;2021-11-06;124768
2021-11-05;"Košický kraj";1029;4905;367;5272;NA;190248;1396;2021-11-05;123555
2021-11-04;"Košický kraj";1000;5354;360;5714;NA;190248;1360;2021-11-04;122159
2021-11-03;"Košický kraj";1051;5749;361;6110;NA;190248;1412;2021-11-03;120799
2021-11-02;"Košický kraj";915;8775;566;9341;NA;190248;1481;2021-11-02;119387
2021-11-01;"Košický kraj";181;1999;265;2264;NA;190248;446;2021-11-01;117906
2021-10-31;"Košický kraj";385;2337;227;2564;NA;190248;612;2021-10-31;117460
2021-10-30;"Košický kraj";641;2380;180;2560;NA;190248;821;2021-10-30;116848
2021-10-29;"Košický kraj";750;4608;289;4897;NA;190248;1039;2021-10-29;116027
2021-10-28;"Košický kraj";823;5115;255;5370;NA;190248;1078;2021-10-28;114988
2021-10-27;"Košický kraj";723;4831;259;5090;NA;190248;982;2021-10-27;113910
2021-10-26;"Košický kraj";618;5049;225;5274;NA;190248;843;2021-10-26;112928
2021-10-25;"Košický kraj";268;6747;292;7039;NA;190248;560;2021-10-25;112085
2021-10-24;"Košický kraj";170;3447;205;3652;NA;190248;375;2021-10-24;111525
2021-10-23;"Košický kraj";397;1953;86;2039;NA;190248;483;2021-10-23;111150
2021-10-22;"Košický kraj";474;4679;130;4809;NA;190248;604;2021-10-22;110667
2021-10-21;"Košický kraj";669;5094;172;5266;NA;190248;841;2021-10-21;110063
2021-10-20;"Košický kraj";398;4963;152;5115;NA;190248;550;2021-10-20;109222
2021-10-19;"Košický kraj";579;4870;161;5031;NA;190248;740;2021-10-19;108672
2021-10-18;"Košický kraj";180;7090;171;7261;NA;190248;351;2021-10-18;107932
2021-10-17;"Košický kraj";70;3614;125;3739;NA;190248;195;2021-10-17;107581
2021-10-16;"Košický kraj";312;1839;40;1879;NA;190248;352;2021-10-16;107386
2021-10-15;"Košický kraj";312;4530;77;4607;NA;190248;389;2021-10-15;107034
2021-10-14;"Košický kraj";327;4652;95;4747;NA;190248;422;2021-10-14;106645
2021-10-13;"Košický kraj";168;4168;88;4256;NA;190248;256;2021-10-13;106223
2021-10-12;"Košický kraj";391;4119;75;4194;NA;190248;466;2021-10-12;105967
2021-10-11;"Košický kraj";119;6351;121;6472;NA;190248;240;2021-10-11;105501
2021-10-10;"Košický kraj";104;2921;63;2984;NA;190248;167;2021-10-10;105261
2021-10-09;"Košický kraj";111;1687;43;1730;NA;190248;154;2021-10-09;105094
2021-10-08;"Košický kraj";274;4143;68;4211;NA;190248;342;2021-10-08;104940
2021-10-07;"Košický kraj";277;4399;74;4473;NA;190248;351;2021-10-07;104598
2021-10-06;"Košický kraj";178;4369;89;4458;NA;190248;267;2021-10-06;104247
2021-10-05;"Košický kraj";345;4542;78;4620;NA;190248;423;2021-10-05;103980
2021-10-04;"Košický kraj";122;6094;110;6204;NA;190248;232;2021-10-04;103557
2021-10-03;"Košický kraj";133;3176;74;3250;NA;190248;207;2021-10-03;103325
2021-10-02;"Košický kraj";124;2567;41;2608;NA;190248;165;2021-10-02;103118
2021-10-01;"Košický kraj";181;4251;73;4324;NA;190248;254;2021-10-01;102953
2021-09-30;"Košický kraj";244;4780;71;4851;NA;190248;315;2021-09-30;102699
2021-09-29;"Košický kraj";183;3824;64;3888;NA;190248;247;2021-09-29;102384
2021-09-28;"Košický kraj";303;4339;80;4419;NA;190248;383;2021-09-28;102137
2021-09-27;"Košický kraj";117;6358;77;6435;NA;190248;194;2021-09-27;101754
2021-09-26;"Košický kraj";13;2809;44;2853;NA;190248;57;2021-09-26;101560
2021-09-25;"Košický kraj";162;2521;35;2556;NA;190248;197;2021-09-25;101503
2021-09-24;"Košický kraj";183;4756;43;4799;NA;190248;226;2021-09-24;101306
2021-09-23;"Košický kraj";142;3880;51;3931;NA;190248;193;2021-09-23;101080
2021-09-22;"Košický kraj";151;4436;52;4488;NA;190248;203;2021-09-22;100887
2021-09-21;"Košický kraj";234;4441;44;4485;NA;190248;278;2021-09-21;100684
2021-09-20;"Košický kraj";158;6017;73;6090;NA;190248;231;2021-09-20;100406
2021-09-19;"Košický kraj";15;2487;30;2517;NA;190248;45;2021-09-19;100175
2021-09-18;"Košický kraj";187;2504;24;2528;NA;190248;211;2021-09-18;100130
2021-09-17;"Košický kraj";121;4797;41;4838;NA;190248;162;2021-09-17;99919
2021-09-16;"Košický kraj";228;4503;71;4574;NA;190248;299;2021-09-16;99757
2021-09-15;"Košický kraj";52;989;16;1005;NA;190248;68;2021-09-15;99458
2021-09-14;"Košický kraj";142;3456;47;3503;NA;190248;189;2021-09-14;99390
2021-09-13;"Košický kraj";96;4949;48;4997;NA;190248;144;2021-09-13;99201
2021-09-12;"Košický kraj";14;2003;31;2034;NA;190248;45;2021-09-12;99057
2021-09-11;"Košický kraj";105;2186;19;2205;NA;190248;124;2021-09-11;99012
2021-09-10;"Košický kraj";125;4293;42;4335;NA;190248;167;2021-09-10;98888
2021-09-09;"Košický kraj";115;3226;30;3256;NA;190248;145;2021-09-09;98721
2021-09-08;"Košický kraj";86;2753;36;2789;NA;190248;122;2021-09-08;98576
2021-09-07;"Košický kraj";79;2686;53;2739;NA;190248;132;2021-09-07;98454
2021-09-06;"Košický kraj";41;2786;36;2822;NA;190248;77;2021-09-06;98322
2021-09-05;"Košický kraj";52;1393;18;1411;NA;190248;70;2021-09-05;98245
2021-09-04;"Košický kraj";37;1678;12;1690;NA;190248;49;2021-09-04;98175
2021-09-03;"Košický kraj";47;2913;35;2948;NA;190248;82;2021-09-03;98126
2021-09-02;"Košický kraj";56;2686;26;2712;NA;190248;82;2021-09-02;98044
2021-09-01;"Košický kraj";95;629;13;642;NA;190248;108;2021-09-01;97962
2021-08-31;"Košický kraj";30;2525;22;2547;NA;190248;52;2021-08-31;97854
2021-08-30;"Košický kraj";8;2404;28;2432;NA;190248;36;2021-08-30;97802
2021-08-29;"Košický kraj";16;603;1;604;NA;190248;17;2021-08-29;97766
2021-08-28;"Košický kraj";14;2103;11;2114;NA;190248;25;2021-08-28;97749
2021-08-27;"Košický kraj";22;2908;16;2924;NA;190248;38;2021-08-27;97724
2021-08-26;"Košický kraj";19;2292;13;2305;NA;190248;32;2021-08-26;97686
2021-08-25;"Košický kraj";33;2010;6;2016;NA;190248;39;2021-08-25;97654
2021-08-24;"Košický kraj";14;2337;3;2340;NA;190248;17;2021-08-24;97615
2021-08-23;"Košický kraj";33;2461;5;2466;NA;190248;38;2021-08-23;97598
2021-08-22;"Košický kraj";4;1457;8;1465;NA;190248;12;2021-08-22;97560
2021-08-21;"Košický kraj";35;2134;5;2139;NA;190248;40;2021-08-21;97548
2021-08-20;"Košický kraj";13;3215;5;3220;NA;190248;18;2021-08-20;97508
2021-08-19;"Košický kraj";14;2178;6;2184;NA;190248;20;2021-08-19;97490
2021-08-18;"Košický kraj";30;1827;8;1835;NA;190248;38;2021-08-18;97470
2021-08-17;"Košický kraj";24;1619;3;1622;NA;190248;27;2021-08-17;97432
2021-08-16;"Košický kraj";3;2236;10;2246;NA;190248;13;2021-08-16;97405
2021-08-15;"Košický kraj";1;778;5;783;NA;190248;6;2021-08-15;97392
2021-08-14;"Košický kraj";15;1222;1;1223;NA;190248;16;2021-08-14;97386
2021-08-13;"Košický kraj";14;1928;8;1936;NA;190248;22;2021-08-13;97370
2021-08-12;"Košický kraj";10;1248;3;1251;NA;190248;13;2021-08-12;97348
2021-08-11;"Košický kraj";6;1368;5;1373;NA;190248;11;2021-08-11;97335
2021-08-10;"Košický kraj";10;1352;8;1360;NA;190248;18;2021-08-10;97324
2021-08-09;"Košický kraj";12;1651;3;1654;NA;190248;15;2021-08-09;97306
2021-08-08;"Košický kraj";8;688;1;689;NA;190248;9;2021-08-08;97291
2021-08-07;"Košický kraj";3;1125;3;1128;NA;190248;6;2021-08-07;97282
2021-08-06;"Košický kraj";9;1614;6;1620;NA;190248;15;2021-08-06;97276
2021-08-05;"Košický kraj";26;1254;6;1260;NA;190248;32;2021-08-05;97261
2021-08-04;"Košický kraj";8;1373;5;1378;NA;190248;13;2021-08-04;97229
2021-08-03;"Košický kraj";33;1121;3;1124;NA;190248;36;2021-08-03;97216
2021-08-02;"Košický kraj";6;1702;8;1710;NA;190248;14;2021-08-02;97180
2021-08-01;"Košický kraj";1;662;1;663;NA;190248;2;2021-08-01;97166
2021-07-31;"Košický kraj";17;1153;2;1155;NA;190248;19;2021-07-31;97164
2021-07-30;"Košický kraj";12;1657;7;1664;NA;190248;19;2021-07-30;97145
2021-07-29;"Košický kraj";7;1242;5;1247;NA;190248;12;2021-07-29;97126
2021-07-28;"Košický kraj";15;956;5;961;NA;190248;20;2021-07-28;97114
2021-07-27;"Košický kraj";17;1180;7;1187;NA;190248;24;2021-07-27;97094
2021-07-26;"Košický kraj";3;1666;9;1675;NA;190248;12;2021-07-26;97070
2021-07-25;"Košický kraj";0;719;3;722;NA;190248;3;2021-07-25;97058
2021-07-24;"Košický kraj";18;996;4;1000;NA;190248;22;2021-07-24;97055
2021-07-23;"Košický kraj";9;1524;5;1529;NA;190248;14;2021-07-23;97033
2021-07-22;"Košický kraj";1;1254;4;1258;NA;190248;5;2021-07-22;97019
2021-07-21;"Košický kraj";4;1117;3;1120;NA;190248;7;2021-07-21;97014
2021-07-20;"Košický kraj";6;1355;1;1356;NA;190248;7;2021-07-20;97007
2021-07-19;"Košický kraj";2;1517;2;1519;NA;190248;4;2021-07-19;97000
2021-07-18;"Košický kraj";0;644;0;644;NA;190248;0;2021-07-18;96996
2021-07-17;"Košický kraj";3;1101;5;1106;NA;190248;8;2021-07-17;96996
2021-07-16;"Košický kraj";3;1609;4;1613;NA;190248;7;2021-07-16;96988
2021-07-15;"Košický kraj";4;1383;4;1387;NA;190248;8;2021-07-15;96981
2021-07-14;"Košický kraj";2;1175;4;1179;NA;190248;6;2021-07-14;96973
2021-07-13;"Košický kraj";4;1331;1;1332;NA;190248;5;2021-07-13;96967
2021-07-12;"Košický kraj";3;1894;3;1897;NA;190248;6;2021-07-12;96962
2021-07-11;"Košický kraj";1;537;2;539;NA;190248;3;2021-07-11;96956
2021-07-10;"Košický kraj";9;1167;0;1167;NA;190248;9;2021-07-10;96953
2021-07-09;"Košický kraj";5;2005;5;2010;NA;190248;10;2021-07-09;96944
2021-07-08;"Košický kraj";13;1282;2;1284;NA;190248;15;2021-07-08;96934
2021-07-07;"Košický kraj";6;1524;1;1525;NA;190248;7;2021-07-07;96919
2021-07-06;"Košický kraj";4;1886;2;1888;NA;190248;6;2021-07-06;96912
2021-07-05;"Košický kraj";1;573;1;574;NA;190248;2;2021-07-05;96906
2021-07-04;"Košický kraj";0;482;2;484;NA;190248;2;2021-07-04;96904
2021-07-03;"Košický kraj";2;1227;0;1227;NA;190248;2;2021-07-03;96902
2021-07-02;"Košický kraj";2;1883;3;1886;NA;190248;5;2021-07-02;96900
2021-07-01;"Košický kraj";0;1211;2;1213;NA;190248;2;2021-07-01;96895
2021-06-30;"Košický kraj";5;9306;7;9313;NA;190248;12;2021-06-30;96893
2021-06-29;"Košický kraj";6;5692;7;5699;NA;190248;13;2021-06-29;96881
2021-06-28;"Košický kraj";5;6129;2;6131;NA;190248;7;2021-06-28;96868
2021-06-27;"Košický kraj";8;4612;3;4615;NA;190248;11;2021-06-27;96861
2021-06-26;"Košický kraj";4;5699;14;5713;NA;190248;18;2021-06-26;96850
2021-06-25;"Košický kraj";5;6981;2;6983;NA;190248;7;2021-06-25;96832
2021-06-24;"Košický kraj";1;5072;3;5075;NA;190248;4;2021-06-24;96825
2021-06-23;"Košický kraj";8;5373;3;5376;NA;190248;11;2021-06-23;96821
2021-06-22;"Košický kraj";1;5269;3;5272;NA;190248;4;2021-06-22;96810
2021-06-21;"Košický kraj";5;6830;11;6841;NA;190248;16;2021-06-21;96806
2021-06-20;"Košický kraj";0;4882;6;4888;NA;190248;6;2021-06-20;96790
2021-06-19;"Košický kraj";7;6473;1;6474;NA;190248;8;2021-06-19;96784
2021-06-18;"Košický kraj";4;7969;8;7977;NA;190248;12;2021-06-18;96776
2021-06-17;"Košický kraj";6;6128;3;6131;NA;190248;9;2021-06-17;96764
2021-06-16;"Košický kraj";11;6059;7;6066;NA;190248;18;2021-06-16;96755
2021-06-15;"Košický kraj";12;6301;2;6303;NA;190248;14;2021-06-15;96737
2021-06-14;"Košický kraj";10;7076;9;7085;NA;190248;19;2021-06-14;96723
2021-06-13;"Košický kraj";7;6948;8;6956;NA;190248;15;2021-06-13;96704
2021-06-12;"Košický kraj";7;7485;9;7494;NA;190248;16;2021-06-12;96689
2021-06-11;"Košický kraj";15;8973;6;8979;NA;190248;21;2021-06-11;96673
2021-06-10;"Košický kraj";11;6588;16;6604;NA;190248;27;2021-06-10;96652
2021-06-09;"Košický kraj";37;6056;7;6063;NA;190248;44;2021-06-09;96625
2021-06-08;"Košický kraj";33;7019;13;7032;NA;190248;46;2021-06-08;96581
2021-06-07;"Košický kraj";11;8106;22;8128;NA;190248;33;2021-06-07;96535
2021-06-06;"Košický kraj";1;7843;7;7850;NA;190248;8;2021-06-06;96502
2021-06-05;"Košický kraj";21;9286;3;9289;NA;190248;24;2021-06-05;96494
2021-06-04;"Košický kraj";26;11418;20;11438;NA;190248;46;2021-06-04;96470
2021-06-03;"Košický kraj";23;6467;14;6481;NA;190248;37;2021-06-03;96424
2021-06-02;"Košický kraj";15;7180;24;7204;NA;190248;39;2021-06-02;96387
2021-06-01;"Košický kraj";13;7562;10;7572;NA;190248;23;2021-06-01;96348
2021-05-31;"Košický kraj";13;9256;18;9274;NA;190248;31;2021-05-31;96325
2021-05-30;"Košický kraj";3;11215;10;11225;NA;190248;13;2021-05-30;96294
2021-05-29;"Košický kraj";25;10942;22;10964;NA;190248;47;2021-05-29;96281
2021-05-28;"Košický kraj";17;13055;29;13084;NA;190248;46;2021-05-28;96234
2021-05-27;"Košický kraj";19;7924;26;7950;NA;190248;45;2021-05-27;96188
2021-05-26;"Košický kraj";35;8118;27;8145;NA;190248;62;2021-05-26;96143
2021-05-25;"Košický kraj";33;9296;29;9325;NA;190248;62;2021-05-25;96081
2021-05-24;"Košický kraj";10;10855;27;10882;NA;190248;37;2021-05-24;96019
2021-05-23;"Košický kraj";4;12151;15;12166;NA;190248;19;2021-05-23;95982
2021-05-22;"Košický kraj";27;12601;19;12620;NA;190248;46;2021-05-22;95963
2021-05-21;"Košický kraj";24;14910;27;14937;NA;190248;51;2021-05-21;95917
2021-05-20;"Košický kraj";20;9422;28;9450;NA;190248;48;2021-05-20;95866
2021-05-19;"Košický kraj";30;10421;21;10442;NA;190248;51;2021-05-19;95818
2021-05-18;"Košický kraj";34;10254;36;10290;NA;190248;70;2021-05-18;95767
2021-05-17;"Košický kraj";20;12686;38;12724;NA;190248;58;2021-05-17;95697
2021-05-16;"Košický kraj";37;17865;20;17885;NA;190248;57;2021-05-16;95639
2021-05-15;"Košický kraj";22;25602;28;25630;NA;190248;50;2021-05-15;95582
2021-05-14;"Košický kraj";32;21824;42;21866;NA;190248;74;2021-05-14;95532
2021-05-13;"Košický kraj";39;10172;32;10204;NA;190248;71;2021-05-13;95458
2021-05-12;"Košický kraj";85;10868;33;10901;NA;190248;118;2021-05-12;95387
2021-05-11;"Košický kraj";68;11166;32;11198;NA;190248;100;2021-05-11;95269
2021-05-10;"Košický kraj";25;17044;42;17086;NA;190248;67;2021-05-10;95169
2021-05-09;"Košický kraj";84;25594;55;25649;NA;190248;139;2021-05-09;95102
2021-05-08;"Košický kraj";18;23399;23;23422;NA;190248;41;2021-05-08;94963
2021-05-07;"Košický kraj";51;24497;57;24554;NA;190248;108;2021-05-07;94922
2021-05-06;"Košický kraj";55;11847;43;11890;NA;190248;98;2021-05-06;94814
2021-05-05;"Košický kraj";23;12124;35;12159;NA;190248;58;2021-05-05;94716
2021-05-04;"Košický kraj";143;13562;38;13600;NA;190248;181;2021-05-04;94658
2021-05-03;"Košický kraj";37;16944;68;17012;NA;190248;105;2021-05-03;94477
2021-05-02;"Košický kraj";45;36096;56;36152;NA;190248;101;2021-05-02;94372
2021-05-01;"Košický kraj";54;52075;76;52151;NA;190248;130;2021-05-01;94271
2021-04-30;"Košický kraj";59;44602;94;44696;NA;190248;153;2021-04-30;94141
2021-04-29;"Košický kraj";76;17014;53;17067;NA;190248;129;2021-04-29;93988
2021-04-28;"Košický kraj";99;17970;52;18022;NA;190248;151;2021-04-28;93859
2021-04-27;"Košický kraj";108;20670;43;20713;NA;190248;151;2021-04-27;93708
2021-04-26;"Košický kraj";39;25915;96;26011;NA;190248;135;2021-04-26;93557
2021-04-25;"Košický kraj";23;48355;57;48412;NA;190248;80;2021-04-25;93422
2021-04-24;"Košický kraj";68;90124;114;90238;NA;190248;182;2021-04-24;93342
2021-04-23;"Košický kraj";110;41232;72;41304;NA;190248;182;2021-04-23;93160
2021-04-22;"Košický kraj";56;16772;44;16816;NA;190248;100;2021-04-22;92978
2021-04-21;"Košický kraj";114;19519;61;19580;NA;190248;175;2021-04-21;92878
2021-04-20;"Košický kraj";81;25432;63;25495;NA;190248;144;2021-04-20;92703
2021-04-19;"Košický kraj";93;29950;108;30058;NA;190248;201;2021-04-19;92559
2021-04-18;"Košický kraj";10;48913;82;48995;NA;190248;92;2021-04-18;92358
2021-04-17;"Košický kraj";187;83856;103;83959;NA;190248;290;2021-04-17;92266
2021-04-16;"Košický kraj";83;41568;127;41695;NA;190248;210;2021-04-16;91976
2021-04-15;"Košický kraj";104;18522;93;18615;NA;190248;197;2021-04-15;91766
2021-04-14;"Košický kraj";119;20089;64;20153;NA;190248;183;2021-04-14;91569
2021-04-13;"Košický kraj";81;23175;120;23295;NA;190248;201;2021-04-13;91386
2021-04-12;"Košický kraj";129;26573;124;26697;NA;190248;253;2021-04-12;91185
2021-04-11;"Košický kraj";29;46949;80;47029;NA;190248;109;2021-04-11;90932
2021-04-10;"Košický kraj";138;100114;183;100297;NA;190248;321;2021-04-10;90823
2021-04-09;"Košický kraj";168;35206;133;35339;NA;190248;301;2021-04-09;90502
2021-04-08;"Košický kraj";81;18530;90;18620;NA;190248;171;2021-04-08;90201
2021-04-07;"Košický kraj";232;28027;194;28221;NA;190248;426;2021-04-07;90030
2021-04-06;"Košický kraj";121;36495;164;36659;NA;190248;285;2021-04-06;89604
2021-04-05;"Košický kraj";19;14361;66;14427;NA;190248;85;2021-04-05;89319
2021-04-04;"Košický kraj";33;15089;66;15155;NA;190248;99;2021-04-04;89234
2021-04-03;"Košický kraj";138;97664;241;97905;NA;190248;379;2021-04-03;89135
2021-04-02;"Košický kraj";128;24515;76;24591;NA;190248;204;2021-04-02;88756
2021-04-01;"Košický kraj";165;46151;156;46307;NA;190248;321;2021-04-01;88552
2021-03-31;"Košický kraj";160;29659;124;29783;NA;190248;284;2021-03-31;88231
2021-03-30;"Košický kraj";229;24038;163;24201;NA;190248;392;2021-03-30;87947
2021-03-29;"Košický kraj";78;28843;194;29037;NA;190248;272;2021-03-29;87555
2021-03-28;"Košický kraj";39;44263;128;44391;NA;190248;167;2021-03-28;87283
2021-03-27;"Košický kraj";222;96602;265;96867;NA;190248;487;2021-03-27;87116
2021-03-26;"Košický kraj";233;45252;202;45454;NA;190248;435;2021-03-26;86629
2021-03-25;"Košický kraj";133;23804;175;23979;NA;190248;308;2021-03-25;86194
2021-03-24;"Košický kraj";165;20696;155;20851;NA;190248;320;2021-03-24;85886
2021-03-23;"Košický kraj";202;22434;192;22626;NA;190248;394;2021-03-23;85566
2021-03-22;"Košický kraj";169;26890;228;27118;NA;190248;397;2021-03-22;85172
2021-03-21;"Košický kraj";109;46746;167;46913;NA;190248;276;2021-03-21;84775
2021-03-20;"Košický kraj";126;101334;311;101645;NA;190248;437;2021-03-20;84499
2021-03-19;"Košický kraj";205;45632;260;45892;NA;190248;465;2021-03-19;84062
2021-03-18;"Košický kraj";274;23827;212;24039;NA;190248;486;2021-03-18;83597
2021-03-17;"Košický kraj";177;21548;195;21743;NA;190248;372;2021-03-17;83111
2021-03-16;"Košický kraj";386;23454;226;23680;NA;190248;612;2021-03-16;82739
2021-03-15;"Košický kraj";173;27900;297;28197;NA;190248;470;2021-03-15;82127
2021-03-14;"Košický kraj";145;44354;220;44574;NA;190248;365;2021-03-14;81657
2021-03-13;"Košický kraj";146;103790;483;104273;NA;190248;629;2021-03-13;81292
2021-03-12;"Košický kraj";366;47871;321;48192;NA;190248;687;2021-03-12;80663
2021-03-11;"Košický kraj";396;23229;263;23492;NA;190248;659;2021-03-11;79976
2021-03-10;"Košický kraj";121;22205;269;22474;NA;190248;390;2021-03-10;79317
2021-03-09;"Košický kraj";676;24509;300;24809;NA;190248;976;2021-03-09;78927
2021-03-08;"Košický kraj";559;29852;344;30196;NA;190248;903;2021-03-08;77951
2021-03-07;"Košický kraj";45;44230;299;44529;NA;190248;344;2021-03-07;77048
2021-03-06;"Košický kraj";177;105598;532;106130;NA;190248;709;2021-03-06;76704
2021-03-05;"Košický kraj";439;45567;424;45991;NA;190248;863;2021-03-05;75995
2021-03-04;"Košický kraj";417;23862;320;24182;NA;190248;737;2021-03-04;75132
2021-03-03;"Košický kraj";390;23169;298;23467;NA;190248;688;2021-03-03;74395
2021-03-02;"Košický kraj";464;24158;368;24526;NA;190248;832;2021-03-02;73707
2021-03-01;"Košický kraj";389;30013;514;30527;NA;190248;903;2021-03-01;72875
2021-02-28;"Košický kraj";265;43053;334;43387;NA;190248;599;2021-02-28;71972
2021-02-27;"Košický kraj";301;100559;784;101343;NA;190248;1085;2021-02-27;71373
2021-02-26;"Košický kraj";440;45466;492;45958;NA;190248;932;2021-02-26;70288
2021-02-25;"Košický kraj";331;19872;342;20214;NA;190248;673;2021-02-25;69356
2021-02-24;"Košický kraj";263;18751;505;19256;NA;190248;768;2021-02-24;68683
2021-02-23;"Košický kraj";642;21605;341;21946;NA;190248;983;2021-02-23;67915
2021-02-22;"Košický kraj";362;30858;434;31292;NA;190248;796;2021-02-22;66932
2021-02-21;"Košický kraj";170;40464;385;40849;NA;190248;555;2021-02-21;66136
2021-02-20;"Košický kraj";283;92550;770;93320;NA;190248;1053;2021-02-20;65581
2021-02-19;"Košický kraj";507;41579;583;42162;NA;190248;1090;2021-02-19;64528
2021-02-18;"Košický kraj";397;18442;345;18787;NA;190248;742;2021-02-18;63438
2021-02-17;"Košický kraj";322;18080;387;18467;NA;190248;709;2021-02-17;62696
2021-02-16;"Košický kraj";600;22111;463;22574;NA;190248;1063;2021-02-16;61987
2021-02-15;"Košický kraj";216;27633;419;28052;NA;190248;635;2021-02-15;60924
2021-02-14;"Košický kraj";241;56743;524;57267;NA;190248;765;2021-02-14;60289
2021-02-13;"Košický kraj";206;93745;765;94510;NA;190248;971;2021-02-13;59524
2021-02-12;"Košický kraj";448;49924;611;50535;NA;190248;1059;2021-02-12;58553
2021-02-11;"Košický kraj";435;14524;323;14847;NA;190248;758;2021-02-11;57494
2021-02-10;"Košický kraj";360;18475;431;18906;NA;190248;791;2021-02-10;56736
2021-02-09;"Košický kraj";544;24841;463;25304;NA;190248;1007;2021-02-09;55945
2021-02-08;"Košický kraj";237;24836;392;25228;NA;190248;629;2021-02-08;54938
2021-02-07;"Košický kraj";208;56897;612;57509;NA;190248;820;2021-02-07;54309
2021-02-06;"Košický kraj";318;104357;884;105241;NA;190248;1202;2021-02-06;53489
2021-02-05;"Košický kraj";384;43186;494;43680;NA;190248;878;2021-02-05;52287
2021-02-04;"Košický kraj";391;14512;371;14883;NA;190248;762;2021-02-04;51409
2021-02-03;"Košický kraj";296;12599;339;12938;NA;190248;635;2021-02-03;50647
2021-02-02;"Košický kraj";473;43883;1212;45095;NA;190248;1685;2021-02-02;50012
2021-02-01;"Košický kraj";415;21984;362;22346;NA;190248;777;2021-02-01;48327
2021-01-31;"Košický kraj";142;54690;617;55307;NA;190248;759;2021-01-31;47550
2021-01-30;"Košický kraj";320;76722;661;77383;NA;190248;981;2021-01-30;46791
2021-01-29;"Košický kraj";311;37164;466;37630;NA;190248;777;2021-01-29;45810
2021-01-28;"Košický kraj";540;9006;244;9250;NA;190248;784;2021-01-28;45033
2021-01-27;"Košický kraj";265;7575;211;7786;NA;190248;476;2021-01-27;44249
2021-01-26;"Košický kraj";530;14210;245;14455;NA;190248;775;2021-01-26;43773
2021-01-25;"Košický kraj";226;26431;413;26844;NA;190248;639;2021-01-25;42998
2021-01-24;"Košický kraj";150;44419;581;45000;NA;190248;731;2021-01-24;42359
2021-01-23;"Košický kraj";232;82705;857;83562;NA;190248;1089;2021-01-23;41628
2021-01-22;"Košický kraj";316;19997;265;20262;NA;190248;581;2021-01-22;40539
2021-01-21;"Košický kraj";274;14053;159;14212;NA;190248;433;2021-01-21;39958
2021-01-20;"Košický kraj";374;10844;201;11045;NA;190248;575;2021-01-20;39525
2021-01-19;"Košický kraj";248;9717;181;9898;NA;190248;429;2021-01-19;38950
2021-01-18;"Košický kraj";333;7659;262;7921;NA;190248;595;2021-01-18;38521
2021-01-17;"Košický kraj";155;535;14;549;NA;190248;169;2021-01-17;37926
2021-01-16;"Košický kraj";153;1403;47;1450;NA;190248;200;2021-01-16;37757
2021-01-15;"Košický kraj";308;6443;213;6656;NA;190248;521;2021-01-15;37557
2021-01-14;"Košický kraj";358;5471;221;5692;NA;190248;579;2021-01-14;37036
2021-01-13;"Košický kraj";421;4897;226;5123;NA;190248;647;2021-01-13;36457
2021-01-12;"Košický kraj";482;6473;237;6710;NA;190248;719;2021-01-12;35810
2021-01-11;"Košický kraj";309;7553;286;7839;NA;190248;595;2021-01-11;35091
2021-01-10;"Košický kraj";193;136;6;142;NA;190248;199;2021-01-10;34496
2021-01-09;"Košický kraj";469;1134;45;1179;NA;190248;514;2021-01-09;34297
2021-01-08;"Košický kraj";551;7106;348;7454;NA;190248;899;2021-01-08;33783
2021-01-07;"Košický kraj";251;5853;398;6251;NA;190248;649;2021-01-07;32884
2021-01-06;"Košický kraj";442;429;33;462;NA;190248;475;2021-01-06;32235
2021-01-05;"Košický kraj";584;7633;527;8160;NA;190248;1111;2021-01-05;31760
2021-01-04;"Košický kraj";407;6479;660;7139;NA;190248;1067;2021-01-04;30649
2021-01-03;"Košický kraj";118;661;22;683;NA;190248;140;2021-01-03;29582
2021-01-02;"Košický kraj";88;440;52;492;NA;190248;140;2021-01-02;29442
2021-01-01;"Košický kraj";398;725;49;774;NA;190248;447;2021-01-01;29302
2020-12-31;"Košický kraj";625;7509;453;7962;NA;190248;1078;2020-12-31;28855
2020-12-30;"Košický kraj";590;6076;395;6471;NA;190248;985;2020-12-30;27777
2020-12-29;"Košický kraj";419;7454;596;8050;NA;190248;1015;2020-12-29;26792
2020-12-28;"Košický kraj";356;7933;756;8689;NA;190248;1112;2020-12-28;25777
2020-12-27;"Košický kraj";159;147;16;163;NA;190248;175;2020-12-27;24665
2020-12-26;"Košický kraj";163;274;23;297;NA;190248;186;2020-12-26;24490
2020-12-25;"Košický kraj";237;140;10;150;NA;190248;247;2020-12-25;24304
2020-12-24;"Košický kraj";564;1470;90;1560;NA;190248;654;2020-12-24;24057
2020-12-23;"Košický kraj";304;7339;327;7666;NA;190248;631;2020-12-23;23403
2020-12-22;"Košický kraj";438;7284;429;7713;NA;190248;867;2020-12-22;22772
2020-12-21;"Košický kraj";405;6703;504;7207;NA;190248;909;2020-12-21;21905
2020-12-20;"Košický kraj";215;73;11;84;NA;190248;226;2020-12-20;20996
2020-12-19;"Košický kraj";207;1309;63;1372;NA;190248;270;2020-12-19;20770
2020-12-18;"Košický kraj";310;7707;292;7999;NA;190248;602;2020-12-18;20500
2020-12-17;"Košický kraj";463;5101;253;5354;NA;190248;716;2020-12-17;19898
2020-12-16;"Košický kraj";455;5725;295;6020;NA;190248;750;2020-12-16;19182
2020-12-15;"Košický kraj";319;4787;327;5114;NA;190248;646;2020-12-15;18432
2020-12-14;"Košický kraj";256;2905;225;3130;NA;190248;481;2020-12-14;17786
2020-12-13;"Košický kraj";47;181;2;183;NA;190248;49;2020-12-13;17305
2020-12-12;"Košický kraj";369;1587;118;1705;NA;190248;487;2020-12-12;17256
2020-12-11;"Košický kraj";354;5328;256;5584;NA;190248;610;2020-12-11;16769
2020-12-10;"Košický kraj";283;3987;174;4161;NA;190248;457;2020-12-10;16159
2020-12-09;"Košický kraj";279;3786;166;3952;NA;190248;445;2020-12-09;15702
2020-12-08;"Košický kraj";226;4105;355;4460;NA;190248;581;2020-12-08;15257
2020-12-07;"Košický kraj";270;2383;106;2489;NA;190248;376;2020-12-07;14676
2020-12-06;"Košický kraj";121;482;33;515;NA;190248;154;2020-12-06;14300
2020-12-05;"Košický kraj";90;1096;48;1144;NA;190248;138;2020-12-05;14146
2020-12-04;"Košický kraj";224;2680;82;2762;NA;190248;306;2020-12-04;14008
2020-12-03;"Košický kraj";211;7717;173;7890;NA;190248;384;2020-12-03;13702
2020-12-02;"Košický kraj";193;8132;496;8628;NA;190248;689;2020-12-02;13318
2020-12-01;"Košický kraj";178;2237;124;2361;NA;190248;302;2020-12-01;12629
2020-11-30;"Košický kraj";171;3598;59;3657;NA;190248;230;2020-11-30;12327
2020-11-29;"Košický kraj";31;325;17;342;NA;190248;48;2020-11-29;12097
2020-11-28;"Košický kraj";69;721;52;773;NA;190248;121;2020-11-28;12049
2020-11-27;"Košický kraj";149;2921;78;2999;NA;190248;227;2020-11-27;11928
2020-11-26;"Košický kraj";239;1234;60;1294;NA;190248;299;2020-11-26;11701
2020-11-25;"Košický kraj";237;1785;123;1908;NA;190248;360;2020-11-25;11402
2020-11-24;"Košický kraj";196;1976;67;2043;NA;190248;263;2020-11-24;11042
2020-11-23;"Košický kraj";51;4115;63;4178;NA;190248;114;2020-11-23;10779
2020-11-22;"Košický kraj";57;57;5;62;NA;190248;62;2020-11-22;10665
2020-11-21;"Košický kraj";87;858;36;894;NA;190248;123;2020-11-21;10603
2020-11-20;"Košický kraj";176;3084;49;3133;NA;190248;225;2020-11-20;10480
2020-11-19;"Košický kraj";206;1736;48;1784;NA;190248;254;2020-11-19;10255
2020-11-18;"Košický kraj";122;532;17;549;NA;190248;139;2020-11-18;10001
2020-11-17;"Košický kraj";152;82;9;91;NA;190248;161;2020-11-17;9862
2020-11-16;"Košický kraj";114;596;27;623;NA;190248;141;2020-11-16;9701
2020-11-15;"Košický kraj";15;338;7;345;NA;190248;22;2020-11-15;9560
2020-11-14;"Košický kraj";234;520;12;532;NA;190248;246;2020-11-14;9538
2020-11-13;"Košický kraj";207;664;29;693;NA;190248;236;2020-11-13;9292
2020-11-12;"Košický kraj";192;736;13;749;NA;190248;205;2020-11-12;9056
2020-11-11;"Košický kraj";301;593;7;600;NA;190248;308;2020-11-11;8851
2020-11-10;"Košický kraj";190;541;11;552;NA;190248;201;2020-11-10;8543
2020-11-09;"Košický kraj";129;380;17;397;NA;190248;146;2020-11-09;8342
2020-11-08;"Košický kraj";78;1306;8;1314;NA;190248;86;2020-11-08;8196
2020-11-07;"Košický kraj";192;3909;22;3931;NA;190248;214;2020-11-07;8110
2020-11-06;"Košický kraj";195;5310;34;5344;NA;190248;229;2020-11-06;7896
2020-11-05;"Košický kraj";342;330;31;361;NA;190248;373;2020-11-05;7667
2020-11-04;"Košický kraj";101;154;6;160;NA;190248;107;2020-11-04;7294
2020-11-03;"Košický kraj";358;1122;13;1135;NA;190248;371;2020-11-03;7187
2020-11-02;"Košický kraj";111;6125;56;6181;NA;190248;167;2020-11-02;6816
2020-11-01;"Košický kraj";346;6522;34;6556;NA;190248;380;2020-11-01;6649
2020-10-31;"Košický kraj";82;14035;106;14141;NA;190248;188;2020-10-31;6269
2020-10-30;"Košický kraj";379;2835;27;2862;NA;190248;406;2020-10-30;6081
2020-10-29;"Košický kraj";333;983;13;996;NA;190248;346;2020-10-29;5675
2020-10-28;"Košický kraj";224;305;13;318;NA;190248;237;2020-10-28;5329
2020-10-27;"Košický kraj";386;439;21;460;NA;190248;407;2020-10-27;5092
2020-10-26;"Košický kraj";56;212;12;224;NA;190248;68;2020-10-26;4685
2020-10-25;"Košický kraj";154;79;2;81;NA;190248;156;2020-10-25;4617
2020-10-24;"Košický kraj";313;118;16;134;NA;190248;329;2020-10-24;4461
2020-10-23;"Košický kraj";315;331;8;339;NA;190248;323;2020-10-23;4132
2020-10-22;"Košický kraj";349;530;16;546;NA;190248;365;2020-10-22;3809
2020-10-21;"Košický kraj";129;84;2;86;NA;190248;131;2020-10-21;3444
2020-10-20;"Košický kraj";181;14;1;15;NA;190248;182;2020-10-20;3313
2020-10-19;"Košický kraj";64;38;1;39;NA;190248;65;2020-10-19;3131
2020-10-18;"Košický kraj";158;0;0;0;NA;190248;158;2020-10-18;3066
2020-10-17;"Košický kraj";142;0;0;0;NA;190248;142;2020-10-17;2908
2020-10-16;"Košický kraj";206;19;0;19;NA;190248;206;2020-10-16;2766
2020-10-15;"Košický kraj";177;19;5;24;NA;190248;182;2020-10-15;2560
2020-10-14;"Košický kraj";211;8;0;8;NA;190248;211;2020-10-14;2378
2020-10-13;"Košický kraj";179;80;3;83;NA;190248;182;2020-10-13;2167
2020-10-12;"Košický kraj";74;0;0;0;NA;190248;74;2020-10-12;1985
2020-10-11;"Košický kraj";121;0;0;0;NA;190248;121;2020-10-11;1911
2020-10-10;"Košický kraj";70;0;0;0;NA;190248;70;2020-10-10;1790
2020-10-09;"Košický kraj";188;0;0;0;NA;190248;188;2020-10-09;1720
2020-10-08;"Košický kraj";102;0;0;0;NA;190248;102;2020-10-08;1532
2020-10-07;"Košický kraj";158;0;0;0;NA;190248;158;2020-10-07;1430
2020-10-06;"Košický kraj";70;0;0;0;NA;190248;70;2020-10-06;1272
2020-10-05;"Košický kraj";39;0;0;0;NA;190248;39;2020-10-05;1202
2020-10-04;"Košický kraj";45;0;0;0;NA;190248;45;2020-10-04;1163
2020-10-03;"Košický kraj";105;0;0;0;NA;190248;105;2020-10-03;1118
2020-10-02;"Košický kraj";57;0;0;0;NA;190248;57;2020-10-02;1013
2020-10-01;"Košický kraj";69;0;0;0;NA;190248;69;2020-10-01;956
2020-09-30;"Košický kraj";95;0;0;0;NA;190248;95;2020-09-30;887
2020-09-29;"Košický kraj";75;0;0;0;NA;190248;75;2020-09-29;792
2020-09-28;"Košický kraj";19;0;0;0;NA;190248;19;2020-09-28;717
2020-09-27;"Košický kraj";21;0;0;0;NA;190248;21;2020-09-27;698
2020-09-26;"Košický kraj";53;0;0;0;NA;190248;53;2020-09-26;677
2020-09-25;"Košický kraj";72;0;0;0;NA;190248;72;2020-09-25;624
2020-09-24;"Košický kraj";35;0;0;0;NA;190248;35;2020-09-24;552
2020-09-23;"Košický kraj";23;0;0;0;NA;190248;23;2020-09-23;517
2020-09-22;"Košický kraj";39;0;0;0;NA;190248;39;2020-09-22;494
2020-09-21;"Košický kraj";5;0;0;0;NA;190248;5;2020-09-21;455
2020-09-20;"Košický kraj";3;0;0;0;NA;190248;3;2020-09-20;450
2020-09-19;"Košický kraj";13;0;0;0;NA;190248;13;2020-09-19;447
2020-09-18;"Košický kraj";20;0;0;0;NA;190248;20;2020-09-18;434
2020-09-17;"Košický kraj";22;0;0;0;NA;190248;22;2020-09-17;414
2020-09-16;"Košický kraj";12;0;0;0;NA;190248;12;2020-09-16;392
2020-09-15;"Košický kraj";10;0;0;0;NA;190248;10;2020-09-15;380
2020-09-14;"Košický kraj";6;0;0;0;NA;190248;6;2020-09-14;370
2020-09-13;"Košický kraj";3;0;0;0;NA;190248;3;2020-09-13;364
2020-09-12;"Košický kraj";16;0;0;0;NA;190248;16;2020-09-12;361
2020-09-11;"Košický kraj";20;0;0;0;NA;190248;20;2020-09-11;345
2020-09-10;"Košický kraj";11;0;0;0;NA;190248;11;2020-09-10;325
2020-09-09;"Košický kraj";37;0;0;0;NA;190248;37;2020-09-09;314
2020-09-08;"Košický kraj";10;0;0;0;NA;190248;10;2020-09-08;277
2020-09-07;"Košický kraj";4;0;0;0;NA;190248;4;2020-09-07;267
2020-09-06;"Košický kraj";2;0;0;0;NA;190248;2;2020-09-06;263
2020-09-05;"Košický kraj";10;0;0;0;NA;190248;10;2020-09-05;261
2020-09-04;"Košický kraj";14;0;0;0;NA;190248;14;2020-09-04;251
2020-09-03;"Košický kraj";22;0;0;0;NA;190248;22;2020-09-03;237
2020-09-02;"Košický kraj";13;0;0;0;NA;190248;13;2020-09-02;215
2020-09-01;"Košický kraj";21;0;0;0;NA;190248;21;2020-09-01;202
2020-08-31;"Košický kraj";9;0;0;0;NA;190248;9;2020-08-31;181
2020-08-30;"Košický kraj";21;0;0;0;NA;190248;21;2020-08-30;172
2020-08-29;"Košický kraj";1;0;0;0;NA;190248;1;2020-08-29;151
2020-08-28;"Košický kraj";19;0;0;0;NA;190248;19;2020-08-28;150
2020-08-27;"Košický kraj";15;0;0;0;NA;190248;15;2020-08-27;131
2020-08-26;"Košický kraj";8;0;0;0;NA;190248;8;2020-08-26;116
2020-08-25;"Košický kraj";23;0;0;0;NA;190248;23;2020-08-25;108
2020-08-24;"Košický kraj";6;0;0;0;NA;190248;6;2020-08-24;85
2020-08-23;"Košický kraj";8;0;0;0;NA;190248;8;2020-08-23;79
2020-08-22;"Košický kraj";13;0;0;0;NA;190248;13;2020-08-22;71
2020-08-21;"Košický kraj";10;0;0;0;NA;190248;10;2020-08-21;58
2020-08-20;"Košický kraj";10;0;0;0;NA;190248;10;2020-08-20;48
2020-08-19;"Košický kraj";3;0;0;0;NA;190248;3;2020-08-19;38
2020-08-18;"Košický kraj";7;0;0;0;NA;190248;7;2020-08-18;35
2020-08-17;"Košický kraj";2;0;0;0;NA;190248;2;2020-08-17;28
2020-08-16;"Košický kraj";2;0;0;0;NA;190248;2;2020-08-16;26
2020-08-15;"Košický kraj";3;0;0;0;NA;190248;3;2020-08-15;24
2020-08-14;"Košický kraj";1;0;0;0;NA;190248;1;2020-08-14;21
2020-08-13;"Košický kraj";3;0;0;0;NA;190248;3;2020-08-13;20
2020-08-12;"Košický kraj";12;0;0;0;NA;190248;12;2020-08-12;17
2020-08-11;"Košický kraj";5;0;0;0;NA;190248;5;2020-08-11;5
2020-08-10;"Košický kraj";1;0;0;0;NA;190248;1;2020-08-10;0
2020-08-09;"Košický kraj";0;0;0;0;NA;190248;0;2020-08-09;-1
2020-08-08;"Košický kraj";5;0;0;0;NA;190248;5;2020-08-08;-1
2020-08-07;"Košický kraj";7;0;0;0;NA;190248;7;2020-08-07;-6
2020-08-06;"Košický kraj";3;0;0;0;NA;190248;3;2020-08-06;-13
2020-08-05;"Košický kraj";4;0;0;0;NA;190248;4;2020-08-05;-16
2020-08-04;"Košický kraj";1;0;0;0;NA;190248;1;2020-08-04;-20
2020-08-03;"Košický kraj";1;0;0;0;NA;190248;1;2020-08-03;-21
2020-08-02;"Košický kraj";0;0;0;0;NA;190248;0;2020-08-02;-22
2020-08-01;"Košický kraj";0;0;0;0;NA;190248;0;2020-08-01;-22
2020-07-31;"Košický kraj";0;0;0;0;NA;190248;0;2020-07-31;-22
2020-07-30;"Košický kraj";2;0;0;0;NA;190248;2;2020-07-30;-22
2020-07-29;"Košický kraj";1;0;0;0;NA;190248;1;2020-07-29;-24
2020-07-28;"Košický kraj";9;0;0;0;NA;190248;9;2020-07-28;-25
2020-07-27;"Košický kraj";4;0;0;0;NA;190248;4;2020-07-27;-34
2020-07-26;"Košický kraj";0;0;0;0;NA;190248;0;2020-07-26;-38
2020-07-25;"Košický kraj";2;0;0;0;NA;190248;2;2020-07-25;-38
2020-07-24;"Košický kraj";2;0;0;0;NA;190248;2;2020-07-24;-40
2020-07-23;"Košický kraj";1;0;0;0;NA;190248;1;2020-07-23;-42
2020-07-22;"Košický kraj";1;0;0;0;NA;190248;1;2020-07-22;-43
2020-07-21;"Košický kraj";0;0;0;0;NA;190248;0;2020-07-21;-44
2020-07-20;"Košický kraj";0;0;0;0;NA;190248;0;2020-07-20;-44
2020-07-19;"Košický kraj";0;0;0;0;NA;190248;0;2020-07-19;-44
2020-07-18;"Košický kraj";1;0;0;0;NA;190248;1;2020-07-18;-44
2020-07-17;"Košický kraj";1;0;0;0;NA;190248;1;2020-07-17;-45
2020-07-16;"Košický kraj";0;0;0;0;NA;190248;0;2020-07-16;-46
2020-07-15;"Košický kraj";2;0;0;0;NA;190248;2;2020-07-15;-46
2020-07-14;"Košický kraj";1;0;0;0;NA;190248;1;2020-07-14;-48
2020-07-13;"Košický kraj";1;0;0;0;NA;190248;1;2020-07-13;-49
2020-07-12;"Košický kraj";0;0;0;0;NA;190248;0;2020-07-12;-50
2020-07-11;"Košický kraj";0;0;0;0;NA;190248;0;2020-07-11;-50
2020-07-10;"Košický kraj";1;0;0;0;NA;190248;1;2020-07-10;-50
2020-07-09;"Košický kraj";1;0;0;0;NA;190248;1;2020-07-09;-51
2020-07-08;"Košický kraj";12;0;0;0;NA;190248;12;2020-07-08;-52
2020-07-07;"Košický kraj";0;0;0;0;NA;190248;0;2020-07-07;-64
2020-07-06;"Košický kraj";0;0;0;0;NA;190248;0;2020-07-06;-64
2020-07-05;"Košický kraj";0;0;0;0;NA;190248;0;2020-07-05;-64
2020-07-04;"Košický kraj";0;0;0;0;NA;190248;0;2020-07-04;-64
2020-07-03;"Košický kraj";1;0;0;0;NA;190248;1;2020-07-03;-64
2020-07-02;"Košický kraj";0;0;0;0;NA;190248;0;2020-07-02;-65
2020-07-01;"Košický kraj";1;0;0;0;NA;190248;1;2020-07-01;-65
2020-06-30;"Košický kraj";0;0;0;0;NA;190248;0;2020-06-30;-66
2020-06-29;"Košický kraj";0;0;0;0;NA;190248;0;2020-06-29;-66
2020-06-28;"Košický kraj";0;0;0;0;NA;190248;0;2020-06-28;-66
2020-06-27;"Košický kraj";0;0;0;0;NA;190248;0;2020-06-27;-66
2020-06-26;"Košický kraj";0;0;0;0;NA;190248;0;2020-06-26;-66
2020-06-25;"Košický kraj";3;0;0;0;NA;190248;3;2020-06-25;-66
2020-06-24;"Košický kraj";3;0;0;0;NA;190248;3;2020-06-24;-69
2020-06-23;"Košický kraj";3;0;0;0;NA;190248;3;2020-06-23;-72
2020-06-22;"Košický kraj";0;0;0;0;NA;190248;0;2020-06-22;-75
2020-06-21;"Košický kraj";0;0;0;0;NA;190248;0;2020-06-21;-75
2020-06-20;"Košický kraj";0;0;0;0;NA;190248;0;2020-06-20;-75
2020-06-19;"Košický kraj";0;0;0;0;NA;190248;0;2020-06-19;-75
2020-06-18;"Košický kraj";1;0;0;0;NA;190248;1;2020-06-18;-75
2020-06-17;"Košický kraj";0;0;0;0;NA;190248;0;2020-06-17;-76
2020-06-16;"Košický kraj";2;0;0;0;NA;190248;2;2020-06-16;-76
2020-06-14;"Košický kraj";0;0;0;0;NA;190248;0;2020-06-14;-78
2020-06-13;"Košický kraj";0;0;0;0;NA;190248;0;2020-06-13;-78
2020-06-12;"Košický kraj";0;0;0;0;NA;190248;0;2020-06-12;-78
2020-06-11;"Košický kraj";0;0;0;0;NA;190248;0;2020-06-11;-78
2020-06-10;"Košický kraj";6;0;0;0;NA;190248;6;2020-06-10;-78
2020-06-09;"Košický kraj";0;0;0;0;NA;190248;0;2020-06-09;-84
2020-06-08;"Košický kraj";0;0;0;0;NA;190248;0;2020-06-08;-84
2020-06-07;"Košický kraj";2;0;0;0;NA;190248;2;2020-06-07;-84
2020-06-05;"Košický kraj";0;0;0;0;NA;190248;0;2020-06-05;-86
2020-06-03;"Košický kraj";0;0;0;0;NA;190248;0;2020-06-03;-86
2020-06-02;"Košický kraj";1;0;0;0;NA;190248;1;2020-06-02;-86
2020-05-31;"Košický kraj";0;0;0;0;NA;190248;0;2020-05-31;-87
2020-05-29;"Košický kraj";1;0;0;0;NA;190248;1;2020-05-29;-87
2020-05-27;"Košický kraj";0;0;0;0;NA;190248;0;2020-05-27;-88
2020-05-26;"Košický kraj";1;0;0;0;NA;190248;1;2020-05-26;-88
2020-05-25;"Košický kraj";1;0;0;0;NA;190248;1;2020-05-25;-89
2020-05-24;"Košický kraj";0;0;0;0;NA;190248;0;2020-05-24;-90
2020-05-23;"Košický kraj";0;0;0;0;NA;190248;0;2020-05-23;-90
2020-05-22;"Košický kraj";0;0;0;0;NA;190248;0;2020-05-22;-90
2020-05-21;"Košický kraj";0;0;0;0;NA;190248;0;2020-05-21;-90
2020-05-20;"Košický kraj";3;0;0;0;NA;190248;3;2020-05-20;-90
2020-05-19;"Košický kraj";0;0;0;0;NA;190248;0;2020-05-19;-93
2020-05-17;"Košický kraj";1;0;0;0;NA;190248;1;2020-05-17;-93
2020-05-16;"Košický kraj";1;0;0;0;NA;190248;1;2020-05-16;-94
2020-05-15;"Košický kraj";10;0;0;0;NA;190248;10;2020-05-15;-95
2020-05-14;"Košický kraj";1;0;0;0;NA;190248;1;2020-05-14;-105
2020-05-13;"Košický kraj";6;0;0;0;NA;190248;6;2020-05-13;-106
2020-05-12;"Košický kraj";0;0;0;0;NA;190248;0;2020-05-12;-112
2020-05-11;"Košický kraj";0;0;0;0;NA;190248;0;2020-05-11;-112
2020-05-09;"Košický kraj";0;0;0;0;NA;190248;0;2020-05-09;-112
2020-05-07;"Košický kraj";0;0;0;0;NA;190248;0;2020-05-07;-112
2020-05-06;"Košický kraj";1;0;0;0;NA;190248;1;2020-05-06;-112
2020-05-05;"Košický kraj";0;0;0;0;NA;190248;0;2020-05-05;-113
2020-05-04;"Košický kraj";0;0;0;0;NA;190248;0;2020-05-04;-113
2020-05-03;"Košický kraj";0;0;0;0;NA;190248;0;2020-05-03;-113
2020-05-02;"Košický kraj";1;0;0;0;NA;190248;1;2020-05-02;-113
2020-05-01;"Košický kraj";0;0;0;0;NA;190248;0;2020-05-01;-114
2020-04-30;"Košický kraj";1;0;0;0;NA;190248;1;2020-04-30;-114
2020-04-29;"Košický kraj";1;0;0;0;NA;190248;1;2020-04-29;-115
2020-04-28;"Košický kraj";1;0;0;0;NA;190248;1;2020-04-28;-116
2020-04-27;"Košický kraj";1;0;0;0;NA;190248;1;2020-04-27;-117
2020-04-26;"Košický kraj";0;0;0;0;NA;190248;0;2020-04-26;-118
2020-04-25;"Košický kraj";0;0;0;0;NA;190248;0;2020-04-25;-118
2020-04-24;"Košický kraj";3;0;0;0;NA;190248;3;2020-04-24;-118
2020-04-23;"Košický kraj";4;0;0;0;NA;190248;4;2020-04-23;-121
2020-04-22;"Košický kraj";21;0;0;0;NA;190248;21;2020-04-22;-125
2020-04-21;"Košický kraj";4;0;0;0;NA;190248;4;2020-04-21;-146
2020-04-20;"Košický kraj";0;0;0;0;NA;190248;0;2020-04-20;-150
2020-04-19;"Košický kraj";1;0;0;0;NA;190248;1;2020-04-19;-150
2020-04-18;"Košický kraj";2;0;0;0;NA;190248;2;2020-04-18;-151
2020-04-17;"Košický kraj";7;0;0;0;NA;190248;7;2020-04-17;-153
2020-04-16;"Košický kraj";29;0;0;0;NA;190248;29;2020-04-16;-160
2020-04-15;"Košický kraj";50;0;0;0;NA;190248;50;2020-04-15;-189
2020-04-14;"Košický kraj";4;0;0;0;NA;190248;4;2020-04-14;-239
2020-04-13;"Košický kraj";5;0;0;0;NA;190248;5;2020-04-13;-243
2020-04-12;"Košický kraj";4;0;0;0;NA;190248;4;2020-04-12;-248
2020-04-11;"Košický kraj";2;0;0;0;NA;190248;2;2020-04-11;-252
2020-04-10;"Košický kraj";1;0;0;0;NA;190248;1;2020-04-10;-254
2020-04-09;"Košický kraj";4;0;0;0;NA;190248;4;2020-04-09;-255
2020-04-08;"Košický kraj";5;0;0;0;NA;190248;5;2020-04-08;-259
2020-04-07;"Košický kraj";34;0;0;0;NA;190248;34;2020-04-07;-264
2020-04-06;"Košický kraj";6;0;0;0;NA;190248;6;2020-04-06;-298
2020-04-05;"Košický kraj";4;0;0;0;NA;190248;4;2020-04-05;-304
2020-04-04;"Košický kraj";5;0;0;0;NA;190248;5;2020-04-04;-308
2020-04-03;"Košický kraj";4;0;0;0;NA;190248;4;2020-04-03;-313
2020-04-02;"Košický kraj";3;0;0;0;NA;190248;3;2020-04-02;-317
2020-04-01;"Košický kraj";3;0;0;0;NA;190248;3;2020-04-01;-320
2020-03-31;"Košický kraj";1;0;0;0;NA;190248;1;2020-03-31;-323
2020-03-30;"Košický kraj";5;0;0;0;NA;190248;5;2020-03-30;-324
2020-03-29;"Košický kraj";0;0;0;0;NA;190248;0;2020-03-29;-329
2020-03-28;"Košický kraj";1;0;0;0;NA;190248;1;2020-03-28;-329
2020-03-27;"Košický kraj";1;0;0;0;NA;190248;1;2020-03-27;-330
2020-03-26;"Košický kraj";3;0;0;0;NA;190248;3;2020-03-26;-331
2020-03-25;"Košický kraj";2;0;0;0;NA;190248;2;2020-03-25;-334
2020-03-24;"Košický kraj";0;0;0;0;NA;190248;0;2020-03-24;-336
2020-03-23;"Košický kraj";2;0;0;0;NA;190248;2;2020-03-23;-336
2020-03-22;"Košický kraj";0;0;0;0;NA;190248;0;2020-03-22;-338
2020-03-21;"Košický kraj";3;0;0;0;NA;190248;3;2020-03-21;-338
2020-03-20;"Košický kraj";1;0;0;0;NA;190248;1;2020-03-20;-341
2020-03-19;"Košický kraj";0;0;0;0;NA;190248;0;2020-03-19;-342
2020-03-18;"Košický kraj";0;0;0;0;NA;190248;0;2020-03-18;-342
2020-03-17;"Košický kraj";0;0;0;0;NA;190248;0;2020-03-17;-342
2020-03-16;"Košický kraj";3;0;0;0;NA;190248;3;2020-03-16;-342
2020-03-15;"Košický kraj";1;0;0;0;NA;190248;1;2020-03-15;-345
2020-03-14;"Košický kraj";0;0;0;0;NA;190248;0;2020-03-14;-346
2020-03-13;"Košický kraj";2;0;0;0;NA;190248;2;2020-03-13;-346
2020-03-12;"Košický kraj";0;0;0;0;NA;190248;0;2020-03-12;-348
2020-03-11;"Košický kraj";0;0;0;0;NA;190248;0;2020-03-11;-348
2020-03-09;"Košický kraj";1;0;0;0;NA;190248;1;2020-03-09;-348
2020-03-08;"Košický kraj";0;0;0;0;NA;190248;0;2020-03-08;-349
2020-03-07;"Košický kraj";0;0;0;0;NA;190248;0;2020-03-07;-349
2020-03-06;"Košický kraj";0;0;0;0;NA;190248;0;2020-03-06;-349
2022-01-11;"Nitriansky kraj";424;0;0;0;79495;148340;424;2022-01-11;148340
2022-01-10;"Nitriansky kraj";292;0;0;0;NA;148340;292;2022-01-10;147916
2022-01-09;"Nitriansky kraj";100;2687;37;2724;NA;148340;137;2022-01-09;147624
2022-01-08;"Nitriansky kraj";206;1221;42;1263;NA;148340;248;2022-01-08;147487
2022-01-07;"Nitriansky kraj";326;2535;66;2601;NA;148340;392;2022-01-07;147239
2022-01-06;"Nitriansky kraj";125;819;29;848;NA;148340;154;2022-01-06;146847
2022-01-05;"Nitriansky kraj";357;4064;65;4129;NA;148340;422;2022-01-05;146693
2022-01-04;"Nitriansky kraj";453;3382;77;3459;NA;148340;530;2022-01-04;146271
2022-01-03;"Nitriansky kraj";353;7018;96;7114;NA;148340;449;2022-01-03;145741
2022-01-02;"Nitriansky kraj";25;2848;87;2935;NA;148340;112;2022-01-02;145292
2022-01-01;"Nitriansky kraj";71;134;9;143;NA;148340;80;2022-01-01;145180
2021-12-31;"Nitriansky kraj";382;1405;59;1464;NA;148340;441;2021-12-31;145100
2021-12-30;"Nitriansky kraj";325;3263;89;3352;NA;148340;414;2021-12-30;144659
2021-12-29;"Nitriansky kraj";347;2371;61;2432;NA;148340;408;2021-12-29;144245
2021-12-28;"Nitriansky kraj";628;2501;88;2589;NA;148340;716;2021-12-28;143837
2021-12-27;"Nitriansky kraj";402;4227;169;4396;NA;148340;571;2021-12-27;143121
2021-12-26;"Nitriansky kraj";84;1039;53;1092;NA;148340;137;2021-12-26;142550
2021-12-25;"Nitriansky kraj";22;499;31;530;NA;148340;53;2021-12-25;142413
2021-12-24;"Nitriansky kraj";175;448;26;474;NA;148340;201;2021-12-24;142360
2021-12-23;"Nitriansky kraj";472;3407;110;3517;NA;148340;582;2021-12-23;142159
2021-12-22;"Nitriansky kraj";398;3517;95;3612;NA;148340;493;2021-12-22;141577
2021-12-21;"Nitriansky kraj";735;2912;93;3005;NA;148340;828;2021-12-21;141084
2021-12-20;"Nitriansky kraj";407;6695;169;6864;NA;148340;576;2021-12-20;140256
2021-12-19;"Nitriansky kraj";198;3587;98;3685;NA;148340;296;2021-12-19;139680
2021-12-18;"Nitriansky kraj";361;1456;96;1552;NA;148340;457;2021-12-18;139384
2021-12-17;"Nitriansky kraj";409;4934;153;5087;NA;148340;562;2021-12-17;138927
2021-12-16;"Nitriansky kraj";429;4215;144;4359;NA;148340;573;2021-12-16;138365
2021-12-15;"Nitriansky kraj";639;5682;143;5825;NA;148340;782;2021-12-15;137792
2021-12-14;"Nitriansky kraj";907;4720;200;4920;NA;148340;1107;2021-12-14;137010
2021-12-13;"Nitriansky kraj";524;7365;291;7656;NA;148340;815;2021-12-13;135903
2021-12-12;"Nitriansky kraj";289;3893;174;4067;NA;148340;463;2021-12-12;135088
2021-12-11;"Nitriansky kraj";458;1754;121;1875;NA;148340;579;2021-12-11;134625
2021-12-10;"Nitriansky kraj";591;4868;177;5045;NA;148340;768;2021-12-10;134046
2021-12-09;"Nitriansky kraj";741;3399;202;3601;NA;148340;943;2021-12-09;133278
2021-12-08;"Nitriansky kraj";954;5136;200;5336;NA;148340;1154;2021-12-08;132335
2021-12-07;"Nitriansky kraj";900;4045;197;4242;NA;148340;1097;2021-12-07;131181
2021-12-06;"Nitriansky kraj";699;8194;339;8533;NA;148340;1038;2021-12-06;130084
2021-12-05;"Nitriansky kraj";337;4151;188;4339;NA;148340;525;2021-12-05;129046
2021-12-04;"Nitriansky kraj";758;2045;180;2225;NA;148340;938;2021-12-04;128521
2021-12-03;"Nitriansky kraj";920;5783;237;6020;NA;148340;1157;2021-12-03;127583
2021-12-02;"Nitriansky kraj";1388;3896;267;4163;NA;148340;1655;2021-12-02;126426
2021-12-01;"Nitriansky kraj";982;4077;261;4338;NA;148340;1243;2021-12-01;124771
2021-11-30;"Nitriansky kraj";751;5575;241;5816;NA;148340;992;2021-11-30;123528
2021-11-29;"Nitriansky kraj";665;10150;499;10649;NA;148340;1164;2021-11-29;122536
2021-11-28;"Nitriansky kraj";357;6214;300;6514;NA;148340;657;2021-11-28;121372
2021-11-27;"Nitriansky kraj";560;2879;281;3160;NA;148340;841;2021-11-27;120715
2021-11-26;"Nitriansky kraj";824;5529;290;5819;NA;148340;1114;2021-11-26;119874
2021-11-25;"Nitriansky kraj";847;4151;342;4493;NA;148340;1189;2021-11-25;118760
2021-11-24;"Nitriansky kraj";875;4419;325;4744;NA;148340;1200;2021-11-24;117571
2021-11-23;"Nitriansky kraj";1103;5148;353;5501;NA;148340;1456;2021-11-23;116371
2021-11-22;"Nitriansky kraj";545;7101;465;7566;NA;148340;1010;2021-11-22;114915
2021-11-21;"Nitriansky kraj";345;3410;314;3724;NA;148340;659;2021-11-21;113905
2021-11-20;"Nitriansky kraj";579;1865;252;2117;NA;148340;831;2021-11-20;113246
2021-11-19;"Nitriansky kraj";571;4255;349;4604;NA;148340;920;2021-11-19;112415
2021-11-18;"Nitriansky kraj";677;4881;420;5301;NA;148340;1097;2021-11-18;111495
2021-11-17;"Nitriansky kraj";479;1622;207;1829;NA;148340;686;2021-11-17;110398
2021-11-16;"Nitriansky kraj";668;3879;266;4145;NA;148340;934;2021-11-16;109712
2021-11-15;"Nitriansky kraj";556;6012;440;6452;NA;148340;996;2021-11-15;108778
2021-11-14;"Nitriansky kraj";229;2796;259;3055;NA;148340;488;2021-11-14;107782
2021-11-13;"Nitriansky kraj";387;1473;201;1674;NA;148340;588;2021-11-13;107294
2021-11-12;"Nitriansky kraj";552;3096;270;3366;NA;148340;822;2021-11-12;106706
2021-11-11;"Nitriansky kraj";539;3541;238;3779;NA;148340;777;2021-11-11;105884
2021-11-10;"Nitriansky kraj";411;3494;234;3728;NA;148340;645;2021-11-10;105107
2021-11-09;"Nitriansky kraj";413;3313;210;3523;NA;148340;623;2021-11-09;104462
2021-11-08;"Nitriansky kraj";464;4936;331;5267;NA;148340;795;2021-11-08;103839
2021-11-07;"Nitriansky kraj";209;2074;161;2235;NA;148340;370;2021-11-07;103044
2021-11-06;"Nitriansky kraj";236;1407;114;1521;NA;148340;350;2021-11-06;102674
2021-11-05;"Nitriansky kraj";407;2583;185;2768;NA;148340;592;2021-11-05;102324
2021-11-04;"Nitriansky kraj";437;3083;168;3251;NA;148340;605;2021-11-04;101732
2021-11-03;"Nitriansky kraj";525;2891;157;3048;NA;148340;682;2021-11-03;101127
2021-11-02;"Nitriansky kraj";320;4279;239;4518;NA;148340;559;2021-11-02;100445
2021-11-01;"Nitriansky kraj";136;712;61;773;NA;148340;197;2021-11-01;99886
2021-10-31;"Nitriansky kraj";109;1234;114;1348;NA;148340;223;2021-10-31;99689
2021-10-30;"Nitriansky kraj";202;1218;82;1300;NA;148340;284;2021-10-30;99466
2021-10-29;"Nitriansky kraj";347;2481;120;2601;NA;148340;467;2021-10-29;99182
2021-10-28;"Nitriansky kraj";281;2603;95;2698;NA;148340;376;2021-10-28;98715
2021-10-27;"Nitriansky kraj";340;2923;112;3035;NA;148340;452;2021-10-27;98339
2021-10-26;"Nitriansky kraj";297;2926;117;3043;NA;148340;414;2021-10-26;97887
2021-10-25;"Nitriansky kraj";171;3599;124;3723;NA;148340;295;2021-10-25;97473
2021-10-24;"Nitriansky kraj";58;1914;74;1988;NA;148340;132;2021-10-24;97178
2021-10-23;"Nitriansky kraj";173;1815;77;1892;NA;148340;250;2021-10-23;97046
2021-10-22;"Nitriansky kraj";202;2216;68;2284;NA;148340;270;2021-10-22;96796
2021-10-21;"Nitriansky kraj";214;2793;65;2858;NA;148340;279;2021-10-21;96526
2021-10-20;"Nitriansky kraj";218;2328;74;2402;NA;148340;292;2021-10-20;96247
2021-10-19;"Nitriansky kraj";250;2929;65;2994;NA;148340;315;2021-10-19;95955
2021-10-18;"Nitriansky kraj";81;3259;90;3349;NA;148340;171;2021-10-18;95640
2021-10-17;"Nitriansky kraj";36;3010;92;3102;NA;148340;128;2021-10-17;95469
2021-10-16;"Nitriansky kraj";37;1477;38;1515;NA;148340;75;2021-10-16;95341
2021-10-15;"Nitriansky kraj";145;2653;34;2687;NA;148340;179;2021-10-15;95266
2021-10-14;"Nitriansky kraj";95;2389;30;2419;NA;148340;125;2021-10-14;95087
2021-10-13;"Nitriansky kraj";91;2248;36;2284;NA;148340;127;2021-10-13;94962
2021-10-12;"Nitriansky kraj";119;2905;34;2939;NA;148340;153;2021-10-12;94835
2021-10-11;"Nitriansky kraj";91;2703;42;2745;NA;148340;133;2021-10-11;94682
2021-10-10;"Nitriansky kraj";33;1527;22;1549;NA;148340;55;2021-10-10;94549
2021-10-09;"Nitriansky kraj";17;1395;17;1412;NA;148340;34;2021-10-09;94494
2021-10-08;"Nitriansky kraj";61;3004;37;3041;NA;148340;98;2021-10-08;94460
2021-10-07;"Nitriansky kraj";59;2829;30;2859;NA;148340;89;2021-10-07;94362
2021-10-06;"Nitriansky kraj";66;2657;28;2685;NA;148340;94;2021-10-06;94273
2021-10-05;"Nitriansky kraj";97;2536;32;2568;NA;148340;129;2021-10-05;94179
2021-10-04;"Nitriansky kraj";56;3263;49;3312;NA;148340;105;2021-10-04;94050
2021-10-03;"Nitriansky kraj";10;1591;24;1615;NA;148340;34;2021-10-03;93945
2021-10-02;"Nitriansky kraj";46;1567;20;1587;NA;148340;66;2021-10-02;93911
2021-10-01;"Nitriansky kraj";26;2830;34;2864;NA;148340;60;2021-10-01;93845
2021-09-30;"Nitriansky kraj";66;2468;15;2483;NA;148340;81;2021-09-30;93785
2021-09-29;"Nitriansky kraj";92;2266;16;2282;NA;148340;108;2021-09-29;93704
2021-09-28;"Nitriansky kraj";86;2893;27;2920;NA;148340;113;2021-09-28;93596
2021-09-27;"Nitriansky kraj";50;3633;41;3674;NA;148340;91;2021-09-27;93483
2021-09-26;"Nitriansky kraj";12;1635;20;1655;NA;148340;32;2021-09-26;93392
2021-09-25;"Nitriansky kraj";43;1456;20;1476;NA;148340;63;2021-09-25;93360
2021-09-24;"Nitriansky kraj";35;2783;15;2798;NA;148340;50;2021-09-24;93297
2021-09-23;"Nitriansky kraj";69;2503;20;2523;NA;148340;89;2021-09-23;93247
2021-09-22;"Nitriansky kraj";68;2380;17;2397;NA;148340;85;2021-09-22;93158
2021-09-21;"Nitriansky kraj";70;2684;30;2714;NA;148340;100;2021-09-21;93073
2021-09-20;"Nitriansky kraj";41;2497;21;2518;NA;148340;62;2021-09-20;92973
2021-09-19;"Nitriansky kraj";16;1553;20;1573;NA;148340;36;2021-09-19;92911
2021-09-18;"Nitriansky kraj";42;1421;19;1440;NA;148340;61;2021-09-18;92875
2021-09-17;"Nitriansky kraj";54;2757;30;2787;NA;148340;84;2021-09-17;92814
2021-09-16;"Nitriansky kraj";55;2499;44;2543;NA;148340;99;2021-09-16;92730
2021-09-15;"Nitriansky kraj";34;538;12;550;NA;148340;46;2021-09-15;92631
2021-09-14;"Nitriansky kraj";52;1821;20;1841;NA;148340;72;2021-09-14;92585
2021-09-13;"Nitriansky kraj";27;2373;27;2400;NA;148340;54;2021-09-13;92513
2021-09-12;"Nitriansky kraj";4;1182;17;1199;NA;148340;21;2021-09-12;92459
2021-09-11;"Nitriansky kraj";36;1181;8;1189;NA;148340;44;2021-09-11;92438
2021-09-10;"Nitriansky kraj";25;2133;12;2145;NA;148340;37;2021-09-10;92394
2021-09-09;"Nitriansky kraj";15;1611;20;1631;NA;148340;35;2021-09-09;92357
2021-09-08;"Nitriansky kraj";30;1463;22;1485;NA;148340;52;2021-09-08;92322
2021-09-07;"Nitriansky kraj";35;1460;9;1469;NA;148340;44;2021-09-07;92270
2021-09-06;"Nitriansky kraj";19;1668;27;1695;NA;148340;46;2021-09-06;92226
2021-09-05;"Nitriansky kraj";10;1007;8;1015;NA;148340;18;2021-09-05;92180
2021-09-04;"Nitriansky kraj";18;1119;10;1129;NA;148340;28;2021-09-04;92162
2021-09-03;"Nitriansky kraj";20;1743;17;1760;NA;148340;37;2021-09-03;92134
2021-09-02;"Nitriansky kraj";16;1389;14;1403;NA;148340;30;2021-09-02;92097
2021-09-01;"Nitriansky kraj";9;322;2;324;NA;148340;11;2021-09-01;92067
2021-08-31;"Nitriansky kraj";10;1360;6;1366;NA;148340;16;2021-08-31;92056
2021-08-30;"Nitriansky kraj";8;1381;10;1391;NA;148340;18;2021-08-30;92040
2021-08-29;"Nitriansky kraj";2;450;1;451;NA;148340;3;2021-08-29;92022
2021-08-28;"Nitriansky kraj";5;1071;3;1074;NA;148340;8;2021-08-28;92019
2021-08-27;"Nitriansky kraj";7;1804;4;1808;NA;148340;11;2021-08-27;92011
2021-08-26;"Nitriansky kraj";2;1255;6;1261;NA;148340;8;2021-08-26;92000
2021-08-25;"Nitriansky kraj";15;1087;3;1090;NA;148340;18;2021-08-25;91992
2021-08-24;"Nitriansky kraj";6;990;2;992;NA;148340;8;2021-08-24;91974
2021-08-23;"Nitriansky kraj";13;1271;4;1275;NA;148340;17;2021-08-23;91966
2021-08-22;"Nitriansky kraj";0;1167;3;1170;NA;148340;3;2021-08-22;91949
2021-08-21;"Nitriansky kraj";1;853;2;855;NA;148340;3;2021-08-21;91946
2021-08-20;"Nitriansky kraj";8;1580;5;1585;NA;148340;13;2021-08-20;91943
2021-08-19;"Nitriansky kraj";11;1167;4;1171;NA;148340;15;2021-08-19;91930
2021-08-18;"Nitriansky kraj";8;1180;7;1187;NA;148340;15;2021-08-18;91915
2021-08-17;"Nitriansky kraj";4;1035;3;1038;NA;148340;7;2021-08-17;91900
2021-08-16;"Nitriansky kraj";7;1129;4;1133;NA;148340;11;2021-08-16;91893
2021-08-15;"Nitriansky kraj";2;662;1;663;NA;148340;3;2021-08-15;91882
2021-08-14;"Nitriansky kraj";1;878;5;883;NA;148340;6;2021-08-14;91879
2021-08-13;"Nitriansky kraj";0;957;1;958;NA;148340;1;2021-08-13;91873
2021-08-12;"Nitriansky kraj";5;765;0;765;NA;148340;5;2021-08-12;91872
2021-08-11;"Nitriansky kraj";3;527;1;528;NA;148340;4;2021-08-11;91867
2021-08-10;"Nitriansky kraj";3;570;1;571;NA;148340;4;2021-08-10;91863
2021-08-09;"Nitriansky kraj";3;992;1;993;NA;148340;4;2021-08-09;91859
2021-08-08;"Nitriansky kraj";0;668;1;669;NA;148340;1;2021-08-08;91855
2021-08-07;"Nitriansky kraj";0;557;1;558;NA;148340;1;2021-08-07;91854
2021-08-06;"Nitriansky kraj";5;799;0;799;NA;148340;5;2021-08-06;91853
2021-08-05;"Nitriansky kraj";6;612;0;612;NA;148340;6;2021-08-05;91848
2021-08-04;"Nitriansky kraj";1;497;2;499;NA;148340;3;2021-08-04;91842
2021-08-03;"Nitriansky kraj";5;1455;0;1455;NA;148340;5;2021-08-03;91839
2021-08-02;"Nitriansky kraj";1;683;4;687;NA;148340;5;2021-08-02;91834
2021-08-01;"Nitriansky kraj";1;606;0;606;NA;148340;1;2021-08-01;91829
2021-07-31;"Nitriansky kraj";1;514;1;515;NA;148340;2;2021-07-31;91828
2021-07-30;"Nitriansky kraj";2;827;0;827;NA;148340;2;2021-07-30;91826
2021-07-29;"Nitriansky kraj";3;720;2;722;NA;148340;5;2021-07-29;91824
2021-07-28;"Nitriansky kraj";4;598;0;598;NA;148340;4;2021-07-28;91819
2021-07-27;"Nitriansky kraj";12;602;1;603;NA;148340;13;2021-07-27;91815
2021-07-26;"Nitriansky kraj";7;970;1;971;NA;148340;8;2021-07-26;91802
2021-07-25;"Nitriansky kraj";1;654;1;655;NA;148340;2;2021-07-25;91794
2021-07-24;"Nitriansky kraj";0;620;0;620;NA;148340;0;2021-07-24;91792
2021-07-23;"Nitriansky kraj";3;851;1;852;NA;148340;4;2021-07-23;91792
2021-07-22;"Nitriansky kraj";5;689;0;689;NA;148340;5;2021-07-22;91788
2021-07-21;"Nitriansky kraj";6;650;2;652;NA;148340;8;2021-07-21;91783
2021-07-20;"Nitriansky kraj";1;527;1;528;NA;148340;2;2021-07-20;91775
2021-07-19;"Nitriansky kraj";2;965;0;965;NA;148340;2;2021-07-19;91773
2021-07-18;"Nitriansky kraj";1;747;0;747;NA;148340;1;2021-07-18;91771
2021-07-17;"Nitriansky kraj";5;612;0;612;NA;148340;5;2021-07-17;91770
2021-07-16;"Nitriansky kraj";2;876;0;876;NA;148340;2;2021-07-16;91765
2021-07-15;"Nitriansky kraj";11;708;0;708;NA;148340;11;2021-07-15;91763
2021-07-14;"Nitriansky kraj";4;646;0;646;NA;148340;4;2021-07-14;91752
2021-07-13;"Nitriansky kraj";2;697;2;699;NA;148340;4;2021-07-13;91748
2021-07-12;"Nitriansky kraj";1;819;0;819;NA;148340;1;2021-07-12;91744
2021-07-11;"Nitriansky kraj";1;961;0;961;NA;148340;1;2021-07-11;91743
2021-07-10;"Nitriansky kraj";1;630;0;630;NA;148340;1;2021-07-10;91742
2021-07-09;"Nitriansky kraj";3;1000;0;1000;NA;148340;3;2021-07-09;91741
2021-07-08;"Nitriansky kraj";0;683;0;683;NA;148340;0;2021-07-08;91738
2021-07-07;"Nitriansky kraj";2;935;2;937;NA;148340;4;2021-07-07;91738
2021-07-06;"Nitriansky kraj";1;1269;1;1270;NA;148340;2;2021-07-06;91734
2021-07-05;"Nitriansky kraj";1;507;0;507;NA;148340;1;2021-07-05;91732
2021-07-04;"Nitriansky kraj";0;821;1;822;NA;148340;1;2021-07-04;91731
2021-07-03;"Nitriansky kraj";0;611;0;611;NA;148340;0;2021-07-03;91730
2021-07-02;"Nitriansky kraj";0;1259;0;1259;NA;148340;0;2021-07-02;91730
2021-07-01;"Nitriansky kraj";0;339;1;340;NA;148340;1;2021-07-01;91730
2021-06-30;"Nitriansky kraj";1;6777;2;6779;NA;148340;3;2021-06-30;91729
2021-06-29;"Nitriansky kraj";1;3536;0;3536;NA;148340;1;2021-06-29;91726
2021-06-28;"Nitriansky kraj";3;4393;0;4393;NA;148340;3;2021-06-28;91725
2021-06-27;"Nitriansky kraj";0;3263;0;3263;NA;148340;0;2021-06-27;91722
2021-06-26;"Nitriansky kraj";1;4979;3;4982;NA;148340;4;2021-06-26;91722
2021-06-25;"Nitriansky kraj";8;5182;1;5183;NA;148340;9;2021-06-25;91718
2021-06-24;"Nitriansky kraj";1;3354;0;3354;NA;148340;1;2021-06-24;91709
2021-06-23;"Nitriansky kraj";1;3033;0;3033;NA;148340;1;2021-06-23;91708
2021-06-22;"Nitriansky kraj";1;3240;3;3243;NA;148340;4;2021-06-22;91707
2021-06-21;"Nitriansky kraj";8;5362;8;5370;NA;148340;16;2021-06-21;91703
2021-06-20;"Nitriansky kraj";0;4437;6;4443;NA;148340;6;2021-06-20;91687
2021-06-19;"Nitriansky kraj";0;5983;4;5987;NA;148340;4;2021-06-19;91681
2021-06-18;"Nitriansky kraj";4;6453;3;6456;NA;148340;7;2021-06-18;91677
2021-06-17;"Nitriansky kraj";5;4152;1;4153;NA;148340;6;2021-06-17;91670
2021-06-16;"Nitriansky kraj";4;3694;3;3697;NA;148340;7;2021-06-16;91664
2021-06-15;"Nitriansky kraj";1;3995;0;3995;NA;148340;1;2021-06-15;91657
2021-06-14;"Nitriansky kraj";0;5875;3;5878;NA;148340;3;2021-06-14;91656
2021-06-13;"Nitriansky kraj";0;6073;3;6076;NA;148340;3;2021-06-13;91653
2021-06-12;"Nitriansky kraj";1;8293;1;8294;NA;148340;2;2021-06-12;91650
2021-06-11;"Nitriansky kraj";3;6891;4;6895;NA;148340;7;2021-06-11;91648
2021-06-10;"Nitriansky kraj";7;4539;1;4540;NA;148340;8;2021-06-10;91641
2021-06-09;"Nitriansky kraj";2;4706;2;4708;NA;148340;4;2021-06-09;91633
2021-06-08;"Nitriansky kraj";8;4239;3;4242;NA;148340;11;2021-06-08;91629
2021-06-07;"Nitriansky kraj";6;5841;8;5849;NA;148340;14;2021-06-07;91618
2021-06-06;"Nitriansky kraj";0;6981;4;6985;NA;148340;4;2021-06-06;91604
2021-06-05;"Nitriansky kraj";6;9089;9;9098;NA;148340;15;2021-06-05;91600
2021-06-04;"Nitriansky kraj";9;7639;5;7644;NA;148340;14;2021-06-04;91585
2021-06-03;"Nitriansky kraj";2;5064;6;5070;NA;148340;8;2021-06-03;91571
2021-06-02;"Nitriansky kraj";11;5119;11;5130;NA;148340;22;2021-06-02;91563
2021-06-01;"Nitriansky kraj";3;4847;2;4849;NA;148340;5;2021-06-01;91541
2021-05-31;"Nitriansky kraj";8;8933;8;8941;NA;148340;16;2021-05-31;91536
2021-05-30;"Nitriansky kraj";1;9067;8;9075;NA;148340;9;2021-05-30;91520
2021-05-29;"Nitriansky kraj";2;13610;7;13617;NA;148340;9;2021-05-29;91511
2021-05-28;"Nitriansky kraj";10;8872;6;8878;NA;148340;16;2021-05-28;91502
2021-05-27;"Nitriansky kraj";4;6164;5;6169;NA;148340;9;2021-05-27;91486
2021-05-26;"Nitriansky kraj";11;8509;10;8519;NA;148340;21;2021-05-26;91477
2021-05-25;"Nitriansky kraj";15;7350;8;7358;NA;148340;23;2021-05-25;91456
2021-05-24;"Nitriansky kraj";14;9816;17;9833;NA;148340;31;2021-05-24;91433
2021-05-23;"Nitriansky kraj";1;9456;13;9469;NA;148340;14;2021-05-23;91402
2021-05-22;"Nitriansky kraj";7;16939;11;16950;NA;148340;18;2021-05-22;91388
2021-05-21;"Nitriansky kraj";18;10632;15;10647;NA;148340;33;2021-05-21;91370
2021-05-20;"Nitriansky kraj";8;7185;7;7192;NA;148340;15;2021-05-20;91337
2021-05-19;"Nitriansky kraj";20;6787;14;6801;NA;148340;34;2021-05-19;91322
2021-05-18;"Nitriansky kraj";23;7797;18;7815;NA;148340;41;2021-05-18;91288
2021-05-17;"Nitriansky kraj";22;9774;20;9794;NA;148340;42;2021-05-17;91247
2021-05-16;"Nitriansky kraj";4;13830;15;13845;NA;148340;19;2021-05-16;91205
2021-05-15;"Nitriansky kraj";5;25389;23;25412;NA;148340;28;2021-05-15;91186
2021-05-14;"Nitriansky kraj";18;13385;23;13408;NA;148340;41;2021-05-14;91158
2021-05-13;"Nitriansky kraj";24;8289;19;8308;NA;148340;43;2021-05-13;91117
2021-05-12;"Nitriansky kraj";10;7682;26;7708;NA;148340;36;2021-05-12;91074
2021-05-11;"Nitriansky kraj";36;8169;13;8182;NA;148340;49;2021-05-11;91038
2021-05-10;"Nitriansky kraj";16;13800;42;13842;NA;148340;58;2021-05-10;90989
2021-05-09;"Nitriansky kraj";8;21879;35;21914;NA;148340;43;2021-05-09;90931
2021-05-08;"Nitriansky kraj";0;24318;29;24347;NA;148340;29;2021-05-08;90888
2021-05-07;"Nitriansky kraj";32;14915;20;14935;NA;148340;52;2021-05-07;90859
2021-05-06;"Nitriansky kraj";30;9463;20;9483;NA;148340;50;2021-05-06;90807
2021-05-05;"Nitriansky kraj";19;8527;23;8550;NA;148340;42;2021-05-05;90757
2021-05-04;"Nitriansky kraj";46;9385;27;9412;NA;148340;73;2021-05-04;90715
2021-05-03;"Nitriansky kraj";32;14490;44;14534;NA;148340;76;2021-05-03;90642
2021-05-02;"Nitriansky kraj";4;31751;46;31797;NA;148340;50;2021-05-02;90566
2021-05-01;"Nitriansky kraj";23;60451;43;60494;NA;148340;66;2021-05-01;90516
2021-04-30;"Nitriansky kraj";28;31803;53;31856;NA;148340;81;2021-04-30;90450
2021-04-29;"Nitriansky kraj";27;14265;34;14299;NA;148340;61;2021-04-29;90369
2021-04-28;"Nitriansky kraj";36;14716;45;14761;NA;148340;81;2021-04-28;90308
2021-04-27;"Nitriansky kraj";51;13154;35;13189;NA;148340;86;2021-04-27;90227
2021-04-26;"Nitriansky kraj";38;21029;44;21073;NA;148340;82;2021-04-26;90141
2021-04-25;"Nitriansky kraj";7;44312;46;44358;NA;148340;53;2021-04-25;90059
2021-04-24;"Nitriansky kraj";23;93455;72;93527;NA;148340;95;2021-04-24;90006
2021-04-23;"Nitriansky kraj";54;35145;51;35196;NA;148340;105;2021-04-23;89911
2021-04-22;"Nitriansky kraj";32;15435;44;15479;NA;148340;76;2021-04-22;89806
2021-04-21;"Nitriansky kraj";38;14228;45;14273;NA;148340;83;2021-04-21;89730
2021-04-20;"Nitriansky kraj";67;16058;51;16109;NA;148340;118;2021-04-20;89647
2021-04-19;"Nitriansky kraj";35;24819;59;24878;NA;148340;94;2021-04-19;89529
2021-04-18;"Nitriansky kraj";0;39569;27;39596;NA;148340;27;2021-04-18;89435
2021-04-17;"Nitriansky kraj";34;92102;82;92184;NA;148340;116;2021-04-17;89408
2021-04-16;"Nitriansky kraj";46;32348;37;32385;NA;148340;83;2021-04-16;89292
2021-04-15;"Nitriansky kraj";75;16215;52;16267;NA;148340;127;2021-04-15;89209
2021-04-14;"Nitriansky kraj";43;15303;42;15345;NA;148340;85;2021-04-14;89082
2021-04-13;"Nitriansky kraj";110;15104;44;15148;NA;148340;154;2021-04-13;88997
2021-04-12;"Nitriansky kraj";29;22817;50;22867;NA;148340;79;2021-04-12;88843
2021-04-11;"Nitriansky kraj";1;37537;31;37568;NA;148340;32;2021-04-11;88764
2021-04-10;"Nitriansky kraj";35;95851;115;95966;NA;148340;150;2021-04-10;88732
2021-04-09;"Nitriansky kraj";69;30669;58;30727;NA;148340;127;2021-04-09;88582
2021-04-08;"Nitriansky kraj";71;15361;36;15397;NA;148340;107;2021-04-08;88455
2021-04-07;"Nitriansky kraj";64;18541;47;18588;NA;148340;111;2021-04-07;88348
2021-04-06;"Nitriansky kraj";65;33218;112;33330;NA;148340;177;2021-04-06;88237
2021-04-05;"Nitriansky kraj";37;12673;48;12721;NA;148340;85;2021-04-05;88060
2021-04-04;"Nitriansky kraj";5;17887;35;17922;NA;148340;40;2021-04-04;87975
2021-04-03;"Nitriansky kraj";26;85465;153;85618;NA;148340;179;2021-04-03;87935
2021-04-02;"Nitriansky kraj";32;18743;46;18789;NA;148340;78;2021-04-02;87756
2021-04-01;"Nitriansky kraj";63;24610;83;24693;NA;148340;146;2021-04-01;87678
2021-03-31;"Nitriansky kraj";73;21752;94;21846;NA;148340;167;2021-03-31;87532
2021-03-30;"Nitriansky kraj";125;17122;83;17205;NA;148340;208;2021-03-30;87365
2021-03-29;"Nitriansky kraj";81;25139;100;25239;NA;148340;181;2021-03-29;87157
2021-03-28;"Nitriansky kraj";6;45581;106;45687;NA;148340;112;2021-03-28;86976
2021-03-27;"Nitriansky kraj";39;104104;174;104278;NA;148340;213;2021-03-27;86864
2021-03-26;"Nitriansky kraj";90;40444;115;40559;NA;148340;205;2021-03-26;86651
2021-03-25;"Nitriansky kraj";95;19219;94;19313;NA;148340;189;2021-03-25;86446
2021-03-24;"Nitriansky kraj";90;14787;91;14878;NA;148340;181;2021-03-24;86257
2021-03-23;"Nitriansky kraj";167;16753;66;16819;NA;148340;233;2021-03-23;86076
2021-03-22;"Nitriansky kraj";101;24886;125;25011;NA;148340;226;2021-03-22;85843
2021-03-21;"Nitriansky kraj";27;42773;99;42872;NA;148340;126;2021-03-21;85617
2021-03-20;"Nitriansky kraj";36;100640;207;100847;NA;148340;243;2021-03-20;85491
2021-03-19;"Nitriansky kraj";76;37312;102;37414;NA;148340;178;2021-03-19;85248
2021-03-18;"Nitriansky kraj";103;20051;113;20164;NA;148340;216;2021-03-18;85070
2021-03-17;"Nitriansky kraj";87;15839;127;15966;NA;148340;214;2021-03-17;84854
2021-03-16;"Nitriansky kraj";172;18085;121;18206;NA;148340;293;2021-03-16;84640
2021-03-15;"Nitriansky kraj";130;24481;165;24646;NA;148340;295;2021-03-15;84347
2021-03-14;"Nitriansky kraj";3;45770;107;45877;NA;148340;110;2021-03-14;84052
2021-03-13;"Nitriansky kraj";65;112573;242;112815;NA;148340;307;2021-03-13;83942
2021-03-12;"Nitriansky kraj";127;40777;159;40936;NA;148340;286;2021-03-12;83635
2021-03-11;"Nitriansky kraj";131;18686;130;18816;NA;148340;261;2021-03-11;83349
2021-03-10;"Nitriansky kraj";96;17422;143;17565;NA;148340;239;2021-03-10;83088
2021-03-09;"Nitriansky kraj";260;17635;149;17784;NA;148340;409;2021-03-09;82849
2021-03-08;"Nitriansky kraj";145;27214;172;27386;NA;148340;317;2021-03-08;82440
2021-03-07;"Nitriansky kraj";48;46867;185;47052;NA;148340;233;2021-03-07;82123
2021-03-06;"Nitriansky kraj";86;112027;327;112354;NA;148340;413;2021-03-06;81890
2021-03-05;"Nitriansky kraj";133;39068;200;39268;NA;148340;333;2021-03-05;81477
2021-03-04;"Nitriansky kraj";176;18340;173;18513;NA;148340;349;2021-03-04;81144
2021-03-03;"Nitriansky kraj";172;17210;177;17387;NA;148340;349;2021-03-03;80795
2021-03-02;"Nitriansky kraj";274;21003;366;21369;NA;148340;640;2021-03-02;80446
2021-03-01;"Nitriansky kraj";133;27881;279;28160;NA;148340;412;2021-03-01;79806
2021-02-28;"Nitriansky kraj";80;40866;218;41084;NA;148340;298;2021-02-28;79394
2021-02-27;"Nitriansky kraj";101;106352;496;106848;NA;148340;597;2021-02-27;79096
2021-02-26;"Nitriansky kraj";109;36788;308;37096;NA;148340;417;2021-02-26;78499
2021-02-25;"Nitriansky kraj";188;15243;212;15455;NA;148340;400;2021-02-25;78082
2021-02-24;"Nitriansky kraj";125;13833;260;14093;NA;148340;385;2021-02-24;77682
2021-02-23;"Nitriansky kraj";273;15402;273;15675;NA;148340;546;2021-02-23;77297
2021-02-22;"Nitriansky kraj";154;26478;330;26808;NA;148340;484;2021-02-22;76751
2021-02-21;"Nitriansky kraj";22;43664;320;43984;NA;148340;342;2021-02-21;76267
2021-02-20;"Nitriansky kraj";128;109038;586;109624;NA;148340;714;2021-02-20;75925
2021-02-19;"Nitriansky kraj";173;36849;328;37177;NA;148340;501;2021-02-19;75211
2021-02-18;"Nitriansky kraj";202;17045;275;17320;NA;148340;477;2021-02-18;74710
2021-02-17;"Nitriansky kraj";198;12080;310;12390;NA;148340;508;2021-02-17;74233
2021-02-16;"Nitriansky kraj";284;16066;288;16354;NA;148340;572;2021-02-16;73725
2021-02-15;"Nitriansky kraj";122;28636;474;29110;NA;148340;596;2021-02-15;73153
2021-02-14;"Nitriansky kraj";8;49392;315;49707;NA;148340;323;2021-02-14;72557
2021-02-13;"Nitriansky kraj";127;110294;690;110984;NA;148340;817;2021-02-13;72234
2021-02-12;"Nitriansky kraj";162;33405;407;33812;NA;148340;569;2021-02-12;71417
2021-02-11;"Nitriansky kraj";195;12406;270;12676;NA;148340;465;2021-02-11;70848
2021-02-10;"Nitriansky kraj";186;17770;644;18414;NA;148340;830;2021-02-10;70383
2021-02-09;"Nitriansky kraj";260;18530;385;18915;NA;148340;645;2021-02-09;69553
2021-02-08;"Nitriansky kraj";177;37530;569;38099;NA;148340;746;2021-02-08;68908
2021-02-07;"Nitriansky kraj";20;52307;513;52820;NA;148340;533;2021-02-07;68162
2021-02-06;"Nitriansky kraj";129;101439;764;102203;NA;148340;893;2021-02-06;67629
2021-02-05;"Nitriansky kraj";244;26137;491;26628;NA;148340;735;2021-02-05;66736
2021-02-04;"Nitriansky kraj";308;15681;512;16193;NA;148340;820;2021-02-04;66001
2021-02-03;"Nitriansky kraj";191;13459;382;13841;NA;148340;573;2021-02-03;65181
2021-02-02;"Nitriansky kraj";327;17880;382;18262;NA;148340;709;2021-02-02;64608
2021-02-01;"Nitriansky kraj";221;24002;460;24462;NA;148340;681;2021-02-01;63899
2021-01-31;"Nitriansky kraj";9;46215;507;46722;NA;148340;516;2021-01-31;63218
2021-01-30;"Nitriansky kraj";152;99241;1090;100331;NA;148340;1242;2021-01-30;62702
2021-01-29;"Nitriansky kraj";302;22461;477;22938;NA;148340;779;2021-01-29;61460
2021-01-28;"Nitriansky kraj";269;11370;398;11768;NA;148340;667;2021-01-28;60681
2021-01-27;"Nitriansky kraj";235;6758;299;7057;NA;148340;534;2021-01-27;60014
2021-01-26;"Nitriansky kraj";345;16015;454;16469;NA;148340;799;2021-01-26;59480
2021-01-25;"Nitriansky kraj";201;21909;434;22343;NA;148340;635;2021-01-25;58681
2021-01-24;"Nitriansky kraj";12;79041;897;79938;NA;148340;909;2021-01-24;58046
2021-01-23;"Nitriansky kraj";277;97845;1446;99291;NA;148340;1723;2021-01-23;57137
2021-01-22;"Nitriansky kraj";139;35924;619;36543;NA;148340;758;2021-01-22;55414
2021-01-21;"Nitriansky kraj";305;14649;412;15061;NA;148340;717;2021-01-21;54656
2021-01-20;"Nitriansky kraj";326;11991;625;12616;NA;148340;951;2021-01-20;53939
2021-01-19;"Nitriansky kraj";344;11015;633;11648;NA;148340;977;2021-01-19;52988
2021-01-18;"Nitriansky kraj";367;8901;519;9420;NA;148340;886;2021-01-18;52011
2021-01-17;"Nitriansky kraj";97;15061;275;15336;NA;148340;372;2021-01-17;51125
2021-01-16;"Nitriansky kraj";64;36838;679;37517;NA;148340;743;2021-01-16;50753
2021-01-15;"Nitriansky kraj";373;15940;474;16414;NA;148340;847;2021-01-15;50010
2021-01-14;"Nitriansky kraj";627;10577;452;11029;NA;148340;1079;2021-01-14;49163
2021-01-13;"Nitriansky kraj";663;9234;484;9718;NA;148340;1147;2021-01-13;48084
2021-01-12;"Nitriansky kraj";642;8805;545;9350;NA;148340;1187;2021-01-12;46937
2021-01-11;"Nitriansky kraj";422;8347;513;8860;NA;148340;935;2021-01-11;45750
2021-01-10;"Nitriansky kraj";44;19841;730;20571;NA;148340;774;2021-01-10;44815
2021-01-09;"Nitriansky kraj";532;36823;1071;37894;NA;148340;1603;2021-01-09;44041
2021-01-08;"Nitriansky kraj";817;14001;691;14692;NA;148340;1508;2021-01-08;42438
2021-01-07;"Nitriansky kraj";438;10121;795;10916;NA;148340;1233;2021-01-07;40930
2021-01-06;"Nitriansky kraj";259;3192;197;3389;NA;148340;456;2021-01-06;39697
2021-01-05;"Nitriansky kraj";732;8918;1208;10126;NA;148340;1940;2021-01-05;39241
2021-01-04;"Nitriansky kraj";362;8375;1287;9662;NA;148340;1649;2021-01-04;37301
2021-01-03;"Nitriansky kraj";42;84;20;104;NA;148340;62;2021-01-03;35652
2021-01-02;"Nitriansky kraj";249;1090;26;1116;NA;148340;275;2021-01-02;35590
2021-01-01;"Nitriansky kraj";119;781;95;876;NA;148340;214;2021-01-01;35315
2020-12-31;"Nitriansky kraj";786;7646;962;8608;NA;148340;1748;2020-12-31;35101
2020-12-30;"Nitriansky kraj";1094;9619;1165;10784;NA;148340;2259;2020-12-30;33353
2020-12-29;"Nitriansky kraj";607;8028;1245;9273;NA;148340;1852;2020-12-29;31094
2020-12-28;"Nitriansky kraj";83;6804;1220;8024;NA;148340;1303;2020-12-28;29242
2020-12-27;"Nitriansky kraj";22;60;8;68;NA;148340;30;2020-12-27;27939
2020-12-26;"Nitriansky kraj";54;297;56;353;NA;148340;110;2020-12-26;27909
2020-12-25;"Nitriansky kraj";35;60;11;71;NA;148340;46;2020-12-25;27799
2020-12-24;"Nitriansky kraj";514;1861;176;2037;NA;148340;690;2020-12-24;27753
2020-12-23;"Nitriansky kraj";349;14679;782;15461;NA;148340;1131;2020-12-23;27063
2020-12-22;"Nitriansky kraj";673;10623;949;11572;NA;148340;1622;2020-12-22;25932
2020-12-21;"Nitriansky kraj";128;7587;931;8518;NA;148340;1059;2020-12-21;24310
2020-12-20;"Nitriansky kraj";77;50;10;60;NA;148340;87;2020-12-20;23251
2020-12-19;"Nitriansky kraj";262;2259;159;2418;NA;148340;421;2020-12-19;23164
2020-12-18;"Nitriansky kraj";512;7946;518;8464;NA;148340;1030;2020-12-18;22743
2020-12-17;"Nitriansky kraj";586;6519;486;7005;NA;148340;1072;2020-12-17;21713
2020-12-16;"Nitriansky kraj";357;8097;500;8597;NA;148340;857;2020-12-16;20641
2020-12-15;"Nitriansky kraj";461;9084;750;9834;NA;148340;1211;2020-12-15;19784
2020-12-14;"Nitriansky kraj";217;7816;797;8613;NA;148340;1014;2020-12-14;18573
2020-12-13;"Nitriansky kraj";12;69;6;75;NA;148340;18;2020-12-13;17559
2020-12-12;"Nitriansky kraj";341;1832;125;1957;NA;148340;466;2020-12-12;17541
2020-12-11;"Nitriansky kraj";409;5117;384;5501;NA;148340;793;2020-12-11;17075
2020-12-10;"Nitriansky kraj";360;5239;345;5584;NA;148340;705;2020-12-10;16282
2020-12-09;"Nitriansky kraj";362;5494;529;6023;NA;148340;891;2020-12-09;15577
2020-12-08;"Nitriansky kraj";340;8168;548;8716;NA;148340;888;2020-12-08;14686
2020-12-07;"Nitriansky kraj";139;6243;573;6816;NA;148340;712;2020-12-07;13798
2020-12-06;"Nitriansky kraj";15;89;4;93;NA;148340;19;2020-12-06;13086
2020-12-05;"Nitriansky kraj";136;1388;19;1407;NA;148340;155;2020-12-05;13067
2020-12-04;"Nitriansky kraj";232;2884;74;2958;NA;148340;306;2020-12-04;12912
2020-12-03;"Nitriansky kraj";248;2471;110;2581;NA;148340;358;2020-12-03;12606
2020-12-02;"Nitriansky kraj";252;2580;151;2731;NA;148340;403;2020-12-02;12248
2020-12-01;"Nitriansky kraj";331;2891;131;3022;NA;148340;462;2020-12-01;11845
2020-11-30;"Nitriansky kraj";91;4228;188;4416;NA;148340;279;2020-11-30;11383
2020-11-29;"Nitriansky kraj";3;634;42;676;NA;148340;45;2020-11-29;11104
2020-11-28;"Nitriansky kraj";135;892;31;923;NA;148340;166;2020-11-28;11059
2020-11-27;"Nitriansky kraj";177;2069;73;2142;NA;148340;250;2020-11-27;10893
2020-11-26;"Nitriansky kraj";191;2813;80;2893;NA;148340;271;2020-11-26;10643
2020-11-25;"Nitriansky kraj";325;2478;91;2569;NA;148340;416;2020-11-25;10372
2020-11-24;"Nitriansky kraj";147;1641;64;1705;NA;148340;211;2020-11-24;9956
2020-11-23;"Nitriansky kraj";102;9891;212;10103;NA;148340;314;2020-11-23;9745
2020-11-22;"Nitriansky kraj";7;1176;25;1201;NA;148340;32;2020-11-22;9431
2020-11-21;"Nitriansky kraj";86;1083;38;1121;NA;148340;124;2020-11-21;9399
2020-11-20;"Nitriansky kraj";264;4180;103;4283;NA;148340;367;2020-11-20;9275
2020-11-19;"Nitriansky kraj";185;3065;134;3199;NA;148340;319;2020-11-19;8908
2020-11-18;"Nitriansky kraj";188;2214;79;2293;NA;148340;267;2020-11-18;8589
2020-11-17;"Nitriansky kraj";178;596;29;625;NA;148340;207;2020-11-17;8322
2020-11-16;"Nitriansky kraj";139;1877;75;1952;NA;148340;214;2020-11-16;8115
2020-11-15;"Nitriansky kraj";14;180;5;185;NA;148340;19;2020-11-15;7901
2020-11-14;"Nitriansky kraj";114;1131;32;1163;NA;148340;146;2020-11-14;7882
2020-11-13;"Nitriansky kraj";210;936;46;982;NA;148340;256;2020-11-13;7736
2020-11-12;"Nitriansky kraj";256;1195;35;1230;NA;148340;291;2020-11-12;7480
2020-11-11;"Nitriansky kraj";279;1247;22;1269;NA;148340;301;2020-11-11;7189
2020-11-10;"Nitriansky kraj";192;2623;39;2662;NA;148340;231;2020-11-10;6888
2020-11-09;"Nitriansky kraj";128;3136;43;3179;NA;148340;171;2020-11-09;6657
2020-11-08;"Nitriansky kraj";43;1462;32;1494;NA;148340;75;2020-11-08;6486
2020-11-07;"Nitriansky kraj";130;1046;4;1050;NA;148340;134;2020-11-07;6411
2020-11-06;"Nitriansky kraj";210;2264;32;2296;NA;148340;242;2020-11-06;6277
2020-11-05;"Nitriansky kraj";178;313;14;327;NA;148340;192;2020-11-05;6035
2020-11-04;"Nitriansky kraj";211;297;16;313;NA;148340;227;2020-11-04;5843
2020-11-03;"Nitriansky kraj";216;435;25;460;NA;148340;241;2020-11-03;5616
2020-11-02;"Nitriansky kraj";171;4208;46;4254;NA;148340;217;2020-11-02;5375
2020-11-01;"Nitriansky kraj";130;2546;27;2573;NA;148340;157;2020-11-01;5158
2020-10-31;"Nitriansky kraj";261;10466;134;10600;NA;148340;395;2020-10-31;5001
2020-10-30;"Nitriansky kraj";204;2593;42;2635;NA;148340;246;2020-10-30;4606
2020-10-29;"Nitriansky kraj";293;841;39;880;NA;148340;332;2020-10-29;4360
2020-10-28;"Nitriansky kraj";216;608;59;667;NA;148340;275;2020-10-28;4028
2020-10-27;"Nitriansky kraj";296;550;47;597;NA;148340;343;2020-10-27;3753
2020-10-26;"Nitriansky kraj";69;633;56;689;NA;148340;125;2020-10-26;3410
2020-10-25;"Nitriansky kraj";50;62;8;70;NA;148340;58;2020-10-25;3285
2020-10-24;"Nitriansky kraj";169;237;11;248;NA;148340;180;2020-10-24;3227
2020-10-23;"Nitriansky kraj";282;762;41;803;NA;148340;323;2020-10-23;3047
2020-10-22;"Nitriansky kraj";137;444;39;483;NA;148340;176;2020-10-22;2724
2020-10-21;"Nitriansky kraj";146;208;3;211;NA;148340;149;2020-10-21;2548
2020-10-20;"Nitriansky kraj";197;78;6;84;NA;148340;203;2020-10-20;2399
2020-10-19;"Nitriansky kraj";148;79;1;80;NA;148340;149;2020-10-19;2196
2020-10-18;"Nitriansky kraj";22;0;0;0;NA;148340;22;2020-10-18;2047
2020-10-17;"Nitriansky kraj";67;0;0;0;NA;148340;67;2020-10-17;2025
2020-10-16;"Nitriansky kraj";133;28;3;31;NA;148340;136;2020-10-16;1958
2020-10-15;"Nitriansky kraj";106;31;2;33;NA;148340;108;2020-10-15;1822
2020-10-14;"Nitriansky kraj";80;22;4;26;NA;148340;84;2020-10-14;1714
2020-10-13;"Nitriansky kraj";101;82;2;84;NA;148340;103;2020-10-13;1630
2020-10-12;"Nitriansky kraj";36;0;0;0;NA;148340;36;2020-10-12;1527
2020-10-11;"Nitriansky kraj";8;0;0;0;NA;148340;8;2020-10-11;1491
2020-10-10;"Nitriansky kraj";107;0;0;0;NA;148340;107;2020-10-10;1483
2020-10-09;"Nitriansky kraj";120;0;0;0;NA;148340;120;2020-10-09;1376
2020-10-08;"Nitriansky kraj";132;0;0;0;NA;148340;132;2020-10-08;1256
2020-10-07;"Nitriansky kraj";81;0;0;0;NA;148340;81;2020-10-07;1124
2020-10-06;"Nitriansky kraj";48;0;0;0;NA;148340;48;2020-10-06;1043
2020-10-05;"Nitriansky kraj";20;0;0;0;NA;148340;20;2020-10-05;995
2020-10-04;"Nitriansky kraj";17;0;0;0;NA;148340;17;2020-10-04;975
2020-10-03;"Nitriansky kraj";96;0;0;0;NA;148340;96;2020-10-03;958
2020-10-02;"Nitriansky kraj";108;0;0;0;NA;148340;108;2020-10-02;862
2020-10-01;"Nitriansky kraj";95;0;0;0;NA;148340;95;2020-10-01;754
2020-09-30;"Nitriansky kraj";100;0;0;0;NA;148340;100;2020-09-30;659
2020-09-29;"Nitriansky kraj";50;0;0;0;NA;148340;50;2020-09-29;559
2020-09-28;"Nitriansky kraj";22;0;0;0;NA;148340;22;2020-09-28;509
2020-09-27;"Nitriansky kraj";16;0;0;0;NA;148340;16;2020-09-27;487
2020-09-26;"Nitriansky kraj";64;0;0;0;NA;148340;64;2020-09-26;471
2020-09-25;"Nitriansky kraj";90;0;0;0;NA;148340;90;2020-09-25;407
2020-09-24;"Nitriansky kraj";51;0;0;0;NA;148340;51;2020-09-24;317
2020-09-23;"Nitriansky kraj";70;0;0;0;NA;148340;70;2020-09-23;266
2020-09-22;"Nitriansky kraj";18;0;0;0;NA;148340;18;2020-09-22;196
2020-09-21;"Nitriansky kraj";10;0;0;0;NA;148340;10;2020-09-21;178
2020-09-20;"Nitriansky kraj";4;0;0;0;NA;148340;4;2020-09-20;168
2020-09-19;"Nitriansky kraj";14;0;0;0;NA;148340;14;2020-09-19;164
2020-09-18;"Nitriansky kraj";19;0;0;0;NA;148340;19;2020-09-18;150
2020-09-17;"Nitriansky kraj";30;0;0;0;NA;148340;30;2020-09-17;131
2020-09-16;"Nitriansky kraj";6;0;0;0;NA;148340;6;2020-09-16;101
2020-09-15;"Nitriansky kraj";19;0;0;0;NA;148340;19;2020-09-15;95
2020-09-14;"Nitriansky kraj";28;0;0;0;NA;148340;28;2020-09-14;76
2020-09-13;"Nitriansky kraj";3;0;0;0;NA;148340;3;2020-09-13;48
2020-09-12;"Nitriansky kraj";12;0;0;0;NA;148340;12;2020-09-12;45
2020-09-11;"Nitriansky kraj";23;0;0;0;NA;148340;23;2020-09-11;33
2020-09-10;"Nitriansky kraj";29;0;0;0;NA;148340;29;2020-09-10;10
2020-09-09;"Nitriansky kraj";19;0;0;0;NA;148340;19;2020-09-09;-19
2020-09-08;"Nitriansky kraj";17;0;0;0;NA;148340;17;2020-09-08;-38
2020-09-07;"Nitriansky kraj";17;0;0;0;NA;148340;17;2020-09-07;-55
2020-09-06;"Nitriansky kraj";0;0;0;0;NA;148340;0;2020-09-06;-72
2020-09-05;"Nitriansky kraj";22;0;0;0;NA;148340;22;2020-09-05;-72
2020-09-04;"Nitriansky kraj";34;0;0;0;NA;148340;34;2020-09-04;-94
2020-09-03;"Nitriansky kraj";15;0;0;0;NA;148340;15;2020-09-03;-128
2020-09-02;"Nitriansky kraj";15;0;0;0;NA;148340;15;2020-09-02;-143
2020-09-01;"Nitriansky kraj";2;0;0;0;NA;148340;2;2020-09-01;-158
2020-08-31;"Nitriansky kraj";12;0;0;0;NA;148340;12;2020-08-31;-160
2020-08-30;"Nitriansky kraj";1;0;0;0;NA;148340;1;2020-08-30;-172
2020-08-29;"Nitriansky kraj";7;46;0;46;NA;148340;7;2020-08-29;-173
2020-08-28;"Nitriansky kraj";12;0;0;0;NA;148340;12;2020-08-28;-180
2020-08-27;"Nitriansky kraj";12;0;0;0;NA;148340;12;2020-08-27;-192
2020-08-26;"Nitriansky kraj";4;0;0;0;NA;148340;4;2020-08-26;-204
2020-08-25;"Nitriansky kraj";8;0;0;0;NA;148340;8;2020-08-25;-208
2020-08-24;"Nitriansky kraj";1;0;0;0;NA;148340;1;2020-08-24;-216
2020-08-23;"Nitriansky kraj";1;0;0;0;NA;148340;1;2020-08-23;-217
2020-08-22;"Nitriansky kraj";2;0;0;0;NA;148340;2;2020-08-22;-218
2020-08-21;"Nitriansky kraj";0;0;0;0;NA;148340;0;2020-08-21;-220
2020-08-20;"Nitriansky kraj";7;0;0;0;NA;148340;7;2020-08-20;-220
2020-08-19;"Nitriansky kraj";1;0;0;0;NA;148340;1;2020-08-19;-227
2020-08-18;"Nitriansky kraj";2;0;0;0;NA;148340;2;2020-08-18;-228
2020-08-17;"Nitriansky kraj";1;0;0;0;NA;148340;1;2020-08-17;-230
2020-08-16;"Nitriansky kraj";0;0;0;0;NA;148340;0;2020-08-16;-231
2020-08-15;"Nitriansky kraj";2;0;0;0;NA;148340;2;2020-08-15;-231
2020-08-14;"Nitriansky kraj";1;0;0;0;NA;148340;1;2020-08-14;-233
2020-08-13;"Nitriansky kraj";4;0;0;0;NA;148340;4;2020-08-13;-234
2020-08-12;"Nitriansky kraj";0;0;0;0;NA;148340;0;2020-08-12;-238
2020-08-11;"Nitriansky kraj";1;0;0;0;NA;148340;1;2020-08-11;-238
2020-08-10;"Nitriansky kraj";0;0;0;0;NA;148340;0;2020-08-10;-239
2020-08-09;"Nitriansky kraj";0;0;0;0;NA;148340;0;2020-08-09;-239
2020-08-08;"Nitriansky kraj";0;0;0;0;NA;148340;0;2020-08-08;-239
2020-08-07;"Nitriansky kraj";4;0;0;0;NA;148340;4;2020-08-07;-239
2020-08-06;"Nitriansky kraj";4;0;0;0;NA;148340;4;2020-08-06;-243
2020-08-05;"Nitriansky kraj";0;0;0;0;NA;148340;0;2020-08-05;-247
2020-08-04;"Nitriansky kraj";7;0;0;0;NA;148340;7;2020-08-04;-247
2020-08-03;"Nitriansky kraj";0;0;0;0;NA;148340;0;2020-08-03;-254
2020-08-02;"Nitriansky kraj";0;0;0;0;NA;148340;0;2020-08-02;-254
2020-08-01;"Nitriansky kraj";0;0;0;0;NA;148340;0;2020-08-01;-254
2020-07-31;"Nitriansky kraj";0;0;0;0;NA;148340;0;2020-07-31;-254
2020-07-30;"Nitriansky kraj";0;0;0;0;NA;148340;0;2020-07-30;-254
2020-07-29;"Nitriansky kraj";0;0;0;0;NA;148340;0;2020-07-29;-254
2020-07-28;"Nitriansky kraj";0;0;0;0;NA;148340;0;2020-07-28;-254
2020-07-27;"Nitriansky kraj";0;0;0;0;NA;148340;0;2020-07-27;-254
2020-07-26;"Nitriansky kraj";0;0;0;0;NA;148340;0;2020-07-26;-254
2020-07-25;"Nitriansky kraj";0;0;0;0;NA;148340;0;2020-07-25;-254
2020-07-24;"Nitriansky kraj";1;0;0;0;NA;148340;1;2020-07-24;-254
2020-07-23;"Nitriansky kraj";3;0;0;0;NA;148340;3;2020-07-23;-255
2020-07-22;"Nitriansky kraj";2;0;0;0;NA;148340;2;2020-07-22;-258
2020-07-21;"Nitriansky kraj";14;0;0;0;NA;148340;14;2020-07-21;-260
2020-07-20;"Nitriansky kraj";11;0;0;0;NA;148340;11;2020-07-20;-274
2020-07-19;"Nitriansky kraj";0;0;0;0;NA;148340;0;2020-07-19;-285
2020-07-18;"Nitriansky kraj";0;0;0;0;NA;148340;0;2020-07-18;-285
2020-07-17;"Nitriansky kraj";0;0;0;0;NA;148340;0;2020-07-17;-285
2020-07-16;"Nitriansky kraj";4;0;0;0;NA;148340;4;2020-07-16;-285
2020-07-15;"Nitriansky kraj";5;0;0;0;NA;148340;5;2020-07-15;-289
2020-07-14;"Nitriansky kraj";0;0;0;0;NA;148340;0;2020-07-14;-294
2020-07-13;"Nitriansky kraj";0;0;0;0;NA;148340;0;2020-07-13;-294
2020-07-12;"Nitriansky kraj";0;0;0;0;NA;148340;0;2020-07-12;-294
2020-07-11;"Nitriansky kraj";0;0;0;0;NA;148340;0;2020-07-11;-294
2020-07-10;"Nitriansky kraj";0;0;0;0;NA;148340;0;2020-07-10;-294
2020-07-09;"Nitriansky kraj";1;0;0;0;NA;148340;1;2020-07-09;-294
2020-07-08;"Nitriansky kraj";2;0;0;0;NA;148340;2;2020-07-08;-295
2020-07-07;"Nitriansky kraj";0;0;0;0;NA;148340;0;2020-07-07;-297
2020-07-06;"Nitriansky kraj";0;0;0;0;NA;148340;0;2020-07-06;-297
2020-07-05;"Nitriansky kraj";0;0;0;0;NA;148340;0;2020-07-05;-297
2020-07-04;"Nitriansky kraj";0;0;0;0;NA;148340;0;2020-07-04;-297
2020-07-03;"Nitriansky kraj";0;0;0;0;NA;148340;0;2020-07-03;-297
2020-07-02;"Nitriansky kraj";0;0;0;0;NA;148340;0;2020-07-02;-297
2020-07-01;"Nitriansky kraj";3;0;0;0;NA;148340;3;2020-07-01;-297
2020-06-30;"Nitriansky kraj";0;0;0;0;NA;148340;0;2020-06-30;-300
2020-06-29;"Nitriansky kraj";0;0;0;0;NA;148340;0;2020-06-29;-300
2020-06-28;"Nitriansky kraj";0;0;0;0;NA;148340;0;2020-06-28;-300
2020-06-27;"Nitriansky kraj";0;0;0;0;NA;148340;0;2020-06-27;-300
2020-06-26;"Nitriansky kraj";0;0;0;0;NA;148340;0;2020-06-26;-300
2020-06-25;"Nitriansky kraj";0;0;0;0;NA;148340;0;2020-06-25;-300
2020-06-24;"Nitriansky kraj";1;0;0;0;NA;148340;1;2020-06-24;-300
2020-06-23;"Nitriansky kraj";0;0;0;0;NA;148340;0;2020-06-23;-301
2020-06-22;"Nitriansky kraj";0;0;0;0;NA;148340;0;2020-06-22;-301
2020-06-21;"Nitriansky kraj";0;0;0;0;NA;148340;0;2020-06-21;-301
2020-06-20;"Nitriansky kraj";0;0;0;0;NA;148340;0;2020-06-20;-301
2020-06-19;"Nitriansky kraj";0;0;0;0;NA;148340;0;2020-06-19;-301
2020-06-18;"Nitriansky kraj";0;0;0;0;NA;148340;0;2020-06-18;-301
2020-06-17;"Nitriansky kraj";0;0;0;0;NA;148340;0;2020-06-17;-301
2020-06-16;"Nitriansky kraj";0;0;0;0;NA;148340;0;2020-06-16;-301
2020-06-14;"Nitriansky kraj";0;0;0;0;NA;148340;0;2020-06-14;-301
2020-06-13;"Nitriansky kraj";0;0;0;0;NA;148340;0;2020-06-13;-301
2020-06-12;"Nitriansky kraj";0;0;0;0;NA;148340;0;2020-06-12;-301
2020-06-11;"Nitriansky kraj";0;0;0;0;NA;148340;0;2020-06-11;-301
2020-06-10;"Nitriansky kraj";1;0;0;0;NA;148340;1;2020-06-10;-301
2020-06-09;"Nitriansky kraj";1;0;0;0;NA;148340;1;2020-06-09;-302
2020-06-08;"Nitriansky kraj";0;0;0;0;NA;148340;0;2020-06-08;-303
2020-06-07;"Nitriansky kraj";0;0;0;0;NA;148340;0;2020-06-07;-303
2020-06-05;"Nitriansky kraj";0;0;0;0;NA;148340;0;2020-06-05;-303
2020-06-03;"Nitriansky kraj";0;0;0;0;NA;148340;0;2020-06-03;-303
2020-06-02;"Nitriansky kraj";1;0;0;0;NA;148340;1;2020-06-02;-303
2020-05-31;"Nitriansky kraj";0;0;0;0;NA;148340;0;2020-05-31;-304
2020-05-29;"Nitriansky kraj";0;0;0;0;NA;148340;0;2020-05-29;-304
2020-05-27;"Nitriansky kraj";0;0;0;0;NA;148340;0;2020-05-27;-304
2020-05-26;"Nitriansky kraj";0;0;0;0;NA;148340;0;2020-05-26;-304
2020-05-25;"Nitriansky kraj";0;0;0;0;NA;148340;0;2020-05-25;-304
2020-05-24;"Nitriansky kraj";2;0;0;0;NA;148340;2;2020-05-24;-304
2020-05-23;"Nitriansky kraj";0;0;0;0;NA;148340;0;2020-05-23;-306
2020-05-22;"Nitriansky kraj";1;0;0;0;NA;148340;1;2020-05-22;-306
2020-05-21;"Nitriansky kraj";0;0;0;0;NA;148340;0;2020-05-21;-307
2020-05-20;"Nitriansky kraj";0;0;0;0;NA;148340;0;2020-05-20;-307
2020-05-19;"Nitriansky kraj";0;0;0;0;NA;148340;0;2020-05-19;-307
2020-05-17;"Nitriansky kraj";0;0;0;0;NA;148340;0;2020-05-17;-307
2020-05-16;"Nitriansky kraj";0;0;0;0;NA;148340;0;2020-05-16;-307
2020-05-15;"Nitriansky kraj";1;0;0;0;NA;148340;1;2020-05-15;-307
2020-05-14;"Nitriansky kraj";0;0;0;0;NA;148340;0;2020-05-14;-308
2020-05-13;"Nitriansky kraj";0;0;0;0;NA;148340;0;2020-05-13;-308
2020-05-12;"Nitriansky kraj";0;0;0;0;NA;148340;0;2020-05-12;-308
2020-05-11;"Nitriansky kraj";2;0;0;0;NA;148340;2;2020-05-11;-308
2020-05-09;"Nitriansky kraj";0;0;0;0;NA;148340;0;2020-05-09;-310
2020-05-07;"Nitriansky kraj";1;0;0;0;NA;148340;1;2020-05-07;-310
2020-05-06;"Nitriansky kraj";9;0;0;0;NA;148340;9;2020-05-06;-311
2020-05-05;"Nitriansky kraj";0;0;0;0;NA;148340;0;2020-05-05;-320
2020-05-04;"Nitriansky kraj";5;0;0;0;NA;148340;5;2020-05-04;-320
2020-05-03;"Nitriansky kraj";2;0;0;0;NA;148340;2;2020-05-03;-325
2020-05-02;"Nitriansky kraj";0;0;0;0;NA;148340;0;2020-05-02;-327
2020-05-01;"Nitriansky kraj";1;0;0;0;NA;148340;1;2020-05-01;-327
2020-04-30;"Nitriansky kraj";0;0;0;0;NA;148340;0;2020-04-30;-328
2020-04-29;"Nitriansky kraj";0;0;0;0;NA;148340;0;2020-04-29;-328
2020-04-28;"Nitriansky kraj";1;0;0;0;NA;148340;1;2020-04-28;-328
2020-04-27;"Nitriansky kraj";0;0;0;0;NA;148340;0;2020-04-27;-329
2020-04-26;"Nitriansky kraj";0;0;0;0;NA;148340;0;2020-04-26;-329
2020-04-25;"Nitriansky kraj";0;0;0;0;NA;148340;0;2020-04-25;-329
2020-04-24;"Nitriansky kraj";0;0;0;0;NA;148340;0;2020-04-24;-329
2020-04-23;"Nitriansky kraj";3;0;0;0;NA;148340;3;2020-04-23;-329
2020-04-22;"Nitriansky kraj";16;0;0;0;NA;148340;16;2020-04-22;-332
2020-04-21;"Nitriansky kraj";6;0;0;0;NA;148340;6;2020-04-21;-348
2020-04-20;"Nitriansky kraj";5;0;0;0;NA;148340;5;2020-04-20;-354
2020-04-19;"Nitriansky kraj";0;0;0;0;NA;148340;0;2020-04-19;-359
2020-04-18;"Nitriansky kraj";0;0;0;0;NA;148340;0;2020-04-18;-359
2020-04-17;"Nitriansky kraj";7;0;0;0;NA;148340;7;2020-04-17;-359
2020-04-16;"Nitriansky kraj";0;0;0;0;NA;148340;0;2020-04-16;-366
2020-04-15;"Nitriansky kraj";6;0;0;0;NA;148340;6;2020-04-15;-366
2020-04-14;"Nitriansky kraj";2;0;0;0;NA;148340;2;2020-04-14;-372
2020-04-13;"Nitriansky kraj";1;0;0;0;NA;148340;1;2020-04-13;-374
2020-04-12;"Nitriansky kraj";3;0;0;0;NA;148340;3;2020-04-12;-375
2020-04-11;"Nitriansky kraj";1;0;0;0;NA;148340;1;2020-04-11;-378
2020-04-10;"Nitriansky kraj";1;0;0;0;NA;148340;1;2020-04-10;-379
2020-04-09;"Nitriansky kraj";0;0;0;0;NA;148340;0;2020-04-09;-380
2020-04-08;"Nitriansky kraj";2;0;0;0;NA;148340;2;2020-04-08;-380
2020-04-07;"Nitriansky kraj";3;0;0;0;NA;148340;3;2020-04-07;-382
2020-04-06;"Nitriansky kraj";4;0;0;0;NA;148340;4;2020-04-06;-385
2020-04-05;"Nitriansky kraj";5;0;0;0;NA;148340;5;2020-04-05;-389
2020-04-04;"Nitriansky kraj";0;0;0;0;NA;148340;0;2020-04-04;-394
2020-04-03;"Nitriansky kraj";0;0;0;0;NA;148340;0;2020-04-03;-394
2020-04-02;"Nitriansky kraj";1;0;0;0;NA;148340;1;2020-04-02;-394
2020-04-01;"Nitriansky kraj";0;0;0;0;NA;148340;0;2020-04-01;-395
2020-03-31;"Nitriansky kraj";3;0;0;0;NA;148340;3;2020-03-31;-395
2020-03-30;"Nitriansky kraj";3;0;0;0;NA;148340;3;2020-03-30;-398
2020-03-29;"Nitriansky kraj";3;0;0;0;NA;148340;3;2020-03-29;-401
2020-03-28;"Nitriansky kraj";1;0;0;0;NA;148340;1;2020-03-28;-404
2020-03-27;"Nitriansky kraj";1;0;0;0;NA;148340;1;2020-03-27;-405
2020-03-26;"Nitriansky kraj";1;0;0;0;NA;148340;1;2020-03-26;-406
2020-03-25;"Nitriansky kraj";1;0;0;0;NA;148340;1;2020-03-25;-407
2020-03-24;"Nitriansky kraj";0;0;0;0;NA;148340;0;2020-03-24;-408
2020-03-23;"Nitriansky kraj";2;0;0;0;NA;148340;2;2020-03-23;-408
2020-03-22;"Nitriansky kraj";2;0;0;0;NA;148340;2;2020-03-22;-410
2020-03-21;"Nitriansky kraj";2;0;0;0;NA;148340;2;2020-03-21;-412
2020-03-20;"Nitriansky kraj";1;0;0;0;NA;148340;1;2020-03-20;-414
2020-03-19;"Nitriansky kraj";1;0;0;0;NA;148340;1;2020-03-19;-415
2020-03-18;"Nitriansky kraj";2;0;0;0;NA;148340;2;2020-03-18;-416
2020-03-17;"Nitriansky kraj";1;0;0;0;NA;148340;1;2020-03-17;-418
2020-03-16;"Nitriansky kraj";0;0;0;0;NA;148340;0;2020-03-16;-419
2020-03-15;"Nitriansky kraj";4;0;0;0;NA;148340;4;2020-03-15;-419
2020-03-14;"Nitriansky kraj";1;0;0;0;NA;148340;1;2020-03-14;-423
2020-03-13;"Nitriansky kraj";0;0;0;0;NA;148340;0;2020-03-13;-424
2020-03-12;"Nitriansky kraj";0;0;0;0;NA;148340;0;2020-03-12;-424
2020-03-11;"Nitriansky kraj";0;0;0;0;NA;148340;0;2020-03-11;-424
2020-03-09;"Nitriansky kraj";0;0;0;0;NA;148340;0;2020-03-09;-424
2020-03-08;"Nitriansky kraj";0;0;0;0;NA;148340;0;2020-03-08;-424
2020-03-07;"Nitriansky kraj";0;0;0;0;NA;148340;0;2020-03-07;-424
2020-03-06;"Nitriansky kraj";0;0;0;0;NA;148340;0;2020-03-06;-424
2022-01-11;"Prešovský kraj";438;0;0;0;135421;209569;438;2022-01-11;209569
2022-01-10;"Prešovský kraj";469;4;0;4;NA;209569;469;2022-01-10;209131
2022-01-09;"Prešovský kraj";114;2825;51;2876;NA;209569;165;2022-01-09;208662
2022-01-08;"Prešovský kraj";291;1617;29;1646;NA;209569;320;2022-01-08;208497
2022-01-07;"Prešovský kraj";370;3095;89;3184;NA;209569;459;2022-01-07;208177
2022-01-06;"Prešovský kraj";104;1000;43;1043;NA;209569;147;2022-01-06;207718
2022-01-05;"Prešovský kraj";373;4592;95;4687;NA;209569;468;2022-01-05;207571
2022-01-04;"Prešovský kraj";428;4537;77;4614;NA;209569;505;2022-01-04;207103
2022-01-03;"Prešovský kraj";390;6817;105;6922;NA;209569;495;2022-01-03;206598
2022-01-02;"Prešovský kraj";158;3180;75;3255;NA;209569;233;2022-01-02;206103
2022-01-01;"Prešovský kraj";55;379;8;387;NA;209569;63;2022-01-01;205870
2021-12-31;"Prešovský kraj";220;2174;77;2251;NA;209569;297;2021-12-31;205807
2021-12-30;"Prešovský kraj";230;2948;81;3029;NA;209569;311;2021-12-30;205510
2021-12-29;"Prešovský kraj";298;3909;73;3982;NA;209569;371;2021-12-29;205199
2021-12-28;"Prešovský kraj";365;3619;60;3679;NA;209569;425;2021-12-28;204828
2021-12-27;"Prešovský kraj";593;5305;93;5398;NA;209569;686;2021-12-27;204403
2021-12-26;"Prešovský kraj";112;1584;62;1646;NA;209569;174;2021-12-26;203717
2021-12-25;"Prešovský kraj";12;600;29;629;NA;209569;41;2021-12-25;203543
2021-12-24;"Prešovský kraj";27;463;26;489;NA;209569;53;2021-12-24;203502
2021-12-23;"Prešovský kraj";623;3091;76;3167;NA;209569;699;2021-12-23;203449
2021-12-22;"Prešovský kraj";234;3601;86;3687;NA;209569;320;2021-12-22;202750
2021-12-21;"Prešovský kraj";520;4571;78;4649;NA;209569;598;2021-12-21;202430
2021-12-20;"Prešovský kraj";371;7161;107;7268;NA;209569;478;2021-12-20;201832
2021-12-19;"Prešovský kraj";110;3166;74;3240;NA;209569;184;2021-12-19;201354
2021-12-18;"Prešovský kraj";313;1562;61;1623;NA;209569;374;2021-12-18;201170
2021-12-17;"Prešovský kraj";429;4479;96;4575;NA;209569;525;2021-12-17;200796
2021-12-16;"Prešovský kraj";401;4530;95;4625;NA;209569;496;2021-12-16;200271
2021-12-15;"Prešovský kraj";473;4499;79;4578;NA;209569;552;2021-12-15;199775
2021-12-14;"Prešovský kraj";662;5466;125;5591;NA;209569;787;2021-12-14;199223
2021-12-13;"Prešovský kraj";588;8055;175;8230;NA;209569;763;2021-12-13;198436
2021-12-12;"Prešovský kraj";160;3852;106;3958;NA;209569;266;2021-12-12;197673
2021-12-11;"Prešovský kraj";483;2040;91;2131;NA;209569;574;2021-12-11;197407
2021-12-10;"Prešovský kraj";649;5013;140;5153;NA;209569;789;2021-12-10;196833
2021-12-09;"Prešovský kraj";669;4680;135;4815;NA;209569;804;2021-12-09;196044
2021-12-08;"Prešovský kraj";944;4794;167;4961;NA;209569;1111;2021-12-08;195240
2021-12-07;"Prešovský kraj";1217;5851;188;6039;NA;209569;1405;2021-12-07;194129
2021-12-06;"Prešovský kraj";784;8604;247;8851;NA;209569;1031;2021-12-06;192724
2021-12-05;"Prešovský kraj";145;4439;133;4572;NA;209569;278;2021-12-05;191693
2021-12-04;"Prešovský kraj";1025;2290;127;2417;NA;209569;1152;2021-12-04;191415
2021-12-03;"Prešovský kraj";1040;5263;231;5494;NA;209569;1271;2021-12-03;190263
2021-12-02;"Prešovský kraj";2255;5291;183;5474;NA;209569;2438;2021-12-02;188992
2021-12-01;"Prešovský kraj";826;5267;239;5506;NA;209569;1065;2021-12-01;186554
2021-11-30;"Prešovský kraj";1123;6651;265;6916;NA;209569;1388;2021-11-30;185489
2021-11-29;"Prešovský kraj";583;11476;473;11949;NA;209569;1056;2021-11-29;184101
2021-11-28;"Prešovský kraj";919;5898;234;6132;NA;209569;1153;2021-11-28;183045
2021-11-27;"Prešovský kraj";884;2977;219;3196;NA;209569;1103;2021-11-27;181892
2021-11-26;"Prešovský kraj";1311;5890;328;6218;NA;209569;1639;2021-11-26;180789
2021-11-25;"Prešovský kraj";1285;5051;307;5358;NA;209569;1592;2021-11-25;179150
2021-11-24;"Prešovský kraj";1209;6121;356;6477;NA;209569;1565;2021-11-24;177558
2021-11-23;"Prešovský kraj";1099;6631;314;6945;NA;209569;1413;2021-11-23;175993
2021-11-22;"Prešovský kraj";905;8209;529;8738;NA;209569;1434;2021-11-22;174580
2021-11-21;"Prešovský kraj";950;3766;316;4082;NA;209569;1266;2021-11-21;173146
2021-11-20;"Prešovský kraj";1372;2193;222;2415;NA;209569;1594;2021-11-20;171880
2021-11-19;"Prešovský kraj";1629;5864;452;6316;NA;209569;2081;2021-11-19;170286
2021-11-18;"Prešovský kraj";823;6693;518;7211;NA;209569;1341;2021-11-18;168205
2021-11-17;"Prešovský kraj";1648;1336;148;1484;NA;209569;1796;2021-11-17;166864
2021-11-16;"Prešovský kraj";1346;5511;398;5909;NA;209569;1744;2021-11-16;165068
2021-11-15;"Prešovský kraj";897;7798;577;8375;NA;209569;1474;2021-11-15;163324
2021-11-14;"Prešovský kraj";603;3168;311;3479;NA;209569;914;2021-11-14;161850
2021-11-13;"Prešovský kraj";1255;2068;262;2330;NA;209569;1517;2021-11-13;160936
2021-11-12;"Prešovský kraj";1358;5236;371;5607;NA;209569;1729;2021-11-12;159419
2021-11-11;"Prešovský kraj";1218;5087;438;5525;NA;209569;1656;2021-11-11;157690
2021-11-10;"Prešovský kraj";1278;4966;380;5346;NA;209569;1658;2021-11-10;156034
2021-11-09;"Prešovský kraj";1038;5431;407;5838;NA;209569;1445;2021-11-09;154376
2021-11-08;"Prešovský kraj";1068;6987;574;7561;NA;209569;1642;2021-11-08;152931
2021-11-07;"Prešovský kraj";421;2500;242;2742;NA;209569;663;2021-11-07;151289
2021-11-06;"Prešovský kraj";1389;1899;234;2133;NA;209569;1623;2021-11-06;150626
2021-11-05;"Prešovský kraj";1080;4974;367;5341;NA;209569;1447;2021-11-05;149003
2021-11-04;"Prešovský kraj";1743;5162;322;5484;NA;209569;2065;2021-11-04;147556
2021-11-03;"Prešovský kraj";1326;5337;387;5724;NA;209569;1713;2021-11-03;145491
2021-11-02;"Prešovský kraj";1002;7463;539;8002;NA;209569;1541;2021-11-02;143778
2021-11-01;"Prešovský kraj";347;1402;131;1533;NA;209569;478;2021-11-01;142237
2021-10-31;"Prešovský kraj";447;2045;210;2255;NA;209569;657;2021-10-31;141759
2021-10-30;"Prešovský kraj";1148;1928;183;2111;NA;209569;1331;2021-10-30;141102
2021-10-29;"Prešovský kraj";1360;4460;253;4713;NA;209569;1613;2021-10-29;139771
2021-10-28;"Prešovský kraj";960;4500;300;4800;NA;209569;1260;2021-10-28;138158
2021-10-27;"Prešovský kraj";1444;4325;221;4546;NA;209569;1665;2021-10-27;136898
2021-10-26;"Prešovský kraj";940;5125;217;5342;NA;209569;1157;2021-10-26;135233
2021-10-25;"Prešovský kraj";673;6077;348;6425;NA;209569;1021;2021-10-25;134076
2021-10-24;"Prešovský kraj";110;2180;149;2329;NA;209569;259;2021-10-24;133055
2021-10-23;"Prešovský kraj";1145;1928;141;2069;NA;209569;1286;2021-10-23;132796
2021-10-22;"Prešovský kraj";792;4876;177;5053;NA;209569;969;2021-10-22;131510
2021-10-21;"Prešovský kraj";901;4738;191;4929;NA;209569;1092;2021-10-21;130541
2021-10-20;"Prešovský kraj";833;4199;195;4394;NA;209569;1028;2021-10-20;129449
2021-10-19;"Prešovský kraj";830;4728;175;4903;NA;209569;1005;2021-10-19;128421
2021-10-18;"Prešovský kraj";454;5752;240;5992;NA;209569;694;2021-10-18;127416
2021-10-17;"Prešovský kraj";181;2430;131;2561;NA;209569;312;2021-10-17;126722
2021-10-16;"Prešovský kraj";561;1924;94;2018;NA;209569;655;2021-10-16;126410
2021-10-15;"Prešovský kraj";533;4735;107;4842;NA;209569;640;2021-10-15;125755
2021-10-14;"Prešovský kraj";506;3948;85;4033;NA;209569;591;2021-10-14;125115
2021-10-13;"Prešovský kraj";549;3794;98;3892;NA;209569;647;2021-10-13;124524
2021-10-12;"Prešovský kraj";520;3966;101;4067;NA;209569;621;2021-10-12;123877
2021-10-11;"Prešovský kraj";433;5421;131;5552;NA;209569;564;2021-10-11;123256
2021-10-10;"Prešovský kraj";78;2099;64;2163;NA;209569;142;2021-10-10;122692
2021-10-09;"Prešovský kraj";311;2077;47;2124;NA;209569;358;2021-10-09;122550
2021-10-08;"Prešovský kraj";636;4934;94;5028;NA;209569;730;2021-10-08;122192
2021-10-07;"Prešovský kraj";487;3919;101;4020;NA;209569;588;2021-10-07;121462
2021-10-06;"Prešovský kraj";296;3851;104;3955;NA;209569;400;2021-10-06;120874
2021-10-05;"Prešovský kraj";430;4151;90;4241;NA;209569;520;2021-10-05;120474
2021-10-04;"Prešovský kraj";353;5569;125;5694;NA;209569;478;2021-10-04;119954
2021-10-03;"Prešovský kraj";19;2324;47;2371;NA;209569;66;2021-10-03;119476
2021-10-02;"Prešovský kraj";269;2238;58;2296;NA;209569;327;2021-10-02;119410
2021-10-01;"Prešovský kraj";325;4997;63;5060;NA;209569;388;2021-10-01;119083
2021-09-30;"Prešovský kraj";265;4044;83;4127;NA;209569;348;2021-09-30;118695
2021-09-29;"Prešovský kraj";381;3825;55;3880;NA;209569;436;2021-09-29;118347
2021-09-28;"Prešovský kraj";312;4714;69;4783;NA;209569;381;2021-09-28;117911
2021-09-27;"Prešovský kraj";257;5062;104;5166;NA;209569;361;2021-09-27;117530
2021-09-26;"Prešovský kraj";8;2422;67;2489;NA;209569;75;2021-09-26;117169
2021-09-25;"Prešovský kraj";134;2540;46;2586;NA;209569;180;2021-09-25;117094
2021-09-24;"Prešovský kraj";297;4822;61;4883;NA;209569;358;2021-09-24;116914
2021-09-23;"Prešovský kraj";109;4105;45;4150;NA;209569;154;2021-09-23;116556
2021-09-22;"Prešovský kraj";177;3836;41;3877;NA;209569;218;2021-09-22;116402
2021-09-21;"Prešovský kraj";219;5059;66;5125;NA;209569;285;2021-09-21;116184
2021-09-20;"Prešovský kraj";180;5183;68;5251;NA;209569;248;2021-09-20;115899
2021-09-19;"Prešovský kraj";7;2726;30;2756;NA;209569;37;2021-09-19;115651
2021-09-18;"Prešovský kraj";169;2406;37;2443;NA;209569;206;2021-09-18;115614
2021-09-17;"Prešovský kraj";157;4402;52;4454;NA;209569;209;2021-09-17;115408
2021-09-16;"Prešovský kraj";146;4371;71;4442;NA;209569;217;2021-09-16;115199
2021-09-15;"Prešovský kraj";68;701;19;720;NA;209569;87;2021-09-15;114982
2021-09-14;"Prešovský kraj";133;3369;38;3407;NA;209569;171;2021-09-14;114895
2021-09-13;"Prešovský kraj";105;4225;37;4262;NA;209569;142;2021-09-13;114724
2021-09-12;"Prešovský kraj";4;1776;29;1805;NA;209569;33;2021-09-12;114582
2021-09-11;"Prešovský kraj";65;2012;24;2036;NA;209569;89;2021-09-11;114549
2021-09-10;"Prešovský kraj";105;3241;30;3271;NA;209569;135;2021-09-10;114460
2021-09-09;"Prešovský kraj";29;3090;27;3117;NA;209569;56;2021-09-09;114325
2021-09-08;"Prešovský kraj";73;2444;20;2464;NA;209569;93;2021-09-08;114269
2021-09-07;"Prešovský kraj";82;2449;24;2473;NA;209569;106;2021-09-07;114176
2021-09-06;"Prešovský kraj";61;3282;20;3302;NA;209569;81;2021-09-06;114070
2021-09-05;"Prešovský kraj";5;1338;11;1349;NA;209569;16;2021-09-05;113989
2021-09-04;"Prešovský kraj";27;1864;14;1878;NA;209569;41;2021-09-04;113973
2021-09-03;"Prešovský kraj";39;2976;15;2991;NA;209569;54;2021-09-03;113932
2021-09-02;"Prešovský kraj";39;2558;20;2578;NA;209569;59;2021-09-02;113878
2021-09-01;"Prešovský kraj";14;575;6;581;NA;209569;20;2021-09-01;113819
2021-08-31;"Prešovský kraj";47;2438;13;2451;NA;209569;60;2021-08-31;113799
2021-08-30;"Prešovský kraj";23;2827;19;2846;NA;209569;42;2021-08-30;113739
2021-08-29;"Prešovský kraj";3;781;1;782;NA;209569;4;2021-08-29;113697
2021-08-28;"Prešovský kraj";5;2101;8;2109;NA;209569;13;2021-08-28;113693
2021-08-27;"Prešovský kraj";32;3084;8;3092;NA;209569;40;2021-08-27;113680
2021-08-26;"Prešovský kraj";13;2094;8;2102;NA;209569;21;2021-08-26;113640
2021-08-25;"Prešovský kraj";18;1947;4;1951;NA;209569;22;2021-08-25;113619
2021-08-24;"Prešovský kraj";10;2138;5;2143;NA;209569;15;2021-08-24;113597
2021-08-23;"Prešovský kraj";16;2576;6;2582;NA;209569;22;2021-08-23;113582
2021-08-22;"Prešovský kraj";0;1440;6;1446;NA;209569;6;2021-08-22;113560
2021-08-21;"Prešovský kraj";28;2018;4;2022;NA;209569;32;2021-08-21;113554
2021-08-20;"Prešovský kraj";15;2906;7;2913;NA;209569;22;2021-08-20;113522
2021-08-19;"Prešovský kraj";22;2242;8;2250;NA;209569;30;2021-08-19;113500
2021-08-18;"Prešovský kraj";6;1752;11;1763;NA;209569;17;2021-08-18;113470
2021-08-17;"Prešovský kraj";29;1829;6;1835;NA;209569;35;2021-08-17;113453
2021-08-16;"Prešovský kraj";11;2524;7;2531;NA;209569;18;2021-08-16;113418
2021-08-15;"Prešovský kraj";0;896;2;898;NA;209569;2;2021-08-15;113400
2021-08-14;"Prešovský kraj";14;1662;1;1663;NA;209569;15;2021-08-14;113398
2021-08-13;"Prešovský kraj";24;1646;12;1658;NA;209569;36;2021-08-13;113383
2021-08-12;"Prešovský kraj";9;1752;3;1755;NA;209569;12;2021-08-12;113347
2021-08-11;"Prešovský kraj";15;1193;3;1196;NA;209569;18;2021-08-11;113335
2021-08-10;"Prešovský kraj";10;1102;4;1106;NA;209569;14;2021-08-10;113317
2021-08-09;"Prešovský kraj";13;2156;4;2160;NA;209569;17;2021-08-09;113303
2021-08-08;"Prešovský kraj";2;675;2;677;NA;209569;4;2021-08-08;113286
2021-08-07;"Prešovský kraj";5;1114;3;1117;NA;209569;8;2021-08-07;113282
2021-08-06;"Prešovský kraj";9;1459;4;1463;NA;209569;13;2021-08-06;113274
2021-08-05;"Prešovský kraj";9;1370;2;1372;NA;209569;11;2021-08-05;113261
2021-08-04;"Prešovský kraj";6;1007;1;1008;NA;209569;7;2021-08-04;113250
2021-08-03;"Prešovský kraj";8;976;1;977;NA;209569;9;2021-08-03;113243
2021-08-02;"Prešovský kraj";5;1477;6;1483;NA;209569;11;2021-08-02;113234
2021-08-01;"Prešovský kraj";0;738;2;740;NA;209569;2;2021-08-01;113223
2021-07-31;"Prešovský kraj";20;1080;0;1080;NA;209569;20;2021-07-31;113221
2021-07-30;"Prešovský kraj";2;1518;1;1519;NA;209569;3;2021-07-30;113201
2021-07-29;"Prešovský kraj";6;1302;1;1303;NA;209569;7;2021-07-29;113198
2021-07-28;"Prešovský kraj";6;1106;1;1107;NA;209569;7;2021-07-28;113191
2021-07-27;"Prešovský kraj";5;1140;2;1142;NA;209569;7;2021-07-27;113184
2021-07-26;"Prešovský kraj";12;1583;1;1584;NA;209569;13;2021-07-26;113177
2021-07-25;"Prešovský kraj";0;687;1;688;NA;209569;1;2021-07-25;113164
2021-07-24;"Prešovský kraj";8;1040;0;1040;NA;209569;8;2021-07-24;113163
2021-07-23;"Prešovský kraj";8;1608;1;1609;NA;209569;9;2021-07-23;113155
2021-07-22;"Prešovský kraj";13;1431;10;1441;NA;209569;23;2021-07-22;113146
2021-07-21;"Prešovský kraj";5;1076;1;1077;NA;209569;6;2021-07-21;113123
2021-07-20;"Prešovský kraj";4;1064;0;1064;NA;209569;4;2021-07-20;113117
2021-07-19;"Prešovský kraj";2;1644;4;1648;NA;209569;6;2021-07-19;113113
2021-07-18;"Prešovský kraj";1;647;0;647;NA;209569;1;2021-07-18;113107
2021-07-17;"Prešovský kraj";6;1245;1;1246;NA;209569;7;2021-07-17;113106
2021-07-16;"Prešovský kraj";4;1558;2;1560;NA;209569;6;2021-07-16;113099
2021-07-15;"Prešovský kraj";5;1310;4;1314;NA;209569;9;2021-07-15;113093
2021-07-14;"Prešovský kraj";1;1051;2;1053;NA;209569;3;2021-07-14;113084
2021-07-13;"Prešovský kraj";1;1071;2;1073;NA;209569;3;2021-07-13;113081
2021-07-12;"Prešovský kraj";1;1949;2;1951;NA;209569;3;2021-07-12;113078
2021-07-11;"Prešovský kraj";0;660;1;661;NA;209569;1;2021-07-11;113075
2021-07-10;"Prešovský kraj";4;1229;2;1231;NA;209569;6;2021-07-10;113074
2021-07-09;"Prešovský kraj";6;1957;1;1958;NA;209569;7;2021-07-09;113068
2021-07-08;"Prešovský kraj";5;1192;0;1192;NA;209569;5;2021-07-08;113061
2021-07-07;"Prešovský kraj";7;1468;3;1471;NA;209569;10;2021-07-07;113056
2021-07-06;"Prešovský kraj";5;1423;2;1425;NA;209569;7;2021-07-06;113046
2021-07-05;"Prešovský kraj";2;645;0;645;NA;209569;2;2021-07-05;113039
2021-07-04;"Prešovský kraj";0;788;0;788;NA;209569;0;2021-07-04;113037
2021-07-03;"Prešovský kraj";2;1391;0;1391;NA;209569;2;2021-07-03;113037
2021-07-02;"Prešovský kraj";4;1796;0;1796;NA;209569;4;2021-07-02;113035
2021-07-01;"Prešovský kraj";2;1590;1;1591;NA;209569;3;2021-07-01;113031
2021-06-30;"Prešovský kraj";3;8829;4;8833;NA;209569;7;2021-06-30;113028
2021-06-29;"Prešovský kraj";1;4935;3;4938;NA;209569;4;2021-06-29;113021
2021-06-28;"Prešovský kraj";5;6109;2;6111;NA;209569;7;2021-06-28;113017
2021-06-27;"Prešovský kraj";0;3852;1;3853;NA;209569;1;2021-06-27;113010
2021-06-26;"Prešovský kraj";4;5815;1;5816;NA;209569;5;2021-06-26;113009
2021-06-25;"Prešovský kraj";7;7321;4;7325;NA;209569;11;2021-06-25;113004
2021-06-24;"Prešovský kraj";10;5406;5;5411;NA;209569;15;2021-06-24;112993
2021-06-23;"Prešovský kraj";4;5124;2;5126;NA;209569;6;2021-06-23;112978
2021-06-22;"Prešovský kraj";5;5143;1;5144;NA;209569;6;2021-06-22;112972
2021-06-21;"Prešovský kraj";13;7033;6;7039;NA;209569;19;2021-06-21;112966
2021-06-20;"Prešovský kraj";0;5204;3;5207;NA;209569;3;2021-06-20;112947
2021-06-19;"Prešovský kraj";1;7349;5;7354;NA;209569;6;2021-06-19;112944
2021-06-18;"Prešovský kraj";9;8682;10;8692;NA;209569;19;2021-06-18;112938
2021-06-17;"Prešovský kraj";9;6548;5;6553;NA;209569;14;2021-06-17;112919
2021-06-16;"Prešovský kraj";6;6422;3;6425;NA;209569;9;2021-06-16;112905
2021-06-15;"Prešovský kraj";2;5709;4;5713;NA;209569;6;2021-06-15;112896
2021-06-14;"Prešovský kraj";5;8229;13;8242;NA;209569;18;2021-06-14;112890
2021-06-13;"Prešovský kraj";1;6455;7;6462;NA;209569;8;2021-06-13;112872
2021-06-12;"Prešovský kraj";3;8904;9;8913;NA;209569;12;2021-06-12;112864
2021-06-11;"Prešovský kraj";21;9877;9;9886;NA;209569;30;2021-06-11;112852
2021-06-10;"Prešovský kraj";11;6512;10;6522;NA;209569;21;2021-06-10;112822
2021-06-09;"Prešovský kraj";16;6375;3;6378;NA;209569;19;2021-06-09;112801
2021-06-08;"Prešovský kraj";31;6495;12;6507;NA;209569;43;2021-06-08;112782
2021-06-07;"Prešovský kraj";11;9111;15;9126;NA;209569;26;2021-06-07;112739
2021-06-06;"Prešovský kraj";0;8016;5;8021;NA;209569;5;2021-06-06;112713
2021-06-05;"Prešovský kraj";17;10248;15;10263;NA;209569;32;2021-06-05;112708
2021-06-04;"Prešovský kraj";26;10375;18;10393;NA;209569;44;2021-06-04;112676
2021-06-03;"Prešovský kraj";14;6820;16;6836;NA;209569;30;2021-06-03;112632
2021-06-02;"Prešovský kraj";47;7372;14;7386;NA;209569;61;2021-06-02;112602
2021-06-01;"Prešovský kraj";15;6926;14;6940;NA;209569;29;2021-06-01;112541
2021-05-31;"Prešovský kraj";27;9951;22;9973;NA;209569;49;2021-05-31;112512
2021-05-30;"Prešovský kraj";2;9717;14;9731;NA;209569;16;2021-05-30;112463
2021-05-29;"Prešovský kraj";23;12733;24;12757;NA;209569;47;2021-05-29;112447
2021-05-28;"Prešovský kraj";30;12468;19;12487;NA;209569;49;2021-05-28;112400
2021-05-27;"Prešovský kraj";16;7653;37;7690;NA;209569;53;2021-05-27;112351
2021-05-26;"Prešovský kraj";32;8140;23;8163;NA;209569;55;2021-05-26;112298
2021-05-25;"Prešovský kraj";38;8690;20;8710;NA;209569;58;2021-05-25;112243
2021-05-24;"Prešovský kraj";17;13298;37;13335;NA;209569;54;2021-05-24;112185
2021-05-23;"Prešovský kraj";3;11947;20;11967;NA;209569;23;2021-05-23;112131
2021-05-22;"Prešovský kraj";11;14422;44;14466;NA;209569;55;2021-05-22;112108
2021-05-21;"Prešovský kraj";44;13803;24;13827;NA;209569;68;2021-05-21;112053
2021-05-20;"Prešovský kraj";13;9437;29;9466;NA;209569;42;2021-05-20;111985
2021-05-19;"Prešovský kraj";60;10756;36;10792;NA;209569;96;2021-05-19;111943
2021-05-18;"Prešovský kraj";44;9062;27;9089;NA;209569;71;2021-05-18;111847
2021-05-17;"Prešovský kraj";60;12856;47;12903;NA;209569;107;2021-05-17;111776
2021-05-16;"Prešovský kraj";20;16302;66;16368;NA;209569;86;2021-05-16;111669
2021-05-15;"Prešovský kraj";20;24604;81;24685;NA;209569;101;2021-05-15;111583
2021-05-14;"Prešovský kraj";49;18671;68;18739;NA;209569;117;2021-05-14;111482
2021-05-13;"Prešovský kraj";54;11166;71;11237;NA;209569;125;2021-05-13;111365
2021-05-12;"Prešovský kraj";59;10822;39;10861;NA;209569;98;2021-05-12;111240
2021-05-11;"Prešovský kraj";61;10728;48;10776;NA;209569;109;2021-05-11;111142
2021-05-10;"Prešovský kraj";79;15726;67;15793;NA;209569;146;2021-05-10;111033
2021-05-09;"Prešovský kraj";54;21658;82;21740;NA;209569;136;2021-05-09;110887
2021-05-08;"Prešovský kraj";39;23050;52;23102;NA;209569;91;2021-05-08;110751
2021-05-07;"Prešovský kraj";81;23543;66;23609;NA;209569;147;2021-05-07;110660
2021-05-06;"Prešovský kraj";107;12924;66;12990;NA;209569;173;2021-05-06;110513
2021-05-05;"Prešovský kraj";60;12808;84;12892;NA;209569;144;2021-05-05;110340
2021-05-04;"Prešovský kraj";203;13470;67;13537;NA;209569;270;2021-05-04;110196
2021-05-03;"Prešovský kraj";68;18458;109;18567;NA;209569;177;2021-05-03;109926
2021-05-02;"Prešovský kraj";29;36676;102;36778;NA;209569;131;2021-05-02;109749
2021-05-01;"Prešovský kraj";70;57153;183;57336;NA;209569;253;2021-05-01;109618
2021-04-30;"Prešovský kraj";135;39333;118;39451;NA;209569;253;2021-04-30;109365
2021-04-29;"Prešovský kraj";110;16635;97;16732;NA;209569;207;2021-04-29;109112
2021-04-28;"Prešovský kraj";122;18671;89;18760;NA;209569;211;2021-04-28;108905
2021-04-27;"Prešovský kraj";154;19994;120;20114;NA;209569;274;2021-04-27;108694
2021-04-26;"Prešovský kraj";99;27241;123;27364;NA;209569;222;2021-04-26;108420
2021-04-25;"Prešovský kraj";9;52776;156;52932;NA;209569;165;2021-04-25;108198
2021-04-24;"Prešovský kraj";61;85698;243;85941;NA;209569;304;2021-04-24;108033
2021-04-23;"Prešovský kraj";171;40365;137;40502;NA;209569;308;2021-04-23;107729
2021-04-22;"Prešovský kraj";86;18104;125;18229;NA;209569;211;2021-04-22;107421
2021-04-21;"Prešovský kraj";144;21550;139;21689;NA;209569;283;2021-04-21;107210
2021-04-20;"Prešovský kraj";115;23346;128;23474;NA;209569;243;2021-04-20;106927
2021-04-19;"Prešovský kraj";106;29133;145;29278;NA;209569;251;2021-04-19;106684
2021-04-18;"Prešovský kraj";4;51824;129;51953;NA;209569;133;2021-04-18;106433
2021-04-17;"Prešovský kraj";119;97970;238;98208;NA;209569;357;2021-04-17;106300
2021-04-16;"Prešovský kraj";135;40989;146;41135;NA;209569;281;2021-04-16;105943
2021-04-15;"Prešovský kraj";112;20179;137;20316;NA;209569;249;2021-04-15;105662
2021-04-14;"Prešovský kraj";199;23332;130;23462;NA;209569;329;2021-04-14;105413
2021-04-13;"Prešovský kraj";180;23907;116;24023;NA;209569;296;2021-04-13;105084
2021-04-12;"Prešovský kraj";172;30152;175;30327;NA;209569;347;2021-04-12;104788
2021-04-11;"Prešovský kraj";11;49955;187;50142;NA;209569;198;2021-04-11;104441
2021-04-10;"Prešovský kraj";94;90181;297;90478;NA;209569;391;2021-04-10;104243
2021-04-09;"Prešovský kraj";255;37163;200;37363;NA;209569;455;2021-04-09;103852
2021-04-08;"Prešovský kraj";192;18893;157;19050;NA;209569;349;2021-04-08;103397
2021-04-07;"Prešovský kraj";314;27797;154;27951;NA;209569;468;2021-04-07;103048
2021-04-06;"Prešovský kraj";231;41711;268;41979;NA;209569;499;2021-04-06;102580
2021-04-05;"Prešovský kraj";54;18454;132;18586;NA;209569;186;2021-04-05;102081
2021-04-04;"Prešovský kraj";31;18569;91;18660;NA;209569;122;2021-04-04;101895
2021-04-03;"Prešovský kraj";104;90664;321;90985;NA;209569;425;2021-04-03;101773
2021-04-02;"Prešovský kraj";194;23381;134;23515;NA;209569;328;2021-04-02;101348
2021-04-01;"Prešovský kraj";256;42879;195;43074;NA;209569;451;2021-04-01;101020
2021-03-31;"Prešovský kraj";311;30176;227;30403;NA;209569;538;2021-03-31;100569
2021-03-30;"Prešovský kraj";374;20751;203;20954;NA;209569;577;2021-03-30;100031
2021-03-29;"Prešovský kraj";219;28188;229;28417;NA;209569;448;2021-03-29;99454
2021-03-28;"Prešovský kraj";26;46811;256;47067;NA;209569;282;2021-03-28;99006
2021-03-27;"Prešovský kraj";181;88673;372;89045;NA;209569;553;2021-03-27;98724
2021-03-26;"Prešovský kraj";310;47751;299;48050;NA;209569;609;2021-03-26;98171
2021-03-25;"Prešovský kraj";248;22281;213;22494;NA;209569;461;2021-03-25;97562
2021-03-24;"Prešovský kraj";381;19590;213;19803;NA;209569;594;2021-03-24;97101
2021-03-23;"Prešovský kraj";241;20351;255;20606;NA;209569;496;2021-03-23;96507
2021-03-22;"Prešovský kraj";299;28634;287;28921;NA;209569;586;2021-03-22;96011
2021-03-21;"Prešovský kraj";32;49439;266;49705;NA;209569;298;2021-03-21;95425
2021-03-20;"Prešovský kraj";180;92529;426;92955;NA;209569;606;2021-03-20;95127
2021-03-19;"Prešovský kraj";373;46582;326;46908;NA;209569;699;2021-03-19;94521
2021-03-18;"Prešovský kraj";251;21721;217;21938;NA;209569;468;2021-03-18;93822
2021-03-17;"Prešovský kraj";331;20887;231;21118;NA;209569;562;2021-03-17;93354
2021-03-16;"Prešovský kraj";461;21094;278;21372;NA;209569;739;2021-03-16;92792
2021-03-15;"Prešovský kraj";370;28813;324;29137;NA;209569;694;2021-03-15;92053
2021-03-14;"Prešovský kraj";52;50410;356;50766;NA;209569;408;2021-03-14;91359
2021-03-13;"Prešovský kraj";200;94768;531;95299;NA;209569;731;2021-03-13;90951
2021-03-12;"Prešovský kraj";425;47691;368;48059;NA;209569;793;2021-03-12;90220
2021-03-11;"Prešovský kraj";463;22059;253;22312;NA;209569;716;2021-03-11;89427
2021-03-10;"Prešovský kraj";325;20821;293;21114;NA;209569;618;2021-03-10;88711
2021-03-09;"Prešovský kraj";505;21496;288;21784;NA;209569;793;2021-03-09;88093
2021-03-08;"Prešovský kraj";314;28903;333;29236;NA;209569;647;2021-03-08;87300
2021-03-07;"Prešovský kraj";19;48328;388;48716;NA;209569;407;2021-03-07;86653
2021-03-06;"Prešovský kraj";193;97527;591;98118;NA;209569;784;2021-03-06;86246
2021-03-05;"Prešovský kraj";497;46054;397;46451;NA;209569;894;2021-03-05;85462
2021-03-04;"Prešovský kraj";372;22670;359;23029;NA;209569;731;2021-03-04;84568
2021-03-03;"Prešovský kraj";397;21623;333;21956;NA;209569;730;2021-03-03;83837
2021-03-02;"Prešovský kraj";421;22682;357;23039;NA;209569;778;2021-03-02;83107
2021-03-01;"Prešovský kraj";303;27716;406;28122;NA;209569;709;2021-03-01;82329
2021-02-28;"Prešovský kraj";75;45000;387;45387;NA;209569;462;2021-02-28;81620
2021-02-27;"Prešovský kraj";273;90231;734;90965;NA;209569;1007;2021-02-27;81158
2021-02-26;"Prešovský kraj";455;41340;438;41778;NA;209569;893;2021-02-26;80151
2021-02-25;"Prešovský kraj";270;19496;337;19833;NA;209569;607;2021-02-25;79258
2021-02-24;"Prešovský kraj";328;19026;377;19403;NA;209569;705;2021-02-24;78651
2021-02-23;"Prešovský kraj";430;21277;345;21622;NA;209569;775;2021-02-23;77946
2021-02-22;"Prešovský kraj";351;27180;356;27536;NA;209569;707;2021-02-22;77171
2021-02-21;"Prešovský kraj";66;31453;301;31754;NA;209569;367;2021-02-21;76464
2021-02-20;"Prešovský kraj";129;71413;517;71930;NA;209569;646;2021-02-20;76097
2021-02-19;"Prešovský kraj";381;38995;430;39425;NA;209569;811;2021-02-19;75451
2021-02-18;"Prešovský kraj";268;16960;322;17282;NA;209569;590;2021-02-18;74640
2021-02-17;"Prešovský kraj";293;17392;246;17638;NA;209569;539;2021-02-17;74050
2021-02-16;"Prešovský kraj";422;18862;265;19127;NA;209569;687;2021-02-16;73511
2021-02-15;"Prešovský kraj";211;31366;303;31669;NA;209569;514;2021-02-15;72824
2021-02-14;"Prešovský kraj";27;39387;321;39708;NA;209569;348;2021-02-14;72310
2021-02-13;"Prešovský kraj";157;74747;402;75149;NA;209569;559;2021-02-13;71962
2021-02-12;"Prešovský kraj";308;38758;365;39123;NA;209569;673;2021-02-12;71403
2021-02-11;"Prešovský kraj";218;16207;238;16445;NA;209569;456;2021-02-11;70730
2021-02-10;"Prešovský kraj";220;18542;282;18824;NA;209569;502;2021-02-10;70274
2021-02-09;"Prešovský kraj";323;21497;370;21867;NA;209569;693;2021-02-09;69772
2021-02-08;"Prešovský kraj";161;36924;261;37185;NA;209569;422;2021-02-08;69079
2021-02-07;"Prešovský kraj";21;34227;209;34436;NA;209569;230;2021-02-07;68657
2021-02-06;"Prešovský kraj";176;69164;360;69524;NA;209569;536;2021-02-06;68427
2021-02-05;"Prešovský kraj";177;31271;262;31533;NA;209569;439;2021-02-05;67891
2021-02-04;"Prešovský kraj";176;13080;237;13317;NA;209569;413;2021-02-04;67452
2021-02-03;"Prešovský kraj";251;8421;236;8657;NA;209569;487;2021-02-03;67039
2021-02-02;"Prešovský kraj";249;11769;264;12033;NA;209569;513;2021-02-02;66552
2021-02-01;"Prešovský kraj";220;16059;316;16375;NA;209569;536;2021-02-01;66039
2021-01-31;"Prešovský kraj";42;10587;107;10694;NA;209569;149;2021-01-31;65503
2021-01-30;"Prešovský kraj";142;23939;215;24154;NA;209569;357;2021-01-30;65354
2021-01-29;"Prešovský kraj";185;17924;326;18250;NA;209569;511;2021-01-29;64997
2021-01-28;"Prešovský kraj";311;7348;150;7498;NA;209569;461;2021-01-28;64486
2021-01-27;"Prešovský kraj";153;9730;147;9877;NA;209569;300;2021-01-27;64025
2021-01-26;"Prešovský kraj";252;16653;151;16804;NA;209569;403;2021-01-26;63725
2021-01-25;"Prešovský kraj";196;30092;253;30345;NA;209569;449;2021-01-25;63322
2021-01-24;"Prešovský kraj";12;45706;304;46010;NA;209569;316;2021-01-24;62873
2021-01-23;"Prešovský kraj";189;96883;487;97370;NA;209569;676;2021-01-23;62557
2021-01-22;"Prešovský kraj";187;35383;261;35644;NA;209569;448;2021-01-22;61881
2021-01-21;"Prešovský kraj";187;20434;212;20646;NA;209569;399;2021-01-21;61433
2021-01-20;"Prešovský kraj";253;14782;195;14977;NA;209569;448;2021-01-20;61034
2021-01-19;"Prešovský kraj";281;12329;305;12634;NA;209569;586;2021-01-19;60586
2021-01-18;"Prešovský kraj";203;10422;336;10758;NA;209569;539;2021-01-18;60000
2021-01-17;"Prešovský kraj";107;14391;1008;15399;NA;209569;1115;2021-01-17;59461
2021-01-16;"Prešovský kraj";72;1838;81;1919;NA;209569;153;2021-01-16;58346
2021-01-15;"Prešovský kraj";159;7033;257;7290;NA;209569;416;2021-01-15;58193
2021-01-14;"Prešovský kraj";268;5534;256;5790;NA;209569;524;2021-01-14;57777
2021-01-13;"Prešovský kraj";342;5649;226;5875;NA;209569;568;2021-01-13;57253
2021-01-12;"Prešovský kraj";455;8251;386;8637;NA;209569;841;2021-01-12;56685
2021-01-11;"Prešovský kraj";343;8149;471;8620;NA;209569;814;2021-01-11;55844
2021-01-10;"Prešovský kraj";63;476;23;499;NA;209569;86;2021-01-10;55030
2021-01-09;"Prešovský kraj";439;2248;125;2373;NA;209569;564;2021-01-09;54944
2021-01-08;"Prešovský kraj";430;10416;561;10977;NA;209569;991;2021-01-08;54380
2021-01-07;"Prešovský kraj";268;7432;622;8054;NA;209569;890;2021-01-07;53389
2021-01-06;"Prešovský kraj";315;1484;134;1618;NA;209569;449;2021-01-06;52499
2021-01-05;"Prešovský kraj";655;11275;976;12251;NA;209569;1631;2021-01-05;52050
2021-01-04;"Prešovský kraj";371;16845;1789;18634;NA;209569;2160;2021-01-04;50419
2021-01-03;"Prešovský kraj";89;459;41;500;NA;209569;130;2021-01-03;48259
2021-01-02;"Prešovský kraj";65;1556;160;1716;NA;209569;225;2021-01-02;48129
2021-01-01;"Prešovský kraj";174;956;71;1027;NA;209569;245;2021-01-01;47904
2020-12-31;"Prešovský kraj";640;11959;783;12742;NA;209569;1423;2020-12-31;47659
2020-12-30;"Prešovský kraj";729;8729;769;9498;NA;209569;1498;2020-12-30;46236
2020-12-29;"Prešovský kraj";435;9273;949;10222;NA;209569;1384;2020-12-29;44738
2020-12-28;"Prešovský kraj";393;9046;1079;10125;NA;209569;1472;2020-12-28;43354
2020-12-27;"Prešovský kraj";40;613;45;658;NA;209569;85;2020-12-27;41882
2020-12-26;"Prešovský kraj";64;176;12;188;NA;209569;76;2020-12-26;41797
2020-12-25;"Prešovský kraj";208;274;11;285;NA;209569;219;2020-12-25;41721
2020-12-24;"Prešovský kraj";452;1214;85;1299;NA;209569;537;2020-12-24;41502
2020-12-23;"Prešovský kraj";361;11006;618;11624;NA;209569;979;2020-12-23;40965
2020-12-22;"Prešovský kraj";439;9023;695;9718;NA;209569;1134;2020-12-22;39986
2020-12-21;"Prešovský kraj";432;9577;847;10424;NA;209569;1279;2020-12-21;38852
2020-12-20;"Prešovský kraj";184;396;20;416;NA;209569;204;2020-12-20;37573
2020-12-19;"Prešovský kraj";276;1658;151;1809;NA;209569;427;2020-12-19;37369
2020-12-18;"Prešovský kraj";396;8246;566;8812;NA;209569;962;2020-12-18;36942
2020-12-17;"Prešovský kraj";427;10505;866;11371;NA;209569;1293;2020-12-17;35980
2020-12-16;"Prešovský kraj";466;5613;473;6086;NA;209569;939;2020-12-16;34687
2020-12-15;"Prešovský kraj";411;5406;574;5980;NA;209569;985;2020-12-15;33748
2020-12-14;"Prešovský kraj";334;5538;477;6015;NA;209569;811;2020-12-14;32763
2020-12-13;"Prešovský kraj";89;29;8;37;NA;209569;97;2020-12-13;31952
2020-12-12;"Prešovský kraj";319;2474;166;2640;NA;209569;485;2020-12-12;31855
2020-12-11;"Prešovský kraj";560;5602;402;6004;NA;209569;962;2020-12-11;31370
2020-12-10;"Prešovský kraj";337;5019;423;5442;NA;209569;760;2020-12-10;30408
2020-12-09;"Prešovský kraj";358;4357;314;4671;NA;209569;672;2020-12-09;29648
2020-12-08;"Prešovský kraj";350;6629;651;7280;NA;209569;1001;2020-12-08;28976
2020-12-07;"Prešovský kraj";309;4345;327;4672;NA;209569;636;2020-12-07;27975
2020-12-06;"Prešovský kraj";59;655;26;681;NA;209569;85;2020-12-06;27339
2020-12-05;"Prešovský kraj";218;984;87;1071;NA;209569;305;2020-12-05;27254
2020-12-04;"Prešovský kraj";352;5070;293;5363;NA;209569;645;2020-12-04;26949
2020-12-03;"Prešovský kraj";284;2456;179;2635;NA;209569;463;2020-12-03;26304
2020-12-02;"Prešovský kraj";232;2830;225;3055;NA;209569;457;2020-12-02;25841
2020-12-01;"Prešovský kraj";281;1884;196;2080;NA;209569;477;2020-12-01;25384
2020-11-30;"Prešovský kraj";196;5333;97;5430;NA;209569;293;2020-11-30;24907
2020-11-29;"Prešovský kraj";27;379;42;421;NA;209569;69;2020-11-29;24614
2020-11-28;"Prešovský kraj";199;772;77;849;NA;209569;276;2020-11-28;24545
2020-11-27;"Prešovský kraj";232;2350;130;2480;NA;209569;362;2020-11-27;24269
2020-11-26;"Prešovský kraj";263;3014;329;3343;NA;209569;592;2020-11-26;23907
2020-11-25;"Prešovský kraj";302;2174;103;2277;NA;209569;405;2020-11-25;23315
2020-11-24;"Prešovský kraj";365;1777;156;1933;NA;209569;521;2020-11-24;22910
2020-11-23;"Prešovský kraj";164;1099;60;1159;NA;209569;224;2020-11-23;22389
2020-11-22;"Prešovský kraj";46;44;1;45;NA;209569;47;2020-11-22;22165
2020-11-21;"Prešovský kraj";205;754;62;816;NA;209569;267;2020-11-21;22118
2020-11-20;"Prešovský kraj";363;2258;102;2360;NA;209569;465;2020-11-20;21851
2020-11-19;"Prešovský kraj";359;2096;238;2334;NA;209569;597;2020-11-19;21386
2020-11-18;"Prešovský kraj";270;488;43;531;NA;209569;313;2020-11-18;20789
2020-11-17;"Prešovský kraj";347;205;23;228;NA;209569;370;2020-11-17;20476
2020-11-16;"Prešovský kraj";226;540;58;598;NA;209569;284;2020-11-16;20106
2020-11-15;"Prešovský kraj";186;39;4;43;NA;209569;190;2020-11-15;19822
2020-11-14;"Prešovský kraj";261;54;4;58;NA;209569;265;2020-11-14;19632
2020-11-13;"Prešovský kraj";395;166;8;174;NA;209569;403;2020-11-13;19367
2020-11-12;"Prešovský kraj";397;229;50;279;NA;209569;447;2020-11-12;18964
2020-11-11;"Prešovský kraj";516;161;15;176;NA;209569;531;2020-11-11;18517
2020-11-10;"Prešovský kraj";437;197;9;206;NA;209569;446;2020-11-10;17986
2020-11-09;"Prešovský kraj";190;4110;945;5055;NA;209569;1135;2020-11-09;17540
2020-11-08;"Prešovský kraj";97;2817;32;2849;NA;209569;129;2020-11-08;16405
2020-11-07;"Prešovský kraj";416;8578;81;8659;NA;209569;497;2020-11-07;16276
2020-11-06;"Prešovský kraj";520;4791;76;4867;NA;209569;596;2020-11-06;15779
2020-11-05;"Prešovský kraj";397;180;5;185;NA;209569;402;2020-11-05;15183
2020-11-04;"Prešovský kraj";350;807;8;815;NA;209569;358;2020-11-04;14781
2020-11-03;"Prešovský kraj";565;98;12;110;NA;209569;577;2020-11-03;14423
2020-11-02;"Prešovský kraj";203;4158;1004;5162;NA;209569;1207;2020-11-02;13846
2020-11-01;"Prešovský kraj";386;2906;53;2959;NA;209569;439;2020-11-01;12639
2020-10-31;"Prešovský kraj";315;10497;170;10667;NA;209569;485;2020-10-31;12200
2020-10-30;"Prešovský kraj";552;2949;65;3014;NA;209569;617;2020-10-30;11715
2020-10-29;"Prešovský kraj";594;301;38;339;NA;209569;632;2020-10-29;11098
2020-10-28;"Prešovský kraj";617;291;46;337;NA;209569;663;2020-10-28;10466
2020-10-27;"Prešovský kraj";656;268;34;302;NA;209569;690;2020-10-27;9803
2020-10-26;"Prešovský kraj";137;363;57;420;NA;209569;194;2020-10-26;9113
2020-10-25;"Prešovský kraj";237;346;11;357;NA;209569;248;2020-10-25;8919
2020-10-24;"Prešovský kraj";719;200;12;212;NA;209569;731;2020-10-24;8671
2020-10-23;"Prešovský kraj";750;218;8;226;NA;209569;758;2020-10-23;7940
2020-10-22;"Prešovský kraj";646;396;30;426;NA;209569;676;2020-10-22;7182
2020-10-21;"Prešovský kraj";383;58;8;66;NA;209569;391;2020-10-21;6506
2020-10-20;"Prešovský kraj";493;65;7;72;NA;209569;500;2020-10-20;6115
2020-10-19;"Prešovský kraj";140;235;15;250;NA;209569;155;2020-10-19;5615
2020-10-18;"Prešovský kraj";209;0;0;0;NA;209569;209;2020-10-18;5460
2020-10-17;"Prešovský kraj";342;0;0;0;NA;209569;342;2020-10-17;5251
2020-10-16;"Prešovský kraj";388;57;3;60;NA;209569;391;2020-10-16;4909
2020-10-15;"Prešovský kraj";435;85;18;103;NA;209569;453;2020-10-15;4518
2020-10-14;"Prešovský kraj";451;54;10;64;NA;209569;461;2020-10-14;4065
2020-10-13;"Prešovský kraj";264;50;6;56;NA;209569;270;2020-10-13;3604
2020-10-12;"Prešovský kraj";214;334;35;369;NA;209569;249;2020-10-12;3334
2020-10-11;"Prešovský kraj";127;0;0;0;NA;209569;127;2020-10-11;3085
2020-10-10;"Prešovský kraj";248;0;0;0;NA;209569;248;2020-10-10;2958
2020-10-09;"Prešovský kraj";406;0;0;0;NA;209569;406;2020-10-09;2710
2020-10-08;"Prešovský kraj";245;0;0;0;NA;209569;245;2020-10-08;2304
2020-10-07;"Prešovský kraj";244;0;0;0;NA;209569;244;2020-10-07;2059
2020-10-06;"Prešovský kraj";166;0;0;0;NA;209569;166;2020-10-06;1815
2020-10-05;"Prešovský kraj";84;0;0;0;NA;209569;84;2020-10-05;1649
2020-10-04;"Prešovský kraj";118;0;0;0;NA;209569;118;2020-10-04;1565
2020-10-03;"Prešovský kraj";204;0;0;0;NA;209569;204;2020-10-03;1447
2020-10-02;"Prešovský kraj";149;0;0;0;NA;209569;149;2020-10-02;1243
2020-10-01;"Prešovský kraj";136;0;0;0;NA;209569;136;2020-10-01;1094
2020-09-30;"Prešovský kraj";121;0;0;0;NA;209569;121;2020-09-30;958
2020-09-29;"Prešovský kraj";156;0;0;0;NA;209569;156;2020-09-29;837
2020-09-28;"Prešovský kraj";51;0;0;0;NA;209569;51;2020-09-28;681
2020-09-27;"Prešovský kraj";10;0;0;0;NA;209569;10;2020-09-27;630
2020-09-26;"Prešovský kraj";72;0;0;0;NA;209569;72;2020-09-26;620
2020-09-25;"Prešovský kraj";91;0;0;0;NA;209569;91;2020-09-25;548
2020-09-24;"Prešovský kraj";52;0;0;0;NA;209569;52;2020-09-24;457
2020-09-23;"Prešovský kraj";55;0;0;0;NA;209569;55;2020-09-23;405
2020-09-22;"Prešovský kraj";29;0;0;0;NA;209569;29;2020-09-22;350
2020-09-21;"Prešovský kraj";14;0;0;0;NA;209569;14;2020-09-21;321
2020-09-20;"Prešovský kraj";5;0;0;0;NA;209569;5;2020-09-20;307
2020-09-19;"Prešovský kraj";12;0;0;0;NA;209569;12;2020-09-19;302
2020-09-18;"Prešovský kraj";29;0;0;0;NA;209569;29;2020-09-18;290
2020-09-17;"Prešovský kraj";25;0;0;0;NA;209569;25;2020-09-17;261
2020-09-16;"Prešovský kraj";8;0;0;0;NA;209569;8;2020-09-16;236
2020-09-15;"Prešovský kraj";10;0;0;0;NA;209569;10;2020-09-15;228
2020-09-14;"Prešovský kraj";47;0;0;0;NA;209569;47;2020-09-14;218
2020-09-13;"Prešovský kraj";3;0;0;0;NA;209569;3;2020-09-13;171
2020-09-12;"Prešovský kraj";4;0;0;0;NA;209569;4;2020-09-12;168
2020-09-11;"Prešovský kraj";15;0;0;0;NA;209569;15;2020-09-11;164
2020-09-10;"Prešovský kraj";10;0;0;0;NA;209569;10;2020-09-10;149
2020-09-09;"Prešovský kraj";21;0;0;0;NA;209569;21;2020-09-09;139
2020-09-08;"Prešovský kraj";23;0;0;0;NA;209569;23;2020-09-08;118
2020-09-07;"Prešovský kraj";5;0;0;0;NA;209569;5;2020-09-07;95
2020-09-06;"Prešovský kraj";3;0;0;0;NA;209569;3;2020-09-06;90
2020-09-05;"Prešovský kraj";7;0;0;0;NA;209569;7;2020-09-05;87
2020-09-04;"Prešovský kraj";24;0;0;0;NA;209569;24;2020-09-04;80
2020-09-03;"Prešovský kraj";8;0;0;0;NA;209569;8;2020-09-03;56
2020-09-02;"Prešovský kraj";9;0;0;0;NA;209569;9;2020-09-02;48
2020-09-01;"Prešovský kraj";6;0;0;0;NA;209569;6;2020-09-01;39
2020-08-31;"Prešovský kraj";3;0;0;0;NA;209569;3;2020-08-31;33
2020-08-30;"Prešovský kraj";6;0;0;0;NA;209569;6;2020-08-30;30
2020-08-29;"Prešovský kraj";4;0;0;0;NA;209569;4;2020-08-29;24
2020-08-28;"Prešovský kraj";6;0;0;0;NA;209569;6;2020-08-28;20
2020-08-27;"Prešovský kraj";7;0;0;0;NA;209569;7;2020-08-27;14
2020-08-26;"Prešovský kraj";22;0;0;0;NA;209569;22;2020-08-26;7
2020-08-25;"Prešovský kraj";1;0;0;0;NA;209569;1;2020-08-25;-15
2020-08-24;"Prešovský kraj";5;0;0;0;NA;209569;5;2020-08-24;-16
2020-08-23;"Prešovský kraj";3;0;0;0;NA;209569;3;2020-08-23;-21
2020-08-22;"Prešovský kraj";3;0;0;0;NA;209569;3;2020-08-22;-24
2020-08-21;"Prešovský kraj";11;0;0;0;NA;209569;11;2020-08-21;-27
2020-08-20;"Prešovský kraj";8;0;0;0;NA;209569;8;2020-08-20;-38
2020-08-19;"Prešovský kraj";8;0;0;0;NA;209569;8;2020-08-19;-46
2020-08-18;"Prešovský kraj";6;0;0;0;NA;209569;6;2020-08-18;-54
2020-08-17;"Prešovský kraj";1;0;0;0;NA;209569;1;2020-08-17;-60
2020-08-16;"Prešovský kraj";0;0;0;0;NA;209569;0;2020-08-16;-61
2020-08-15;"Prešovský kraj";8;0;0;0;NA;209569;8;2020-08-15;-61
2020-08-14;"Prešovský kraj";6;0;0;0;NA;209569;6;2020-08-14;-69
2020-08-13;"Prešovský kraj";8;0;0;0;NA;209569;8;2020-08-13;-75
2020-08-12;"Prešovský kraj";19;0;0;0;NA;209569;19;2020-08-12;-83
2020-08-11;"Prešovský kraj";3;0;0;0;NA;209569;3;2020-08-11;-102
2020-08-10;"Prešovský kraj";0;0;0;0;NA;209569;0;2020-08-10;-105
2020-08-09;"Prešovský kraj";0;0;0;0;NA;209569;0;2020-08-09;-105
2020-08-08;"Prešovský kraj";2;0;0;0;NA;209569;2;2020-08-08;-105
2020-08-07;"Prešovský kraj";6;0;0;0;NA;209569;6;2020-08-07;-107
2020-08-06;"Prešovský kraj";2;0;0;0;NA;209569;2;2020-08-06;-113
2020-08-05;"Prešovský kraj";8;0;0;0;NA;209569;8;2020-08-05;-115
2020-08-04;"Prešovský kraj";5;0;0;0;NA;209569;5;2020-08-04;-123
2020-08-03;"Prešovský kraj";4;0;0;0;NA;209569;4;2020-08-03;-128
2020-08-02;"Prešovský kraj";6;0;0;0;NA;209569;6;2020-08-02;-132
2020-08-01;"Prešovský kraj";0;0;0;0;NA;209569;0;2020-08-01;-138
2020-07-31;"Prešovský kraj";2;0;0;0;NA;209569;2;2020-07-31;-138
2020-07-30;"Prešovský kraj";6;0;0;0;NA;209569;6;2020-07-30;-140
2020-07-29;"Prešovský kraj";5;0;0;0;NA;209569;5;2020-07-29;-146
2020-07-28;"Prešovský kraj";0;0;0;0;NA;209569;0;2020-07-28;-151
2020-07-27;"Prešovský kraj";1;0;0;0;NA;209569;1;2020-07-27;-151
2020-07-26;"Prešovský kraj";1;0;0;0;NA;209569;1;2020-07-26;-152
2020-07-25;"Prešovský kraj";21;0;0;0;NA;209569;21;2020-07-25;-153
2020-07-24;"Prešovský kraj";1;0;0;0;NA;209569;1;2020-07-24;-174
2020-07-23;"Prešovský kraj";5;0;0;0;NA;209569;5;2020-07-23;-175
2020-07-22;"Prešovský kraj";1;0;0;0;NA;209569;1;2020-07-22;-180
2020-07-21;"Prešovský kraj";2;0;0;0;NA;209569;2;2020-07-21;-181
2020-07-20;"Prešovský kraj";1;0;0;0;NA;209569;1;2020-07-20;-183
2020-07-19;"Prešovský kraj";0;0;0;0;NA;209569;0;2020-07-19;-184
2020-07-18;"Prešovský kraj";0;0;0;0;NA;209569;0;2020-07-18;-184
2020-07-17;"Prešovský kraj";3;0;0;0;NA;209569;3;2020-07-17;-184
2020-07-16;"Prešovský kraj";1;0;0;0;NA;209569;1;2020-07-16;-187
2020-07-15;"Prešovský kraj";5;0;0;0;NA;209569;5;2020-07-15;-188
2020-07-14;"Prešovský kraj";5;0;0;0;NA;209569;5;2020-07-14;-193
2020-07-13;"Prešovský kraj";1;0;0;0;NA;209569;1;2020-07-13;-198
2020-07-12;"Prešovský kraj";1;0;0;0;NA;209569;1;2020-07-12;-199
2020-07-11;"Prešovský kraj";6;0;0;0;NA;209569;6;2020-07-11;-200
2020-07-10;"Prešovský kraj";5;0;0;0;NA;209569;5;2020-07-10;-206
2020-07-09;"Prešovský kraj";2;0;0;0;NA;209569;2;2020-07-09;-211
2020-07-08;"Prešovský kraj";14;0;0;0;NA;209569;14;2020-07-08;-213
2020-07-07;"Prešovský kraj";2;0;0;0;NA;209569;2;2020-07-07;-227
2020-07-06;"Prešovský kraj";0;0;0;0;NA;209569;0;2020-07-06;-229
2020-07-05;"Prešovský kraj";0;0;0;0;NA;209569;0;2020-07-05;-229
2020-07-04;"Prešovský kraj";1;0;0;0;NA;209569;1;2020-07-04;-229
2020-07-03;"Prešovský kraj";3;0;0;0;NA;209569;3;2020-07-03;-230
2020-07-02;"Prešovský kraj";0;0;0;0;NA;209569;0;2020-07-02;-233
2020-07-01;"Prešovský kraj";0;0;0;0;NA;209569;0;2020-07-01;-233
2020-06-30;"Prešovský kraj";7;0;0;0;NA;209569;7;2020-06-30;-233
2020-06-29;"Prešovský kraj";0;0;0;0;NA;209569;0;2020-06-29;-240
2020-06-28;"Prešovský kraj";0;0;0;0;NA;209569;0;2020-06-28;-240
2020-06-27;"Prešovský kraj";3;0;0;0;NA;209569;3;2020-06-27;-240
2020-06-26;"Prešovský kraj";3;0;0;0;NA;209569;3;2020-06-26;-243
2020-06-25;"Prešovský kraj";0;0;0;0;NA;209569;0;2020-06-25;-246
2020-06-24;"Prešovský kraj";4;0;0;0;NA;209569;4;2020-06-24;-246
2020-06-23;"Prešovský kraj";0;0;0;0;NA;209569;0;2020-06-23;-250
2020-06-22;"Prešovský kraj";0;0;0;0;NA;209569;0;2020-06-22;-250
2020-06-21;"Prešovský kraj";0;0;0;0;NA;209569;0;2020-06-21;-250
2020-06-20;"Prešovský kraj";0;0;0;0;NA;209569;0;2020-06-20;-250
2020-06-19;"Prešovský kraj";1;0;0;0;NA;209569;1;2020-06-19;-250
2020-06-18;"Prešovský kraj";0;0;0;0;NA;209569;0;2020-06-18;-251
2020-06-17;"Prešovský kraj";0;0;0;0;NA;209569;0;2020-06-17;-251
2020-06-16;"Prešovský kraj";6;0;0;0;NA;209569;6;2020-06-16;-251
2020-06-14;"Prešovský kraj";0;0;0;0;NA;209569;0;2020-06-14;-257
2020-06-13;"Prešovský kraj";0;0;0;0;NA;209569;0;2020-06-13;-257
2020-06-12;"Prešovský kraj";1;0;0;0;NA;209569;1;2020-06-12;-257
2020-06-11;"Prešovský kraj";0;0;0;0;NA;209569;0;2020-06-11;-258
2020-06-10;"Prešovský kraj";0;0;0;0;NA;209569;0;2020-06-10;-258
2020-06-09;"Prešovský kraj";0;0;0;0;NA;209569;0;2020-06-09;-258
2020-06-08;"Prešovský kraj";0;0;0;0;NA;209569;0;2020-06-08;-258
2020-06-07;"Prešovský kraj";0;0;0;0;NA;209569;0;2020-06-07;-258
2020-06-05;"Prešovský kraj";0;0;0;0;NA;209569;0;2020-06-05;-258
2020-06-03;"Prešovský kraj";0;0;0;0;NA;209569;0;2020-06-03;-258
2020-06-02;"Prešovský kraj";1;0;0;0;NA;209569;1;2020-06-02;-258
2020-05-31;"Prešovský kraj";1;0;0;0;NA;209569;1;2020-05-31;-259
2020-05-29;"Prešovský kraj";0;0;0;0;NA;209569;0;2020-05-29;-260
2020-05-27;"Prešovský kraj";0;0;0;0;NA;209569;0;2020-05-27;-260
2020-05-26;"Prešovský kraj";0;0;0;0;NA;209569;0;2020-05-26;-260
2020-05-25;"Prešovský kraj";0;0;0;0;NA;209569;0;2020-05-25;-260
2020-05-24;"Prešovský kraj";0;0;0;0;NA;209569;0;2020-05-24;-260
2020-05-23;"Prešovský kraj";0;0;0;0;NA;209569;0;2020-05-23;-260
2020-05-22;"Prešovský kraj";0;0;0;0;NA;209569;0;2020-05-22;-260
2020-05-21;"Prešovský kraj";1;0;0;0;NA;209569;1;2020-05-21;-260
2020-05-20;"Prešovský kraj";0;0;0;0;NA;209569;0;2020-05-20;-261
2020-05-19;"Prešovský kraj";0;0;0;0;NA;209569;0;2020-05-19;-261
2020-05-17;"Prešovský kraj";0;0;0;0;NA;209569;0;2020-05-17;-261
2020-05-16;"Prešovský kraj";0;0;0;0;NA;209569;0;2020-05-16;-261
2020-05-15;"Prešovský kraj";0;0;0;0;NA;209569;0;2020-05-15;-261
2020-05-14;"Prešovský kraj";0;0;0;0;NA;209569;0;2020-05-14;-261
2020-05-13;"Prešovský kraj";1;0;0;0;NA;209569;1;2020-05-13;-261
2020-05-12;"Prešovský kraj";0;0;0;0;NA;209569;0;2020-05-12;-262
2020-05-11;"Prešovský kraj";1;0;0;0;NA;209569;1;2020-05-11;-262
2020-05-09;"Prešovský kraj";0;0;0;0;NA;209569;0;2020-05-09;-263
2020-05-07;"Prešovský kraj";0;0;0;0;NA;209569;0;2020-05-07;-263
2020-05-06;"Prešovský kraj";0;0;0;0;NA;209569;0;2020-05-06;-263
2020-05-05;"Prešovský kraj";1;0;0;0;NA;209569;1;2020-05-05;-263
2020-05-04;"Prešovský kraj";0;0;0;0;NA;209569;0;2020-05-04;-264
2020-05-03;"Prešovský kraj";0;0;0;0;NA;209569;0;2020-05-03;-264
2020-05-02;"Prešovský kraj";0;0;0;0;NA;209569;0;2020-05-02;-264
2020-05-01;"Prešovský kraj";2;0;0;0;NA;209569;2;2020-05-01;-264
2020-04-30;"Prešovský kraj";0;0;0;0;NA;209569;0;2020-04-30;-266
2020-04-29;"Prešovský kraj";1;0;0;0;NA;209569;1;2020-04-29;-266
2020-04-28;"Prešovský kraj";1;0;0;0;NA;209569;1;2020-04-28;-267
2020-04-27;"Prešovský kraj";2;0;0;0;NA;209569;2;2020-04-27;-268
2020-04-26;"Prešovský kraj";0;0;0;0;NA;209569;0;2020-04-26;-270
2020-04-25;"Prešovský kraj";0;0;0;0;NA;209569;0;2020-04-25;-270
2020-04-24;"Prešovský kraj";0;0;0;0;NA;209569;0;2020-04-24;-270
2020-04-23;"Prešovský kraj";2;0;0;0;NA;209569;2;2020-04-23;-270
2020-04-22;"Prešovský kraj";11;0;0;0;NA;209569;11;2020-04-22;-272
2020-04-21;"Prešovský kraj";12;0;0;0;NA;209569;12;2020-04-21;-283
2020-04-20;"Prešovský kraj";2;0;0;0;NA;209569;2;2020-04-20;-295
2020-04-19;"Prešovský kraj";4;0;0;0;NA;209569;4;2020-04-19;-297
2020-04-18;"Prešovský kraj";1;0;0;0;NA;209569;1;2020-04-18;-301
2020-04-17;"Prešovský kraj";4;0;0;0;NA;209569;4;2020-04-17;-302
2020-04-16;"Prešovský kraj";9;0;0;0;NA;209569;9;2020-04-16;-306
2020-04-15;"Prešovský kraj";21;0;0;0;NA;209569;21;2020-04-15;-315
2020-04-14;"Prešovský kraj";1;0;0;0;NA;209569;1;2020-04-14;-336
2020-04-13;"Prešovský kraj";2;0;0;0;NA;209569;2;2020-04-13;-337
2020-04-12;"Prešovský kraj";6;0;0;0;NA;209569;6;2020-04-12;-339
2020-04-11;"Prešovský kraj";4;0;0;0;NA;209569;4;2020-04-11;-345
2020-04-10;"Prešovský kraj";0;0;0;0;NA;209569;0;2020-04-10;-349
2020-04-09;"Prešovský kraj";1;0;0;0;NA;209569;1;2020-04-09;-349
2020-04-08;"Prešovský kraj";0;0;0;0;NA;209569;0;2020-04-08;-350
2020-04-07;"Prešovský kraj";7;0;0;0;NA;209569;7;2020-04-07;-350
2020-04-06;"Prešovský kraj";10;0;0;0;NA;209569;10;2020-04-06;-357
2020-04-05;"Prešovský kraj";13;0;0;0;NA;209569;13;2020-04-05;-367
2020-04-04;"Prešovský kraj";1;0;0;0;NA;209569;1;2020-04-04;-380
2020-04-03;"Prešovský kraj";4;0;0;0;NA;209569;4;2020-04-03;-381
2020-04-02;"Prešovský kraj";6;0;0;0;NA;209569;6;2020-04-02;-385
2020-04-01;"Prešovský kraj";6;0;0;0;NA;209569;6;2020-04-01;-391
2020-03-31;"Prešovský kraj";6;0;0;0;NA;209569;6;2020-03-31;-397
2020-03-30;"Prešovský kraj";2;0;0;0;NA;209569;2;2020-03-30;-403
2020-03-29;"Prešovský kraj";2;0;0;0;NA;209569;2;2020-03-29;-405
2020-03-28;"Prešovský kraj";2;0;0;0;NA;209569;2;2020-03-28;-407
2020-03-27;"Prešovský kraj";1;0;0;0;NA;209569;1;2020-03-27;-409
2020-03-26;"Prešovský kraj";8;0;0;0;NA;209569;8;2020-03-26;-410
2020-03-25;"Prešovský kraj";1;0;0;0;NA;209569;1;2020-03-25;-418
2020-03-24;"Prešovský kraj";4;0;0;0;NA;209569;4;2020-03-24;-419
2020-03-23;"Prešovský kraj";0;0;0;0;NA;209569;0;2020-03-23;-423
2020-03-22;"Prešovský kraj";1;0;0;0;NA;209569;1;2020-03-22;-423
2020-03-21;"Prešovský kraj";2;0;0;0;NA;209569;2;2020-03-21;-424
2020-03-20;"Prešovský kraj";3;0;0;0;NA;209569;3;2020-03-20;-426
2020-03-19;"Prešovský kraj";2;0;0;0;NA;209569;2;2020-03-19;-429
2020-03-18;"Prešovský kraj";1;0;0;0;NA;209569;1;2020-03-18;-431
2020-03-17;"Prešovský kraj";1;0;0;0;NA;209569;1;2020-03-17;-432
2020-03-16;"Prešovský kraj";4;0;0;0;NA;209569;4;2020-03-16;-433
2020-03-15;"Prešovský kraj";0;0;0;0;NA;209569;0;2020-03-15;-437
2020-03-14;"Prešovský kraj";1;0;0;0;NA;209569;1;2020-03-14;-437
2020-03-13;"Prešovský kraj";0;0;0;0;NA;209569;0;2020-03-13;-438
2020-03-12;"Prešovský kraj";0;0;0;0;NA;209569;0;2020-03-12;-438
2020-03-11;"Prešovský kraj";0;0;0;0;NA;209569;0;2020-03-11;-438
2020-03-09;"Prešovský kraj";0;0;0;0;NA;209569;0;2020-03-09;-438
2020-03-08;"Prešovský kraj";0;0;0;0;NA;209569;0;2020-03-08;-438
2020-03-07;"Prešovský kraj";0;0;0;0;NA;209569;0;2020-03-07;-438
2020-03-06;"Prešovský kraj";0;0;0;0;NA;209569;0;2020-03-06;-438
2022-01-11;"Trenčiansky kraj";300;0;0;0;107815;173634;300;2022-01-11;173634
2022-01-10;"Trenčiansky kraj";218;0;0;0;NA;173634;218;2022-01-10;173334
2022-01-09;"Trenčiansky kraj";40;1948;35;1983;NA;173634;75;2022-01-09;173116
2022-01-08;"Trenčiansky kraj";267;1239;36;1275;NA;173634;303;2022-01-08;173041
2022-01-07;"Trenčiansky kraj";334;2107;52;2159;NA;173634;386;2022-01-07;172738
2022-01-06;"Trenčiansky kraj";75;1100;45;1145;NA;173634;120;2022-01-06;172352
2022-01-05;"Trenčiansky kraj";496;2724;62;2786;NA;173634;558;2022-01-05;172232
2022-01-04;"Trenčiansky kraj";521;3394;67;3461;NA;173634;588;2022-01-04;171674
2022-01-03;"Trenčiansky kraj";357;5380;108;5488;NA;173634;465;2022-01-03;171086
2022-01-02;"Trenčiansky kraj";179;2331;74;2405;NA;173634;253;2022-01-02;170621
2022-01-01;"Trenčiansky kraj";4;519;28;547;NA;173634;32;2022-01-01;170368
2021-12-31;"Trenčiansky kraj";443;1422;76;1498;NA;173634;519;2021-12-31;170336
2021-12-30;"Trenčiansky kraj";370;2341;126;2467;NA;173634;496;2021-12-30;169817
2021-12-29;"Trenčiansky kraj";429;2405;82;2487;NA;173634;511;2021-12-29;169321
2021-12-28;"Trenčiansky kraj";609;2690;105;2795;NA;173634;714;2021-12-28;168810
2021-12-27;"Trenčiansky kraj";546;3182;98;3280;NA;173634;644;2021-12-27;168096
2021-12-26;"Trenčiansky kraj";147;1089;78;1167;NA;173634;225;2021-12-26;167452
2021-12-25;"Trenčiansky kraj";52;485;26;511;NA;173634;78;2021-12-25;167227
2021-12-24;"Trenčiansky kraj";176;643;37;680;NA;173634;213;2021-12-24;167149
2021-12-23;"Trenčiansky kraj";532;2370;99;2469;NA;173634;631;2021-12-23;166936
2021-12-22;"Trenčiansky kraj";512;2521;116;2637;NA;173634;628;2021-12-22;166305
2021-12-21;"Trenčiansky kraj";694;3209;117;3326;NA;173634;811;2021-12-21;165677
2021-12-20;"Trenčiansky kraj";488;6610;199;6809;NA;173634;687;2021-12-20;164866
2021-12-19;"Trenčiansky kraj";202;2574;118;2692;NA;173634;320;2021-12-19;164179
2021-12-18;"Trenčiansky kraj";438;1752;108;1860;NA;173634;546;2021-12-18;163859
2021-12-17;"Trenčiansky kraj";427;4005;135;4140;NA;173634;562;2021-12-17;163313
2021-12-16;"Trenčiansky kraj";649;3169;177;3346;NA;173634;826;2021-12-16;162751
2021-12-15;"Trenčiansky kraj";791;4596;165;4761;NA;173634;956;2021-12-15;161925
2021-12-14;"Trenčiansky kraj";885;3590;139;3729;NA;173634;1024;2021-12-14;160969
2021-12-13;"Trenčiansky kraj";573;7310;247;7557;NA;173634;820;2021-12-13;159945
2021-12-12;"Trenčiansky kraj";306;3156;156;3312;NA;173634;462;2021-12-12;159125
2021-12-11;"Trenčiansky kraj";706;1876;138;2014;NA;173634;844;2021-12-11;158663
2021-12-10;"Trenčiansky kraj";789;3643;199;3842;NA;173634;988;2021-12-10;157819
2021-12-09;"Trenčiansky kraj";967;3847;202;4049;NA;173634;1169;2021-12-09;156831
2021-12-08;"Trenčiansky kraj";1020;4428;201;4629;NA;173634;1221;2021-12-08;155662
2021-12-07;"Trenčiansky kraj";1241;6231;214;6445;NA;173634;1455;2021-12-07;154441
2021-12-06;"Trenčiansky kraj";751;8778;421;9199;NA;173634;1172;2021-12-06;152986
2021-12-05;"Trenčiansky kraj";510;3610;210;3820;NA;173634;720;2021-12-05;151814
2021-12-04;"Trenčiansky kraj";1058;2043;156;2199;NA;173634;1214;2021-12-04;151094
2021-12-03;"Trenčiansky kraj";1272;4379;304;4683;NA;173634;1576;2021-12-03;149880
2021-12-02;"Trenčiansky kraj";2007;4087;263;4350;NA;173634;2270;2021-12-02;148304
2021-12-01;"Trenčiansky kraj";1000;4935;296;5231;NA;173634;1296;2021-12-01;146034
2021-11-30;"Trenčiansky kraj";1086;4702;329;5031;NA;173634;1415;2021-11-30;144738
2021-11-29;"Trenčiansky kraj";1165;10325;540;10865;NA;173634;1705;2021-11-29;143323
2021-11-28;"Trenčiansky kraj";664;5566;308;5874;NA;173634;972;2021-11-28;141618
2021-11-27;"Trenčiansky kraj";1080;2782;301;3083;NA;173634;1381;2021-11-27;140646
2021-11-26;"Trenčiansky kraj";1238;4493;346;4839;NA;173634;1584;2021-11-26;139265
2021-11-25;"Trenčiansky kraj";1018;3590;343;3933;NA;173634;1361;2021-11-25;137681
2021-11-24;"Trenčiansky kraj";1362;5559;466;6025;NA;173634;1828;2021-11-24;136320
2021-11-23;"Trenčiansky kraj";1140;3717;347;4064;NA;173634;1487;2021-11-23;134492
2021-11-22;"Trenčiansky kraj";920;6467;566;7033;NA;173634;1486;2021-11-22;133005
2021-11-21;"Trenčiansky kraj";413;3233;377;3610;NA;173634;790;2021-11-21;131519
2021-11-20;"Trenčiansky kraj";914;2379;341;2720;NA;173634;1255;2021-11-20;130729
2021-11-19;"Trenčiansky kraj";1261;3785;445;4230;NA;173634;1706;2021-11-19;129474
2021-11-18;"Trenčiansky kraj";810;5024;524;5548;NA;173634;1334;2021-11-18;127768
2021-11-17;"Trenčiansky kraj";796;1852;237;2089;NA;173634;1033;2021-11-17;126434
2021-11-16;"Trenčiansky kraj";859;4060;401;4461;NA;173634;1260;2021-11-16;125401
2021-11-15;"Trenčiansky kraj";720;5114;550;5664;NA;173634;1270;2021-11-15;124141
2021-11-14;"Trenčiansky kraj";447;2462;343;2805;NA;173634;790;2021-11-14;122871
2021-11-13;"Trenčiansky kraj";478;1879;254;2133;NA;173634;732;2021-11-13;122081
2021-11-12;"Trenčiansky kraj";784;3855;338;4193;NA;173634;1122;2021-11-12;121349
2021-11-11;"Trenčiansky kraj";805;3561;345;3906;NA;173634;1150;2021-11-11;120227
2021-11-10;"Trenčiansky kraj";647;3358;279;3637;NA;173634;926;2021-11-10;119077
2021-11-09;"Trenčiansky kraj";752;2886;304;3190;NA;173634;1056;2021-11-09;118151
2021-11-08;"Trenčiansky kraj";489;4643;348;4991;NA;173634;837;2021-11-08;117095
2021-11-07;"Trenčiansky kraj";405;2043;220;2263;NA;173634;625;2021-11-07;116258
2021-11-06;"Trenčiansky kraj";542;1755;176;1931;NA;173634;718;2021-11-06;115633
2021-11-05;"Trenčiansky kraj";677;3083;238;3321;NA;173634;915;2021-11-05;114915
2021-11-04;"Trenčiansky kraj";563;2713;229;2942;NA;173634;792;2021-11-04;114000
2021-11-03;"Trenčiansky kraj";619;2955;222;3177;NA;173634;841;2021-11-03;113208
2021-11-02;"Trenčiansky kraj";663;3808;309;4117;NA;173634;972;2021-11-02;112367
2021-11-01;"Trenčiansky kraj";219;1029;101;1130;NA;173634;320;2021-11-01;111395
2021-10-31;"Trenčiansky kraj";151;1462;152;1614;NA;173634;303;2021-10-31;111075
2021-10-30;"Trenčiansky kraj";345;1770;130;1900;NA;173634;475;2021-10-30;110772
2021-10-29;"Trenčiansky kraj";415;2860;129;2989;NA;173634;544;2021-10-29;110297
2021-10-28;"Trenčiansky kraj";429;2653;157;2810;NA;173634;586;2021-10-28;109753
2021-10-27;"Trenčiansky kraj";463;2612;93;2705;NA;173634;556;2021-10-27;109167
2021-10-26;"Trenčiansky kraj";419;2635;133;2768;NA;173634;552;2021-10-26;108611
2021-10-25;"Trenčiansky kraj";192;3370;130;3500;NA;173634;322;2021-10-25;108059
2021-10-24;"Trenčiansky kraj";121;1643;79;1722;NA;173634;200;2021-10-24;107737
2021-10-23;"Trenčiansky kraj";326;1737;64;1801;NA;173634;390;2021-10-23;107537
2021-10-22;"Trenčiansky kraj";358;2694;78;2772;NA;173634;436;2021-10-22;107147
2021-10-21;"Trenčiansky kraj";247;2343;74;2417;NA;173634;321;2021-10-21;106711
2021-10-20;"Trenčiansky kraj";302;2101;70;2171;NA;173634;372;2021-10-20;106390
2021-10-19;"Trenčiansky kraj";227;2847;59;2906;NA;173634;286;2021-10-19;106018
2021-10-18;"Trenčiansky kraj";143;2453;71;2524;NA;173634;214;2021-10-18;105732
2021-10-17;"Trenčiansky kraj";46;1457;31;1488;NA;173634;77;2021-10-17;105518
2021-10-16;"Trenčiansky kraj";76;1671;35;1706;NA;173634;111;2021-10-16;105441
2021-10-15;"Trenčiansky kraj";126;2925;50;2975;NA;173634;176;2021-10-15;105330
2021-10-14;"Trenčiansky kraj";103;1717;27;1744;NA;173634;130;2021-10-14;105154
2021-10-13;"Trenčiansky kraj";171;2656;28;2684;NA;173634;199;2021-10-13;105024
2021-10-12;"Trenčiansky kraj";114;2350;32;2382;NA;173634;146;2021-10-12;104825
2021-10-11;"Trenčiansky kraj";109;2541;48;2589;NA;173634;157;2021-10-11;104679
2021-10-10;"Trenčiansky kraj";17;1487;23;1510;NA;173634;40;2021-10-10;104522
2021-10-09;"Trenčiansky kraj";157;1809;16;1825;NA;173634;173;2021-10-09;104482
2021-10-08;"Trenčiansky kraj";82;3087;37;3124;NA;173634;119;2021-10-08;104309
2021-10-07;"Trenčiansky kraj";107;2039;30;2069;NA;173634;137;2021-10-07;104190
2021-10-06;"Trenčiansky kraj";193;2289;36;2325;NA;173634;229;2021-10-06;104053
2021-10-05;"Trenčiansky kraj";119;2229;40;2269;NA;173634;159;2021-10-05;103824
2021-10-04;"Trenčiansky kraj";105;2769;52;2821;NA;173634;157;2021-10-04;103665
2021-10-03;"Trenčiansky kraj";30;1558;27;1585;NA;173634;57;2021-10-03;103508
2021-10-02;"Trenčiansky kraj";107;1794;35;1829;NA;173634;142;2021-10-02;103451
2021-10-01;"Trenčiansky kraj";119;2690;37;2727;NA;173634;156;2021-10-01;103309
2021-09-30;"Trenčiansky kraj";74;2327;50;2377;NA;173634;124;2021-09-30;103153
2021-09-29;"Trenčiansky kraj";170;2150;30;2180;NA;173634;200;2021-09-29;103029
2021-09-28;"Trenčiansky kraj";95;2267;31;2298;NA;173634;126;2021-09-28;102829
2021-09-27;"Trenčiansky kraj";56;2813;57;2870;NA;173634;113;2021-09-27;102703
2021-09-26;"Trenčiansky kraj";20;1675;33;1708;NA;173634;53;2021-09-26;102590
2021-09-25;"Trenčiansky kraj";76;1674;21;1695;NA;173634;97;2021-09-25;102537
2021-09-24;"Trenčiansky kraj";104;3220;35;3255;NA;173634;139;2021-09-24;102440
2021-09-23;"Trenčiansky kraj";91;2251;27;2278;NA;173634;118;2021-09-23;102301
2021-09-22;"Trenčiansky kraj";90;2146;24;2170;NA;173634;114;2021-09-22;102183
2021-09-21;"Trenčiansky kraj";79;2307;29;2336;NA;173634;108;2021-09-21;102069
2021-09-20;"Trenčiansky kraj";78;2612;37;2649;NA;173634;115;2021-09-20;101961
2021-09-19;"Trenčiansky kraj";11;1571;20;1591;NA;173634;31;2021-09-19;101846
2021-09-18;"Trenčiansky kraj";53;2099;14;2113;NA;173634;67;2021-09-18;101815
2021-09-17;"Trenčiansky kraj";55;3143;26;3169;NA;173634;81;2021-09-17;101748
2021-09-16;"Trenčiansky kraj";52;2160;20;2180;NA;173634;72;2021-09-16;101667
2021-09-15;"Trenčiansky kraj";63;1043;7;1050;NA;173634;70;2021-09-15;101595
2021-09-14;"Trenčiansky kraj";67;2449;25;2474;NA;173634;92;2021-09-14;101525
2021-09-13;"Trenčiansky kraj";33;2271;35;2306;NA;173634;68;2021-09-13;101433
2021-09-12;"Trenčiansky kraj";3;1411;11;1422;NA;173634;14;2021-09-12;101365
2021-09-11;"Trenčiansky kraj";55;1729;6;1735;NA;173634;61;2021-09-11;101351
2021-09-10;"Trenčiansky kraj";49;2246;15;2261;NA;173634;64;2021-09-10;101290
2021-09-09;"Trenčiansky kraj";24;1684;30;1714;NA;173634;54;2021-09-09;101226
2021-09-08;"Trenčiansky kraj";54;1770;15;1785;NA;173634;69;2021-09-08;101172
2021-09-07;"Trenčiansky kraj";43;1393;18;1411;NA;173634;61;2021-09-07;101103
2021-09-06;"Trenčiansky kraj";47;1398;15;1413;NA;173634;62;2021-09-06;101042
2021-09-05;"Trenčiansky kraj";2;966;23;989;NA;173634;25;2021-09-05;100980
2021-09-04;"Trenčiansky kraj";41;925;4;929;NA;173634;45;2021-09-04;100955
2021-09-03;"Trenčiansky kraj";53;1421;15;1436;NA;173634;68;2021-09-03;100910
2021-09-02;"Trenčiansky kraj";7;999;14;1013;NA;173634;21;2021-09-02;100842
2021-09-01;"Trenčiansky kraj";27;431;8;439;NA;173634;35;2021-09-01;100821
2021-08-31;"Trenčiansky kraj";21;1146;15;1161;NA;173634;36;2021-08-31;100786
2021-08-30;"Trenčiansky kraj";32;1166;10;1176;NA;173634;42;2021-08-30;100750
2021-08-29;"Trenčiansky kraj";1;482;11;493;NA;173634;12;2021-08-29;100708
2021-08-28;"Trenčiansky kraj";9;976;10;986;NA;173634;19;2021-08-28;100696
2021-08-27;"Trenčiansky kraj";21;1599;1;1600;NA;173634;22;2021-08-27;100677
2021-08-26;"Trenčiansky kraj";8;992;6;998;NA;173634;14;2021-08-26;100655
2021-08-25;"Trenčiansky kraj";40;875;7;882;NA;173634;47;2021-08-25;100641
2021-08-24;"Trenčiansky kraj";4;822;4;826;NA;173634;8;2021-08-24;100594
2021-08-23;"Trenčiansky kraj";6;1165;17;1182;NA;173634;23;2021-08-23;100586
2021-08-22;"Trenčiansky kraj";0;726;10;736;NA;173634;10;2021-08-22;100563
2021-08-21;"Trenčiansky kraj";5;964;7;971;NA;173634;12;2021-08-21;100553
2021-08-20;"Trenčiansky kraj";15;1537;2;1539;NA;173634;17;2021-08-20;100541
2021-08-19;"Trenčiansky kraj";2;985;2;987;NA;173634;4;2021-08-19;100524
2021-08-18;"Trenčiansky kraj";6;814;7;821;NA;173634;13;2021-08-18;100520
2021-08-17;"Trenčiansky kraj";9;633;1;634;NA;173634;10;2021-08-17;100507
2021-08-16;"Trenčiansky kraj";5;925;3;928;NA;173634;8;2021-08-16;100497
2021-08-15;"Trenčiansky kraj";0;558;1;559;NA;173634;1;2021-08-15;100489
2021-08-14;"Trenčiansky kraj";12;574;6;580;NA;173634;18;2021-08-14;100488
2021-08-13;"Trenčiansky kraj";2;933;0;933;NA;173634;2;2021-08-13;100470
2021-08-12;"Trenčiansky kraj";2;564;3;567;NA;173634;5;2021-08-12;100468
2021-08-11;"Trenčiansky kraj";1;680;0;680;NA;173634;1;2021-08-11;100463
2021-08-10;"Trenčiansky kraj";8;530;1;531;NA;173634;9;2021-08-10;100462
2021-08-09;"Trenčiansky kraj";8;694;1;695;NA;173634;9;2021-08-09;100453
2021-08-08;"Trenčiansky kraj";0;468;0;468;NA;173634;0;2021-08-08;100444
2021-08-07;"Trenčiansky kraj";3;464;0;464;NA;173634;3;2021-08-07;100444
2021-08-06;"Trenčiansky kraj";3;955;1;956;NA;173634;4;2021-08-06;100441
2021-08-05;"Trenčiansky kraj";3;579;1;580;NA;173634;4;2021-08-05;100437
2021-08-04;"Trenčiansky kraj";14;546;3;549;NA;173634;17;2021-08-04;100433
2021-08-03;"Trenčiansky kraj";9;508;5;513;NA;173634;14;2021-08-03;100416
2021-08-02;"Trenčiansky kraj";1;807;2;809;NA;173634;3;2021-08-02;100402
2021-08-01;"Trenčiansky kraj";0;458;1;459;NA;173634;1;2021-08-01;100399
2021-07-31;"Trenčiansky kraj";4;525;2;527;NA;173634;6;2021-07-31;100398
2021-07-30;"Trenčiansky kraj";2;1069;0;1069;NA;173634;2;2021-07-30;100392
2021-07-29;"Trenčiansky kraj";5;708;0;708;NA;173634;5;2021-07-29;100390
2021-07-28;"Trenčiansky kraj";3;517;2;519;NA;173634;5;2021-07-28;100385
2021-07-27;"Trenčiansky kraj";6;551;1;552;NA;173634;7;2021-07-27;100380
2021-07-26;"Trenčiansky kraj";7;772;1;773;NA;173634;8;2021-07-26;100373
2021-07-25;"Trenčiansky kraj";0;487;2;489;NA;173634;2;2021-07-25;100365
2021-07-24;"Trenčiansky kraj";3;643;1;644;NA;173634;4;2021-07-24;100363
2021-07-23;"Trenčiansky kraj";3;1151;0;1151;NA;173634;3;2021-07-23;100359
2021-07-22;"Trenčiansky kraj";2;844;2;846;NA;173634;4;2021-07-22;100356
2021-07-21;"Trenčiansky kraj";8;661;2;663;NA;173634;10;2021-07-21;100352
2021-07-20;"Trenčiansky kraj";4;525;1;526;NA;173634;5;2021-07-20;100342
2021-07-19;"Trenčiansky kraj";0;866;4;870;NA;173634;4;2021-07-19;100337
2021-07-18;"Trenčiansky kraj";0;526;0;526;NA;173634;0;2021-07-18;100333
2021-07-17;"Trenčiansky kraj";3;673;0;673;NA;173634;3;2021-07-17;100333
2021-07-16;"Trenčiansky kraj";4;1122;0;1122;NA;173634;4;2021-07-16;100330
2021-07-15;"Trenčiansky kraj";2;824;0;824;NA;173634;2;2021-07-15;100326
2021-07-14;"Trenčiansky kraj";8;645;0;645;NA;173634;8;2021-07-14;100324
2021-07-13;"Trenčiansky kraj";1;520;3;523;NA;173634;4;2021-07-13;100316
2021-07-12;"Trenčiansky kraj";9;820;2;822;NA;173634;11;2021-07-12;100312
2021-07-11;"Trenčiansky kraj";0;611;2;613;NA;173634;2;2021-07-11;100301
2021-07-10;"Trenčiansky kraj";2;535;0;535;NA;173634;2;2021-07-10;100299
2021-07-09;"Trenčiansky kraj";7;1379;0;1379;NA;173634;7;2021-07-09;100297
2021-07-08;"Trenčiansky kraj";2;815;1;816;NA;173634;3;2021-07-08;100290
2021-07-07;"Trenčiansky kraj";2;928;0;928;NA;173634;2;2021-07-07;100287
2021-07-06;"Trenčiansky kraj";4;1041;1;1042;NA;173634;5;2021-07-06;100285
2021-07-05;"Trenčiansky kraj";1;508;0;508;NA;173634;1;2021-07-05;100280
2021-07-04;"Trenčiansky kraj";0;612;1;613;NA;173634;1;2021-07-04;100279
2021-07-03;"Trenčiansky kraj";3;815;1;816;NA;173634;4;2021-07-03;100278
2021-07-02;"Trenčiansky kraj";5;1583;2;1585;NA;173634;7;2021-07-02;100274
2021-07-01;"Trenčiansky kraj";4;1152;1;1153;NA;173634;5;2021-07-01;100267
2021-06-30;"Trenčiansky kraj";2;7021;6;7027;NA;173634;8;2021-06-30;100262
2021-06-29;"Trenčiansky kraj";4;2773;5;2778;NA;173634;9;2021-06-29;100254
2021-06-28;"Trenčiansky kraj";5;3644;4;3648;NA;173634;9;2021-06-28;100245
2021-06-27;"Trenčiansky kraj";0;2861;1;2862;NA;173634;1;2021-06-27;100236
2021-06-26;"Trenčiansky kraj";1;3547;4;3551;NA;173634;5;2021-06-26;100235
2021-06-25;"Trenčiansky kraj";2;4626;1;4627;NA;173634;3;2021-06-25;100230
2021-06-24;"Trenčiansky kraj";3;3320;4;3324;NA;173634;7;2021-06-24;100227
2021-06-23;"Trenčiansky kraj";4;2808;2;2810;NA;173634;6;2021-06-23;100220
2021-06-22;"Trenčiansky kraj";7;3137;4;3141;NA;173634;11;2021-06-22;100214
2021-06-21;"Trenčiansky kraj";10;3891;4;3895;NA;173634;14;2021-06-21;100203
2021-06-20;"Trenčiansky kraj";0;3579;5;3584;NA;173634;5;2021-06-20;100189
2021-06-19;"Trenčiansky kraj";5;4528;1;4529;NA;173634;6;2021-06-19;100184
2021-06-18;"Trenčiansky kraj";7;6725;7;6732;NA;173634;14;2021-06-18;100178
2021-06-17;"Trenčiansky kraj";0;3469;6;3475;NA;173634;6;2021-06-17;100164
2021-06-16;"Trenčiansky kraj";4;3183;3;3186;NA;173634;7;2021-06-16;100158
2021-06-15;"Trenčiansky kraj";10;3697;2;3699;NA;173634;12;2021-06-15;100151
2021-06-14;"Trenčiansky kraj";10;4805;15;4820;NA;173634;25;2021-06-14;100139
2021-06-13;"Trenčiansky kraj";0;4643;4;4647;NA;173634;4;2021-06-13;100114
2021-06-12;"Trenčiansky kraj";4;5260;8;5268;NA;173634;12;2021-06-12;100110
2021-06-11;"Trenčiansky kraj";10;7365;11;7376;NA;173634;21;2021-06-11;100098
2021-06-10;"Trenčiansky kraj";5;4345;7;4352;NA;173634;12;2021-06-10;100077
2021-06-09;"Trenčiansky kraj";7;3693;7;3700;NA;173634;14;2021-06-09;100065
2021-06-08;"Trenčiansky kraj";21;3965;7;3972;NA;173634;28;2021-06-08;100051
2021-06-07;"Trenčiansky kraj";13;5560;10;5570;NA;173634;23;2021-06-07;100023
2021-06-06;"Trenčiansky kraj";0;5500;10;5510;NA;173634;10;2021-06-06;1e+05
2021-06-05;"Trenčiansky kraj";7;6511;5;6516;NA;173634;12;2021-06-05;99990
2021-06-04;"Trenčiansky kraj";16;7653;3;7656;NA;173634;19;2021-06-04;99978
2021-06-03;"Trenčiansky kraj";9;4485;10;4495;NA;173634;19;2021-06-03;99959
2021-06-02;"Trenčiansky kraj";28;4329;8;4337;NA;173634;36;2021-06-02;99940
2021-06-01;"Trenčiansky kraj";22;5396;18;5414;NA;173634;40;2021-06-01;99904
2021-05-31;"Trenčiansky kraj";30;6117;24;6141;NA;173634;54;2021-05-31;99864
2021-05-30;"Trenčiansky kraj";0;8258;16;8274;NA;173634;16;2021-05-30;99810
2021-05-29;"Trenčiansky kraj";13;7915;14;7929;NA;173634;27;2021-05-29;99794
2021-05-28;"Trenčiansky kraj";22;8995;25;9020;NA;173634;47;2021-05-28;99767
2021-05-27;"Trenčiansky kraj";6;5205;12;5217;NA;173634;18;2021-05-27;99720
2021-05-26;"Trenčiansky kraj";26;5069;15;5084;NA;173634;41;2021-05-26;99702
2021-05-25;"Trenčiansky kraj";18;6168;24;6192;NA;173634;42;2021-05-25;99661
2021-05-24;"Trenčiansky kraj";19;9292;37;9329;NA;173634;56;2021-05-24;99619
2021-05-23;"Trenčiansky kraj";0;9083;26;9109;NA;173634;26;2021-05-23;99563
2021-05-22;"Trenčiansky kraj";11;11314;21;11335;NA;173634;32;2021-05-22;99537
2021-05-21;"Trenčiansky kraj";23;11572;26;11598;NA;173634;49;2021-05-21;99505
2021-05-20;"Trenčiansky kraj";23;6320;25;6345;NA;173634;48;2021-05-20;99456
2021-05-19;"Trenčiansky kraj";16;5694;32;5726;NA;173634;48;2021-05-19;99408
2021-05-18;"Trenčiansky kraj";26;7779;28;7807;NA;173634;54;2021-05-18;99360
2021-05-17;"Trenčiansky kraj";37;7671;43;7714;NA;173634;80;2021-05-17;99306
2021-05-16;"Trenčiansky kraj";25;15615;41;15656;NA;173634;66;2021-05-16;99226
2021-05-15;"Trenčiansky kraj";3;21237;32;21269;NA;173634;35;2021-05-15;99160
2021-05-14;"Trenčiansky kraj";41;18676;42;18718;NA;173634;83;2021-05-14;99125
2021-05-13;"Trenčiansky kraj";41;8195;24;8219;NA;173634;65;2021-05-13;99042
2021-05-12;"Trenčiansky kraj";41;7409;31;7440;NA;173634;72;2021-05-12;98977
2021-05-11;"Trenčiansky kraj";66;10507;32;10539;NA;173634;98;2021-05-11;98905
2021-05-10;"Trenčiansky kraj";48;12989;55;13044;NA;173634;103;2021-05-10;98807
2021-05-09;"Trenčiansky kraj";52;17737;39;17776;NA;173634;91;2021-05-09;98704
2021-05-08;"Trenčiansky kraj";3;23822;33;23855;NA;173634;36;2021-05-08;98613
2021-05-07;"Trenčiansky kraj";45;23549;56;23605;NA;173634;101;2021-05-07;98577
2021-05-06;"Trenčiansky kraj";26;10771;44;10815;NA;173634;70;2021-05-06;98476
2021-05-05;"Trenčiansky kraj";73;9377;41;9418;NA;173634;114;2021-05-05;98406
2021-05-04;"Trenčiansky kraj";55;12733;53;12786;NA;173634;108;2021-05-04;98292
2021-05-03;"Trenčiansky kraj";60;15331;51;15382;NA;173634;111;2021-05-03;98184
2021-05-02;"Trenčiansky kraj";0;31152;65;31217;NA;173634;65;2021-05-02;98073
2021-05-01;"Trenčiansky kraj";71;56982;60;57042;NA;173634;131;2021-05-01;98008
2021-04-30;"Trenčiansky kraj";77;29427;61;29488;NA;173634;138;2021-04-30;97877
2021-04-29;"Trenčiansky kraj";49;13184;59;13243;NA;173634;108;2021-04-29;97739
2021-04-28;"Trenčiansky kraj";79;12537;52;12589;NA;173634;131;2021-04-28;97631
2021-04-27;"Trenčiansky kraj";107;15527;40;15567;NA;173634;147;2021-04-27;97500
2021-04-26;"Trenčiansky kraj";52;21070;63;21133;NA;173634;115;2021-04-26;97353
2021-04-25;"Trenčiansky kraj";0;34560;48;34608;NA;173634;48;2021-04-25;97238
2021-04-24;"Trenčiansky kraj";76;72398;100;72498;NA;173634;176;2021-04-24;97190
2021-04-23;"Trenčiansky kraj";143;29959;79;30038;NA;173634;222;2021-04-23;97014
2021-04-22;"Trenčiansky kraj";71;13847;64;13911;NA;173634;135;2021-04-22;96792
2021-04-21;"Trenčiansky kraj";79;13000;67;13067;NA;173634;146;2021-04-21;96657
2021-04-20;"Trenčiansky kraj";142;17740;80;17820;NA;173634;222;2021-04-20;96511
2021-04-19;"Trenčiansky kraj";102;22631;103;22734;NA;173634;205;2021-04-19;96289
2021-04-18;"Trenčiansky kraj";3;40879;97;40976;NA;173634;100;2021-04-18;96084
2021-04-17;"Trenčiansky kraj";77;81498;136;81634;NA;173634;213;2021-04-17;95984
2021-04-16;"Trenčiansky kraj";100;31961;90;32051;NA;173634;190;2021-04-16;95771
2021-04-15;"Trenčiansky kraj";71;14479;69;14548;NA;173634;140;2021-04-15;95581
2021-04-14;"Trenčiansky kraj";135;15563;72;15635;NA;173634;207;2021-04-14;95441
2021-04-13;"Trenčiansky kraj";189;18721;75;18796;NA;173634;264;2021-04-13;95234
2021-04-12;"Trenčiansky kraj";97;23743;91;23834;NA;173634;188;2021-04-12;94970
2021-04-11;"Trenčiansky kraj";1;34735;75;34810;NA;173634;76;2021-04-11;94782
2021-04-10;"Trenčiansky kraj";81;83093;145;83238;NA;173634;226;2021-04-10;94706
2021-04-09;"Trenčiansky kraj";120;28014;91;28105;NA;173634;211;2021-04-09;94480
2021-04-08;"Trenčiansky kraj";112;13283;85;13368;NA;173634;197;2021-04-08;94269
2021-04-07;"Trenčiansky kraj";204;17688;123;17811;NA;173634;327;2021-04-07;94072
2021-04-06;"Trenčiansky kraj";157;28567;178;28745;NA;173634;335;2021-04-06;93745
2021-04-05;"Trenčiansky kraj";15;9227;64;9291;NA;173634;79;2021-04-05;93410
2021-04-04;"Trenčiansky kraj";2;20291;85;20376;NA;173634;87;2021-04-04;93331
2021-04-03;"Trenčiansky kraj";86;80473;221;80694;NA;173634;307;2021-04-03;93244
2021-04-02;"Trenčiansky kraj";126;21620;81;21701;NA;173634;207;2021-04-02;92937
2021-04-01;"Trenčiansky kraj";159;32376;139;32515;NA;173634;298;2021-04-01;92730
2021-03-31;"Trenčiansky kraj";198;20100;130;20230;NA;173634;328;2021-03-31;92432
2021-03-30;"Trenčiansky kraj";272;17305;136;17441;NA;173634;408;2021-03-30;92104
2021-03-29;"Trenčiansky kraj";142;19479;170;19649;NA;173634;312;2021-03-29;91696
2021-03-28;"Trenčiansky kraj";3;34759;116;34875;NA;173634;119;2021-03-28;91384
2021-03-27;"Trenčiansky kraj";130;77314;293;77607;NA;173634;423;2021-03-27;91265
2021-03-26;"Trenčiansky kraj";211;35095;157;35252;NA;173634;368;2021-03-26;90842
2021-03-25;"Trenčiansky kraj";184;16580;176;16756;NA;173634;360;2021-03-25;90474
2021-03-24;"Trenčiansky kraj";259;13102;171;13273;NA;173634;430;2021-03-24;90114
2021-03-23;"Trenčiansky kraj";349;17589;174;17763;NA;173634;523;2021-03-23;89684
2021-03-22;"Trenčiansky kraj";141;21116;213;21329;NA;173634;354;2021-03-22;89161
2021-03-21;"Trenčiansky kraj";85;32711;164;32875;NA;173634;249;2021-03-21;88807
2021-03-20;"Trenčiansky kraj";128;80035;322;80357;NA;173634;450;2021-03-20;88558
2021-03-19;"Trenčiansky kraj";231;34783;232;35015;NA;173634;463;2021-03-19;88108
2021-03-18;"Trenčiansky kraj";262;16105;178;16283;NA;173634;440;2021-03-18;87645
2021-03-17;"Trenčiansky kraj";366;13435;164;13599;NA;173634;530;2021-03-17;87205
2021-03-16;"Trenčiansky kraj";450;15282;241;15523;NA;173634;691;2021-03-16;86675
2021-03-15;"Trenčiansky kraj";162;21235;261;21496;NA;173634;423;2021-03-15;85984
2021-03-14;"Trenčiansky kraj";42;34416;238;34654;NA;173634;280;2021-03-14;85561
2021-03-13;"Trenčiansky kraj";270;79186;453;79639;NA;173634;723;2021-03-13;85281
2021-03-12;"Trenčiansky kraj";366;34795;307;35102;NA;173634;673;2021-03-12;84558
2021-03-11;"Trenčiansky kraj";302;15558;213;15771;NA;173634;515;2021-03-11;83885
2021-03-10;"Trenčiansky kraj";402;13585;237;13822;NA;173634;639;2021-03-10;83370
2021-03-09;"Trenčiansky kraj";586;17982;285;18267;NA;173634;871;2021-03-09;82731
2021-03-08;"Trenčiansky kraj";174;21704;363;22067;NA;173634;537;2021-03-08;81860
2021-03-07;"Trenčiansky kraj";4;33660;313;33973;NA;173634;317;2021-03-07;81323
2021-03-06;"Trenčiansky kraj";260;79661;529;80190;NA;173634;789;2021-03-06;81006
2021-03-05;"Trenčiansky kraj";326;32969;415;33384;NA;173634;741;2021-03-05;80217
2021-03-04;"Trenčiansky kraj";323;16821;317;17138;NA;173634;640;2021-03-04;79476
2021-03-03;"Trenčiansky kraj";413;13960;347;14307;NA;173634;760;2021-03-03;78836
2021-03-02;"Trenčiansky kraj";612;17794;344;18138;NA;173634;956;2021-03-02;78076
2021-03-01;"Trenčiansky kraj";217;21104;445;21549;NA;173634;662;2021-03-01;77120
2021-02-28;"Trenčiansky kraj";45;30238;376;30614;NA;173634;421;2021-02-28;76458
2021-02-27;"Trenčiansky kraj";277;78735;686;79421;NA;173634;963;2021-02-27;76037
2021-02-26;"Trenčiansky kraj";420;32940;434;33374;NA;173634;854;2021-02-26;75074
2021-02-25;"Trenčiansky kraj";424;14029;328;14357;NA;173634;752;2021-02-25;74220
2021-02-24;"Trenčiansky kraj";427;12014;399;12413;NA;173634;826;2021-02-24;73468
2021-02-23;"Trenčiansky kraj";577;14904;390;15294;NA;173634;967;2021-02-23;72642
2021-02-22;"Trenčiansky kraj";160;19969;468;20437;NA;173634;628;2021-02-22;71675
2021-02-21;"Trenčiansky kraj";64;29478;392;29870;NA;173634;456;2021-02-21;71047
2021-02-20;"Trenčiansky kraj";274;77840;745;78585;NA;173634;1019;2021-02-20;70591
2021-02-19;"Trenčiansky kraj";272;30260;523;30783;NA;173634;795;2021-02-19;69572
2021-02-18;"Trenčiansky kraj";355;14094;403;14497;NA;173634;758;2021-02-18;68777
2021-02-17;"Trenčiansky kraj";363;11412;376;11788;NA;173634;739;2021-02-17;68019
2021-02-16;"Trenčiansky kraj";488;17761;406;18167;NA;173634;894;2021-02-16;67280
2021-02-15;"Trenčiansky kraj";151;21846;463;22309;NA;173634;614;2021-02-15;66386
2021-02-14;"Trenčiansky kraj";2;31255;324;31579;NA;173634;326;2021-02-14;65772
2021-02-13;"Trenčiansky kraj";274;63006;522;63528;NA;173634;796;2021-02-13;65446
2021-02-12;"Trenčiansky kraj";276;27979;412;28391;NA;173634;688;2021-02-12;64650
2021-02-11;"Trenčiansky kraj";291;11567;323;11890;NA;173634;614;2021-02-11;63962
2021-02-10;"Trenčiansky kraj";304;11408;317;11725;NA;173634;621;2021-02-10;63348
2021-02-09;"Trenčiansky kraj";514;18412;360;18772;NA;173634;874;2021-02-09;62727
2021-02-08;"Trenčiansky kraj";182;26832;430;27262;NA;173634;612;2021-02-08;61853
2021-02-07;"Trenčiansky kraj";31;36781;341;37122;NA;173634;372;2021-02-07;61241
2021-02-06;"Trenčiansky kraj";216;63931;560;64491;NA;173634;776;2021-02-06;60869
2021-02-05;"Trenčiansky kraj";202;18164;367;18531;NA;173634;569;2021-02-05;60093
2021-02-04;"Trenčiansky kraj";266;7253;311;7564;NA;173634;577;2021-02-04;59524
2021-02-03;"Trenčiansky kraj";162;6723;320;7043;NA;173634;482;2021-02-03;58947
2021-02-02;"Trenčiansky kraj";347;8074;381;8455;NA;173634;728;2021-02-02;58465
2021-02-01;"Trenčiansky kraj";167;8921;311;9232;NA;173634;478;2021-02-01;57737
2021-01-31;"Trenčiansky kraj";7;19103;159;19262;NA;173634;166;2021-01-31;57259
2021-01-30;"Trenčiansky kraj";228;38167;332;38499;NA;173634;560;2021-01-30;57093
2021-01-29;"Trenčiansky kraj";214;7590;235;7825;NA;173634;449;2021-01-29;56533
2021-01-28;"Trenčiansky kraj";307;5442;158;5600;NA;173634;465;2021-01-28;56084
2021-01-27;"Trenčiansky kraj";166;4842;181;5023;NA;173634;347;2021-01-27;55619
2021-01-26;"Trenčiansky kraj";303;14589;250;14839;NA;173634;553;2021-01-26;55272
2021-01-25;"Trenčiansky kraj";160;24310;207;24517;NA;173634;367;2021-01-25;54719
2021-01-24;"Trenčiansky kraj";51;38369;282;38651;NA;173634;333;2021-01-24;54352
2021-01-23;"Trenčiansky kraj";206;114125;749;114874;NA;173634;955;2021-01-23;54019
2021-01-22;"Trenčiansky kraj";148;21831;241;22072;NA;173634;389;2021-01-22;53064
2021-01-21;"Trenčiansky kraj";143;8586;166;8752;NA;173634;309;2021-01-21;52675
2021-01-20;"Trenčiansky kraj";181;8189;227;8416;NA;173634;408;2021-01-20;52366
2021-01-19;"Trenčiansky kraj";363;6600;262;6862;NA;173634;625;2021-01-19;51958
2021-01-18;"Trenčiansky kraj";72;4970;321;5291;NA;173634;393;2021-01-18;51333
2021-01-17;"Trenčiansky kraj";124;156;11;167;NA;173634;135;2021-01-17;50940
2021-01-16;"Trenčiansky kraj";39;1288;53;1341;NA;173634;92;2021-01-16;50805
2021-01-15;"Trenčiansky kraj";264;4031;214;4245;NA;173634;478;2021-01-15;50713
2021-01-14;"Trenčiansky kraj";275;3193;189;3382;NA;173634;464;2021-01-14;50235
2021-01-13;"Trenčiansky kraj";222;3893;215;4108;NA;173634;437;2021-01-13;49771
2021-01-12;"Trenčiansky kraj";508;4604;261;4865;NA;173634;769;2021-01-12;49334
2021-01-11;"Trenčiansky kraj";142;4367;354;4721;NA;173634;496;2021-01-11;48565
2021-01-10;"Trenčiansky kraj";89;4969;77;5046;NA;173634;166;2021-01-10;48069
2021-01-09;"Trenčiansky kraj";276;8280;128;8408;NA;173634;404;2021-01-09;47903
2021-01-08;"Trenčiansky kraj";489;6435;484;6919;NA;173634;973;2021-01-08;47499
2021-01-07;"Trenčiansky kraj";420;6138;577;6715;NA;173634;997;2021-01-07;46526
2021-01-06;"Trenčiansky kraj";221;1021;64;1085;NA;173634;285;2021-01-06;45529
2021-01-05;"Trenčiansky kraj";669;5753;706;6459;NA;173634;1375;2021-01-05;45244
2021-01-04;"Trenčiansky kraj";337;5248;782;6030;NA;173634;1119;2021-01-04;43869
2021-01-03;"Trenčiansky kraj";38;114;15;129;NA;173634;53;2021-01-03;42750
2021-01-02;"Trenčiansky kraj";129;196;23;219;NA;173634;152;2021-01-02;42697
2021-01-01;"Trenčiansky kraj";329;347;23;370;NA;173634;352;2021-01-01;42545
2020-12-31;"Trenčiansky kraj";597;4943;557;5500;NA;173634;1154;2020-12-31;42193
2020-12-30;"Trenčiansky kraj";836;7012;762;7774;NA;173634;1598;2020-12-30;41039
2020-12-29;"Trenčiansky kraj";459;6121;1009;7130;NA;173634;1468;2020-12-29;39441
2020-12-28;"Trenčiansky kraj";258;4195;777;4972;NA;173634;1035;2020-12-28;37973
2020-12-27;"Trenčiansky kraj";5;208;36;244;NA;173634;41;2020-12-27;36938
2020-12-26;"Trenčiansky kraj";174;74;10;84;NA;173634;184;2020-12-26;36897
2020-12-25;"Trenčiansky kraj";251;325;47;372;NA;173634;298;2020-12-25;36713
2020-12-24;"Trenčiansky kraj";552;2194;256;2450;NA;173634;808;2020-12-24;36415
2020-12-23;"Trenčiansky kraj";421;6552;661;7213;NA;173634;1082;2020-12-23;35607
2020-12-22;"Trenčiansky kraj";673;5760;694;6454;NA;173634;1367;2020-12-22;34525
2020-12-21;"Trenčiansky kraj";248;13395;979;14374;NA;173634;1227;2020-12-21;33158
2020-12-20;"Trenčiansky kraj";238;12504;292;12796;NA;173634;530;2020-12-20;31931
2020-12-19;"Trenčiansky kraj";341;1611;150;1761;NA;173634;491;2020-12-19;31401
2020-12-18;"Trenčiansky kraj";521;5199;615;5814;NA;173634;1136;2020-12-18;30910
2020-12-17;"Trenčiansky kraj";670;3843;524;4367;NA;173634;1194;2020-12-17;29774
2020-12-16;"Trenčiansky kraj";461;4474;648;5122;NA;173634;1109;2020-12-16;28580
2020-12-15;"Trenčiansky kraj";595;3805;670;4475;NA;173634;1265;2020-12-15;27471
2020-12-14;"Trenčiansky kraj";318;2907;552;3459;NA;173634;870;2020-12-14;26206
2020-12-13;"Trenčiansky kraj";77;49;6;55;NA;173634;83;2020-12-13;25336
2020-12-12;"Trenčiansky kraj";314;1191;136;1327;NA;173634;450;2020-12-12;25253
2020-12-11;"Trenčiansky kraj";751;3773;453;4226;NA;173634;1204;2020-12-11;24803
2020-12-10;"Trenčiansky kraj";271;3354;473;3827;NA;173634;744;2020-12-10;23599
2020-12-09;"Trenčiansky kraj";508;3788;466;4254;NA;173634;974;2020-12-09;22855
2020-12-08;"Trenčiansky kraj";546;3440;522;3962;NA;173634;1068;2020-12-08;21881
2020-12-07;"Trenčiansky kraj";258;3832;468;4300;NA;173634;726;2020-12-07;20813
2020-12-06;"Trenčiansky kraj";114;179;10;189;NA;173634;124;2020-12-06;20087
2020-12-05;"Trenčiansky kraj";223;610;56;666;NA;173634;279;2020-12-05;19963
2020-12-04;"Trenčiansky kraj";253;2943;273;3216;NA;173634;526;2020-12-04;19684
2020-12-03;"Trenčiansky kraj";503;1714;178;1892;NA;173634;681;2020-12-03;19158
2020-12-02;"Trenčiansky kraj";418;1844;232;2076;NA;173634;650;2020-12-02;18477
2020-12-01;"Trenčiansky kraj";321;5642;351;5993;NA;173634;672;2020-12-01;17827
2020-11-30;"Trenčiansky kraj";167;11514;520;12034;NA;173634;687;2020-11-30;17155
2020-11-29;"Trenčiansky kraj";29;30;5;35;NA;173634;34;2020-11-29;16468
2020-11-28;"Trenčiansky kraj";202;1051;93;1144;NA;173634;295;2020-11-28;16434
2020-11-27;"Trenčiansky kraj";330;1888;186;2074;NA;173634;516;2020-11-27;16139
2020-11-26;"Trenčiansky kraj";395;1252;122;1374;NA;173634;517;2020-11-26;15623
2020-11-25;"Trenčiansky kraj";322;1444;160;1604;NA;173634;482;2020-11-25;15106
2020-11-24;"Trenčiansky kraj";348;2553;308;2861;NA;173634;656;2020-11-24;14624
2020-11-23;"Trenčiansky kraj";159;1186;122;1308;NA;173634;281;2020-11-23;13968
2020-11-22;"Trenčiansky kraj";26;30;7;37;NA;173634;33;2020-11-22;13687
2020-11-21;"Trenčiansky kraj";255;1376;69;1445;NA;173634;324;2020-11-21;13654
2020-11-20;"Trenčiansky kraj";316;861;93;954;NA;173634;409;2020-11-20;13330
2020-11-19;"Trenčiansky kraj";316;740;113;853;NA;173634;429;2020-11-19;12921
2020-11-18;"Trenčiansky kraj";233;379;66;445;NA;173634;299;2020-11-18;12492
2020-11-17;"Trenčiansky kraj";222;106;15;121;NA;173634;237;2020-11-17;12193
2020-11-16;"Trenčiansky kraj";245;236;45;281;NA;173634;290;2020-11-16;11956
2020-11-15;"Trenčiansky kraj";109;29;6;35;NA;173634;115;2020-11-15;11666
2020-11-14;"Trenčiansky kraj";190;74;11;85;NA;173634;201;2020-11-14;11551
2020-11-13;"Trenčiansky kraj";308;131;13;144;NA;173634;321;2020-11-13;11350
2020-11-12;"Trenčiansky kraj";324;124;5;129;NA;173634;329;2020-11-12;11029
2020-11-11;"Trenčiansky kraj";366;113;10;123;NA;173634;376;2020-11-11;10700
2020-11-10;"Trenčiansky kraj";277;106;6;112;NA;173634;283;2020-11-10;10324
2020-11-09;"Trenčiansky kraj";115;1407;48;1455;NA;173634;163;2020-11-09;10041
2020-11-08;"Trenčiansky kraj";81;1271;8;1279;NA;173634;89;2020-11-08;9878
2020-11-07;"Trenčiansky kraj";319;3662;59;3721;NA;173634;378;2020-11-07;9789
2020-11-06;"Trenčiansky kraj";383;6893;84;6977;NA;173634;467;2020-11-06;9411
2020-11-05;"Trenčiansky kraj";399;98;15;113;NA;173634;414;2020-11-05;8944
2020-11-04;"Trenčiansky kraj";370;91;9;100;NA;173634;379;2020-11-04;8530
2020-11-03;"Trenčiansky kraj";575;97;8;105;NA;173634;583;2020-11-03;8151
2020-11-02;"Trenčiansky kraj";197;1833;68;1901;NA;173634;265;2020-11-02;7568
2020-11-01;"Trenčiansky kraj";257;808;24;832;NA;173634;281;2020-11-01;7303
2020-10-31;"Trenčiansky kraj";332;4719;82;4801;NA;173634;414;2020-10-31;7022
2020-10-30;"Trenčiansky kraj";299;5283;102;5385;NA;173634;401;2020-10-30;6608
2020-10-29;"Trenčiansky kraj";496;764;68;832;NA;173634;564;2020-10-29;6207
2020-10-28;"Trenčiansky kraj";269;192;33;225;NA;173634;302;2020-10-28;5643
2020-10-27;"Trenčiansky kraj";473;127;27;154;NA;173634;500;2020-10-27;5341
2020-10-26;"Trenčiansky kraj";177;107;36;143;NA;173634;213;2020-10-26;4841
2020-10-25;"Trenčiansky kraj";138;9;5;14;NA;173634;143;2020-10-25;4628
2020-10-24;"Trenčiansky kraj";395;128;6;134;NA;173634;401;2020-10-24;4485
2020-10-23;"Trenčiansky kraj";301;154;8;162;NA;173634;309;2020-10-23;4084
2020-10-22;"Trenčiansky kraj";273;82;12;94;NA;173634;285;2020-10-22;3775
2020-10-21;"Trenčiansky kraj";183;53;9;62;NA;173634;192;2020-10-21;3490
2020-10-20;"Trenčiansky kraj";212;47;6;53;NA;173634;218;2020-10-20;3298
2020-10-19;"Trenčiansky kraj";41;83;25;108;NA;173634;66;2020-10-19;3080
2020-10-18;"Trenčiansky kraj";104;0;0;0;NA;173634;104;2020-10-18;3014
2020-10-17;"Trenčiansky kraj";157;0;0;0;NA;173634;157;2020-10-17;2910
2020-10-16;"Trenčiansky kraj";225;42;6;48;NA;173634;231;2020-10-16;2753
2020-10-15;"Trenčiansky kraj";255;39;4;43;NA;173634;259;2020-10-15;2522
2020-10-14;"Trenčiansky kraj";162;42;7;49;NA;173634;169;2020-10-14;2263
2020-10-13;"Trenčiansky kraj";124;105;12;117;NA;173634;136;2020-10-13;2094
2020-10-12;"Trenčiansky kraj";55;0;0;0;NA;173634;55;2020-10-12;1958
2020-10-11;"Trenčiansky kraj";73;0;0;0;NA;173634;73;2020-10-11;1903
2020-10-10;"Trenčiansky kraj";180;0;0;0;NA;173634;180;2020-10-10;1830
2020-10-09;"Trenčiansky kraj";198;0;0;0;NA;173634;198;2020-10-09;1650
2020-10-08;"Trenčiansky kraj";115;0;0;0;NA;173634;115;2020-10-08;1452
2020-10-07;"Trenčiansky kraj";75;0;0;0;NA;173634;75;2020-10-07;1337
2020-10-06;"Trenčiansky kraj";72;0;0;0;NA;173634;72;2020-10-06;1262
2020-10-05;"Trenčiansky kraj";32;0;0;0;NA;173634;32;2020-10-05;1190
2020-10-04;"Trenčiansky kraj";37;0;0;0;NA;173634;37;2020-10-04;1158
2020-10-03;"Trenčiansky kraj";79;0;0;0;NA;173634;79;2020-10-03;1121
2020-10-02;"Trenčiansky kraj";69;0;0;0;NA;173634;69;2020-10-02;1042
2020-10-01;"Trenčiansky kraj";58;0;0;0;NA;173634;58;2020-10-01;973
2020-09-30;"Trenčiansky kraj";76;0;0;0;NA;173634;76;2020-09-30;915
2020-09-29;"Trenčiansky kraj";43;0;0;0;NA;173634;43;2020-09-29;839
2020-09-28;"Trenčiansky kraj";7;0;0;0;NA;173634;7;2020-09-28;796
2020-09-27;"Trenčiansky kraj";12;0;0;0;NA;173634;12;2020-09-27;789
2020-09-26;"Trenčiansky kraj";37;0;0;0;NA;173634;37;2020-09-26;777
2020-09-25;"Trenčiansky kraj";72;0;0;0;NA;173634;72;2020-09-25;740
2020-09-24;"Trenčiansky kraj";41;0;0;0;NA;173634;41;2020-09-24;668
2020-09-23;"Trenčiansky kraj";32;0;0;0;NA;173634;32;2020-09-23;627
2020-09-22;"Trenčiansky kraj";26;0;0;0;NA;173634;26;2020-09-22;595
2020-09-21;"Trenčiansky kraj";23;0;0;0;NA;173634;23;2020-09-21;569
2020-09-20;"Trenčiansky kraj";21;0;0;0;NA;173634;21;2020-09-20;546
2020-09-19;"Trenčiansky kraj";20;0;0;0;NA;173634;20;2020-09-19;525
2020-09-18;"Trenčiansky kraj";41;0;0;0;NA;173634;41;2020-09-18;505
2020-09-17;"Trenčiansky kraj";20;0;0;0;NA;173634;20;2020-09-17;464
2020-09-16;"Trenčiansky kraj";14;0;0;0;NA;173634;14;2020-09-16;444
2020-09-15;"Trenčiansky kraj";8;0;0;0;NA;173634;8;2020-09-15;430
2020-09-14;"Trenčiansky kraj";5;0;0;0;NA;173634;5;2020-09-14;422
2020-09-13;"Trenčiansky kraj";12;0;0;0;NA;173634;12;2020-09-13;417
2020-09-12;"Trenčiansky kraj";2;0;0;0;NA;173634;2;2020-09-12;405
2020-09-11;"Trenčiansky kraj";27;0;0;0;NA;173634;27;2020-09-11;403
2020-09-10;"Trenčiansky kraj";15;0;0;0;NA;173634;15;2020-09-10;376
2020-09-09;"Trenčiansky kraj";11;0;0;0;NA;173634;11;2020-09-09;361
2020-09-08;"Trenčiansky kraj";12;0;0;0;NA;173634;12;2020-09-08;350
2020-09-07;"Trenčiansky kraj";6;0;0;0;NA;173634;6;2020-09-07;338
2020-09-06;"Trenčiansky kraj";1;0;0;0;NA;173634;1;2020-09-06;332
2020-09-05;"Trenčiansky kraj";3;0;0;0;NA;173634;3;2020-09-05;331
2020-09-04;"Trenčiansky kraj";9;0;0;0;NA;173634;9;2020-09-04;328
2020-09-03;"Trenčiansky kraj";10;0;0;0;NA;173634;10;2020-09-03;319
2020-09-02;"Trenčiansky kraj";5;0;0;0;NA;173634;5;2020-09-02;309
2020-09-01;"Trenčiansky kraj";1;0;0;0;NA;173634;1;2020-09-01;304
2020-08-31;"Trenčiansky kraj";12;0;0;0;NA;173634;12;2020-08-31;303
2020-08-30;"Trenčiansky kraj";0;0;0;0;NA;173634;0;2020-08-30;291
2020-08-29;"Trenčiansky kraj";1;0;0;0;NA;173634;1;2020-08-29;291
2020-08-28;"Trenčiansky kraj";12;0;0;0;NA;173634;12;2020-08-28;290
2020-08-27;"Trenčiansky kraj";10;0;0;0;NA;173634;10;2020-08-27;278
2020-08-26;"Trenčiansky kraj";15;0;0;0;NA;173634;15;2020-08-26;268
2020-08-25;"Trenčiansky kraj";12;0;0;0;NA;173634;12;2020-08-25;253
2020-08-24;"Trenčiansky kraj";4;0;0;0;NA;173634;4;2020-08-24;241
2020-08-23;"Trenčiansky kraj";5;0;0;0;NA;173634;5;2020-08-23;237
2020-08-22;"Trenčiansky kraj";6;0;0;0;NA;173634;6;2020-08-22;232
2020-08-21;"Trenčiansky kraj";6;0;0;0;NA;173634;6;2020-08-21;226
2020-08-20;"Trenčiansky kraj";20;0;0;0;NA;173634;20;2020-08-20;220
2020-08-19;"Trenčiansky kraj";17;0;0;0;NA;173634;17;2020-08-19;200
2020-08-18;"Trenčiansky kraj";9;0;0;0;NA;173634;9;2020-08-18;183
2020-08-17;"Trenčiansky kraj";4;0;0;0;NA;173634;4;2020-08-17;174
2020-08-16;"Trenčiansky kraj";0;0;0;0;NA;173634;0;2020-08-16;170
2020-08-15;"Trenčiansky kraj";9;0;0;0;NA;173634;9;2020-08-15;170
2020-08-14;"Trenčiansky kraj";15;0;0;0;NA;173634;15;2020-08-14;161
2020-08-13;"Trenčiansky kraj";23;0;0;0;NA;173634;23;2020-08-13;146
2020-08-12;"Trenčiansky kraj";6;0;0;0;NA;173634;6;2020-08-12;123
2020-08-11;"Trenčiansky kraj";7;0;0;0;NA;173634;7;2020-08-11;117
2020-08-10;"Trenčiansky kraj";9;0;0;0;NA;173634;9;2020-08-10;110
2020-08-09;"Trenčiansky kraj";1;0;0;0;NA;173634;1;2020-08-09;101
2020-08-08;"Trenčiansky kraj";4;0;0;0;NA;173634;4;2020-08-08;100
2020-08-07;"Trenčiansky kraj";4;0;0;0;NA;173634;4;2020-08-07;96
2020-08-06;"Trenčiansky kraj";13;0;0;0;NA;173634;13;2020-08-06;92
2020-08-05;"Trenčiansky kraj";39;0;0;0;NA;173634;39;2020-08-05;79
2020-08-04;"Trenčiansky kraj";9;0;0;0;NA;173634;9;2020-08-04;40
2020-08-03;"Trenčiansky kraj";0;0;0;0;NA;173634;0;2020-08-03;31
2020-08-02;"Trenčiansky kraj";2;0;0;0;NA;173634;2;2020-08-02;31
2020-08-01;"Trenčiansky kraj";6;0;0;0;NA;173634;6;2020-08-01;29
2020-07-31;"Trenčiansky kraj";16;0;0;0;NA;173634;16;2020-07-31;23
2020-07-30;"Trenčiansky kraj";4;0;0;0;NA;173634;4;2020-07-30;7
2020-07-29;"Trenčiansky kraj";5;0;0;0;NA;173634;5;2020-07-29;3
2020-07-28;"Trenčiansky kraj";11;0;0;0;NA;173634;11;2020-07-28;-2
2020-07-27;"Trenčiansky kraj";4;0;0;0;NA;173634;4;2020-07-27;-13
2020-07-26;"Trenčiansky kraj";1;0;0;0;NA;173634;1;2020-07-26;-17
2020-07-25;"Trenčiansky kraj";7;0;0;0;NA;173634;7;2020-07-25;-18
2020-07-24;"Trenčiansky kraj";5;0;0;0;NA;173634;5;2020-07-24;-25
2020-07-23;"Trenčiansky kraj";10;0;0;0;NA;173634;10;2020-07-23;-30
2020-07-22;"Trenčiansky kraj";11;0;0;0;NA;173634;11;2020-07-22;-40
2020-07-21;"Trenčiansky kraj";6;0;0;0;NA;173634;6;2020-07-21;-51
2020-07-20;"Trenčiansky kraj";13;0;0;0;NA;173634;13;2020-07-20;-57
2020-07-19;"Trenčiansky kraj";0;0;0;0;NA;173634;0;2020-07-19;-70
2020-07-18;"Trenčiansky kraj";0;0;0;0;NA;173634;0;2020-07-18;-70
2020-07-17;"Trenčiansky kraj";1;0;0;0;NA;173634;1;2020-07-17;-70
2020-07-16;"Trenčiansky kraj";0;0;0;0;NA;173634;0;2020-07-16;-71
2020-07-15;"Trenčiansky kraj";2;0;0;0;NA;173634;2;2020-07-15;-71
2020-07-14;"Trenčiansky kraj";8;0;0;0;NA;173634;8;2020-07-14;-73
2020-07-13;"Trenčiansky kraj";1;0;0;0;NA;173634;1;2020-07-13;-81
2020-07-12;"Trenčiansky kraj";0;0;0;0;NA;173634;0;2020-07-12;-82
2020-07-11;"Trenčiansky kraj";0;0;0;0;NA;173634;0;2020-07-11;-82
2020-07-10;"Trenčiansky kraj";3;0;0;0;NA;173634;3;2020-07-10;-82
2020-07-09;"Trenčiansky kraj";2;0;0;0;NA;173634;2;2020-07-09;-85
2020-07-08;"Trenčiansky kraj";1;0;0;0;NA;173634;1;2020-07-08;-87
2020-07-07;"Trenčiansky kraj";9;0;0;0;NA;173634;9;2020-07-07;-88
2020-07-06;"Trenčiansky kraj";1;0;0;0;NA;173634;1;2020-07-06;-97
2020-07-05;"Trenčiansky kraj";1;0;0;0;NA;173634;1;2020-07-05;-98
2020-07-04;"Trenčiansky kraj";0;0;0;0;NA;173634;0;2020-07-04;-99
2020-07-03;"Trenčiansky kraj";2;0;0;0;NA;173634;2;2020-07-03;-99
2020-07-02;"Trenčiansky kraj";10;0;0;0;NA;173634;10;2020-07-02;-101
2020-07-01;"Trenčiansky kraj";1;0;0;0;NA;173634;1;2020-07-01;-111
2020-06-30;"Trenčiansky kraj";6;0;0;0;NA;173634;6;2020-06-30;-112
2020-06-29;"Trenčiansky kraj";1;0;0;0;NA;173634;1;2020-06-29;-118
2020-06-28;"Trenčiansky kraj";0;0;0;0;NA;173634;0;2020-06-28;-119
2020-06-27;"Trenčiansky kraj";0;0;0;0;NA;173634;0;2020-06-27;-119
2020-06-26;"Trenčiansky kraj";0;0;0;0;NA;173634;0;2020-06-26;-119
2020-06-25;"Trenčiansky kraj";2;0;0;0;NA;173634;2;2020-06-25;-119
2020-06-24;"Trenčiansky kraj";1;0;0;0;NA;173634;1;2020-06-24;-121
2020-06-23;"Trenčiansky kraj";0;0;0;0;NA;173634;0;2020-06-23;-122
2020-06-22;"Trenčiansky kraj";0;0;0;0;NA;173634;0;2020-06-22;-122
2020-06-21;"Trenčiansky kraj";0;0;0;0;NA;173634;0;2020-06-21;-122
2020-06-20;"Trenčiansky kraj";0;0;0;0;NA;173634;0;2020-06-20;-122
2020-06-19;"Trenčiansky kraj";0;0;0;0;NA;173634;0;2020-06-19;-122
2020-06-18;"Trenčiansky kraj";0;0;0;0;NA;173634;0;2020-06-18;-122
2020-06-17;"Trenčiansky kraj";0;0;0;0;NA;173634;0;2020-06-17;-122
2020-06-16;"Trenčiansky kraj";0;0;0;0;NA;173634;0;2020-06-16;-122
2020-06-14;"Trenčiansky kraj";0;0;0;0;NA;173634;0;2020-06-14;-122
2020-06-13;"Trenčiansky kraj";0;0;0;0;NA;173634;0;2020-06-13;-122
2020-06-12;"Trenčiansky kraj";0;0;0;0;NA;173634;0;2020-06-12;-122
2020-06-11;"Trenčiansky kraj";0;0;0;0;NA;173634;0;2020-06-11;-122
2020-06-10;"Trenčiansky kraj";1;0;0;0;NA;173634;1;2020-06-10;-122
2020-06-09;"Trenčiansky kraj";0;0;0;0;NA;173634;0;2020-06-09;-123
2020-06-08;"Trenčiansky kraj";0;0;0;0;NA;173634;0;2020-06-08;-123
2020-06-07;"Trenčiansky kraj";0;0;0;0;NA;173634;0;2020-06-07;-123
2020-06-05;"Trenčiansky kraj";0;0;0;0;NA;173634;0;2020-06-05;-123
2020-06-03;"Trenčiansky kraj";0;0;0;0;NA;173634;0;2020-06-03;-123
2020-06-02;"Trenčiansky kraj";0;0;0;0;NA;173634;0;2020-06-02;-123
2020-05-31;"Trenčiansky kraj";0;0;0;0;NA;173634;0;2020-05-31;-123
2020-05-29;"Trenčiansky kraj";0;0;0;0;NA;173634;0;2020-05-29;-123
2020-05-27;"Trenčiansky kraj";2;0;0;0;NA;173634;2;2020-05-27;-123
2020-05-26;"Trenčiansky kraj";0;0;0;0;NA;173634;0;2020-05-26;-125
2020-05-25;"Trenčiansky kraj";0;0;0;0;NA;173634;0;2020-05-25;-125
2020-05-24;"Trenčiansky kraj";0;0;0;0;NA;173634;0;2020-05-24;-125
2020-05-23;"Trenčiansky kraj";0;0;0;0;NA;173634;0;2020-05-23;-125
2020-05-22;"Trenčiansky kraj";0;0;0;0;NA;173634;0;2020-05-22;-125
2020-05-21;"Trenčiansky kraj";0;0;0;0;NA;173634;0;2020-05-21;-125
2020-05-20;"Trenčiansky kraj";0;0;0;0;NA;173634;0;2020-05-20;-125
2020-05-19;"Trenčiansky kraj";0;0;0;0;NA;173634;0;2020-05-19;-125
2020-05-17;"Trenčiansky kraj";0;0;0;0;NA;173634;0;2020-05-17;-125
2020-05-16;"Trenčiansky kraj";0;0;0;0;NA;173634;0;2020-05-16;-125
2020-05-15;"Trenčiansky kraj";1;0;0;0;NA;173634;1;2020-05-15;-125
2020-05-14;"Trenčiansky kraj";2;0;0;0;NA;173634;2;2020-05-14;-126
2020-05-13;"Trenčiansky kraj";1;0;0;0;NA;173634;1;2020-05-13;-128
2020-05-12;"Trenčiansky kraj";1;0;0;0;NA;173634;1;2020-05-12;-129
2020-05-11;"Trenčiansky kraj";3;0;0;0;NA;173634;3;2020-05-11;-130
2020-05-09;"Trenčiansky kraj";2;0;0;0;NA;173634;2;2020-05-09;-133
2020-05-07;"Trenčiansky kraj";6;0;0;0;NA;173634;6;2020-05-07;-135
2020-05-06;"Trenčiansky kraj";0;0;0;0;NA;173634;0;2020-05-06;-141
2020-05-05;"Trenčiansky kraj";2;0;0;0;NA;173634;2;2020-05-05;-141
2020-05-04;"Trenčiansky kraj";0;0;0;0;NA;173634;0;2020-05-04;-143
2020-05-03;"Trenčiansky kraj";0;0;0;0;NA;173634;0;2020-05-03;-143
2020-05-02;"Trenčiansky kraj";0;0;0;0;NA;173634;0;2020-05-02;-143
2020-05-01;"Trenčiansky kraj";0;0;0;0;NA;173634;0;2020-05-01;-143
2020-04-30;"Trenčiansky kraj";0;0;0;0;NA;173634;0;2020-04-30;-143
2020-04-29;"Trenčiansky kraj";2;0;0;0;NA;173634;2;2020-04-29;-143
2020-04-28;"Trenčiansky kraj";1;0;0;0;NA;173634;1;2020-04-28;-145
2020-04-27;"Trenčiansky kraj";0;0;0;0;NA;173634;0;2020-04-27;-146
2020-04-26;"Trenčiansky kraj";1;0;0;0;NA;173634;1;2020-04-26;-146
2020-04-25;"Trenčiansky kraj";0;0;0;0;NA;173634;0;2020-04-25;-147
2020-04-24;"Trenčiansky kraj";0;0;0;0;NA;173634;0;2020-04-24;-147
2020-04-23;"Trenčiansky kraj";11;0;0;0;NA;173634;11;2020-04-23;-147
2020-04-22;"Trenčiansky kraj";1;0;0;0;NA;173634;1;2020-04-22;-158
2020-04-21;"Trenčiansky kraj";11;0;0;0;NA;173634;11;2020-04-21;-159
2020-04-20;"Trenčiansky kraj";15;0;0;0;NA;173634;15;2020-04-20;-170
2020-04-19;"Trenčiansky kraj";2;0;0;0;NA;173634;2;2020-04-19;-185
2020-04-18;"Trenčiansky kraj";3;0;0;0;NA;173634;3;2020-04-18;-187
2020-04-17;"Trenčiansky kraj";4;0;0;0;NA;173634;4;2020-04-17;-190
2020-04-16;"Trenčiansky kraj";10;0;0;0;NA;173634;10;2020-04-16;-194
2020-04-15;"Trenčiansky kraj";4;0;0;0;NA;173634;4;2020-04-15;-204
2020-04-14;"Trenčiansky kraj";0;0;0;0;NA;173634;0;2020-04-14;-208
2020-04-13;"Trenčiansky kraj";1;0;0;0;NA;173634;1;2020-04-13;-208
2020-04-12;"Trenčiansky kraj";2;0;0;0;NA;173634;2;2020-04-12;-209
2020-04-11;"Trenčiansky kraj";3;0;0;0;NA;173634;3;2020-04-11;-211
2020-04-10;"Trenčiansky kraj";0;0;0;0;NA;173634;0;2020-04-10;-214
2020-04-09;"Trenčiansky kraj";0;0;0;0;NA;173634;0;2020-04-09;-214
2020-04-08;"Trenčiansky kraj";2;0;0;0;NA;173634;2;2020-04-08;-214
2020-04-07;"Trenčiansky kraj";18;0;0;0;NA;173634;18;2020-04-07;-216
2020-04-06;"Trenčiansky kraj";0;0;0;0;NA;173634;0;2020-04-06;-234
2020-04-05;"Trenčiansky kraj";3;0;0;0;NA;173634;3;2020-04-05;-234
2020-04-04;"Trenčiansky kraj";5;0;0;0;NA;173634;5;2020-04-04;-237
2020-04-03;"Trenčiansky kraj";4;0;0;0;NA;173634;4;2020-04-03;-242
2020-04-02;"Trenčiansky kraj";1;0;0;0;NA;173634;1;2020-04-02;-246
2020-04-01;"Trenčiansky kraj";3;0;0;0;NA;173634;3;2020-04-01;-247
2020-03-31;"Trenčiansky kraj";1;0;0;0;NA;173634;1;2020-03-31;-250
2020-03-30;"Trenčiansky kraj";3;0;0;0;NA;173634;3;2020-03-30;-251
2020-03-29;"Trenčiansky kraj";6;0;0;0;NA;173634;6;2020-03-29;-254
2020-03-28;"Trenčiansky kraj";9;0;0;0;NA;173634;9;2020-03-28;-260
2020-03-27;"Trenčiansky kraj";2;0;0;0;NA;173634;2;2020-03-27;-269
2020-03-26;"Trenčiansky kraj";6;0;0;0;NA;173634;6;2020-03-26;-271
2020-03-25;"Trenčiansky kraj";3;0;0;0;NA;173634;3;2020-03-25;-277
2020-03-24;"Trenčiansky kraj";1;0;0;0;NA;173634;1;2020-03-24;-280
2020-03-23;"Trenčiansky kraj";0;0;0;0;NA;173634;0;2020-03-23;-281
2020-03-22;"Trenčiansky kraj";0;0;0;0;NA;173634;0;2020-03-22;-281
2020-03-21;"Trenčiansky kraj";2;0;0;0;NA;173634;2;2020-03-21;-281
2020-03-20;"Trenčiansky kraj";2;0;0;0;NA;173634;2;2020-03-20;-283
2020-03-19;"Trenčiansky kraj";8;0;0;0;NA;173634;8;2020-03-19;-285
2020-03-18;"Trenčiansky kraj";0;0;0;0;NA;173634;0;2020-03-18;-293
2020-03-17;"Trenčiansky kraj";0;0;0;0;NA;173634;0;2020-03-17;-293
2020-03-16;"Trenčiansky kraj";1;0;0;0;NA;173634;1;2020-03-16;-293
2020-03-15;"Trenčiansky kraj";5;0;0;0;NA;173634;5;2020-03-15;-294
2020-03-14;"Trenčiansky kraj";0;0;0;0;NA;173634;0;2020-03-14;-299
2020-03-13;"Trenčiansky kraj";0;0;0;0;NA;173634;0;2020-03-13;-299
2020-03-12;"Trenčiansky kraj";1;0;0;0;NA;173634;1;2020-03-12;-299
2020-03-11;"Trenčiansky kraj";0;0;0;0;NA;173634;0;2020-03-11;-300
2020-03-09;"Trenčiansky kraj";0;0;0;0;NA;173634;0;2020-03-09;-300
2020-03-08;"Trenčiansky kraj";0;0;0;0;NA;173634;0;2020-03-08;-300
2020-03-07;"Trenčiansky kraj";0;0;0;0;NA;173634;0;2020-03-07;-300
2020-03-06;"Trenčiansky kraj";0;0;0;0;NA;173634;0;2020-03-06;-300
2022-01-11;"Trnavský kraj";384;0;0;0;95048;149518;384;2022-01-11;149518
2022-01-10;"Trnavský kraj";258;0;0;0;NA;149518;258;2022-01-10;149134
2022-01-09;"Trnavský kraj";35;1578;15;1593;NA;149518;50;2022-01-09;148876
2022-01-08;"Trnavský kraj";364;983;28;1011;NA;149518;392;2022-01-08;148826
2022-01-07;"Trnavský kraj";332;1882;46;1928;NA;149518;378;2022-01-07;148434
2022-01-06;"Trnavský kraj";234;765;20;785;NA;149518;254;2022-01-06;148056
2022-01-05;"Trnavský kraj";416;1905;37;1942;NA;149518;453;2022-01-05;147802
2022-01-04;"Trnavský kraj";538;2337;37;2374;NA;149518;575;2022-01-04;147349
2022-01-03;"Trnavský kraj";441;3869;65;3934;NA;149518;506;2022-01-03;146774
2022-01-02;"Trnavský kraj";79;1561;21;1582;NA;149518;100;2022-01-02;146268
2022-01-01;"Trnavský kraj";4;190;7;197;NA;149518;11;2022-01-01;146168
2021-12-31;"Trnavský kraj";485;1244;60;1304;NA;149518;545;2021-12-31;146157
2021-12-30;"Trnavský kraj";401;1919;58;1977;NA;149518;459;2021-12-30;145612
2021-12-29;"Trnavský kraj";401;1756;70;1826;NA;149518;471;2021-12-29;145153
2021-12-28;"Trnavský kraj";633;1931;77;2008;NA;149518;710;2021-12-28;144682
2021-12-27;"Trnavský kraj";463;2802;134;2936;NA;149518;597;2021-12-27;143972
2021-12-26;"Trnavský kraj";253;818;25;843;NA;149518;278;2021-12-26;143375
2021-12-25;"Trnavský kraj";104;341;41;382;NA;149518;145;2021-12-25;143097
2021-12-24;"Trnavský kraj";216;369;27;396;NA;149518;243;2021-12-24;142952
2021-12-23;"Trnavský kraj";570;1802;102;1904;NA;149518;672;2021-12-23;142709
2021-12-22;"Trnavský kraj";545;1732;81;1813;NA;149518;626;2021-12-22;142037
2021-12-21;"Trnavský kraj";699;2567;89;2656;NA;149518;788;2021-12-21;141411
2021-12-20;"Trnavský kraj";438;3916;103;4019;NA;149518;541;2021-12-20;140623
2021-12-19;"Trnavský kraj";155;1762;63;1825;NA;149518;218;2021-12-19;140082
2021-12-18;"Trnavský kraj";627;1302;77;1379;NA;149518;704;2021-12-18;139864
2021-12-17;"Trnavský kraj";576;2276;109;2385;NA;149518;685;2021-12-17;139160
2021-12-16;"Trnavský kraj";653;2521;123;2644;NA;149518;776;2021-12-16;138475
2021-12-15;"Trnavský kraj";746;2198;120;2318;NA;149518;866;2021-12-15;137699
2021-12-14;"Trnavský kraj";976;2718;134;2852;NA;149518;1110;2021-12-14;136833
2021-12-13;"Trnavský kraj";521;4845;175;5020;NA;149518;696;2021-12-13;135723
2021-12-12;"Trnavský kraj";337;2117;87;2204;NA;149518;424;2021-12-12;135027
2021-12-11;"Trnavský kraj";720;1324;83;1407;NA;149518;803;2021-12-11;134603
2021-12-10;"Trnavský kraj";702;2884;136;3020;NA;149518;838;2021-12-10;133800
2021-12-09;"Trnavský kraj";926;2308;96;2404;NA;149518;1022;2021-12-09;132962
2021-12-08;"Trnavský kraj";1233;2547;137;2684;NA;149518;1370;2021-12-08;131940
2021-12-07;"Trnavský kraj";1159;3637;174;3811;NA;149518;1333;2021-12-07;130570
2021-12-06;"Trnavský kraj";911;3649;208;3857;NA;149518;1119;2021-12-06;129237
2021-12-05;"Trnavský kraj";269;2302;106;2408;NA;149518;375;2021-12-05;128118
2021-12-04;"Trnavský kraj";1225;1608;115;1723;NA;149518;1340;2021-12-04;127743
2021-12-03;"Trnavský kraj";1246;2998;201;3199;NA;149518;1447;2021-12-03;126403
2021-12-02;"Trnavský kraj";1809;2379;188;2567;NA;149518;1997;2021-12-02;124956
2021-12-01;"Trnavský kraj";738;3011;179;3190;NA;149518;917;2021-12-01;122959
2021-11-30;"Trnavský kraj";1166;4217;202;4419;NA;149518;1368;2021-11-30;122042
2021-11-29;"Trnavský kraj";814;5356;299;5655;NA;149518;1113;2021-11-29;120674
2021-11-28;"Trnavský kraj";482;3086;146;3232;NA;149518;628;2021-11-28;119561
2021-11-27;"Trnavský kraj";1186;2240;206;2446;NA;149518;1392;2021-11-27;118933
2021-11-26;"Trnavský kraj";880;2895;202;3097;NA;149518;1082;2021-11-26;117541
2021-11-25;"Trnavský kraj";1002;2680;158;2838;NA;149518;1160;2021-11-25;116459
2021-11-24;"Trnavský kraj";1060;3442;250;3692;NA;149518;1310;2021-11-24;115299
2021-11-23;"Trnavský kraj";1078;3714;273;3987;NA;149518;1351;2021-11-23;113989
2021-11-22;"Trnavský kraj";696;4028;295;4323;NA;149518;991;2021-11-22;112638
2021-11-21;"Trnavský kraj";298;2270;212;2482;NA;149518;510;2021-11-21;111647
2021-11-20;"Trnavský kraj";826;1529;196;1725;NA;149518;1022;2021-11-20;111137
2021-11-19;"Trnavský kraj";901;3369;315;3684;NA;149518;1216;2021-11-19;110115
2021-11-18;"Trnavský kraj";796;2871;240;3111;NA;149518;1036;2021-11-18;108899
2021-11-17;"Trnavský kraj";769;1186;139;1325;NA;149518;908;2021-11-17;107863
2021-11-16;"Trnavský kraj";591;2754;206;2960;NA;149518;797;2021-11-16;106955
2021-11-15;"Trnavský kraj";606;3350;239;3589;NA;149518;845;2021-11-15;106158
2021-11-14;"Trnavský kraj";236;1578;141;1719;NA;149518;377;2021-11-14;105313
2021-11-13;"Trnavský kraj";815;1314;132;1446;NA;149518;947;2021-11-13;104936
2021-11-12;"Trnavský kraj";563;2584;156;2740;NA;149518;719;2021-11-12;103989
2021-11-11;"Trnavský kraj";512;2426;161;2587;NA;149518;673;2021-11-11;103270
2021-11-10;"Trnavský kraj";590;2315;173;2488;NA;149518;763;2021-11-10;102597
2021-11-09;"Trnavský kraj";585;2538;187;2725;NA;149518;772;2021-11-09;101834
2021-11-08;"Trnavský kraj";357;2715;163;2878;NA;149518;520;2021-11-08;101062
2021-11-07;"Trnavský kraj";162;1349;111;1460;NA;149518;273;2021-11-07;100542
2021-11-06;"Trnavský kraj";391;1287;82;1369;NA;149518;473;2021-11-06;100269
2021-11-05;"Trnavský kraj";447;2202;102;2304;NA;149518;549;2021-11-05;99796
2021-11-04;"Trnavský kraj";432;2289;112;2401;NA;149518;544;2021-11-04;99247
2021-11-03;"Trnavský kraj";420;2091;97;2188;NA;149518;517;2021-11-03;98703
2021-11-02;"Trnavský kraj";365;2767;124;2891;NA;149518;489;2021-11-02;98186
2021-11-01;"Trnavský kraj";220;583;27;610;NA;149518;247;2021-11-01;97697
2021-10-31;"Trnavský kraj";61;887;62;949;NA;149518;123;2021-10-31;97450
2021-10-30;"Trnavský kraj";251;1099;50;1149;NA;149518;301;2021-10-30;97327
2021-10-29;"Trnavský kraj";312;2123;53;2176;NA;149518;365;2021-10-29;97026
2021-10-28;"Trnavský kraj";339;2034;65;2099;NA;149518;404;2021-10-28;96661
2021-10-27;"Trnavský kraj";232;1884;58;1942;NA;149518;290;2021-10-27;96257
2021-10-26;"Trnavský kraj";366;1964;54;2018;NA;149518;420;2021-10-26;95967
2021-10-25;"Trnavský kraj";142;2786;72;2858;NA;149518;214;2021-10-25;95547
2021-10-24;"Trnavský kraj";11;990;30;1020;NA;149518;41;2021-10-24;95333
2021-10-23;"Trnavský kraj";228;1126;27;1153;NA;149518;255;2021-10-23;95292
2021-10-22;"Trnavský kraj";204;2249;51;2300;NA;149518;255;2021-10-22;95037
2021-10-21;"Trnavský kraj";188;1671;46;1717;NA;149518;234;2021-10-21;94782
2021-10-20;"Trnavský kraj";212;1634;47;1681;NA;149518;259;2021-10-20;94548
2021-10-19;"Trnavský kraj";240;1848;30;1878;NA;149518;270;2021-10-19;94289
2021-10-18;"Trnavský kraj";95;2316;72;2388;NA;149518;167;2021-10-18;94019
2021-10-17;"Trnavský kraj";5;1218;17;1235;NA;149518;22;2021-10-17;93852
2021-10-16;"Trnavský kraj";129;1233;17;1250;NA;149518;146;2021-10-16;93830
2021-10-15;"Trnavský kraj";122;2121;24;2145;NA;149518;146;2021-10-15;93684
2021-10-14;"Trnavský kraj";131;1663;24;1687;NA;149518;155;2021-10-14;93538
2021-10-13;"Trnavský kraj";128;2072;23;2095;NA;149518;151;2021-10-13;93383
2021-10-12;"Trnavský kraj";189;2788;38;2826;NA;149518;227;2021-10-12;93232
2021-10-11;"Trnavský kraj";115;2621;35;2656;NA;149518;150;2021-10-11;93005
2021-10-10;"Trnavský kraj";2;993;15;1008;NA;149518;17;2021-10-10;92855
2021-10-09;"Trnavský kraj";151;1099;10;1109;NA;149518;161;2021-10-09;92838
2021-10-08;"Trnavský kraj";106;2326;34;2360;NA;149518;140;2021-10-08;92677
2021-10-07;"Trnavský kraj";151;1714;25;1739;NA;149518;176;2021-10-07;92537
2021-10-06;"Trnavský kraj";122;1929;27;1956;NA;149518;149;2021-10-06;92361
2021-10-05;"Trnavský kraj";220;3726;34;3760;NA;149518;254;2021-10-05;92212
2021-10-04;"Trnavský kraj";54;1963;47;2010;NA;149518;101;2021-10-04;91958
2021-10-03;"Trnavský kraj";1;1106;17;1123;NA;149518;18;2021-10-03;91857
2021-10-02;"Trnavský kraj";52;1055;12;1067;NA;149518;64;2021-10-02;91839
2021-10-01;"Trnavský kraj";113;2243;17;2260;NA;149518;130;2021-10-01;91775
2021-09-30;"Trnavský kraj";109;1872;18;1890;NA;149518;127;2021-09-30;91645
2021-09-29;"Trnavský kraj";83;1331;11;1342;NA;149518;94;2021-09-29;91518
2021-09-28;"Trnavský kraj";135;1934;31;1965;NA;149518;166;2021-09-28;91424
2021-09-27;"Trnavský kraj";80;2084;25;2109;NA;149518;105;2021-09-27;91258
2021-09-26;"Trnavský kraj";2;1048;12;1060;NA;149518;14;2021-09-26;91153
2021-09-25;"Trnavský kraj";61;1105;9;1114;NA;149518;70;2021-09-25;91139
2021-09-24;"Trnavský kraj";41;2229;15;2244;NA;149518;56;2021-09-24;91069
2021-09-23;"Trnavský kraj";89;1691;16;1707;NA;149518;105;2021-09-23;91013
2021-09-22;"Trnavský kraj";119;1706;28;1734;NA;149518;147;2021-09-22;90908
2021-09-21;"Trnavský kraj";108;1505;17;1522;NA;149518;125;2021-09-21;90761
2021-09-20;"Trnavský kraj";50;1652;20;1672;NA;149518;70;2021-09-20;90636
2021-09-19;"Trnavský kraj";2;924;8;932;NA;149518;10;2021-09-19;90566
2021-09-18;"Trnavský kraj";100;982;6;988;NA;149518;106;2021-09-18;90556
2021-09-17;"Trnavský kraj";77;1709;20;1729;NA;149518;97;2021-09-17;90450
2021-09-16;"Trnavský kraj";105;1279;32;1311;NA;149518;137;2021-09-16;90353
2021-09-15;"Trnavský kraj";59;841;5;846;NA;149518;64;2021-09-15;90216
2021-09-14;"Trnavský kraj";38;1583;12;1595;NA;149518;50;2021-09-14;90152
2021-09-13;"Trnavský kraj";56;1410;16;1426;NA;149518;72;2021-09-13;90102
2021-09-12;"Trnavský kraj";0;653;1;654;NA;149518;1;2021-09-12;90030
2021-09-11;"Trnavský kraj";37;971;10;981;NA;149518;47;2021-09-11;90029
2021-09-10;"Trnavský kraj";43;1441;9;1450;NA;149518;52;2021-09-10;89982
2021-09-09;"Trnavský kraj";42;954;13;967;NA;149518;55;2021-09-09;89930
2021-09-08;"Trnavský kraj";65;802;15;817;NA;149518;80;2021-09-08;89875
2021-09-07;"Trnavský kraj";29;844;5;849;NA;149518;34;2021-09-07;89795
2021-09-06;"Trnavský kraj";18;1234;14;1248;NA;149518;32;2021-09-06;89761
2021-09-05;"Trnavský kraj";2;580;4;584;NA;149518;6;2021-09-05;89729
2021-09-04;"Trnavský kraj";17;868;6;874;NA;149518;23;2021-09-04;89723
2021-09-03;"Trnavský kraj";14;1060;5;1065;NA;149518;19;2021-09-03;89700
2021-09-02;"Trnavský kraj";30;830;10;840;NA;149518;40;2021-09-02;89681
2021-09-01;"Trnavský kraj";6;409;4;413;NA;149518;10;2021-09-01;89641
2021-08-31;"Trnavský kraj";13;884;3;887;NA;149518;16;2021-08-31;89631
2021-08-30;"Trnavský kraj";7;904;1;905;NA;149518;8;2021-08-30;89615
2021-08-29;"Trnavský kraj";8;427;1;428;NA;149518;9;2021-08-29;89607
2021-08-28;"Trnavský kraj";17;694;2;696;NA;149518;19;2021-08-28;89598
2021-08-27;"Trnavský kraj";1;1186;4;1190;NA;149518;5;2021-08-27;89579
2021-08-26;"Trnavský kraj";8;713;3;716;NA;149518;11;2021-08-26;89574
2021-08-25;"Trnavský kraj";11;683;6;689;NA;149518;17;2021-08-25;89563
2021-08-24;"Trnavský kraj";7;801;1;802;NA;149518;8;2021-08-24;89546
2021-08-23;"Trnavský kraj";4;844;1;845;NA;149518;5;2021-08-23;89538
2021-08-22;"Trnavský kraj";0;474;0;474;NA;149518;0;2021-08-22;89533
2021-08-21;"Trnavský kraj";8;703;0;703;NA;149518;8;2021-08-21;89533
2021-08-20;"Trnavský kraj";4;1095;4;1099;NA;149518;8;2021-08-20;89525
2021-08-19;"Trnavský kraj";10;875;3;878;NA;149518;13;2021-08-19;89517
2021-08-18;"Trnavský kraj";6;789;2;791;NA;149518;8;2021-08-18;89504
2021-08-17;"Trnavský kraj";7;524;4;528;NA;149518;11;2021-08-17;89496
2021-08-16;"Trnavský kraj";9;966;3;969;NA;149518;12;2021-08-16;89485
2021-08-15;"Trnavský kraj";0;556;1;557;NA;149518;1;2021-08-15;89473
2021-08-14;"Trnavský kraj";10;801;3;804;NA;149518;13;2021-08-14;89472
2021-08-13;"Trnavský kraj";5;1077;6;1083;NA;149518;11;2021-08-13;89459
2021-08-12;"Trnavský kraj";3;666;3;669;NA;149518;6;2021-08-12;89448
2021-08-11;"Trnavský kraj";7;576;2;578;NA;149518;9;2021-08-11;89442
2021-08-10;"Trnavský kraj";3;757;3;760;NA;149518;6;2021-08-10;89433
2021-08-09;"Trnavský kraj";12;808;0;808;NA;149518;12;2021-08-09;89427
2021-08-08;"Trnavský kraj";1;545;0;545;NA;149518;1;2021-08-08;89415
2021-08-07;"Trnavský kraj";9;724;0;724;NA;149518;9;2021-08-07;89414
2021-08-06;"Trnavský kraj";3;988;0;988;NA;149518;3;2021-08-06;89405
2021-08-05;"Trnavský kraj";2;662;1;663;NA;149518;3;2021-08-05;89402
2021-08-04;"Trnavský kraj";1;891;1;892;NA;149518;2;2021-08-04;89399
2021-08-03;"Trnavský kraj";13;645;0;645;NA;149518;13;2021-08-03;89397
2021-08-02;"Trnavský kraj";2;725;1;726;NA;149518;3;2021-08-02;89384
2021-08-01;"Trnavský kraj";0;565;2;567;NA;149518;2;2021-08-01;89381
2021-07-31;"Trnavský kraj";3;886;0;886;NA;149518;3;2021-07-31;89379
2021-07-30;"Trnavský kraj";3;1084;3;1087;NA;149518;6;2021-07-30;89376
2021-07-29;"Trnavský kraj";1;775;0;775;NA;149518;1;2021-07-29;89370
2021-07-28;"Trnavský kraj";5;794;1;795;NA;149518;6;2021-07-28;89369
2021-07-27;"Trnavský kraj";7;623;2;625;NA;149518;9;2021-07-27;89363
2021-07-26;"Trnavský kraj";2;857;2;859;NA;149518;4;2021-07-26;89354
2021-07-25;"Trnavský kraj";0;707;0;707;NA;149518;0;2021-07-25;89350
2021-07-24;"Trnavský kraj";4;828;2;830;NA;149518;6;2021-07-24;89350
2021-07-23;"Trnavský kraj";3;1057;0;1057;NA;149518;3;2021-07-23;89344
2021-07-22;"Trnavský kraj";0;671;2;673;NA;149518;2;2021-07-22;89341
2021-07-21;"Trnavský kraj";2;660;2;662;NA;149518;4;2021-07-21;89339
2021-07-20;"Trnavský kraj";2;593;0;593;NA;149518;2;2021-07-20;89335
2021-07-19;"Trnavský kraj";9;886;0;886;NA;149518;9;2021-07-19;89333
2021-07-18;"Trnavský kraj";0;600;2;602;NA;149518;2;2021-07-18;89324
2021-07-17;"Trnavský kraj";8;796;0;796;NA;149518;8;2021-07-17;89322
2021-07-16;"Trnavský kraj";11;963;0;963;NA;149518;11;2021-07-16;89314
2021-07-15;"Trnavský kraj";4;832;1;833;NA;149518;5;2021-07-15;89303
2021-07-14;"Trnavský kraj";1;699;1;700;NA;149518;2;2021-07-14;89298
2021-07-13;"Trnavský kraj";1;693;1;694;NA;149518;2;2021-07-13;89296
2021-07-12;"Trnavský kraj";4;959;0;959;NA;149518;4;2021-07-12;89294
2021-07-11;"Trnavský kraj";0;692;0;692;NA;149518;0;2021-07-11;89290
2021-07-10;"Trnavský kraj";1;803;0;803;NA;149518;1;2021-07-10;89290
2021-07-09;"Trnavský kraj";3;1262;3;1265;NA;149518;6;2021-07-09;89289
2021-07-08;"Trnavský kraj";4;755;0;755;NA;149518;4;2021-07-08;89283
2021-07-07;"Trnavský kraj";9;924;2;926;NA;149518;11;2021-07-07;89279
2021-07-06;"Trnavský kraj";2;1401;1;1402;NA;149518;3;2021-07-06;89268
2021-07-05;"Trnavský kraj";1;503;2;505;NA;149518;3;2021-07-05;89265
2021-07-04;"Trnavský kraj";0;1129;3;1132;NA;149518;3;2021-07-04;89262
2021-07-03;"Trnavský kraj";4;815;0;815;NA;149518;4;2021-07-03;89259
2021-07-02;"Trnavský kraj";2;1137;2;1139;NA;149518;4;2021-07-02;89255
2021-07-01;"Trnavský kraj";4;487;0;487;NA;149518;4;2021-07-01;89251
2021-06-30;"Trnavský kraj";0;5135;1;5136;NA;149518;1;2021-06-30;89247
2021-06-29;"Trnavský kraj";4;2563;1;2564;NA;149518;5;2021-06-29;89246
2021-06-28;"Trnavský kraj";2;2600;1;2601;NA;149518;3;2021-06-28;89241
2021-06-27;"Trnavský kraj";0;3213;0;3213;NA;149518;0;2021-06-27;89238
2021-06-26;"Trnavský kraj";3;3871;1;3872;NA;149518;4;2021-06-26;89238
2021-06-25;"Trnavský kraj";2;4374;3;4377;NA;149518;5;2021-06-25;89234
2021-06-24;"Trnavský kraj";4;2520;3;2523;NA;149518;7;2021-06-24;89229
2021-06-23;"Trnavský kraj";4;2842;2;2844;NA;149518;6;2021-06-23;89222
2021-06-22;"Trnavský kraj";2;2996;1;2997;NA;149518;3;2021-06-22;89216
2021-06-21;"Trnavský kraj";6;3114;5;3119;NA;149518;11;2021-06-21;89213
2021-06-20;"Trnavský kraj";0;3952;1;3953;NA;149518;1;2021-06-20;89202
2021-06-19;"Trnavský kraj";3;4735;2;4737;NA;149518;5;2021-06-19;89201
2021-06-18;"Trnavský kraj";5;6125;4;6129;NA;149518;9;2021-06-18;89196
2021-06-17;"Trnavský kraj";3;3340;0;3340;NA;149518;3;2021-06-17;89187
2021-06-16;"Trnavský kraj";6;2926;3;2929;NA;149518;9;2021-06-16;89184
2021-06-15;"Trnavský kraj";8;3234;3;3237;NA;149518;11;2021-06-15;89175
2021-06-14;"Trnavský kraj";2;3829;1;3830;NA;149518;3;2021-06-14;89164
2021-06-13;"Trnavský kraj";0;5001;8;5009;NA;149518;8;2021-06-13;89161
2021-06-12;"Trnavský kraj";11;5807;2;5809;NA;149518;13;2021-06-12;89153
2021-06-11;"Trnavský kraj";17;5850;4;5854;NA;149518;21;2021-06-11;89140
2021-06-10;"Trnavský kraj";14;3476;1;3477;NA;149518;15;2021-06-10;89119
2021-06-09;"Trnavský kraj";10;3681;1;3682;NA;149518;11;2021-06-09;89104
2021-06-08;"Trnavský kraj";8;3344;4;3348;NA;149518;12;2021-06-08;89093
2021-06-07;"Trnavský kraj";12;4498;8;4506;NA;149518;20;2021-06-07;89081
2021-06-06;"Trnavský kraj";0;5517;2;5519;NA;149518;2;2021-06-06;89061
2021-06-05;"Trnavský kraj";20;6905;8;6913;NA;149518;28;2021-06-05;89059
2021-06-04;"Trnavský kraj";9;6735;10;6745;NA;149518;19;2021-06-04;89031
2021-06-03;"Trnavský kraj";14;4361;11;4372;NA;149518;25;2021-06-03;89012
2021-06-02;"Trnavský kraj";4;4148;11;4159;NA;149518;15;2021-06-02;88987
2021-06-01;"Trnavský kraj";18;3662;5;3667;NA;149518;23;2021-06-01;88972
2021-05-31;"Trnavský kraj";14;5515;16;5531;NA;149518;30;2021-05-31;88949
2021-05-30;"Trnavský kraj";0;6473;7;6480;NA;149518;7;2021-05-30;88919
2021-05-29;"Trnavský kraj";11;8964;4;8968;NA;149518;15;2021-05-29;88912
2021-05-28;"Trnavský kraj";14;7160;11;7171;NA;149518;25;2021-05-28;88897
2021-05-27;"Trnavský kraj";22;4753;8;4761;NA;149518;30;2021-05-27;88872
2021-05-26;"Trnavský kraj";6;4870;8;4878;NA;149518;14;2021-05-26;88842
2021-05-25;"Trnavský kraj";19;5026;27;5053;NA;149518;46;2021-05-25;88828
2021-05-24;"Trnavský kraj";15;6520;22;6542;NA;149518;37;2021-05-24;88782
2021-05-23;"Trnavský kraj";0;7920;8;7928;NA;149518;8;2021-05-23;88745
2021-05-22;"Trnavský kraj";13;13381;21;13402;NA;149518;34;2021-05-22;88737
2021-05-21;"Trnavský kraj";16;8525;19;8544;NA;149518;35;2021-05-21;88703
2021-05-20;"Trnavský kraj";15;5511;11;5522;NA;149518;26;2021-05-20;88668
2021-05-19;"Trnavský kraj";18;5431;13;5444;NA;149518;31;2021-05-19;88642
2021-05-18;"Trnavský kraj";26;5768;15;5783;NA;149518;41;2021-05-18;88611
2021-05-17;"Trnavský kraj";17;6262;24;6286;NA;149518;41;2021-05-17;88570
2021-05-16;"Trnavský kraj";10;9984;8;9992;NA;149518;18;2021-05-16;88529
2021-05-15;"Trnavský kraj";11;18525;14;18539;NA;149518;25;2021-05-15;88511
2021-05-14;"Trnavský kraj";34;10279;21;10300;NA;149518;55;2021-05-14;88486
2021-05-13;"Trnavský kraj";26;6913;12;6925;NA;149518;38;2021-05-13;88431
2021-05-12;"Trnavský kraj";34;6621;26;6647;NA;149518;60;2021-05-12;88393
2021-05-11;"Trnavský kraj";32;6393;13;6406;NA;149518;45;2021-05-11;88333
2021-05-10;"Trnavský kraj";58;9139;24;9163;NA;149518;82;2021-05-10;88288
2021-05-09;"Trnavský kraj";21;12570;12;12582;NA;149518;33;2021-05-09;88206
2021-05-08;"Trnavský kraj";4;23028;22;23050;NA;149518;26;2021-05-08;88173
2021-05-07;"Trnavský kraj";26;15465;30;15495;NA;149518;56;2021-05-07;88147
2021-05-06;"Trnavský kraj";22;8407;22;8429;NA;149518;44;2021-05-06;88091
2021-05-05;"Trnavský kraj";34;6273;22;6295;NA;149518;56;2021-05-05;88047
2021-05-04;"Trnavský kraj";51;8538;17;8555;NA;149518;68;2021-05-04;87991
2021-05-03;"Trnavský kraj";20;8957;22;8979;NA;149518;42;2021-05-03;87923
2021-05-02;"Trnavský kraj";0;25657;29;25686;NA;149518;29;2021-05-02;87881
2021-05-01;"Trnavský kraj";30;81353;64;81417;NA;149518;94;2021-05-01;87852
2021-04-30;"Trnavský kraj";45;26846;35;26881;NA;149518;80;2021-04-30;87758
2021-04-29;"Trnavský kraj";25;20323;28;20351;NA;149518;53;2021-04-29;87678
2021-04-28;"Trnavský kraj";46;8896;28;8924;NA;149518;74;2021-04-28;87625
2021-04-27;"Trnavský kraj";54;8756;37;8793;NA;149518;91;2021-04-27;87551
2021-04-26;"Trnavský kraj";53;16116;42;16158;NA;149518;95;2021-04-26;87460
2021-04-25;"Trnavský kraj";0;30183;24;30207;NA;149518;24;2021-04-25;87365
2021-04-24;"Trnavský kraj";46;126077;84;126161;NA;149518;130;2021-04-24;87341
2021-04-23;"Trnavský kraj";71;25741;53;25794;NA;149518;124;2021-04-23;87211
2021-04-22;"Trnavský kraj";40;10904;25;10929;NA;149518;65;2021-04-22;87087
2021-04-21;"Trnavský kraj";60;10748;45;10793;NA;149518;105;2021-04-21;87022
2021-04-20;"Trnavský kraj";57;13504;28;13532;NA;149518;85;2021-04-20;86917
2021-04-19;"Trnavský kraj";46;14603;18;14621;NA;149518;64;2021-04-19;86832
2021-04-18;"Trnavský kraj";7;40843;43;40886;NA;149518;50;2021-04-18;86768
2021-04-17;"Trnavský kraj";58;118102;89;118191;NA;149518;147;2021-04-17;86718
2021-04-16;"Trnavský kraj";67;25962;48;26010;NA;149518;115;2021-04-16;86571
2021-04-15;"Trnavský kraj";65;11373;36;11409;NA;149518;101;2021-04-15;86456
2021-04-14;"Trnavský kraj";78;18442;53;18495;NA;149518;131;2021-04-14;86355
2021-04-13;"Trnavský kraj";126;9871;44;9915;NA;149518;170;2021-04-13;86224
2021-04-12;"Trnavský kraj";40;15577;40;15617;NA;149518;80;2021-04-12;86054
2021-04-11;"Trnavský kraj";3;44420;44;44464;NA;149518;47;2021-04-11;85974
2021-04-10;"Trnavský kraj";60;123822;107;123929;NA;149518;167;2021-04-10;85927
2021-04-09;"Trnavský kraj";95;26191;34;26225;NA;149518;129;2021-04-09;85760
2021-04-08;"Trnavský kraj";85;10913;54;10967;NA;149518;139;2021-04-08;85631
2021-04-07;"Trnavský kraj";131;15979;81;16060;NA;149518;212;2021-04-07;85492
2021-04-06;"Trnavský kraj";92;20586;90;20676;NA;149518;182;2021-04-06;85280
2021-04-05;"Trnavský kraj";91;7542;17;7559;NA;149518;108;2021-04-05;85098
2021-04-04;"Trnavský kraj";9;28831;49;28880;NA;149518;58;2021-04-04;84990
2021-04-03;"Trnavský kraj";29;144452;186;144638;NA;149518;215;2021-04-03;84932
2021-04-02;"Trnavský kraj";91;17538;33;17571;NA;149518;124;2021-04-02;84717
2021-04-01;"Trnavský kraj";118;22279;71;22350;NA;149518;189;2021-04-01;84593
2021-03-31;"Trnavský kraj";140;15828;82;15910;NA;149518;222;2021-03-31;84404
2021-03-30;"Trnavský kraj";182;10482;79;10561;NA;149518;261;2021-03-30;84182
2021-03-29;"Trnavský kraj";126;19255;122;19377;NA;149518;248;2021-03-29;83921
2021-03-28;"Trnavský kraj";26;50664;134;50798;NA;149518;160;2021-03-28;83673
2021-03-27;"Trnavský kraj";64;130217;246;130463;NA;149518;310;2021-03-27;83513
2021-03-26;"Trnavský kraj";139;30217;130;30347;NA;149518;269;2021-03-26;83203
2021-03-25;"Trnavský kraj";135;14212;80;14292;NA;149518;215;2021-03-25;82934
2021-03-24;"Trnavský kraj";159;10521;89;10610;NA;149518;248;2021-03-24;82719
2021-03-23;"Trnavský kraj";221;12735;104;12839;NA;149518;325;2021-03-23;82471
2021-03-22;"Trnavský kraj";103;17118;110;17228;NA;149518;213;2021-03-22;82146
2021-03-21;"Trnavský kraj";31;49119;150;49269;NA;149518;181;2021-03-21;81933
2021-03-20;"Trnavský kraj";112;136963;317;137280;NA;149518;429;2021-03-20;81752
2021-03-19;"Trnavský kraj";174;29071;137;29208;NA;149518;311;2021-03-19;81323
2021-03-18;"Trnavský kraj";158;12217;136;12353;NA;149518;294;2021-03-18;81012
2021-03-17;"Trnavský kraj";245;10434;103;10537;NA;149518;348;2021-03-17;80718
2021-03-16;"Trnavský kraj";311;12811;135;12946;NA;149518;446;2021-03-16;80370
2021-03-15;"Trnavský kraj";127;18271;146;18417;NA;149518;273;2021-03-15;79924
2021-03-14;"Trnavský kraj";14;47608;164;47772;NA;149518;178;2021-03-14;79651
2021-03-13;"Trnavský kraj";155;139224;409;139633;NA;149518;564;2021-03-13;79473
2021-03-12;"Trnavský kraj";201;28566;181;28747;NA;149518;382;2021-03-12;78909
2021-03-11;"Trnavský kraj";204;13301;140;13441;NA;149518;344;2021-03-11;78527
2021-03-10;"Trnavský kraj";242;10583;135;10718;NA;149518;377;2021-03-10;78183
2021-03-09;"Trnavský kraj";442;12824;155;12979;NA;149518;597;2021-03-09;77806
2021-03-08;"Trnavský kraj";182;21812;166;21978;NA;149518;348;2021-03-08;77209
2021-03-07;"Trnavský kraj";30;45463;227;45690;NA;149518;257;2021-03-07;76861
2021-03-06;"Trnavský kraj";154;135784;531;136315;NA;149518;685;2021-03-06;76604
2021-03-05;"Trnavský kraj";299;27959;239;28198;NA;149518;538;2021-03-05;75919
2021-03-04;"Trnavský kraj";238;14505;176;14681;NA;149518;414;2021-03-04;75381
2021-03-03;"Trnavský kraj";413;11583;246;11829;NA;149518;659;2021-03-03;74967
2021-03-02;"Trnavský kraj";477;12367;191;12558;NA;149518;668;2021-03-02;74308
2021-03-01;"Trnavský kraj";189;18586;234;18820;NA;149518;423;2021-03-01;73640
2021-02-28;"Trnavský kraj";87;47709;321;48030;NA;149518;408;2021-02-28;73217
2021-02-27;"Trnavský kraj";264;140224;800;141024;NA;149518;1064;2021-02-27;72809
2021-02-26;"Trnavský kraj";362;26637;284;26921;NA;149518;646;2021-02-26;71745
2021-02-25;"Trnavský kraj";433;10490;227;10717;NA;149518;660;2021-02-25;71099
2021-02-24;"Trnavský kraj";407;9113;290;9403;NA;149518;697;2021-02-24;70439
2021-02-23;"Trnavský kraj";469;11322;284;11606;NA;149518;753;2021-02-23;69742
2021-02-22;"Trnavský kraj";206;19901;330;20231;NA;149518;536;2021-02-22;68989
2021-02-21;"Trnavský kraj";38;48221;329;48550;NA;149518;367;2021-02-21;68453
2021-02-20;"Trnavský kraj";273;135835;859;136694;NA;149518;1132;2021-02-20;68086
2021-02-19;"Trnavský kraj";335;26382;366;26748;NA;149518;701;2021-02-19;66954
2021-02-18;"Trnavský kraj";344;11264;348;11612;NA;149518;692;2021-02-18;66253
2021-02-17;"Trnavský kraj";431;8783;416;9199;NA;149518;847;2021-02-17;65561
2021-02-16;"Trnavský kraj";426;11236;294;11530;NA;149518;720;2021-02-16;64714
2021-02-15;"Trnavský kraj";146;18276;326;18602;NA;149518;472;2021-02-15;63994
2021-02-14;"Trnavský kraj";51;57642;495;58137;NA;149518;546;2021-02-14;63522
2021-02-13;"Trnavský kraj";218;137051;994;138045;NA;149518;1212;2021-02-13;62976
2021-02-12;"Trnavský kraj";300;24090;352;24442;NA;149518;652;2021-02-12;61764
2021-02-11;"Trnavský kraj";422;9831;349;10180;NA;149518;771;2021-02-11;61112
2021-02-10;"Trnavský kraj";511;9194;342;9536;NA;149518;853;2021-02-10;60341
2021-02-09;"Trnavský kraj";544;12755;369;13124;NA;149518;913;2021-02-09;59488
2021-02-08;"Trnavský kraj";220;33414;497;33911;NA;149518;717;2021-02-08;58575
2021-02-07;"Trnavský kraj";140;69694;628;70322;NA;149518;768;2021-02-07;57858
2021-02-06;"Trnavský kraj";348;112687;1482;114169;NA;149518;1830;2021-02-06;57090
2021-02-05;"Trnavský kraj";377;16063;373;16436;NA;149518;750;2021-02-05;55260
2021-02-04;"Trnavský kraj";456;7317;456;7773;NA;149518;912;2021-02-04;54510
2021-02-03;"Trnavský kraj";472;6583;434;7017;NA;149518;906;2021-02-03;53598
2021-02-02;"Trnavský kraj";446;14243;424;14667;NA;149518;870;2021-02-02;52692
2021-02-01;"Trnavský kraj";198;38882;679;39561;NA;149518;877;2021-02-01;51822
2021-01-31;"Trnavský kraj";19;64707;822;65529;NA;149518;841;2021-01-31;50945
2021-01-30;"Trnavský kraj";323;111483;1288;112771;NA;149518;1611;2021-01-30;50104
2021-01-29;"Trnavský kraj";421;9689;290;9979;NA;149518;711;2021-01-29;48493
2021-01-28;"Trnavský kraj";389;5817;289;6106;NA;149518;678;2021-01-28;47782
2021-01-27;"Trnavský kraj";433;5554;225;5779;NA;149518;658;2021-01-27;47104
2021-01-26;"Trnavský kraj";565;25411;636;26047;NA;149518;1201;2021-01-26;46446
2021-01-25;"Trnavský kraj";210;41805;620;42425;NA;149518;830;2021-01-25;45245
2021-01-24;"Trnavský kraj";91;66399;779;67178;NA;149518;870;2021-01-24;44415
2021-01-23;"Trnavský kraj";372;113375;1319;114694;NA;149518;1691;2021-01-23;43545
2021-01-22;"Trnavský kraj";217;32755;505;33260;NA;149518;722;2021-01-22;41854
2021-01-21;"Trnavský kraj";311;13913;377;14290;NA;149518;688;2021-01-21;41132
2021-01-20;"Trnavský kraj";503;8685;283;8968;NA;149518;786;2021-01-20;40444
2021-01-19;"Trnavský kraj";415;7013;347;7360;NA;149518;762;2021-01-19;39658
2021-01-18;"Trnavský kraj";247;6690;513;7203;NA;149518;760;2021-01-18;38896
2021-01-17;"Trnavský kraj";128;854;215;1069;NA;149518;343;2021-01-17;38136
2021-01-16;"Trnavský kraj";103;898;24;922;NA;149518;127;2021-01-16;37793
2021-01-15;"Trnavský kraj";278;5467;336;5803;NA;149518;614;2021-01-15;37666
2021-01-14;"Trnavský kraj";452;4001;338;4339;NA;149518;790;2021-01-14;37052
2021-01-13;"Trnavský kraj";457;4751;378;5129;NA;149518;835;2021-01-13;36262
2021-01-12;"Trnavský kraj";469;6860;470;7330;NA;149518;939;2021-01-12;35427
2021-01-11;"Trnavský kraj";370;4587;360;4947;NA;149518;730;2021-01-11;34488
2021-01-10;"Trnavský kraj";71;13;0;13;NA;149518;71;2021-01-10;33758
2021-01-09;"Trnavský kraj";417;1775;100;1875;NA;149518;517;2021-01-09;33687
2021-01-08;"Trnavský kraj";381;6016;506;6522;NA;149518;887;2021-01-08;33170
2021-01-07;"Trnavský kraj";501;3545;329;3874;NA;149518;830;2021-01-07;32283
2021-01-06;"Trnavský kraj";179;758;132;890;NA;149518;311;2021-01-06;31453
2021-01-05;"Trnavský kraj";611;5165;561;5726;NA;149518;1172;2021-01-05;31142
2021-01-04;"Trnavský kraj";302;5556;709;6265;NA;149518;1011;2021-01-04;29970
2021-01-03;"Trnavský kraj";60;53;7;60;NA;149518;67;2021-01-03;28959
2021-01-02;"Trnavský kraj";282;417;32;449;NA;149518;314;2021-01-02;28892
2021-01-01;"Trnavský kraj";143;455;76;531;NA;149518;219;2021-01-01;28578
2020-12-31;"Trnavský kraj";498;8325;820;9145;NA;149518;1318;2020-12-31;28359
2020-12-30;"Trnavský kraj";785;5318;612;5930;NA;149518;1397;2020-12-30;27041
2020-12-29;"Trnavský kraj";322;4913;565;5478;NA;149518;887;2020-12-29;25644
2020-12-28;"Trnavský kraj";213;4900;552;5452;NA;149518;765;2020-12-28;24757
2020-12-27;"Trnavský kraj";27;20;4;24;NA;149518;31;2020-12-27;23992
2020-12-26;"Trnavský kraj";148;44;1;45;NA;149518;149;2020-12-26;23961
2020-12-25;"Trnavský kraj";65;49;5;54;NA;149518;70;2020-12-25;23812
2020-12-24;"Trnavský kraj";333;1359;117;1476;NA;149518;450;2020-12-24;23742
2020-12-23;"Trnavský kraj";210;6672;414;7086;NA;149518;624;2020-12-23;23292
2020-12-22;"Trnavský kraj";311;5427;455;5882;NA;149518;766;2020-12-22;22668
2020-12-21;"Trnavský kraj";328;4092;350;4442;NA;149518;678;2020-12-21;21902
2020-12-20;"Trnavský kraj";134;133;12;145;NA;149518;146;2020-12-20;21224
2020-12-19;"Trnavský kraj";201;1407;103;1510;NA;149518;304;2020-12-19;21078
2020-12-18;"Trnavský kraj";341;4432;334;4766;NA;149518;675;2020-12-18;20774
2020-12-17;"Trnavský kraj";375;4880;414;5294;NA;149518;789;2020-12-17;20099
2020-12-16;"Trnavský kraj";312;4945;383;5328;NA;149518;695;2020-12-16;19310
2020-12-15;"Trnavský kraj";492;6240;598;6838;NA;149518;1090;2020-12-15;18615
2020-12-14;"Trnavský kraj";161;3505;292;3797;NA;149518;453;2020-12-14;17525
2020-12-13;"Trnavský kraj";7;7;0;7;NA;149518;7;2020-12-13;17072
2020-12-12;"Trnavský kraj";254;1456;114;1570;NA;149518;368;2020-12-12;17065
2020-12-11;"Trnavský kraj";384;4289;241;4530;NA;149518;625;2020-12-11;16697
2020-12-10;"Trnavský kraj";183;5197;320;5517;NA;149518;503;2020-12-10;16072
2020-12-09;"Trnavský kraj";521;4199;317;4516;NA;149518;838;2020-12-09;15569
2020-12-08;"Trnavský kraj";281;4090;304;4394;NA;149518;585;2020-12-08;14731
2020-12-07;"Trnavský kraj";178;2895;199;3094;NA;149518;377;2020-12-07;14146
2020-12-06;"Trnavský kraj";46;0;0;0;NA;149518;46;2020-12-06;13769
2020-12-05;"Trnavský kraj";129;2218;41;2259;NA;149518;170;2020-12-05;13723
2020-12-04;"Trnavský kraj";242;3948;158;4106;NA;149518;400;2020-12-04;13553
2020-12-03;"Trnavský kraj";248;2770;190;2960;NA;149518;438;2020-12-03;13153
2020-12-02;"Trnavský kraj";284;4516;176;4692;NA;149518;460;2020-12-02;12715
2020-12-01;"Trnavský kraj";253;3190;205;3395;NA;149518;458;2020-12-01;12255
2020-11-30;"Trnavský kraj";200;7360;186;7546;NA;149518;386;2020-11-30;11797
2020-11-29;"Trnavský kraj";17;738;36;774;NA;149518;53;2020-11-29;11411
2020-11-28;"Trnavský kraj";83;1453;77;1530;NA;149518;160;2020-11-28;11358
2020-11-27;"Trnavský kraj";148;1779;85;1864;NA;149518;233;2020-11-27;11198
2020-11-26;"Trnavský kraj";234;1123;68;1191;NA;149518;302;2020-11-26;10965
2020-11-25;"Trnavský kraj";232;1168;74;1242;NA;149518;306;2020-11-25;10663
2020-11-24;"Trnavský kraj";295;1909;96;2005;NA;149518;391;2020-11-24;10357
2020-11-23;"Trnavský kraj";242;7393;129;7522;NA;149518;371;2020-11-23;9966
2020-11-22;"Trnavský kraj";10;82;9;91;NA;149518;19;2020-11-22;9595
2020-11-21;"Trnavský kraj";129;1354;36;1390;NA;149518;165;2020-11-21;9576
2020-11-20;"Trnavský kraj";246;1154;64;1218;NA;149518;310;2020-11-20;9411
2020-11-19;"Trnavský kraj";157;823;64;887;NA;149518;221;2020-11-19;9101
2020-11-18;"Trnavský kraj";235;822;82;904;NA;149518;317;2020-11-18;8880
2020-11-17;"Trnavský kraj";129;705;74;779;NA;149518;203;2020-11-17;8563
2020-11-16;"Trnavský kraj";187;732;32;764;NA;149518;219;2020-11-16;8360
2020-11-15;"Trnavský kraj";23;73;4;77;NA;149518;27;2020-11-15;8141
2020-11-14;"Trnavský kraj";86;397;12;409;NA;149518;98;2020-11-14;8114
2020-11-13;"Trnavský kraj";219;1312;21;1333;NA;149518;240;2020-11-13;8016
2020-11-12;"Trnavský kraj";162;420;18;438;NA;149518;180;2020-11-12;7776
2020-11-11;"Trnavský kraj";257;392;15;407;NA;149518;272;2020-11-11;7596
2020-11-10;"Trnavský kraj";189;889;30;919;NA;149518;219;2020-11-10;7324
2020-11-09;"Trnavský kraj";196;369;23;392;NA;149518;219;2020-11-09;7105
2020-11-08;"Trnavský kraj";55;400;4;404;NA;149518;59;2020-11-08;6886
2020-11-07;"Trnavský kraj";207;6070;74;6144;NA;149518;281;2020-11-07;6827
2020-11-06;"Trnavský kraj";260;1531;19;1550;NA;149518;279;2020-11-06;6546
2020-11-05;"Trnavský kraj";150;220;27;247;NA;149518;177;2020-11-05;6267
2020-11-04;"Trnavský kraj";188;212;10;222;NA;149518;198;2020-11-04;6090
2020-11-03;"Trnavský kraj";317;127;8;135;NA;149518;325;2020-11-03;5892
2020-11-02;"Trnavský kraj";281;1728;31;1759;NA;149518;312;2020-11-02;5567
2020-11-01;"Trnavský kraj";87;494;27;521;NA;149518;114;2020-11-01;5255
2020-10-31;"Trnavský kraj";259;5024;41;5065;NA;149518;300;2020-10-31;5141
2020-10-30;"Trnavský kraj";198;3784;27;3811;NA;149518;225;2020-10-30;4841
2020-10-29;"Trnavský kraj";273;1461;16;1477;NA;149518;289;2020-10-29;4616
2020-10-28;"Trnavský kraj";319;117;16;133;NA;149518;335;2020-10-28;4327
2020-10-27;"Trnavský kraj";199;461;36;497;NA;149518;235;2020-10-27;3992
2020-10-26;"Trnavský kraj";153;29;2;31;NA;149518;155;2020-10-26;3757
2020-10-25;"Trnavský kraj";95;19;1;20;NA;149518;96;2020-10-25;3602
2020-10-24;"Trnavský kraj";158;109;2;111;NA;149518;160;2020-10-24;3506
2020-10-23;"Trnavský kraj";201;89;4;93;NA;149518;205;2020-10-23;3346
2020-10-22;"Trnavský kraj";195;55;2;57;NA;149518;197;2020-10-22;3141
2020-10-21;"Trnavský kraj";134;73;3;76;NA;149518;137;2020-10-21;2944
2020-10-20;"Trnavský kraj";202;82;3;85;NA;149518;205;2020-10-20;2807
2020-10-19;"Trnavský kraj";67;55;0;55;NA;149518;67;2020-10-19;2602
2020-10-18;"Trnavský kraj";84;0;0;0;NA;149518;84;2020-10-18;2535
2020-10-17;"Trnavský kraj";123;0;0;0;NA;149518;123;2020-10-17;2451
2020-10-16;"Trnavský kraj";86;45;2;47;NA;149518;88;2020-10-16;2328
2020-10-15;"Trnavský kraj";155;66;2;68;NA;149518;157;2020-10-15;2240
2020-10-14;"Trnavský kraj";236;468;3;471;NA;149518;239;2020-10-14;2083
2020-10-13;"Trnavský kraj";138;16;2;18;NA;149518;140;2020-10-13;1844
2020-10-12;"Trnavský kraj";33;41;1;42;NA;149518;34;2020-10-12;1704
2020-10-11;"Trnavský kraj";31;0;0;0;NA;149518;31;2020-10-11;1670
2020-10-10;"Trnavský kraj";128;0;0;0;NA;149518;128;2020-10-10;1639
2020-10-09;"Trnavský kraj";156;0;0;0;NA;149518;156;2020-10-09;1511
2020-10-08;"Trnavský kraj";153;0;0;0;NA;149518;153;2020-10-08;1355
2020-10-07;"Trnavský kraj";80;0;0;0;NA;149518;80;2020-10-07;1202
2020-10-06;"Trnavský kraj";112;0;0;0;NA;149518;112;2020-10-06;1122
2020-10-05;"Trnavský kraj";33;0;0;0;NA;149518;33;2020-10-05;1010
2020-10-04;"Trnavský kraj";44;0;0;0;NA;149518;44;2020-10-04;977
2020-10-03;"Trnavský kraj";60;0;0;0;NA;149518;60;2020-10-03;933
2020-10-02;"Trnavský kraj";41;0;0;0;NA;149518;41;2020-10-02;873
2020-10-01;"Trnavský kraj";53;0;0;0;NA;149518;53;2020-10-01;832
2020-09-30;"Trnavský kraj";91;0;0;0;NA;149518;91;2020-09-30;779
2020-09-29;"Trnavský kraj";40;0;0;0;NA;149518;40;2020-09-29;688
2020-09-28;"Trnavský kraj";69;0;0;0;NA;149518;69;2020-09-28;648
2020-09-27;"Trnavský kraj";30;0;0;0;NA;149518;30;2020-09-27;579
2020-09-26;"Trnavský kraj";46;0;0;0;NA;149518;46;2020-09-26;549
2020-09-25;"Trnavský kraj";32;0;0;0;NA;149518;32;2020-09-25;503
2020-09-24;"Trnavský kraj";42;0;0;0;NA;149518;42;2020-09-24;471
2020-09-23;"Trnavský kraj";43;0;0;0;NA;149518;43;2020-09-23;429
2020-09-22;"Trnavský kraj";55;0;0;0;NA;149518;55;2020-09-22;386
2020-09-21;"Trnavský kraj";41;0;0;0;NA;149518;41;2020-09-21;331
2020-09-20;"Trnavský kraj";17;0;0;0;NA;149518;17;2020-09-20;290
2020-09-19;"Trnavský kraj";4;0;0;0;NA;149518;4;2020-09-19;273
2020-09-18;"Trnavský kraj";33;0;0;0;NA;149518;33;2020-09-18;269
2020-09-17;"Trnavský kraj";42;0;0;0;NA;149518;42;2020-09-17;236
2020-09-16;"Trnavský kraj";49;0;0;0;NA;149518;49;2020-09-16;194
2020-09-15;"Trnavský kraj";5;0;0;0;NA;149518;5;2020-09-15;145
2020-09-14;"Trnavský kraj";26;0;0;0;NA;149518;26;2020-09-14;140
2020-09-13;"Trnavský kraj";9;0;0;0;NA;149518;9;2020-09-13;114
2020-09-12;"Trnavský kraj";12;0;0;0;NA;149518;12;2020-09-12;105
2020-09-11;"Trnavský kraj";16;0;0;0;NA;149518;16;2020-09-11;93
2020-09-10;"Trnavský kraj";32;0;0;0;NA;149518;32;2020-09-10;77
2020-09-09;"Trnavský kraj";14;0;0;0;NA;149518;14;2020-09-09;45
2020-09-08;"Trnavský kraj";11;0;0;0;NA;149518;11;2020-09-08;31
2020-09-07;"Trnavský kraj";7;0;0;0;NA;149518;7;2020-09-07;20
2020-09-06;"Trnavský kraj";5;0;0;0;NA;149518;5;2020-09-06;13
2020-09-05;"Trnavský kraj";7;0;0;0;NA;149518;7;2020-09-05;8
2020-09-04;"Trnavský kraj";16;0;0;0;NA;149518;16;2020-09-04;1
2020-09-03;"Trnavský kraj";8;0;0;0;NA;149518;8;2020-09-03;-15
2020-09-02;"Trnavský kraj";7;0;0;0;NA;149518;7;2020-09-02;-23
2020-09-01;"Trnavský kraj";1;0;0;0;NA;149518;1;2020-09-01;-30
2020-08-31;"Trnavský kraj";6;0;0;0;NA;149518;6;2020-08-31;-31
2020-08-30;"Trnavský kraj";1;0;0;0;NA;149518;1;2020-08-30;-37
2020-08-29;"Trnavský kraj";3;0;0;0;NA;149518;3;2020-08-29;-38
2020-08-28;"Trnavský kraj";14;0;0;0;NA;149518;14;2020-08-28;-41
2020-08-27;"Trnavský kraj";6;0;0;0;NA;149518;6;2020-08-27;-55
2020-08-26;"Trnavský kraj";4;0;0;0;NA;149518;4;2020-08-26;-61
2020-08-25;"Trnavský kraj";7;0;0;0;NA;149518;7;2020-08-25;-65
2020-08-24;"Trnavský kraj";1;0;0;0;NA;149518;1;2020-08-24;-72
2020-08-23;"Trnavský kraj";6;0;0;0;NA;149518;6;2020-08-23;-73
2020-08-22;"Trnavský kraj";3;0;0;0;NA;149518;3;2020-08-22;-79
2020-08-21;"Trnavský kraj";4;0;0;0;NA;149518;4;2020-08-21;-82
2020-08-20;"Trnavský kraj";23;0;0;0;NA;149518;23;2020-08-20;-86
2020-08-19;"Trnavský kraj";13;0;0;0;NA;149518;13;2020-08-19;-109
2020-08-18;"Trnavský kraj";20;0;0;0;NA;149518;20;2020-08-18;-122
2020-08-17;"Trnavský kraj";3;0;0;0;NA;149518;3;2020-08-17;-142
2020-08-16;"Trnavský kraj";0;0;0;0;NA;149518;0;2020-08-16;-145
2020-08-15;"Trnavský kraj";7;0;0;0;NA;149518;7;2020-08-15;-145
2020-08-14;"Trnavský kraj";6;0;0;0;NA;149518;6;2020-08-14;-152
2020-08-13;"Trnavský kraj";10;0;0;0;NA;149518;10;2020-08-13;-158
2020-08-12;"Trnavský kraj";2;0;0;0;NA;149518;2;2020-08-12;-168
2020-08-11;"Trnavský kraj";30;0;0;0;NA;149518;30;2020-08-11;-170
2020-08-10;"Trnavský kraj";0;0;0;0;NA;149518;0;2020-08-10;-200
2020-08-09;"Trnavský kraj";0;0;0;0;NA;149518;0;2020-08-09;-200
2020-08-08;"Trnavský kraj";13;0;0;0;NA;149518;13;2020-08-08;-200
2020-08-07;"Trnavský kraj";4;0;0;0;NA;149518;4;2020-08-07;-213
2020-08-06;"Trnavský kraj";4;0;0;0;NA;149518;4;2020-08-06;-217
2020-08-05;"Trnavský kraj";0;0;0;0;NA;149518;0;2020-08-05;-221
2020-08-04;"Trnavský kraj";1;0;0;0;NA;149518;1;2020-08-04;-221
2020-08-03;"Trnavský kraj";2;0;0;0;NA;149518;2;2020-08-03;-222
2020-08-02;"Trnavský kraj";1;0;0;0;NA;149518;1;2020-08-02;-224
2020-08-01;"Trnavský kraj";0;0;0;0;NA;149518;0;2020-08-01;-225
2020-07-31;"Trnavský kraj";7;0;0;0;NA;149518;7;2020-07-31;-225
2020-07-30;"Trnavský kraj";6;0;0;0;NA;149518;6;2020-07-30;-232
2020-07-29;"Trnavský kraj";0;0;0;0;NA;149518;0;2020-07-29;-238
2020-07-28;"Trnavský kraj";1;0;0;0;NA;149518;1;2020-07-28;-238
2020-07-27;"Trnavský kraj";2;0;0;0;NA;149518;2;2020-07-27;-239
2020-07-26;"Trnavský kraj";0;0;0;0;NA;149518;0;2020-07-26;-241
2020-07-25;"Trnavský kraj";0;0;0;0;NA;149518;0;2020-07-25;-241
2020-07-24;"Trnavský kraj";1;0;0;0;NA;149518;1;2020-07-24;-241
2020-07-23;"Trnavský kraj";2;0;0;0;NA;149518;2;2020-07-23;-242
2020-07-22;"Trnavský kraj";1;0;0;0;NA;149518;1;2020-07-22;-244
2020-07-21;"Trnavský kraj";2;0;0;0;NA;149518;2;2020-07-21;-245
2020-07-20;"Trnavský kraj";0;0;0;0;NA;149518;0;2020-07-20;-247
2020-07-19;"Trnavský kraj";0;0;0;0;NA;149518;0;2020-07-19;-247
2020-07-18;"Trnavský kraj";0;0;0;0;NA;149518;0;2020-07-18;-247
2020-07-17;"Trnavský kraj";0;0;0;0;NA;149518;0;2020-07-17;-247
2020-07-16;"Trnavský kraj";0;0;0;0;NA;149518;0;2020-07-16;-247
2020-07-15;"Trnavský kraj";1;0;0;0;NA;149518;1;2020-07-15;-247
2020-07-14;"Trnavský kraj";0;0;0;0;NA;149518;0;2020-07-14;-248
2020-07-13;"Trnavský kraj";0;0;0;0;NA;149518;0;2020-07-13;-248
2020-07-12;"Trnavský kraj";0;0;0;0;NA;149518;0;2020-07-12;-248
2020-07-11;"Trnavský kraj";0;0;0;0;NA;149518;0;2020-07-11;-248
2020-07-10;"Trnavský kraj";0;0;0;0;NA;149518;0;2020-07-10;-248
2020-07-09;"Trnavský kraj";0;0;0;0;NA;149518;0;2020-07-09;-248
2020-07-08;"Trnavský kraj";3;0;0;0;NA;149518;3;2020-07-08;-248
2020-07-07;"Trnavský kraj";4;0;0;0;NA;149518;4;2020-07-07;-251
2020-07-06;"Trnavský kraj";0;0;0;0;NA;149518;0;2020-07-06;-255
2020-07-05;"Trnavský kraj";0;0;0;0;NA;149518;0;2020-07-05;-255
2020-07-04;"Trnavský kraj";0;0;0;0;NA;149518;0;2020-07-04;-255
2020-07-03;"Trnavský kraj";0;0;0;0;NA;149518;0;2020-07-03;-255
2020-07-02;"Trnavský kraj";3;0;0;0;NA;149518;3;2020-07-02;-255
2020-07-01;"Trnavský kraj";0;0;0;0;NA;149518;0;2020-07-01;-258
2020-06-30;"Trnavský kraj";0;0;0;0;NA;149518;0;2020-06-30;-258
2020-06-29;"Trnavský kraj";0;0;0;0;NA;149518;0;2020-06-29;-258
2020-06-28;"Trnavský kraj";0;0;0;0;NA;149518;0;2020-06-28;-258
2020-06-27;"Trnavský kraj";0;0;0;0;NA;149518;0;2020-06-27;-258
2020-06-26;"Trnavský kraj";0;0;0;0;NA;149518;0;2020-06-26;-258
2020-06-25;"Trnavský kraj";0;0;0;0;NA;149518;0;2020-06-25;-258
2020-06-24;"Trnavský kraj";0;0;0;0;NA;149518;0;2020-06-24;-258
2020-06-23;"Trnavský kraj";0;0;0;0;NA;149518;0;2020-06-23;-258
2020-06-22;"Trnavský kraj";0;0;0;0;NA;149518;0;2020-06-22;-258
2020-06-21;"Trnavský kraj";0;0;0;0;NA;149518;0;2020-06-21;-258
2020-06-20;"Trnavský kraj";0;0;0;0;NA;149518;0;2020-06-20;-258
2020-06-19;"Trnavský kraj";0;0;0;0;NA;149518;0;2020-06-19;-258
2020-06-18;"Trnavský kraj";2;0;0;0;NA;149518;2;2020-06-18;-258
2020-06-17;"Trnavský kraj";0;0;0;0;NA;149518;0;2020-06-17;-260
2020-06-16;"Trnavský kraj";0;0;0;0;NA;149518;0;2020-06-16;-260
2020-06-14;"Trnavský kraj";0;0;0;0;NA;149518;0;2020-06-14;-260
2020-06-13;"Trnavský kraj";0;0;0;0;NA;149518;0;2020-06-13;-260
2020-06-12;"Trnavský kraj";0;0;0;0;NA;149518;0;2020-06-12;-260
2020-06-11;"Trnavský kraj";0;0;0;0;NA;149518;0;2020-06-11;-260
2020-06-10;"Trnavský kraj";0;0;0;0;NA;149518;0;2020-06-10;-260
2020-06-09;"Trnavský kraj";0;0;0;0;NA;149518;0;2020-06-09;-260
2020-06-08;"Trnavský kraj";0;0;0;0;NA;149518;0;2020-06-08;-260
2020-06-07;"Trnavský kraj";0;0;0;0;NA;149518;0;2020-06-07;-260
2020-06-05;"Trnavský kraj";0;0;0;0;NA;149518;0;2020-06-05;-260
2020-06-03;"Trnavský kraj";0;0;0;0;NA;149518;0;2020-06-03;-260
2020-06-02;"Trnavský kraj";0;0;0;0;NA;149518;0;2020-06-02;-260
2020-05-31;"Trnavský kraj";0;0;0;0;NA;149518;0;2020-05-31;-260
2020-05-29;"Trnavský kraj";0;0;0;0;NA;149518;0;2020-05-29;-260
2020-05-27;"Trnavský kraj";0;0;0;0;NA;149518;0;2020-05-27;-260
2020-05-26;"Trnavský kraj";0;0;0;0;NA;149518;0;2020-05-26;-260
2020-05-25;"Trnavský kraj";1;0;0;0;NA;149518;1;2020-05-25;-260
2020-05-24;"Trnavský kraj";0;0;0;0;NA;149518;0;2020-05-24;-261
2020-05-23;"Trnavský kraj";2;0;0;0;NA;149518;2;2020-05-23;-261
2020-05-22;"Trnavský kraj";0;0;0;0;NA;149518;0;2020-05-22;-263
2020-05-21;"Trnavský kraj";0;0;0;0;NA;149518;0;2020-05-21;-263
2020-05-20;"Trnavský kraj";2;0;0;0;NA;149518;2;2020-05-20;-263
2020-05-19;"Trnavský kraj";0;0;0;0;NA;149518;0;2020-05-19;-265
2020-05-17;"Trnavský kraj";0;0;0;0;NA;149518;0;2020-05-17;-265
2020-05-16;"Trnavský kraj";0;0;0;0;NA;149518;0;2020-05-16;-265
2020-05-15;"Trnavský kraj";1;0;0;0;NA;149518;1;2020-05-15;-265
2020-05-14;"Trnavský kraj";0;0;0;0;NA;149518;0;2020-05-14;-266
2020-05-13;"Trnavský kraj";0;0;0;0;NA;149518;0;2020-05-13;-266
2020-05-12;"Trnavský kraj";0;0;0;0;NA;149518;0;2020-05-12;-266
2020-05-11;"Trnavský kraj";2;0;0;0;NA;149518;2;2020-05-11;-266
2020-05-09;"Trnavský kraj";0;0;0;0;NA;149518;0;2020-05-09;-268
2020-05-07;"Trnavský kraj";0;0;0;0;NA;149518;0;2020-05-07;-268
2020-05-06;"Trnavský kraj";0;0;0;0;NA;149518;0;2020-05-06;-268
2020-05-05;"Trnavský kraj";0;0;0;0;NA;149518;0;2020-05-05;-268
2020-05-04;"Trnavský kraj";0;0;0;0;NA;149518;0;2020-05-04;-268
2020-05-03;"Trnavský kraj";0;0;0;0;NA;149518;0;2020-05-03;-268
2020-05-02;"Trnavský kraj";0;0;0;0;NA;149518;0;2020-05-02;-268
2020-05-01;"Trnavský kraj";0;0;0;0;NA;149518;0;2020-05-01;-268
2020-04-30;"Trnavský kraj";0;0;0;0;NA;149518;0;2020-04-30;-268
2020-04-29;"Trnavský kraj";0;0;0;0;NA;149518;0;2020-04-29;-268
2020-04-28;"Trnavský kraj";1;0;0;0;NA;149518;1;2020-04-28;-268
2020-04-27;"Trnavský kraj";0;0;0;0;NA;149518;0;2020-04-27;-269
2020-04-26;"Trnavský kraj";0;0;0;0;NA;149518;0;2020-04-26;-269
2020-04-25;"Trnavský kraj";2;0;0;0;NA;149518;2;2020-04-25;-269
2020-04-24;"Trnavský kraj";4;0;0;0;NA;149518;4;2020-04-24;-271
2020-04-23;"Trnavský kraj";5;0;0;0;NA;149518;5;2020-04-23;-275
2020-04-22;"Trnavský kraj";10;0;0;0;NA;149518;10;2020-04-22;-280
2020-04-21;"Trnavský kraj";5;0;0;0;NA;149518;5;2020-04-21;-290
2020-04-20;"Trnavský kraj";0;0;0;0;NA;149518;0;2020-04-20;-295
2020-04-19;"Trnavský kraj";1;0;0;0;NA;149518;1;2020-04-19;-295
2020-04-18;"Trnavský kraj";4;0;0;0;NA;149518;4;2020-04-18;-296
2020-04-17;"Trnavský kraj";7;0;0;0;NA;149518;7;2020-04-17;-300
2020-04-16;"Trnavský kraj";5;0;0;0;NA;149518;5;2020-04-16;-307
2020-04-15;"Trnavský kraj";5;0;0;0;NA;149518;5;2020-04-15;-312
2020-04-14;"Trnavský kraj";1;0;0;0;NA;149518;1;2020-04-14;-317
2020-04-13;"Trnavský kraj";0;0;0;0;NA;149518;0;2020-04-13;-318
2020-04-12;"Trnavský kraj";0;0;0;0;NA;149518;0;2020-04-12;-318
2020-04-11;"Trnavský kraj";0;0;0;0;NA;149518;0;2020-04-11;-318
2020-04-10;"Trnavský kraj";2;0;0;0;NA;149518;2;2020-04-10;-318
2020-04-09;"Trnavský kraj";3;0;0;0;NA;149518;3;2020-04-09;-320
2020-04-08;"Trnavský kraj";4;0;0;0;NA;149518;4;2020-04-08;-323
2020-04-07;"Trnavský kraj";6;0;0;0;NA;149518;6;2020-04-07;-327
2020-04-06;"Trnavský kraj";6;0;0;0;NA;149518;6;2020-04-06;-333
2020-04-05;"Trnavský kraj";1;0;0;0;NA;149518;1;2020-04-05;-339
2020-04-04;"Trnavský kraj";1;0;0;0;NA;149518;1;2020-04-04;-340
2020-04-03;"Trnavský kraj";3;0;0;0;NA;149518;3;2020-04-03;-341
2020-04-02;"Trnavský kraj";4;0;0;0;NA;149518;4;2020-04-02;-344
2020-04-01;"Trnavský kraj";0;0;0;0;NA;149518;0;2020-04-01;-348
2020-03-31;"Trnavský kraj";3;0;0;0;NA;149518;3;2020-03-31;-348
2020-03-30;"Trnavský kraj";4;0;0;0;NA;149518;4;2020-03-30;-351
2020-03-29;"Trnavský kraj";1;0;0;0;NA;149518;1;2020-03-29;-355
2020-03-28;"Trnavský kraj";3;0;0;0;NA;149518;3;2020-03-28;-356
2020-03-27;"Trnavský kraj";5;0;0;0;NA;149518;5;2020-03-27;-359
2020-03-26;"Trnavský kraj";5;0;0;0;NA;149518;5;2020-03-26;-364
2020-03-25;"Trnavský kraj";1;0;0;0;NA;149518;1;2020-03-25;-369
2020-03-24;"Trnavský kraj";0;0;0;0;NA;149518;0;2020-03-24;-370
2020-03-23;"Trnavský kraj";2;0;0;0;NA;149518;2;2020-03-23;-370
2020-03-22;"Trnavský kraj";1;0;0;0;NA;149518;1;2020-03-22;-372
2020-03-21;"Trnavský kraj";5;0;0;0;NA;149518;5;2020-03-21;-373
2020-03-20;"Trnavský kraj";0;0;0;0;NA;149518;0;2020-03-20;-378
2020-03-19;"Trnavský kraj";0;0;0;0;NA;149518;0;2020-03-19;-378
2020-03-18;"Trnavský kraj";0;0;0;0;NA;149518;0;2020-03-18;-378
2020-03-17;"Trnavský kraj";3;0;0;0;NA;149518;3;2020-03-17;-378
2020-03-16;"Trnavský kraj";1;0;0;0;NA;149518;1;2020-03-16;-381
2020-03-15;"Trnavský kraj";0;0;0;0;NA;149518;0;2020-03-15;-382
2020-03-14;"Trnavský kraj";0;0;0;0;NA;149518;0;2020-03-14;-382
2020-03-13;"Trnavský kraj";1;0;0;0;NA;149518;1;2020-03-13;-382
2020-03-12;"Trnavský kraj";1;0;0;0;NA;149518;1;2020-03-12;-383
2020-03-11;"Trnavský kraj";0;0;0;0;NA;149518;0;2020-03-11;-384
2020-03-09;"Trnavský kraj";0;0;0;0;NA;149518;0;2020-03-09;-384
2020-03-08;"Trnavský kraj";0;0;0;0;NA;149518;0;2020-03-08;-384
2020-03-07;"Trnavský kraj";0;0;0;0;NA;149518;0;2020-03-07;-384
2020-03-06;"Trnavský kraj";0;0;0;0;NA;149518;0;2020-03-06;-384
2022-01-11;"Žilinský kraj";622;0;0;0;129545;198695;622;2022-01-11;198695
2022-01-10;"Žilinský kraj";436;10;0;10;NA;198695;436;2022-01-10;198073
2022-01-09;"Žilinský kraj";95;2646;49;2695;NA;198695;144;2022-01-09;197637
2022-01-08;"Žilinský kraj";345;1551;45;1596;NA;198695;390;2022-01-08;197493
2022-01-07;"Žilinský kraj";525;3624;63;3687;NA;198695;588;2022-01-07;197103
2022-01-06;"Žilinský kraj";167;1205;40;1245;NA;198695;207;2022-01-06;196515
2022-01-05;"Žilinský kraj";471;3479;75;3554;NA;198695;546;2022-01-05;196308
2022-01-04;"Žilinský kraj";606;4161;91;4252;NA;198695;697;2022-01-04;195762
2022-01-03;"Žilinský kraj";601;6531;128;6659;NA;198695;729;2022-01-03;195065
2022-01-02;"Žilinský kraj";288;2381;81;2462;NA;198695;369;2022-01-02;194336
2022-01-01;"Žilinský kraj";14;439;15;454;NA;198695;29;2022-01-01;193967
2021-12-31;"Žilinský kraj";321;1958;80;2038;NA;198695;401;2021-12-31;193938
2021-12-30;"Žilinský kraj";492;2156;79;2235;NA;198695;571;2021-12-30;193537
2021-12-29;"Žilinský kraj";543;2952;91;3043;NA;198695;634;2021-12-29;192966
2021-12-28;"Žilinský kraj";641;3402;106;3508;NA;198695;747;2021-12-28;192332
2021-12-27;"Žilinský kraj";691;3951;144;4095;NA;198695;835;2021-12-27;191585
2021-12-26;"Žilinský kraj";242;1286;67;1353;NA;198695;309;2021-12-26;190750
2021-12-25;"Žilinský kraj";22;442;45;487;NA;198695;67;2021-12-25;190441
2021-12-24;"Žilinský kraj";98;518;21;539;NA;198695;119;2021-12-24;190374
2021-12-23;"Žilinský kraj";731;2675;105;2780;NA;198695;836;2021-12-23;190255
2021-12-22;"Žilinský kraj";510;2428;77;2505;NA;198695;587;2021-12-22;189419
2021-12-21;"Žilinský kraj";755;3641;102;3743;NA;198695;857;2021-12-21;188832
2021-12-20;"Žilinský kraj";563;4499;122;4621;NA;198695;685;2021-12-20;187975
2021-12-19;"Žilinský kraj";133;2215;90;2305;NA;198695;223;2021-12-19;187290
2021-12-18;"Žilinský kraj";417;1321;70;1391;NA;198695;487;2021-12-18;187067
2021-12-17;"Žilinský kraj";604;3895;127;4022;NA;198695;731;2021-12-17;186580
2021-12-16;"Žilinský kraj";660;3915;109;4024;NA;198695;769;2021-12-16;185849
2021-12-15;"Žilinský kraj";802;3489;122;3611;NA;198695;924;2021-12-15;185080
2021-12-14;"Žilinský kraj";798;4587;129;4716;NA;198695;927;2021-12-14;184156
2021-12-13;"Žilinský kraj";759;7745;212;7957;NA;198695;971;2021-12-13;183229
2021-12-12;"Žilinský kraj";340;2836;114;2950;NA;198695;454;2021-12-12;182258
2021-12-11;"Žilinský kraj";761;1849;112;1961;NA;198695;873;2021-12-11;181804
2021-12-10;"Žilinský kraj";638;4041;136;4177;NA;198695;774;2021-12-10;180931
2021-12-09;"Žilinský kraj";870;5827;161;5988;NA;198695;1031;2021-12-09;180157
2021-12-08;"Žilinský kraj";1018;3214;158;3372;NA;198695;1176;2021-12-08;179126
2021-12-07;"Žilinský kraj";1356;5147;160;5307;NA;198695;1516;2021-12-07;177950
2021-12-06;"Žilinský kraj";919;7441;226;7667;NA;198695;1145;2021-12-06;176434
2021-12-05;"Žilinský kraj";505;3306;134;3440;NA;198695;639;2021-12-05;175289
2021-12-04;"Žilinský kraj";704;1892;153;2045;NA;198695;857;2021-12-04;174650
2021-12-03;"Žilinský kraj";1204;4864;215;5079;NA;198695;1419;2021-12-03;173793
2021-12-02;"Žilinský kraj";1847;4131;199;4330;NA;198695;2046;2021-12-02;172374
2021-12-01;"Žilinský kraj";1183;4073;195;4268;NA;198695;1378;2021-12-01;170328
2021-11-30;"Žilinský kraj";1575;5467;252;5719;NA;198695;1827;2021-11-30;168950
2021-11-29;"Žilinský kraj";1395;9067;358;9425;NA;198695;1753;2021-11-29;167123
2021-11-28;"Žilinský kraj";625;4581;235;4816;NA;198695;860;2021-11-28;165370
2021-11-27;"Žilinský kraj";909;2557;192;2749;NA;198695;1101;2021-11-27;164510
2021-11-26;"Žilinský kraj";1195;6581;342;6923;NA;198695;1537;2021-11-26;163409
2021-11-25;"Žilinský kraj";1281;4701;331;5032;NA;198695;1612;2021-11-25;161872
2021-11-24;"Žilinský kraj";1792;4659;324;4983;NA;198695;2116;2021-11-24;160260
2021-11-23;"Žilinský kraj";1630;4654;353;5007;NA;198695;1983;2021-11-23;158144
2021-11-22;"Žilinský kraj";1126;6699;452;7151;NA;198695;1578;2021-11-22;156161
2021-11-21;"Žilinský kraj";443;2865;260;3125;NA;198695;703;2021-11-21;154583
2021-11-20;"Žilinský kraj";963;2104;241;2345;NA;198695;1204;2021-11-20;153880
2021-11-19;"Žilinský kraj";1281;4622;434;5056;NA;198695;1715;2021-11-19;152676
2021-11-18;"Žilinský kraj";1220;4432;376;4808;NA;198695;1596;2021-11-18;150961
2021-11-17;"Žilinský kraj";1001;1434;149;1583;NA;198695;1150;2021-11-17;149365
2021-11-16;"Žilinský kraj";1197;4058;323;4381;NA;198695;1520;2021-11-16;148215
2021-11-15;"Žilinský kraj";977;5050;476;5526;NA;198695;1453;2021-11-15;146695
2021-11-14;"Žilinský kraj";356;2287;262;2549;NA;198695;618;2021-11-14;145242
2021-11-13;"Žilinský kraj";652;1882;220;2102;NA;198695;872;2021-11-13;144624
2021-11-12;"Žilinský kraj";1027;4291;340;4631;NA;198695;1367;2021-11-12;143752
2021-11-11;"Žilinský kraj";924;4192;272;4464;NA;198695;1196;2021-11-11;142385
2021-11-10;"Žilinský kraj";897;4509;305;4814;NA;198695;1202;2021-11-10;141189
2021-11-09;"Žilinský kraj";1440;4619;256;4875;NA;198695;1696;2021-11-09;139987
2021-11-08;"Žilinský kraj";781;4438;425;4863;NA;198695;1206;2021-11-08;138291
2021-11-07;"Žilinský kraj";304;2130;231;2361;NA;198695;535;2021-11-07;137085
2021-11-06;"Žilinský kraj";741;2150;201;2351;NA;198695;942;2021-11-06;136550
2021-11-05;"Žilinský kraj";1064;4067;235;4302;NA;198695;1299;2021-11-05;135608
2021-11-04;"Žilinský kraj";776;3709;232;3941;NA;198695;1008;2021-11-04;134309
2021-11-03;"Žilinský kraj";1106;5550;338;5888;NA;198695;1444;2021-11-03;133301
2021-11-02;"Žilinský kraj";1136;4451;333;4784;NA;198695;1469;2021-11-02;131857
2021-11-01;"Žilinský kraj";399;1456;137;1593;NA;198695;536;2021-11-01;130388
2021-10-31;"Žilinský kraj";344;1387;145;1532;NA;198695;489;2021-10-31;129852
2021-10-30;"Žilinský kraj";571;1944;161;2105;NA;198695;732;2021-10-30;129363
2021-10-29;"Žilinský kraj";733;3339;194;3533;NA;198695;927;2021-10-29;128631
2021-10-28;"Žilinský kraj";639;4953;247;5200;NA;198695;886;2021-10-28;127704
2021-10-27;"Žilinský kraj";739;3446;173;3619;NA;198695;912;2021-10-27;126818
2021-10-26;"Žilinský kraj";945;4748;216;4964;NA;198695;1161;2021-10-26;125906
2021-10-25;"Žilinský kraj";649;5736;271;6007;NA;198695;920;2021-10-25;124745
2021-10-24;"Žilinský kraj";248;1679;107;1786;NA;198695;355;2021-10-24;123825
2021-10-23;"Žilinský kraj";399;2415;149;2564;NA;198695;548;2021-10-23;123470
2021-10-22;"Žilinský kraj";587;3898;151;4049;NA;198695;738;2021-10-22;122922
2021-10-21;"Žilinský kraj";591;3367;162;3529;NA;198695;753;2021-10-21;122184
2021-10-20;"Žilinský kraj";479;3864;154;4018;NA;198695;633;2021-10-20;121431
2021-10-19;"Žilinský kraj";675;3763;161;3924;NA;198695;836;2021-10-19;120798
2021-10-18;"Žilinský kraj";432;5160;271;5431;NA;198695;703;2021-10-18;119962
2021-10-17;"Žilinský kraj";135;1769;101;1870;NA;198695;236;2021-10-17;119259
2021-10-16;"Žilinský kraj";273;2341;100;2441;NA;198695;373;2021-10-16;119023
2021-10-15;"Žilinský kraj";347;3859;146;4005;NA;198695;493;2021-10-15;118650
2021-10-14;"Žilinský kraj";419;3035;110;3145;NA;198695;529;2021-10-14;118157
2021-10-13;"Žilinský kraj";404;3427;112;3539;NA;198695;516;2021-10-13;117628
2021-10-12;"Žilinský kraj";589;4000;141;4141;NA;198695;730;2021-10-12;117112
2021-10-11;"Žilinský kraj";323;4501;154;4655;NA;198695;477;2021-10-11;116382
2021-10-10;"Žilinský kraj";113;1577;77;1654;NA;198695;190;2021-10-10;115905
2021-10-09;"Žilinský kraj";201;1565;57;1622;NA;198695;258;2021-10-09;115715
2021-10-08;"Žilinský kraj";265;4227;99;4326;NA;198695;364;2021-10-08;115457
2021-10-07;"Žilinský kraj";338;3384;113;3497;NA;198695;451;2021-10-07;115093
2021-10-06;"Žilinský kraj";313;3901;89;3990;NA;198695;402;2021-10-06;114642
2021-10-05;"Žilinský kraj";387;4031;122;4153;NA;198695;509;2021-10-05;114240
2021-10-04;"Žilinský kraj";297;4449;121;4570;NA;198695;418;2021-10-04;113731
2021-10-03;"Žilinský kraj";22;1596;63;1659;NA;198695;85;2021-10-03;113313
2021-10-02;"Žilinský kraj";209;1990;45;2035;NA;198695;254;2021-10-02;113228
2021-10-01;"Žilinský kraj";263;4047;104;4151;NA;198695;367;2021-10-01;112974
2021-09-30;"Žilinský kraj";248;3531;71;3602;NA;198695;319;2021-09-30;112607
2021-09-29;"Žilinský kraj";285;3577;82;3659;NA;198695;367;2021-09-29;112288
2021-09-28;"Žilinský kraj";272;3656;73;3729;NA;198695;345;2021-09-28;111921
2021-09-27;"Žilinský kraj";239;4418;152;4570;NA;198695;391;2021-09-27;111576
2021-09-26;"Žilinský kraj";17;1665;42;1707;NA;198695;59;2021-09-26;111185
2021-09-25;"Žilinský kraj";111;1711;50;1761;NA;198695;161;2021-09-25;111126
2021-09-24;"Žilinský kraj";199;6127;98;6225;NA;198695;297;2021-09-24;110965
2021-09-23;"Žilinský kraj";176;2629;74;2703;NA;198695;250;2021-09-23;110668
2021-09-22;"Žilinský kraj";185;2728;77;2805;NA;198695;262;2021-09-22;110418
2021-09-21;"Žilinský kraj";250;3123;78;3201;NA;198695;328;2021-09-21;110156
2021-09-20;"Žilinský kraj";244;3231;95;3326;NA;198695;339;2021-09-20;109828
2021-09-19;"Žilinský kraj";26;1579;37;1616;NA;198695;63;2021-09-19;109489
2021-09-18;"Žilinský kraj";87;1441;45;1486;NA;198695;132;2021-09-18;109426
2021-09-17;"Žilinský kraj";192;3351;56;3407;NA;198695;248;2021-09-17;109294
2021-09-16;"Žilinský kraj";164;2744;87;2831;NA;198695;251;2021-09-16;109046
2021-09-15;"Žilinský kraj";31;555;11;566;NA;198695;42;2021-09-15;108795
2021-09-14;"Žilinský kraj";155;3268;61;3329;NA;198695;216;2021-09-14;108753
2021-09-13;"Žilinský kraj";81;3231;75;3306;NA;198695;156;2021-09-13;108537
2021-09-12;"Žilinský kraj";9;1138;24;1162;NA;198695;33;2021-09-12;108381
2021-09-11;"Žilinský kraj";47;1322;21;1343;NA;198695;68;2021-09-11;108348
2021-09-10;"Žilinský kraj";66;2439;34;2473;NA;198695;100;2021-09-10;108280
2021-09-09;"Žilinský kraj";56;2352;18;2370;NA;198695;74;2021-09-09;108180
2021-09-08;"Žilinský kraj";68;1560;24;1584;NA;198695;92;2021-09-08;108106
2021-09-07;"Žilinský kraj";72;1806;27;1833;NA;198695;99;2021-09-07;108014
2021-09-06;"Žilinský kraj";31;2381;45;2426;NA;198695;76;2021-09-06;107915
2021-09-05;"Žilinský kraj";11;785;8;793;NA;198695;19;2021-09-05;107839
2021-09-04;"Žilinský kraj";24;1080;5;1085;NA;198695;29;2021-09-04;107820
2021-09-03;"Žilinský kraj";52;2047;28;2075;NA;198695;80;2021-09-03;107791
2021-09-02;"Žilinský kraj";30;1432;22;1454;NA;198695;52;2021-09-02;107711
2021-09-01;"Žilinský kraj";5;461;6;467;NA;198695;11;2021-09-01;107659
2021-08-31;"Žilinský kraj";32;1710;15;1725;NA;198695;47;2021-08-31;107648
2021-08-30;"Žilinský kraj";7;1801;4;1805;NA;198695;11;2021-08-30;107601
2021-08-29;"Žilinský kraj";8;631;5;636;NA;198695;13;2021-08-29;107590
2021-08-28;"Žilinský kraj";2;1005;1;1006;NA;198695;3;2021-08-28;107577
2021-08-27;"Žilinský kraj";13;1765;12;1777;NA;198695;25;2021-08-27;107574
2021-08-26;"Žilinský kraj";17;1636;7;1643;NA;198695;24;2021-08-26;107549
2021-08-25;"Žilinský kraj";9;1203;11;1214;NA;198695;20;2021-08-25;107525
2021-08-24;"Žilinský kraj";6;1395;9;1404;NA;198695;15;2021-08-24;107505
2021-08-23;"Žilinský kraj";11;1877;7;1884;NA;198695;18;2021-08-23;107490
2021-08-22;"Žilinský kraj";2;733;3;736;NA;198695;5;2021-08-22;107472
2021-08-21;"Žilinský kraj";6;1183;2;1185;NA;198695;8;2021-08-21;107467
2021-08-20;"Žilinský kraj";7;2284;5;2289;NA;198695;12;2021-08-20;107459
2021-08-19;"Žilinský kraj";6;1281;3;1284;NA;198695;9;2021-08-19;107447
2021-08-18;"Žilinský kraj";4;1331;7;1338;NA;198695;11;2021-08-18;107438
2021-08-17;"Žilinský kraj";9;1219;3;1222;NA;198695;12;2021-08-17;107427
2021-08-16;"Žilinský kraj";14;1696;5;1701;NA;198695;19;2021-08-16;107415
2021-08-15;"Žilinský kraj";1;880;2;882;NA;198695;3;2021-08-15;107396
2021-08-14;"Žilinský kraj";5;1197;0;1197;NA;198695;5;2021-08-14;107393
2021-08-13;"Žilinský kraj";6;1685;0;1685;NA;198695;6;2021-08-13;107388
2021-08-12;"Žilinský kraj";4;1105;1;1106;NA;198695;5;2021-08-12;107382
2021-08-11;"Žilinský kraj";13;1250;3;1253;NA;198695;16;2021-08-11;107377
2021-08-10;"Žilinský kraj";12;1292;3;1295;NA;198695;15;2021-08-10;107361
2021-08-09;"Žilinský kraj";9;1142;1;1143;NA;198695;10;2021-08-09;107346
2021-08-08;"Žilinský kraj";1;748;5;753;NA;198695;6;2021-08-08;107336
2021-08-07;"Žilinský kraj";7;1192;1;1193;NA;198695;8;2021-08-07;107330
2021-08-06;"Žilinský kraj";1;1347;0;1347;NA;198695;1;2021-08-06;107322
2021-08-05;"Žilinský kraj";7;1148;3;1151;NA;198695;10;2021-08-05;107321
2021-08-04;"Žilinský kraj";12;875;0;875;NA;198695;12;2021-08-04;107311
2021-08-03;"Žilinský kraj";11;918;0;918;NA;198695;11;2021-08-03;107299
2021-08-02;"Žilinský kraj";5;1513;1;1514;NA;198695;6;2021-08-02;107288
2021-08-01;"Žilinský kraj";0;679;2;681;NA;198695;2;2021-08-01;107282
2021-07-31;"Žilinský kraj";4;1114;0;1114;NA;198695;4;2021-07-31;107280
2021-07-30;"Žilinský kraj";3;1671;0;1671;NA;198695;3;2021-07-30;107276
2021-07-29;"Žilinský kraj";1;1299;0;1299;NA;198695;1;2021-07-29;107273
2021-07-28;"Žilinský kraj";4;901;0;901;NA;198695;4;2021-07-28;107272
2021-07-27;"Žilinský kraj";11;1378;0;1378;NA;198695;11;2021-07-27;107268
2021-07-26;"Žilinský kraj";1;1301;1;1302;NA;198695;2;2021-07-26;107257
2021-07-25;"Žilinský kraj";2;828;2;830;NA;198695;4;2021-07-25;107255
2021-07-24;"Žilinský kraj";2;1338;2;1340;NA;198695;4;2021-07-24;107251
2021-07-23;"Žilinský kraj";4;1750;0;1750;NA;198695;4;2021-07-23;107247
2021-07-22;"Žilinský kraj";2;1207;0;1207;NA;198695;2;2021-07-22;107243
2021-07-21;"Žilinský kraj";2;1021;0;1021;NA;198695;2;2021-07-21;107241
2021-07-20;"Žilinský kraj";4;1439;0;1439;NA;198695;4;2021-07-20;107239
2021-07-19;"Žilinský kraj";4;1763;1;1764;NA;198695;5;2021-07-19;107235
2021-07-18;"Žilinský kraj";0;854;1;855;NA;198695;1;2021-07-18;107230
2021-07-17;"Žilinský kraj";0;1350;0;1350;NA;198695;0;2021-07-17;107229
2021-07-16;"Žilinský kraj";2;1767;0;1767;NA;198695;2;2021-07-16;107229
2021-07-15;"Žilinský kraj";2;1577;0;1577;NA;198695;2;2021-07-15;107227
2021-07-14;"Žilinský kraj";5;1042;1;1043;NA;198695;6;2021-07-14;107225
2021-07-13;"Žilinský kraj";3;1709;1;1710;NA;198695;4;2021-07-13;107219
2021-07-12;"Žilinský kraj";3;1325;1;1326;NA;198695;4;2021-07-12;107215
2021-07-11;"Žilinský kraj";2;989;0;989;NA;198695;2;2021-07-11;107211
2021-07-10;"Žilinský kraj";1;1511;4;1515;NA;198695;5;2021-07-10;107209
2021-07-09;"Žilinský kraj";1;2208;1;2209;NA;198695;2;2021-07-09;107204
2021-07-08;"Žilinský kraj";6;1776;3;1779;NA;198695;9;2021-07-08;107202
2021-07-07;"Žilinský kraj";1;1585;3;1588;NA;198695;4;2021-07-07;107193
2021-07-06;"Žilinský kraj";4;1956;0;1956;NA;198695;4;2021-07-06;107189
2021-07-05;"Žilinský kraj";2;1031;1;1032;NA;198695;3;2021-07-05;107185
2021-07-04;"Žilinský kraj";0;1003;0;1003;NA;198695;0;2021-07-04;107182
2021-07-03;"Žilinský kraj";1;1696;2;1698;NA;198695;3;2021-07-03;107182
2021-07-02;"Žilinský kraj";0;3356;2;3358;NA;198695;2;2021-07-02;107179
2021-07-01;"Žilinský kraj";1;1118;0;1118;NA;198695;1;2021-07-01;107177
2021-06-30;"Žilinský kraj";1;10464;6;10470;NA;198695;7;2021-06-30;107176
2021-06-29;"Žilinský kraj";10;5946;0;5946;NA;198695;10;2021-06-29;107169
2021-06-28;"Žilinský kraj";4;6245;2;6247;NA;198695;6;2021-06-28;107159
2021-06-27;"Žilinský kraj";3;4702;1;4703;NA;198695;4;2021-06-27;107153
2021-06-26;"Žilinský kraj";4;5919;0;5919;NA;198695;4;2021-06-26;107149
2021-06-25;"Žilinský kraj";8;9756;5;9761;NA;198695;13;2021-06-25;107145
2021-06-24;"Žilinský kraj";6;5657;3;5660;NA;198695;9;2021-06-24;107132
2021-06-23;"Žilinský kraj";7;5955;10;5965;NA;198695;17;2021-06-23;107123
2021-06-22;"Žilinský kraj";6;5214;8;5222;NA;198695;14;2021-06-22;107106
2021-06-21;"Žilinský kraj";6;6287;8;6295;NA;198695;14;2021-06-21;107092
2021-06-20;"Žilinský kraj";1;5531;8;5539;NA;198695;9;2021-06-20;107078
2021-06-19;"Žilinský kraj";9;8353;2;8355;NA;198695;11;2021-06-19;107069
2021-06-18;"Žilinský kraj";11;10624;12;10636;NA;198695;23;2021-06-18;107058
2021-06-17;"Žilinský kraj";10;6092;12;6104;NA;198695;22;2021-06-17;107035
2021-06-16;"Žilinský kraj";17;5786;11;5797;NA;198695;28;2021-06-16;107013
2021-06-15;"Žilinský kraj";13;5996;13;6009;NA;198695;26;2021-06-15;106985
2021-06-14;"Žilinský kraj";10;7596;21;7617;NA;198695;31;2021-06-14;106959
2021-06-13;"Žilinský kraj";2;6682;9;6691;NA;198695;11;2021-06-13;106928
2021-06-12;"Žilinský kraj";9;8634;11;8645;NA;198695;20;2021-06-12;106917
2021-06-11;"Žilinský kraj";11;11566;14;11580;NA;198695;25;2021-06-11;106897
2021-06-10;"Žilinský kraj";14;6788;14;6802;NA;198695;28;2021-06-10;106872
2021-06-09;"Žilinský kraj";23;5925;14;5939;NA;198695;37;2021-06-09;106844
2021-06-08;"Žilinský kraj";18;6615;16;6631;NA;198695;34;2021-06-08;106807
2021-06-07;"Žilinský kraj";25;8534;21;8555;NA;198695;46;2021-06-07;106773
2021-06-06;"Žilinský kraj";10;8056;27;8083;NA;198695;37;2021-06-06;106727
2021-06-05;"Žilinský kraj";8;9175;10;9185;NA;198695;18;2021-06-05;106690
2021-06-04;"Žilinský kraj";19;12260;34;12294;NA;198695;53;2021-06-04;106672
2021-06-03;"Žilinský kraj";12;7033;33;7066;NA;198695;45;2021-06-03;106619
2021-06-02;"Žilinský kraj";17;7090;28;7118;NA;198695;45;2021-06-02;106574
2021-06-01;"Žilinský kraj";38;8285;46;8331;NA;198695;84;2021-06-01;106529
2021-05-31;"Žilinský kraj";31;9616;59;9675;NA;198695;90;2021-05-31;106445
2021-05-30;"Žilinský kraj";21;9025;35;9060;NA;198695;56;2021-05-30;106355
2021-05-29;"Žilinský kraj";13;11195;23;11218;NA;198695;36;2021-05-29;106299
2021-05-28;"Žilinský kraj";28;13277;30;13307;NA;198695;58;2021-05-28;106263
2021-05-27;"Žilinský kraj";17;8267;39;8306;NA;198695;56;2021-05-27;106205
2021-05-26;"Žilinský kraj";20;8329;25;8354;NA;198695;45;2021-05-26;106149
2021-05-25;"Žilinský kraj";21;9624;38;9662;NA;198695;59;2021-05-25;106104
2021-05-24;"Žilinský kraj";36;11487;57;11544;NA;198695;93;2021-05-24;106045
2021-05-23;"Žilinský kraj";4;10923;56;10979;NA;198695;60;2021-05-23;105952
2021-05-22;"Žilinský kraj";21;11893;28;11921;NA;198695;49;2021-05-22;105892
2021-05-21;"Žilinský kraj";28;15654;50;15704;NA;198695;78;2021-05-21;105843
2021-05-20;"Žilinský kraj";30;9616;30;9646;NA;198695;60;2021-05-20;105765
2021-05-19;"Žilinský kraj";46;8693;41;8734;NA;198695;87;2021-05-19;105705
2021-05-18;"Žilinský kraj";52;10609;44;10653;NA;198695;96;2021-05-18;105618
2021-05-17;"Žilinský kraj";51;12676;84;12760;NA;198695;135;2021-05-17;105522
2021-05-16;"Žilinský kraj";13;14114;42;14156;NA;198695;55;2021-05-16;105387
2021-05-15;"Žilinský kraj";30;18404;35;18439;NA;198695;65;2021-05-15;105332
2021-05-14;"Žilinský kraj";34;21205;82;21287;NA;198695;116;2021-05-14;105267
2021-05-13;"Žilinský kraj";64;11865;51;11916;NA;198695;115;2021-05-13;105151
2021-05-12;"Žilinský kraj";57;10337;51;10388;NA;198695;108;2021-05-12;105036
2021-05-11;"Žilinský kraj";70;12174;51;12225;NA;198695;121;2021-05-11;104928
2021-05-10;"Žilinský kraj";69;16182;72;16254;NA;198695;141;2021-05-10;104807
2021-05-09;"Žilinský kraj";58;20385;77;20462;NA;198695;135;2021-05-09;104666
2021-05-08;"Žilinský kraj";0;24133;63;24196;NA;198695;63;2021-05-08;104531
2021-05-07;"Žilinský kraj";65;26522;87;26609;NA;198695;152;2021-05-07;104468
2021-05-06;"Žilinský kraj";67;16605;72;16677;NA;198695;139;2021-05-06;104316
2021-05-05;"Žilinský kraj";71;13096;73;13169;NA;198695;144;2021-05-05;104177
2021-05-04;"Žilinský kraj";81;16749;80;16829;NA;198695;161;2021-05-04;104033
2021-05-03;"Žilinský kraj";97;20391;111;20502;NA;198695;208;2021-05-03;103872
2021-05-02;"Žilinský kraj";8;28886;64;28950;NA;198695;72;2021-05-02;103664
2021-05-01;"Žilinský kraj";65;55053;105;55158;NA;198695;170;2021-05-01;103592
2021-04-30;"Žilinský kraj";84;44000;117;44117;NA;198695;201;2021-04-30;103422
2021-04-29;"Žilinský kraj";77;24566;101;24667;NA;198695;178;2021-04-29;103221
2021-04-28;"Žilinský kraj";76;19214;91;19305;NA;198695;167;2021-04-28;103043
2021-04-27;"Žilinský kraj";97;21805;110;21915;NA;198695;207;2021-04-27;102876
2021-04-26;"Žilinský kraj";114;27412;136;27548;NA;198695;250;2021-04-26;102669
2021-04-25;"Žilinský kraj";38;35750;82;35832;NA;198695;120;2021-04-25;102419
2021-04-24;"Žilinský kraj";93;78854;157;79011;NA;198695;250;2021-04-24;102299
2021-04-23;"Žilinský kraj";144;49440;153;49593;NA;198695;297;2021-04-23;102049
2021-04-22;"Žilinský kraj";110;25224;132;25356;NA;198695;242;2021-04-22;101752
2021-04-21;"Žilinský kraj";118;20616;145;20761;NA;198695;263;2021-04-21;101510
2021-04-20;"Žilinský kraj";128;23873;136;24009;NA;198695;264;2021-04-20;101247
2021-04-19;"Žilinský kraj";164;32773;210;32983;NA;198695;374;2021-04-19;100983
2021-04-18;"Žilinský kraj";18;36767;91;36858;NA;198695;109;2021-04-18;100609
2021-04-17;"Žilinský kraj";108;89377;156;89533;NA;198695;264;2021-04-17;100500
2021-04-16;"Žilinský kraj";185;47847;208;48055;NA;198695;393;2021-04-16;100236
2021-04-15;"Žilinský kraj";108;24830;130;24960;NA;198695;238;2021-04-15;99843
2021-04-14;"Žilinský kraj";135;23145;145;23290;NA;198695;280;2021-04-14;99605
2021-04-13;"Žilinský kraj";171;25050;135;25185;NA;198695;306;2021-04-13;99325
2021-04-12;"Žilinský kraj";266;30794;189;30983;NA;198695;455;2021-04-12;99019
2021-04-11;"Žilinský kraj";19;37126;107;37233;NA;198695;126;2021-04-11;98564
2021-04-10;"Žilinský kraj";111;86284;237;86521;NA;198695;348;2021-04-10;98438
2021-04-09;"Žilinský kraj";195;41973;206;42179;NA;198695;401;2021-04-09;98090
2021-04-08;"Žilinský kraj";179;24404;141;24545;NA;198695;320;2021-04-08;97689
2021-04-07;"Žilinský kraj";309;28651;174;28825;NA;198695;483;2021-04-07;97369
2021-04-06;"Žilinský kraj";308;40107;301;40408;NA;198695;609;2021-04-06;96886
2021-04-05;"Žilinský kraj";17;14747;140;14887;NA;198695;157;2021-04-05;96277
2021-04-04;"Žilinský kraj";17;16284;69;16353;NA;198695;86;2021-04-04;96120
2021-04-03;"Žilinský kraj";180;100699;403;101102;NA;198695;583;2021-04-03;96034
2021-04-02;"Žilinský kraj";73;22411;83;22494;NA;198695;156;2021-04-02;95451
2021-04-01;"Žilinský kraj";334;43264;240;43504;NA;198695;574;2021-04-01;95295
2021-03-31;"Žilinský kraj";170;31635;247;31882;NA;198695;417;2021-03-31;94721
2021-03-30;"Žilinský kraj";406;26323;243;26566;NA;198695;649;2021-03-30;94304
2021-03-29;"Žilinský kraj";297;28029;268;28297;NA;198695;565;2021-03-29;93655
2021-03-28;"Žilinský kraj";21;36206;239;36445;NA;198695;260;2021-03-28;93090
2021-03-27;"Žilinský kraj";151;89107;353;89460;NA;198695;504;2021-03-27;92830
2021-03-26;"Žilinský kraj";312;51757;330;52087;NA;198695;642;2021-03-26;92326
2021-03-25;"Žilinský kraj";281;27619;214;27833;NA;198695;495;2021-03-25;91684
2021-03-24;"Žilinský kraj";280;21268;260;21528;NA;198695;540;2021-03-24;91189
2021-03-23;"Žilinský kraj";418;23193;278;23471;NA;198695;696;2021-03-23;90649
2021-03-22;"Žilinský kraj";293;29289;314;29603;NA;198695;607;2021-03-22;89953
2021-03-21;"Žilinský kraj";32;33705;227;33932;NA;198695;259;2021-03-21;89346
2021-03-20;"Žilinský kraj";165;93015;497;93512;NA;198695;662;2021-03-20;89087
2021-03-19;"Žilinský kraj";357;51988;414;52402;NA;198695;771;2021-03-19;88425
2021-03-18;"Žilinský kraj";329;28459;294;28753;NA;198695;623;2021-03-18;87654
2021-03-17;"Žilinský kraj";395;21919;269;22188;NA;198695;664;2021-03-17;87031
2021-03-16;"Žilinský kraj";514;24341;317;24658;NA;198695;831;2021-03-16;86367
2021-03-15;"Žilinský kraj";341;29613;419;30032;NA;198695;760;2021-03-15;85536
2021-03-14;"Žilinský kraj";87;34121;267;34388;NA;198695;354;2021-03-14;84776
2021-03-13;"Žilinský kraj";113;93386;581;93967;NA;198695;694;2021-03-13;84422
2021-03-12;"Žilinský kraj";520;52329;411;52740;NA;198695;931;2021-03-12;83728
2021-03-11;"Žilinský kraj";399;28189;302;28491;NA;198695;701;2021-03-11;82797
2021-03-10;"Žilinský kraj";368;22414;378;22792;NA;198695;746;2021-03-10;82096
2021-03-09;"Žilinský kraj";537;24857;316;25173;NA;198695;853;2021-03-09;81350
2021-03-08;"Žilinský kraj";387;30873;458;31331;NA;198695;845;2021-03-08;80497
2021-03-07;"Žilinský kraj";48;33469;290;33759;NA;198695;338;2021-03-07;79652
2021-03-06;"Žilinský kraj";173;92410;589;92999;NA;198695;762;2021-03-06;79314
2021-03-05;"Žilinský kraj";369;51987;484;52471;NA;198695;853;2021-03-05;78552
2021-03-04;"Žilinský kraj";467;30037;377;30414;NA;198695;844;2021-03-04;77699
2021-03-03;"Žilinský kraj";448;26261;394;26655;NA;198695;842;2021-03-03;76855
2021-03-02;"Žilinský kraj";551;25913;378;26291;NA;198695;929;2021-03-02;76013
2021-03-01;"Žilinský kraj";375;30498;441;30939;NA;198695;816;2021-03-01;75084
2021-02-28;"Žilinský kraj";61;34802;327;35129;NA;198695;388;2021-02-28;74268
2021-02-27;"Žilinský kraj";159;83781;639;84420;NA;198695;798;2021-02-27;73880
2021-02-26;"Žilinský kraj";459;47500;508;48008;NA;198695;967;2021-02-26;73082
2021-02-25;"Žilinský kraj";347;30879;393;31272;NA;198695;740;2021-02-25;72115
2021-02-24;"Žilinský kraj";339;18760;395;19155;NA;198695;734;2021-02-24;71375
2021-02-23;"Žilinský kraj";437;22172;418;22590;NA;198695;855;2021-02-23;70641
2021-02-22;"Žilinský kraj";345;29270;438;29708;NA;198695;783;2021-02-22;69786
2021-02-21;"Žilinský kraj";36;28686;322;29008;NA;198695;358;2021-02-21;69003
2021-02-20;"Žilinský kraj";152;89944;671;90615;NA;198695;823;2021-02-20;68645
2021-02-19;"Žilinský kraj";337;45541;417;45958;NA;198695;754;2021-02-19;67822
2021-02-18;"Žilinský kraj";263;24662;337;24999;NA;198695;600;2021-02-18;67068
2021-02-17;"Žilinský kraj";269;17932;355;18287;NA;198695;624;2021-02-17;66468
2021-02-16;"Žilinský kraj";321;24298;325;24623;NA;198695;646;2021-02-16;65844
2021-02-15;"Žilinský kraj";230;30420;311;30731;NA;198695;541;2021-02-15;65198
2021-02-14;"Žilinský kraj";30;28574;231;28805;NA;198695;261;2021-02-14;64657
2021-02-13;"Žilinský kraj";91;69638;453;70091;NA;198695;544;2021-02-13;64396
2021-02-12;"Žilinský kraj";242;43338;336;43674;NA;198695;578;2021-02-12;63852
2021-02-11;"Žilinský kraj";228;23521;300;23821;NA;198695;528;2021-02-11;63274
2021-02-10;"Žilinský kraj";259;17894;267;18161;NA;198695;526;2021-02-10;62746
2021-02-09;"Žilinský kraj";377;24784;274;25058;NA;198695;651;2021-02-09;62220
2021-02-08;"Žilinský kraj";160;41375;390;41765;NA;198695;550;2021-02-08;61569
2021-02-07;"Žilinský kraj";24;46446;252;46698;NA;198695;276;2021-02-07;61019
2021-02-06;"Žilinský kraj";71;72880;367;73247;NA;198695;438;2021-02-06;60743
2021-02-05;"Žilinský kraj";248;31869;323;32192;NA;198695;571;2021-02-05;60305
2021-02-04;"Žilinský kraj";238;13240;258;13498;NA;198695;496;2021-02-04;59734
2021-02-03;"Žilinský kraj";194;9186;255;9441;NA;198695;449;2021-02-03;59238
2021-02-02;"Žilinský kraj";216;9280;272;9552;NA;198695;488;2021-02-02;58789
2021-02-01;"Žilinský kraj";220;19690;370;20060;NA;198695;590;2021-02-01;58301
2021-01-31;"Žilinský kraj";11;2652;27;2679;NA;198695;38;2021-01-31;57711
2021-01-30;"Žilinský kraj";85;18447;187;18634;NA;198695;272;2021-01-30;57673
2021-01-29;"Žilinský kraj";209;22891;304;23195;NA;198695;513;2021-01-29;57401
2021-01-28;"Žilinský kraj";240;5533;172;5705;NA;198695;412;2021-01-28;56888
2021-01-27;"Žilinský kraj";256;6725;119;6844;NA;198695;375;2021-01-27;56476
2021-01-26;"Žilinský kraj";245;49781;348;50129;NA;198695;593;2021-01-26;56101
2021-01-25;"Žilinský kraj";159;21245;150;21395;NA;198695;309;2021-01-25;55508
2021-01-24;"Žilinský kraj";22;55835;268;56103;NA;198695;290;2021-01-24;55199
2021-01-23;"Žilinský kraj";91;101730;444;102174;NA;198695;535;2021-01-23;54909
2021-01-22;"Žilinský kraj";163;32160;237;32397;NA;198695;400;2021-01-22;54374
2021-01-21;"Žilinský kraj";116;19828;181;20009;NA;198695;297;2021-01-21;53974
2021-01-20;"Žilinský kraj";236;17126;159;17285;NA;198695;395;2021-01-20;53677
2021-01-19;"Žilinský kraj";245;15730;285;16015;NA;198695;530;2021-01-19;53282
2021-01-18;"Žilinský kraj";236;12685;326;13011;NA;198695;562;2021-01-18;52752
2021-01-17;"Žilinský kraj";95;147;8;155;NA;198695;103;2021-01-17;52190
2021-01-16;"Žilinský kraj";14;516;31;547;NA;198695;45;2021-01-16;52087
2021-01-15;"Žilinský kraj";248;7486;209;7695;NA;198695;457;2021-01-15;52042
2021-01-14;"Žilinský kraj";166;5319;239;5558;NA;198695;405;2021-01-14;51585
2021-01-13;"Žilinský kraj";247;11263;557;11820;NA;198695;804;2021-01-13;51180
2021-01-12;"Žilinský kraj";376;8410;385;8795;NA;198695;761;2021-01-12;50376
2021-01-11;"Žilinský kraj";351;10058;465;10523;NA;198695;816;2021-01-11;49615
2021-01-10;"Žilinský kraj";38;229;6;235;NA;198695;44;2021-01-10;48799
2021-01-09;"Žilinský kraj";192;1282;60;1342;NA;198695;252;2021-01-09;48755
2021-01-08;"Žilinský kraj";413;8721;462;9183;NA;198695;875;2021-01-08;48503
2021-01-07;"Žilinský kraj";438;23407;1872;25279;NA;198695;2310;2021-01-07;47628
2021-01-06;"Žilinský kraj";145;1076;67;1143;NA;198695;212;2021-01-06;45318
2021-01-05;"Žilinský kraj";717;10227;796;11023;NA;198695;1513;2021-01-05;45106
2021-01-04;"Žilinský kraj";479;9313;893;10206;NA;198695;1372;2021-01-04;43593
2021-01-03;"Žilinský kraj";13;1006;107;1113;NA;198695;120;2021-01-03;42221
2021-01-02;"Žilinský kraj";98;789;91;880;NA;198695;189;2021-01-02;42101
2021-01-01;"Žilinský kraj";118;241;13;254;NA;198695;131;2021-01-01;41912
2020-12-31;"Žilinský kraj";395;9626;784;10410;NA;198695;1179;2020-12-31;41781
2020-12-30;"Žilinský kraj";1038;11781;823;12604;NA;198695;1861;2020-12-30;40602
2020-12-29;"Žilinský kraj";256;10159;979;11138;NA;198695;1235;2020-12-29;38741
2020-12-28;"Žilinský kraj";406;10704;976;11680;NA;198695;1382;2020-12-28;37506
2020-12-27;"Žilinský kraj";40;684;94;778;NA;198695;134;2020-12-27;36124
2020-12-26;"Žilinský kraj";135;593;48;641;NA;198695;183;2020-12-26;35990
2020-12-25;"Žilinský kraj";66;83;9;92;NA;198695;75;2020-12-25;35807
2020-12-24;"Žilinský kraj";643;667;55;722;NA;198695;698;2020-12-24;35732
2020-12-23;"Žilinský kraj";228;16229;975;17204;NA;198695;1203;2020-12-23;35034
2020-12-22;"Žilinský kraj";519;13483;988;14471;NA;198695;1507;2020-12-22;33831
2020-12-21;"Žilinský kraj";444;12429;1078;13507;NA;198695;1522;2020-12-21;32324
2020-12-20;"Žilinský kraj";36;598;80;678;NA;198695;116;2020-12-20;30802
2020-12-19;"Žilinský kraj";208;1678;127;1805;NA;198695;335;2020-12-19;30686
2020-12-18;"Žilinský kraj";333;6553;370;6923;NA;198695;703;2020-12-18;30351
2020-12-17;"Žilinský kraj";500;3922;262;4184;NA;198695;762;2020-12-17;29648
2020-12-16;"Žilinský kraj";333;3815;267;4082;NA;198695;600;2020-12-16;28886
2020-12-15;"Žilinský kraj";528;3729;340;4069;NA;198695;868;2020-12-15;28286
2020-12-14;"Žilinský kraj";321;3884;309;4193;NA;198695;630;2020-12-14;27418
2020-12-13;"Žilinský kraj";26;494;66;560;NA;198695;92;2020-12-13;26788
2020-12-12;"Žilinský kraj";95;767;46;813;NA;198695;141;2020-12-12;26696
2020-12-11;"Žilinský kraj";455;3938;227;4165;NA;198695;682;2020-12-11;26555
2020-12-10;"Žilinský kraj";166;9129;838;9967;NA;198695;1004;2020-12-10;25873
2020-12-09;"Žilinský kraj";392;2169;132;2301;NA;198695;524;2020-12-09;24869
2020-12-08;"Žilinský kraj";331;3127;101;3228;NA;198695;432;2020-12-08;24345
2020-12-07;"Žilinský kraj";348;2746;162;2908;NA;198695;510;2020-12-07;23913
2020-12-06;"Žilinský kraj";15;128;6;134;NA;198695;21;2020-12-06;23403
2020-12-05;"Žilinský kraj";98;781;41;822;NA;198695;139;2020-12-05;23382
2020-12-04;"Žilinský kraj";228;3091;107;3198;NA;198695;335;2020-12-04;23243
2020-12-03;"Žilinský kraj";237;1609;115;1724;NA;198695;352;2020-12-03;22908
2020-12-02;"Žilinský kraj";181;1710;94;1804;NA;198695;275;2020-12-02;22556
2020-12-01;"Žilinský kraj";209;6239;284;6523;NA;198695;493;2020-12-01;22281
2020-11-30;"Žilinský kraj";203;5326;305;5631;NA;198695;508;2020-11-30;21788
2020-11-29;"Žilinský kraj";18;81;7;88;NA;198695;25;2020-11-29;21280
2020-11-28;"Žilinský kraj";99;349;15;364;NA;198695;114;2020-11-28;21255
2020-11-27;"Žilinský kraj";218;904;46;950;NA;198695;264;2020-11-27;21141
2020-11-26;"Žilinský kraj";190;1041;54;1095;NA;198695;244;2020-11-26;20877
2020-11-25;"Žilinský kraj";225;1217;49;1266;NA;198695;274;2020-11-25;20633
2020-11-24;"Žilinský kraj";213;2139;67;2206;NA;198695;280;2020-11-24;20359
2020-11-23;"Žilinský kraj";170;759;44;803;NA;198695;214;2020-11-23;20079
2020-11-22;"Žilinský kraj";11;67;2;69;NA;198695;13;2020-11-22;19865
2020-11-21;"Žilinský kraj";61;505;20;525;NA;198695;81;2020-11-21;19852
2020-11-20;"Žilinský kraj";251;1074;45;1119;NA;198695;296;2020-11-20;19771
2020-11-19;"Žilinský kraj";252;752;61;813;NA;198695;313;2020-11-19;19475
2020-11-18;"Žilinský kraj";346;348;15;363;NA;198695;361;2020-11-18;19162
2020-11-17;"Žilinský kraj";123;490;15;505;NA;198695;138;2020-11-17;18801
2020-11-16;"Žilinský kraj";227;247;15;262;NA;198695;242;2020-11-16;18663
2020-11-15;"Žilinský kraj";63;13;0;13;NA;198695;63;2020-11-15;18421
2020-11-14;"Žilinský kraj";189;1038;11;1049;NA;198695;200;2020-11-14;18358
2020-11-13;"Žilinský kraj";181;125;9;134;NA;198695;190;2020-11-13;18158
2020-11-12;"Žilinský kraj";334;79;2;81;NA;198695;336;2020-11-12;17968
2020-11-11;"Žilinský kraj";489;147;10;157;NA;198695;499;2020-11-11;17632
2020-11-10;"Žilinský kraj";374;519;9;528;NA;198695;383;2020-11-10;17133
2020-11-09;"Žilinský kraj";143;2335;30;2365;NA;198695;173;2020-11-09;16750
2020-11-08;"Žilinský kraj";59;2538;37;2575;NA;198695;96;2020-11-08;16577
2020-11-07;"Žilinský kraj";312;8175;88;8263;NA;198695;400;2020-11-07;16481
2020-11-06;"Žilinský kraj";503;4090;38;4128;NA;198695;541;2020-11-06;16081
2020-11-05;"Žilinský kraj";473;64;4;68;NA;198695;477;2020-11-05;15540
2020-11-04;"Žilinský kraj";423;178;10;188;NA;198695;433;2020-11-04;15063
2020-11-03;"Žilinský kraj";688;889;16;905;NA;198695;704;2020-11-03;14630
2020-11-02;"Žilinský kraj";472;1043;39;1082;NA;198695;511;2020-11-02;13926
2020-11-01;"Žilinský kraj";349;5096;130;5226;NA;198695;479;2020-11-01;13415
2020-10-31;"Žilinský kraj";661;7963;203;8166;NA;198695;864;2020-10-31;12936
2020-10-30;"Žilinský kraj";529;2575;61;2636;NA;198695;590;2020-10-30;12072
2020-10-29;"Žilinský kraj";740;503;17;520;NA;198695;757;2020-10-29;11482
2020-10-28;"Žilinský kraj";635;105;11;116;NA;198695;646;2020-10-28;10725
2020-10-27;"Žilinský kraj";355;154;24;178;NA;198695;379;2020-10-27;10079
2020-10-26;"Žilinský kraj";148;117;28;145;NA;198695;176;2020-10-26;9700
2020-10-25;"Žilinský kraj";436;0;0;0;NA;198695;436;2020-10-25;9524
2020-10-24;"Žilinský kraj";803;0;0;0;NA;198695;803;2020-10-24;9088
2020-10-23;"Žilinský kraj";659;102;13;115;NA;198695;672;2020-10-23;8285
2020-10-22;"Žilinský kraj";525;33;3;36;NA;198695;528;2020-10-22;7613
2020-10-21;"Žilinský kraj";478;74;14;88;NA;198695;492;2020-10-21;7085
2020-10-20;"Žilinský kraj";524;127;8;135;NA;198695;532;2020-10-20;6593
2020-10-19;"Žilinský kraj";70;80;12;92;NA;198695;82;2020-10-19;6061
2020-10-18;"Žilinský kraj";159;0;0;0;NA;198695;159;2020-10-18;5979
2020-10-17;"Žilinský kraj";509;0;0;0;NA;198695;509;2020-10-17;5820
2020-10-16;"Žilinský kraj";603;51;9;60;NA;198695;612;2020-10-16;5311
2020-10-15;"Žilinský kraj";679;61;3;64;NA;198695;682;2020-10-15;4699
2020-10-14;"Žilinský kraj";523;269;6;275;NA;198695;529;2020-10-14;4017
2020-10-13;"Žilinský kraj";367;458;40;498;NA;198695;407;2020-10-13;3488
2020-10-12;"Žilinský kraj";62;0;0;0;NA;198695;62;2020-10-12;3081
2020-10-11;"Žilinský kraj";50;0;0;0;NA;198695;50;2020-10-11;3019
2020-10-10;"Žilinský kraj";213;0;0;0;NA;198695;213;2020-10-10;2969
2020-10-09;"Žilinský kraj";543;0;0;0;NA;198695;543;2020-10-09;2756
2020-10-08;"Žilinský kraj";238;0;0;0;NA;198695;238;2020-10-08;2213
2020-10-07;"Žilinský kraj";168;0;0;0;NA;198695;168;2020-10-07;1975
2020-10-06;"Žilinský kraj";233;0;0;0;NA;198695;233;2020-10-06;1807
2020-10-05;"Žilinský kraj";33;0;0;0;NA;198695;33;2020-10-05;1574
2020-10-04;"Žilinský kraj";35;0;0;0;NA;198695;35;2020-10-04;1541
2020-10-03;"Žilinský kraj";155;0;0;0;NA;198695;155;2020-10-03;1506
2020-10-02;"Žilinský kraj";105;0;0;0;NA;198695;105;2020-10-02;1351
2020-10-01;"Žilinský kraj";147;0;0;0;NA;198695;147;2020-10-01;1246
2020-09-30;"Žilinský kraj";163;0;0;0;NA;198695;163;2020-09-30;1099
2020-09-29;"Žilinský kraj";105;0;0;0;NA;198695;105;2020-09-29;936
2020-09-28;"Žilinský kraj";34;0;0;0;NA;198695;34;2020-09-28;831
2020-09-27;"Žilinský kraj";108;0;0;0;NA;198695;108;2020-09-27;797
2020-09-26;"Žilinský kraj";96;0;0;0;NA;198695;96;2020-09-26;689
2020-09-25;"Žilinský kraj";69;0;0;0;NA;198695;69;2020-09-25;593
2020-09-24;"Žilinský kraj";100;0;0;0;NA;198695;100;2020-09-24;524
2020-09-23;"Žilinský kraj";65;0;0;0;NA;198695;65;2020-09-23;424
2020-09-22;"Žilinský kraj";65;0;0;0;NA;198695;65;2020-09-22;359
2020-09-21;"Žilinský kraj";47;0;0;0;NA;198695;47;2020-09-21;294
2020-09-20;"Žilinský kraj";4;0;0;0;NA;198695;4;2020-09-20;247
2020-09-19;"Žilinský kraj";6;0;0;0;NA;198695;6;2020-09-19;243
2020-09-18;"Žilinský kraj";82;0;0;0;NA;198695;82;2020-09-18;237
2020-09-17;"Žilinský kraj";30;0;0;0;NA;198695;30;2020-09-17;155
2020-09-16;"Žilinský kraj";34;0;0;0;NA;198695;34;2020-09-16;125
2020-09-15;"Žilinský kraj";12;0;0;0;NA;198695;12;2020-09-15;91
2020-09-14;"Žilinský kraj";39;0;0;0;NA;198695;39;2020-09-14;79
2020-09-13;"Žilinský kraj";6;0;0;0;NA;198695;6;2020-09-13;40
2020-09-12;"Žilinský kraj";4;0;0;0;NA;198695;4;2020-09-12;34
2020-09-11;"Žilinský kraj";31;0;0;0;NA;198695;31;2020-09-11;30
2020-09-10;"Žilinský kraj";31;12;0;12;NA;198695;31;2020-09-10;-1
2020-09-09;"Žilinský kraj";23;0;0;0;NA;198695;23;2020-09-09;-32
2020-09-08;"Žilinský kraj";25;0;0;0;NA;198695;25;2020-09-08;-55
2020-09-07;"Žilinský kraj";11;0;0;0;NA;198695;11;2020-09-07;-80
2020-09-06;"Žilinský kraj";0;0;0;0;NA;198695;0;2020-09-06;-91
2020-09-05;"Žilinský kraj";2;0;0;0;NA;198695;2;2020-09-05;-91
2020-09-04;"Žilinský kraj";33;0;0;0;NA;198695;33;2020-09-04;-93
2020-09-03;"Žilinský kraj";18;0;0;0;NA;198695;18;2020-09-03;-126
2020-09-02;"Žilinský kraj";16;0;0;0;NA;198695;16;2020-09-02;-144
2020-09-01;"Žilinský kraj";4;0;0;0;NA;198695;4;2020-09-01;-160
2020-08-31;"Žilinský kraj";5;0;0;0;NA;198695;5;2020-08-31;-164
2020-08-30;"Žilinský kraj";3;0;0;0;NA;198695;3;2020-08-30;-169
2020-08-29;"Žilinský kraj";5;0;0;0;NA;198695;5;2020-08-29;-172
2020-08-28;"Žilinský kraj";13;0;0;0;NA;198695;13;2020-08-28;-177
2020-08-27;"Žilinský kraj";18;0;0;0;NA;198695;18;2020-08-27;-190
2020-08-26;"Žilinský kraj";8;0;0;0;NA;198695;8;2020-08-26;-208
2020-08-25;"Žilinský kraj";2;0;0;0;NA;198695;2;2020-08-25;-216
2020-08-24;"Žilinský kraj";5;0;0;0;NA;198695;5;2020-08-24;-218
2020-08-23;"Žilinský kraj";0;0;0;0;NA;198695;0;2020-08-23;-223
2020-08-22;"Žilinský kraj";0;0;0;0;NA;198695;0;2020-08-22;-223
2020-08-21;"Žilinský kraj";10;0;0;0;NA;198695;10;2020-08-21;-223
2020-08-20;"Žilinský kraj";13;0;0;0;NA;198695;13;2020-08-20;-233
2020-08-19;"Žilinský kraj";7;0;0;0;NA;198695;7;2020-08-19;-246
2020-08-18;"Žilinský kraj";9;0;0;0;NA;198695;9;2020-08-18;-253
2020-08-17;"Žilinský kraj";1;0;0;0;NA;198695;1;2020-08-17;-262
2020-08-16;"Žilinský kraj";0;0;0;0;NA;198695;0;2020-08-16;-263
2020-08-15;"Žilinský kraj";0;0;0;0;NA;198695;0;2020-08-15;-263
2020-08-14;"Žilinský kraj";4;0;0;0;NA;198695;4;2020-08-14;-263
2020-08-13;"Žilinský kraj";2;0;0;0;NA;198695;2;2020-08-13;-267
2020-08-12;"Žilinský kraj";0;0;0;0;NA;198695;0;2020-08-12;-269
2020-08-11;"Žilinský kraj";4;0;0;0;NA;198695;4;2020-08-11;-269
2020-08-10;"Žilinský kraj";1;0;0;0;NA;198695;1;2020-08-10;-273
2020-08-09;"Žilinský kraj";0;0;0;0;NA;198695;0;2020-08-09;-274
2020-08-08;"Žilinský kraj";3;0;0;0;NA;198695;3;2020-08-08;-274
2020-08-07;"Žilinský kraj";8;0;0;0;NA;198695;8;2020-08-07;-277
2020-08-06;"Žilinský kraj";1;0;0;0;NA;198695;1;2020-08-06;-285
2020-08-05;"Žilinský kraj";1;0;0;0;NA;198695;1;2020-08-05;-286
2020-08-04;"Žilinský kraj";2;0;0;0;NA;198695;2;2020-08-04;-287
2020-08-03;"Žilinský kraj";0;0;0;0;NA;198695;0;2020-08-03;-289
2020-08-02;"Žilinský kraj";1;0;0;0;NA;198695;1;2020-08-02;-289
2020-08-01;"Žilinský kraj";0;0;0;0;NA;198695;0;2020-08-01;-290
2020-07-31;"Žilinský kraj";4;0;0;0;NA;198695;4;2020-07-31;-290
2020-07-30;"Žilinský kraj";2;0;0;0;NA;198695;2;2020-07-30;-294
2020-07-29;"Žilinský kraj";2;0;0;0;NA;198695;2;2020-07-29;-296
2020-07-28;"Žilinský kraj";4;0;0;0;NA;198695;4;2020-07-28;-298
2020-07-27;"Žilinský kraj";6;0;0;0;NA;198695;6;2020-07-27;-302
2020-07-26;"Žilinský kraj";0;0;0;0;NA;198695;0;2020-07-26;-308
2020-07-25;"Žilinský kraj";0;0;0;0;NA;198695;0;2020-07-25;-308
2020-07-24;"Žilinský kraj";2;0;0;0;NA;198695;2;2020-07-24;-308
2020-07-23;"Žilinský kraj";0;0;0;0;NA;198695;0;2020-07-23;-310
2020-07-22;"Žilinský kraj";1;0;0;0;NA;198695;1;2020-07-22;-310
2020-07-21;"Žilinský kraj";2;0;0;0;NA;198695;2;2020-07-21;-311
2020-07-20;"Žilinský kraj";3;0;0;0;NA;198695;3;2020-07-20;-313
2020-07-19;"Žilinský kraj";0;0;0;0;NA;198695;0;2020-07-19;-316
2020-07-18;"Žilinský kraj";0;0;0;0;NA;198695;0;2020-07-18;-316
2020-07-17;"Žilinský kraj";2;0;0;0;NA;198695;2;2020-07-17;-316
2020-07-16;"Žilinský kraj";2;0;0;0;NA;198695;2;2020-07-16;-318
2020-07-15;"Žilinský kraj";2;0;0;0;NA;198695;2;2020-07-15;-320
2020-07-14;"Žilinský kraj";1;0;0;0;NA;198695;1;2020-07-14;-322
2020-07-13;"Žilinský kraj";0;0;0;0;NA;198695;0;2020-07-13;-323
2020-07-12;"Žilinský kraj";0;0;0;0;NA;198695;0;2020-07-12;-323
2020-07-11;"Žilinský kraj";2;0;0;0;NA;198695;2;2020-07-11;-323
2020-07-10;"Žilinský kraj";3;0;0;0;NA;198695;3;2020-07-10;-325
2020-07-09;"Žilinský kraj";2;0;0;0;NA;198695;2;2020-07-09;-328
2020-07-08;"Žilinský kraj";10;0;0;0;NA;198695;10;2020-07-08;-330
2020-07-07;"Žilinský kraj";7;0;0;0;NA;198695;7;2020-07-07;-340
2020-07-06;"Žilinský kraj";0;0;0;0;NA;198695;0;2020-07-06;-347
2020-07-05;"Žilinský kraj";0;0;0;0;NA;198695;0;2020-07-05;-347
2020-07-04;"Žilinský kraj";10;0;0;0;NA;198695;10;2020-07-04;-347
2020-07-03;"Žilinský kraj";18;0;0;0;NA;198695;18;2020-07-03;-357
2020-07-02;"Žilinský kraj";7;0;0;0;NA;198695;7;2020-07-02;-375
2020-07-01;"Žilinský kraj";0;0;0;0;NA;198695;0;2020-07-01;-382
2020-06-30;"Žilinský kraj";4;0;0;0;NA;198695;4;2020-06-30;-382
2020-06-29;"Žilinský kraj";0;0;0;0;NA;198695;0;2020-06-29;-386
2020-06-28;"Žilinský kraj";1;0;0;0;NA;198695;1;2020-06-28;-386
2020-06-27;"Žilinský kraj";3;0;0;0;NA;198695;3;2020-06-27;-387
2020-06-26;"Žilinský kraj";5;0;0;0;NA;198695;5;2020-06-26;-390
2020-06-25;"Žilinský kraj";7;0;0;0;NA;198695;7;2020-06-25;-395
2020-06-24;"Žilinský kraj";11;0;0;0;NA;198695;11;2020-06-24;-402
2020-06-23;"Žilinský kraj";9;0;0;0;NA;198695;9;2020-06-23;-413
2020-06-22;"Žilinský kraj";0;0;0;0;NA;198695;0;2020-06-22;-422
2020-06-21;"Žilinský kraj";1;0;0;0;NA;198695;1;2020-06-21;-422
2020-06-20;"Žilinský kraj";1;0;0;0;NA;198695;1;2020-06-20;-423
2020-06-19;"Žilinský kraj";4;0;0;0;NA;198695;4;2020-06-19;-424
2020-06-18;"Žilinský kraj";1;0;0;0;NA;198695;1;2020-06-18;-428
2020-06-17;"Žilinský kraj";0;0;0;0;NA;198695;0;2020-06-17;-429
2020-06-16;"Žilinský kraj";1;0;0;0;NA;198695;1;2020-06-16;-429
2020-06-14;"Žilinský kraj";0;0;0;0;NA;198695;0;2020-06-14;-430
2020-06-13;"Žilinský kraj";0;0;0;0;NA;198695;0;2020-06-13;-430
2020-06-12;"Žilinský kraj";0;0;0;0;NA;198695;0;2020-06-12;-430
2020-06-11;"Žilinský kraj";0;0;0;0;NA;198695;0;2020-06-11;-430
2020-06-10;"Žilinský kraj";0;0;0;0;NA;198695;0;2020-06-10;-430
2020-06-09;"Žilinský kraj";1;0;0;0;NA;198695;1;2020-06-09;-430
2020-06-08;"Žilinský kraj";0;0;0;0;NA;198695;0;2020-06-08;-431
2020-06-07;"Žilinský kraj";0;0;0;0;NA;198695;0;2020-06-07;-431
2020-06-05;"Žilinský kraj";0;0;0;0;NA;198695;0;2020-06-05;-431
2020-06-03;"Žilinský kraj";0;0;0;0;NA;198695;0;2020-06-03;-431
2020-06-02;"Žilinský kraj";0;0;0;0;NA;198695;0;2020-06-02;-431
2020-05-31;"Žilinský kraj";0;0;0;0;NA;198695;0;2020-05-31;-431
2020-05-29;"Žilinský kraj";0;0;0;0;NA;198695;0;2020-05-29;-431
2020-05-27;"Žilinský kraj";1;0;0;0;NA;198695;1;2020-05-27;-431
2020-05-26;"Žilinský kraj";1;0;0;0;NA;198695;1;2020-05-26;-432
2020-05-25;"Žilinský kraj";0;0;0;0;NA;198695;0;2020-05-25;-433
2020-05-24;"Žilinský kraj";0;0;0;0;NA;198695;0;2020-05-24;-433
2020-05-23;"Žilinský kraj";0;0;0;0;NA;198695;0;2020-05-23;-433
2020-05-22;"Žilinský kraj";0;0;0;0;NA;198695;0;2020-05-22;-433
2020-05-21;"Žilinský kraj";0;0;0;0;NA;198695;0;2020-05-21;-433
2020-05-20;"Žilinský kraj";0;0;0;0;NA;198695;0;2020-05-20;-433
2020-05-19;"Žilinský kraj";1;0;0;0;NA;198695;1;2020-05-19;-433
2020-05-17;"Žilinský kraj";0;0;0;0;NA;198695;0;2020-05-17;-434
2020-05-16;"Žilinský kraj";0;0;0;0;NA;198695;0;2020-05-16;-434
2020-05-15;"Žilinský kraj";0;0;0;0;NA;198695;0;2020-05-15;-434
2020-05-14;"Žilinský kraj";0;0;0;0;NA;198695;0;2020-05-14;-434
2020-05-13;"Žilinský kraj";0;0;0;0;NA;198695;0;2020-05-13;-434
2020-05-12;"Žilinský kraj";0;0;0;0;NA;198695;0;2020-05-12;-434
2020-05-11;"Žilinský kraj";0;0;0;0;NA;198695;0;2020-05-11;-434
2020-05-09;"Žilinský kraj";0;0;0;0;NA;198695;0;2020-05-09;-434
2020-05-07;"Žilinský kraj";0;0;0;0;NA;198695;0;2020-05-07;-434
2020-05-06;"Žilinský kraj";2;0;0;0;NA;198695;2;2020-05-06;-434
2020-05-05;"Žilinský kraj";3;0;0;0;NA;198695;3;2020-05-05;-436
2020-05-04;"Žilinský kraj";3;0;0;0;NA;198695;3;2020-05-04;-439
2020-05-03;"Žilinský kraj";1;0;0;0;NA;198695;1;2020-05-03;-442
2020-05-02;"Žilinský kraj";0;0;0;0;NA;198695;0;2020-05-02;-443
2020-05-01;"Žilinský kraj";1;0;0;0;NA;198695;1;2020-05-01;-443
2020-04-30;"Žilinský kraj";0;0;0;0;NA;198695;0;2020-04-30;-444
2020-04-29;"Žilinský kraj";0;0;0;0;NA;198695;0;2020-04-29;-444
2020-04-28;"Žilinský kraj";0;0;0;0;NA;198695;0;2020-04-28;-444
2020-04-27;"Žilinský kraj";0;0;0;0;NA;198695;0;2020-04-27;-444
2020-04-26;"Žilinský kraj";0;0;0;0;NA;198695;0;2020-04-26;-444
2020-04-25;"Žilinský kraj";2;0;0;0;NA;198695;2;2020-04-25;-444
2020-04-24;"Žilinský kraj";1;0;0;0;NA;198695;1;2020-04-24;-446
2020-04-23;"Žilinský kraj";2;0;0;0;NA;198695;2;2020-04-23;-447
2020-04-22;"Žilinský kraj";9;0;0;0;NA;198695;9;2020-04-22;-449
2020-04-21;"Žilinský kraj";1;0;0;0;NA;198695;1;2020-04-21;-458
2020-04-20;"Žilinský kraj";4;0;0;0;NA;198695;4;2020-04-20;-459
2020-04-19;"Žilinský kraj";0;0;0;0;NA;198695;0;2020-04-19;-463
2020-04-18;"Žilinský kraj";49;0;0;0;NA;198695;49;2020-04-18;-463
2020-04-17;"Žilinský kraj";3;0;0;0;NA;198695;3;2020-04-17;-512
2020-04-16;"Žilinský kraj";4;0;0;0;NA;198695;4;2020-04-16;-515
2020-04-15;"Žilinský kraj";7;0;0;0;NA;198695;7;2020-04-15;-519
2020-04-14;"Žilinský kraj";1;0;0;0;NA;198695;1;2020-04-14;-526
2020-04-13;"Žilinský kraj";2;0;0;0;NA;198695;2;2020-04-13;-527
2020-04-12;"Žilinský kraj";5;0;0;0;NA;198695;5;2020-04-12;-529
2020-04-11;"Žilinský kraj";2;0;0;0;NA;198695;2;2020-04-11;-534
2020-04-10;"Žilinský kraj";1;0;0;0;NA;198695;1;2020-04-10;-536
2020-04-09;"Žilinský kraj";1;0;0;0;NA;198695;1;2020-04-09;-537
2020-04-08;"Žilinský kraj";3;0;0;0;NA;198695;3;2020-04-08;-538
2020-04-07;"Žilinský kraj";5;0;0;0;NA;198695;5;2020-04-07;-541
2020-04-06;"Žilinský kraj";6;0;0;0;NA;198695;6;2020-04-06;-546
2020-04-05;"Žilinský kraj";8;0;0;0;NA;198695;8;2020-04-05;-552
2020-04-04;"Žilinský kraj";0;0;0;0;NA;198695;0;2020-04-04;-560
2020-04-03;"Žilinský kraj";3;0;0;0;NA;198695;3;2020-04-03;-560
2020-04-02;"Žilinský kraj";5;0;0;0;NA;198695;5;2020-04-02;-563
2020-04-01;"Žilinský kraj";4;0;0;0;NA;198695;4;2020-04-01;-568
2020-03-31;"Žilinský kraj";1;0;0;0;NA;198695;1;2020-03-31;-572
2020-03-30;"Žilinský kraj";3;0;0;0;NA;198695;3;2020-03-30;-573
2020-03-29;"Žilinský kraj";0;0;0;0;NA;198695;0;2020-03-29;-576
2020-03-28;"Žilinský kraj";1;0;0;0;NA;198695;1;2020-03-28;-576
2020-03-27;"Žilinský kraj";9;0;0;0;NA;198695;9;2020-03-27;-577
2020-03-26;"Žilinský kraj";4;0;0;0;NA;198695;4;2020-03-26;-586
2020-03-25;"Žilinský kraj";1;0;0;0;NA;198695;1;2020-03-25;-590
2020-03-24;"Žilinský kraj";2;0;0;0;NA;198695;2;2020-03-24;-591
2020-03-23;"Žilinský kraj";3;0;0;0;NA;198695;3;2020-03-23;-593
2020-03-22;"Žilinský kraj";1;0;0;0;NA;198695;1;2020-03-22;-596
2020-03-21;"Žilinský kraj";2;0;0;0;NA;198695;2;2020-03-21;-597
2020-03-20;"Žilinský kraj";4;0;0;0;NA;198695;4;2020-03-20;-599
2020-03-19;"Žilinský kraj";2;0;0;0;NA;198695;2;2020-03-19;-603
2020-03-18;"Žilinský kraj";1;0;0;0;NA;198695;1;2020-03-18;-605
2020-03-17;"Žilinský kraj";5;0;0;0;NA;198695;5;2020-03-17;-606
2020-03-16;"Žilinský kraj";1;0;0;0;NA;198695;1;2020-03-16;-611
2020-03-15;"Žilinský kraj";2;0;0;0;NA;198695;2;2020-03-15;-612
2020-03-14;"Žilinský kraj";1;0;0;0;NA;198695;1;2020-03-14;-614
2020-03-13;"Žilinský kraj";5;0;0;0;NA;198695;5;2020-03-13;-615
2020-03-12;"Žilinský kraj";1;0;0;0;NA;198695;1;2020-03-12;-620
2020-03-11;"Žilinský kraj";0;0;0;0;NA;198695;0;2020-03-11;-621
2020-03-09;"Žilinský kraj";1;0;0;0;NA;198695;1;2020-03-09;-621
2020-03-08;"Žilinský kraj";0;0;0;0;NA;198695;0;2020-03-08;-622
2020-03-07;"Žilinský kraj";0;0;0;0;NA;198695;0;2020-03-07;-622
2020-03-06;"Žilinský kraj";0;0;0;0;NA;198695;0;2020-03-06;-622
