"Datum";"Region";"PCR_Pos";"Ag_Neg";"Ag_Pos";"Total";"Pocet.potvrdenych";"Potvrdenych";"newcases";"date";"positive"
2022-04-25;"Banskobystrický kraj";148;0;0;0;182210;273296;148;2022-04-25;273296
2022-04-24;"Banskobystrický kraj";16;64;4;68;NA;273296;20;2022-04-24;273148
2022-04-23;"Banskobystrický kraj";110;54;5;59;NA;273296;115;2022-04-23;273128
2022-04-22;"Banskobystrický kraj";140;936;30;966;NA;273296;170;2022-04-22;273013
2022-04-21;"Banskobystrický kraj";154;1228;41;1269;NA;273296;195;2022-04-21;272843
2022-04-20;"Banskobystrický kraj";243;2052;141;2193;NA;273296;384;2022-04-20;272648
2022-04-19;"Banskobystrický kraj";209;1975;94;2069;NA;273296;303;2022-04-19;272264
2022-04-18;"Banskobystrický kraj";25;113;7;120;NA;273296;32;2022-04-18;271961
2022-04-17;"Banskobystrický kraj";105;54;3;57;NA;273296;108;2022-04-17;271929
2022-04-16;"Banskobystrický kraj";58;96;12;108;NA;273296;70;2022-04-16;271821
2022-04-15;"Banskobystrický kraj";44;106;5;111;NA;273296;49;2022-04-15;271751
2022-04-14;"Banskobystrický kraj";230;1095;31;1126;NA;273296;261;2022-04-14;271702
2022-04-13;"Banskobystrický kraj";212;929;60;989;NA;273296;272;2022-04-13;271441
2022-04-12;"Banskobystrický kraj";242;1066;60;1126;NA;273296;302;2022-04-12;271169
2022-04-11;"Banskobystrický kraj";300;2345;99;2444;NA;273296;399;2022-04-11;270867
2022-04-10;"Banskobystrický kraj";62;260;28;288;NA;273296;90;2022-04-10;270468
2022-04-09;"Banskobystrický kraj";147;112;16;128;NA;273296;163;2022-04-09;270378
2022-04-08;"Banskobystrický kraj";284;1192;95;1287;NA;273296;379;2022-04-08;270215
2022-04-07;"Banskobystrický kraj";298;1622;74;1696;NA;273296;372;2022-04-07;269836
2022-04-06;"Banskobystrický kraj";505;1190;89;1279;NA;273296;594;2022-04-06;269464
2022-04-05;"Banskobystrický kraj";458;1358;84;1442;NA;273296;542;2022-04-05;268870
2022-04-04;"Banskobystrický kraj";553;2810;177;2987;NA;273296;730;2022-04-04;268328
2022-04-03;"Banskobystrický kraj";66;441;83;524;NA;273296;149;2022-04-03;267598
2022-04-02;"Banskobystrický kraj";208;131;34;165;NA;273296;242;2022-04-02;267449
2022-04-01;"Banskobystrický kraj";529;1195;137;1332;NA;273296;666;2022-04-01;267207
2022-03-31;"Banskobystrický kraj";516;1775;102;1877;NA;273296;618;2022-03-31;266541
2022-03-30;"Banskobystrický kraj";734;1541;125;1666;NA;273296;859;2022-03-30;265923
2022-03-29;"Banskobystrický kraj";666;1380;161;1541;NA;273296;827;2022-03-29;265064
2022-03-28;"Banskobystrický kraj";618;2523;318;2841;NA;273296;936;2022-03-28;264237
2022-03-27;"Banskobystrický kraj";147;687;114;801;NA;273296;261;2022-03-27;263301
2022-03-26;"Banskobystrický kraj";343;150;53;203;NA;273296;396;2022-03-26;263040
2022-03-25;"Banskobystrický kraj";721;1382;192;1574;NA;273296;913;2022-03-25;262644
2022-03-24;"Banskobystrický kraj";769;1789;162;1951;NA;273296;931;2022-03-24;261731
2022-03-23;"Banskobystrický kraj";823;1643;201;1844;NA;273296;1024;2022-03-23;260800
2022-03-22;"Banskobystrický kraj";1148;1703;220;1923;NA;273296;1368;2022-03-22;259776
2022-03-21;"Banskobystrický kraj";879;2711;356;3067;NA;273296;1235;2022-03-21;258408
2022-03-20;"Banskobystrický kraj";172;605;174;779;NA;273296;346;2022-03-20;257173
2022-03-19;"Banskobystrický kraj";529;218;89;307;NA;273296;618;2022-03-19;256827
2022-03-18;"Banskobystrický kraj";819;2081;200;2281;NA;273296;1019;2022-03-18;256209
2022-03-17;"Banskobystrický kraj";981;3476;224;3700;NA;273296;1205;2022-03-17;255190
2022-03-16;"Banskobystrický kraj";1189;1396;235;1631;NA;273296;1424;2022-03-16;253985
2022-03-15;"Banskobystrický kraj";1420;1730;231;1961;NA;273296;1651;2022-03-15;252561
2022-03-14;"Banskobystrický kraj";948;3220;426;3646;NA;273296;1374;2022-03-14;250910
2022-03-13;"Banskobystrický kraj";224;577;216;793;NA;273296;440;2022-03-13;249536
2022-03-12;"Banskobystrický kraj";625;262;94;356;NA;273296;719;2022-03-12;249096
2022-03-11;"Banskobystrický kraj";1144;1817;287;2104;NA;273296;1431;2022-03-11;248377
2022-03-10;"Banskobystrický kraj";1325;2126;311;2437;NA;273296;1636;2022-03-10;246946
2022-03-09;"Banskobystrický kraj";1370;2036;333;2369;NA;273296;1703;2022-03-09;245310
2022-03-08;"Banskobystrický kraj";1738;2329;376;2705;NA;273296;2114;2022-03-08;243607
2022-03-07;"Banskobystrický kraj";1048;4977;604;5581;NA;273296;1652;2022-03-07;241493
2022-03-06;"Banskobystrický kraj";356;1265;278;1543;NA;273296;634;2022-03-06;239841
2022-03-05;"Banskobystrický kraj";745;497;180;677;NA;273296;925;2022-03-05;239207
2022-03-04;"Banskobystrický kraj";1302;2576;391;2967;NA;273296;1693;2022-03-04;238282
2022-03-03;"Banskobystrický kraj";1766;3466;386;3852;NA;273296;2152;2022-03-03;236589
2022-03-02;"Banskobystrický kraj";1515;5604;415;6019;NA;273296;1930;2022-03-02;234437
2022-03-01;"Banskobystrický kraj";1842;3325;396;3721;NA;273296;2238;2022-03-01;232507
2022-02-28;"Banskobystrický kraj";1050;4913;708;5621;NA;273296;1758;2022-02-28;230269
2022-02-27;"Banskobystrický kraj";604;1162;303;1465;NA;273296;907;2022-02-27;228511
2022-02-26;"Banskobystrický kraj";909;528;154;682;NA;273296;1063;2022-02-26;227604
2022-02-25;"Banskobystrický kraj";1591;2519;430;2949;NA;273296;2021;2022-02-25;226541
2022-02-24;"Banskobystrický kraj";1781;3858;404;4262;NA;273296;2185;2022-02-24;224520
2022-02-23;"Banskobystrický kraj";2094;2869;454;3323;NA;273296;2548;2022-02-23;222335
2022-02-22;"Banskobystrický kraj";2195;3737;469;4206;NA;273296;2664;2022-02-22;219787
2022-02-21;"Banskobystrický kraj";1409;5733;806;6539;NA;273296;2215;2022-02-21;217123
2022-02-20;"Banskobystrický kraj";484;1717;423;2140;NA;273296;907;2022-02-20;214908
2022-02-19;"Banskobystrický kraj";1180;774;242;1016;NA;273296;1422;2022-02-19;214001
2022-02-18;"Banskobystrický kraj";2473;3620;541;4161;NA;273296;3014;2022-02-18;212579
2022-02-17;"Banskobystrický kraj";1924;4239;460;4699;NA;273296;2384;2022-02-17;209565
2022-02-16;"Banskobystrický kraj";1856;3635;543;4178;NA;273296;2399;2022-02-16;207181
2022-02-15;"Banskobystrický kraj";2287;4460;584;5044;NA;273296;2871;2022-02-15;204782
2022-02-14;"Banskobystrický kraj";2071;6848;891;7739;NA;273296;2962;2022-02-14;201911
2022-02-13;"Banskobystrický kraj";577;2247;471;2718;NA;273296;1048;2022-02-13;198949
2022-02-12;"Banskobystrický kraj";1308;906;308;1214;NA;273296;1616;2022-02-12;197901
2022-02-11;"Banskobystrický kraj";2684;3818;555;4373;NA;273296;3239;2022-02-11;196285
2022-02-10;"Banskobystrický kraj";1765;5733;567;6300;NA;273296;2332;2022-02-10;193046
2022-02-09;"Banskobystrický kraj";2544;3794;569;4363;NA;273296;3113;2022-02-09;190714
2022-02-08;"Banskobystrický kraj";1806;4418;538;4956;NA;273296;2344;2022-02-08;187601
2022-02-07;"Banskobystrický kraj";1683;7388;728;8116;NA;273296;2411;2022-02-07;185257
2022-02-06;"Banskobystrický kraj";604;2244;392;2636;NA;273296;996;2022-02-06;182846
2022-02-05;"Banskobystrický kraj";1032;1434;233;1667;NA;273296;1265;2022-02-05;181850
2022-02-04;"Banskobystrický kraj";1866;3745;438;4183;NA;273296;2304;2022-02-04;180585
2022-02-03;"Banskobystrický kraj";1561;5433;359;5792;NA;273296;1920;2022-02-03;178281
2022-02-02;"Banskobystrický kraj";1716;4793;395;5188;NA;273296;2111;2022-02-02;176361
2022-02-01;"Banskobystrický kraj";1918;4558;410;4968;NA;273296;2328;2022-02-01;174250
2022-01-31;"Banskobystrický kraj";779;9006;553;9559;NA;273296;1332;2022-01-31;171922
2022-01-30;"Banskobystrický kraj";412;3055;267;3322;NA;273296;679;2022-01-30;170590
2022-01-29;"Banskobystrický kraj";981;1155;174;1329;NA;273296;1155;2022-01-29;169911
2022-01-28;"Banskobystrický kraj";1040;3814;313;4127;NA;273296;1353;2022-01-28;168756
2022-01-27;"Banskobystrický kraj";1035;4955;225;5180;NA;273296;1260;2022-01-27;167403
2022-01-26;"Banskobystrický kraj";1060;4035;213;4248;NA;273296;1273;2022-01-26;166143
2022-01-25;"Banskobystrický kraj";1001;6119;257;6376;NA;273296;1258;2022-01-25;164870
2022-01-24;"Banskobystrický kraj";557;10186;257;10443;NA;273296;814;2022-01-24;163612
2022-01-23;"Banskobystrický kraj";246;3710;129;3839;NA;273296;375;2022-01-23;162798
2022-01-22;"Banskobystrický kraj";411;1077;64;1141;NA;273296;475;2022-01-22;162423
2022-01-21;"Banskobystrický kraj";578;3491;113;3604;NA;273296;691;2022-01-21;161948
2022-01-20;"Banskobystrický kraj";490;3810;91;3901;NA;273296;581;2022-01-20;161257
2022-01-19;"Banskobystrický kraj";421;4173;98;4271;NA;273296;519;2022-01-19;160676
2022-01-18;"Banskobystrický kraj";517;4737;95;4832;NA;273296;612;2022-01-18;160157
2022-01-17;"Banskobystrický kraj";269;8102;114;8216;NA;273296;383;2022-01-17;159545
2022-01-16;"Banskobystrický kraj";63;2746;84;2830;NA;273296;147;2022-01-16;159162
2022-01-15;"Banskobystrický kraj";287;858;16;874;NA;273296;303;2022-01-15;159015
2022-01-14;"Banskobystrický kraj";165;2758;67;2825;NA;273296;232;2022-01-14;158712
2022-01-13;"Banskobystrický kraj";182;3411;57;3468;NA;273296;239;2022-01-13;158480
2022-01-12;"Banskobystrický kraj";241;3787;67;3854;NA;273296;308;2022-01-12;158241
2022-01-11;"Banskobystrický kraj";327;4970;74;5044;NA;273296;401;2022-01-11;157933
2022-01-10;"Banskobystrický kraj";219;8173;113;8286;NA;273296;332;2022-01-10;157532
2022-01-09;"Banskobystrický kraj";54;3514;38;3552;NA;273296;92;2022-01-09;157200
2022-01-08;"Banskobystrický kraj";177;1054;40;1094;NA;273296;217;2022-01-08;157108
2022-01-07;"Banskobystrický kraj";320;3087;86;3173;NA;273296;406;2022-01-07;156891
2022-01-06;"Banskobystrický kraj";101;985;21;1006;NA;273296;122;2022-01-06;156485
2022-01-05;"Banskobystrický kraj";376;2852;67;2919;NA;273296;443;2022-01-05;156363
2022-01-04;"Banskobystrický kraj";458;4197;72;4269;NA;273296;530;2022-01-04;155920
2022-01-03;"Banskobystrický kraj";420;8216;115;8331;NA;273296;535;2022-01-03;155390
2022-01-02;"Banskobystrický kraj";117;2239;95;2334;NA;273296;212;2022-01-02;154855
2022-01-01;"Banskobystrický kraj";33;80;4;84;NA;273296;37;2022-01-01;154643
2021-12-31;"Banskobystrický kraj";314;1803;68;1871;NA;273296;382;2021-12-31;154606
2021-12-30;"Banskobystrický kraj";308;2833;88;2921;NA;273296;396;2021-12-30;154224
2021-12-29;"Banskobystrický kraj";390;2448;83;2531;NA;273296;473;2021-12-29;153828
2021-12-28;"Banskobystrický kraj";492;2902;95;2997;NA;273296;587;2021-12-28;153355
2021-12-27;"Banskobystrický kraj";397;5029;203;5232;NA;273296;600;2021-12-27;152768
2021-12-26;"Banskobystrický kraj";76;1245;62;1307;NA;273296;138;2021-12-26;152168
2021-12-25;"Banskobystrický kraj";107;373;45;418;NA;273296;152;2021-12-25;152030
2021-12-24;"Banskobystrický kraj";116;213;10;223;NA;273296;126;2021-12-24;151878
2021-12-23;"Banskobystrický kraj";429;3501;107;3608;NA;273296;536;2021-12-23;151752
2021-12-22;"Banskobystrický kraj";393;3394;106;3500;NA;273296;499;2021-12-22;151216
2021-12-21;"Banskobystrický kraj";508;4173;88;4261;NA;273296;596;2021-12-21;150717
2021-12-20;"Banskobystrický kraj";424;7610;186;7796;NA;273296;610;2021-12-20;150121
2021-12-19;"Banskobystrický kraj";39;2681;87;2768;NA;273296;126;2021-12-19;149511
2021-12-18;"Banskobystrický kraj";333;1036;67;1103;NA;273296;400;2021-12-18;149385
2021-12-17;"Banskobystrický kraj";465;3805;102;3907;NA;273296;567;2021-12-17;148985
2021-12-16;"Banskobystrický kraj";499;4278;116;4394;NA;273296;615;2021-12-16;148418
2021-12-15;"Banskobystrický kraj";554;4772;102;4874;NA;273296;656;2021-12-15;147803
2021-12-14;"Banskobystrický kraj";729;4614;108;4722;NA;273296;837;2021-12-14;147147
2021-12-13;"Banskobystrický kraj";470;8201;222;8423;NA;273296;692;2021-12-13;146310
2021-12-12;"Banskobystrický kraj";161;3332;101;3433;NA;273296;262;2021-12-12;145618
2021-12-11;"Banskobystrický kraj";568;1166;82;1248;NA;273296;650;2021-12-11;145356
2021-12-10;"Banskobystrický kraj";731;4033;185;4218;NA;273296;916;2021-12-10;144706
2021-12-09;"Banskobystrický kraj";652;4381;139;4520;NA;273296;791;2021-12-09;143790
2021-12-08;"Banskobystrický kraj";1087;4100;169;4269;NA;273296;1256;2021-12-08;142999
2021-12-07;"Banskobystrický kraj";1104;5410;201;5611;NA;273296;1305;2021-12-07;141743
2021-12-06;"Banskobystrický kraj";647;9113;324;9437;NA;273296;971;2021-12-06;140438
2021-12-05;"Banskobystrický kraj";217;3425;155;3580;NA;273296;372;2021-12-05;139467
2021-12-04;"Banskobystrický kraj";654;1334;131;1465;NA;273296;785;2021-12-04;139095
2021-12-03;"Banskobystrický kraj";1117;5057;246;5303;NA;273296;1363;2021-12-03;138310
2021-12-02;"Banskobystrický kraj";1710;5259;258;5517;NA;273296;1968;2021-12-02;136947
2021-12-01;"Banskobystrický kraj";947;4753;264;5017;NA;273296;1211;2021-12-01;134979
2021-11-30;"Banskobystrický kraj";1266;6543;245;6788;NA;273296;1511;2021-11-30;133768
2021-11-29;"Banskobystrický kraj";591;10653;468;11121;NA;273296;1059;2021-11-29;132257
2021-11-28;"Banskobystrický kraj";418;4289;216;4505;NA;273296;634;2021-11-28;131198
2021-11-27;"Banskobystrický kraj";827;1781;208;1989;NA;273296;1035;2021-11-27;130564
2021-11-26;"Banskobystrický kraj";963;4771;354;5125;NA;273296;1317;2021-11-26;129529
2021-11-25;"Banskobystrický kraj";1110;5911;350;6261;NA;273296;1460;2021-11-25;128212
2021-11-24;"Banskobystrický kraj";1387;5956;330;6286;NA;273296;1717;2021-11-24;126752
2021-11-23;"Banskobystrický kraj";1436;6082;377;6459;NA;273296;1813;2021-11-23;125035
2021-11-22;"Banskobystrický kraj";489;8727;579;9306;NA;273296;1068;2021-11-22;123222
2021-11-21;"Banskobystrický kraj";408;4109;307;4416;NA;273296;715;2021-11-21;122154
2021-11-20;"Banskobystrický kraj";985;1758;199;1957;NA;273296;1184;2021-11-20;121439
2021-11-19;"Banskobystrický kraj";1006;4886;470;5356;NA;273296;1476;2021-11-19;120255
2021-11-18;"Banskobystrický kraj";979;8037;620;8657;NA;273296;1599;2021-11-18;118779
2021-11-17;"Banskobystrický kraj";772;1051;147;1198;NA;273296;919;2021-11-17;117180
2021-11-16;"Banskobystrický kraj";1130;5473;453;5926;NA;273296;1583;2021-11-16;116261
2021-11-15;"Banskobystrický kraj";749;7884;588;8472;NA;273296;1337;2021-11-15;114678
2021-11-14;"Banskobystrický kraj";311;2629;302;2931;NA;273296;613;2021-11-14;113341
2021-11-13;"Banskobystrický kraj";761;1471;214;1685;NA;273296;975;2021-11-13;112728
2021-11-12;"Banskobystrický kraj";972;5019;434;5453;NA;273296;1406;2021-11-12;111753
2021-11-11;"Banskobystrický kraj";1023;5584;345;5929;NA;273296;1368;2021-11-11;110347
2021-11-10;"Banskobystrický kraj";950;4713;333;5046;NA;273296;1283;2021-11-10;108979
2021-11-09;"Banskobystrický kraj";921;4616;283;4899;NA;273296;1204;2021-11-09;107696
2021-11-08;"Banskobystrický kraj";519;7249;488;7737;NA;273296;1007;2021-11-08;106492
2021-11-07;"Banskobystrický kraj";460;2479;258;2737;NA;273296;718;2021-11-07;105485
2021-11-06;"Banskobystrický kraj";505;1344;170;1514;NA;273296;675;2021-11-06;104767
2021-11-05;"Banskobystrický kraj";997;4773;342;5115;NA;273296;1339;2021-11-05;104092
2021-11-04;"Banskobystrický kraj";1086;4811;248;5059;NA;273296;1334;2021-11-04;102753
2021-11-03;"Banskobystrický kraj";976;4825;330;5155;NA;273296;1306;2021-11-03;101419
2021-11-02;"Banskobystrický kraj";538;5709;492;6201;NA;273296;1030;2021-11-02;100113
2021-11-01;"Banskobystrický kraj";390;1178;132;1310;NA;273296;522;2021-11-01;99083
2021-10-31;"Banskobystrický kraj";150;1700;210;1910;NA;273296;360;2021-10-31;98561
2021-10-30;"Banskobystrický kraj";449;1508;140;1648;NA;273296;589;2021-10-30;98201
2021-10-29;"Banskobystrický kraj";780;4178;286;4464;NA;273296;1066;2021-10-29;97612
2021-10-28;"Banskobystrický kraj";744;4182;247;4429;NA;273296;991;2021-10-28;96546
2021-10-27;"Banskobystrický kraj";664;4577;233;4810;NA;273296;897;2021-10-27;95555
2021-10-26;"Banskobystrický kraj";700;3673;187;3860;NA;273296;887;2021-10-26;94658
2021-10-25;"Banskobystrický kraj";376;5478;257;5735;NA;273296;633;2021-10-25;93771
2021-10-24;"Banskobystrický kraj";161;1707;143;1850;NA;273296;304;2021-10-24;93138
2021-10-23;"Banskobystrický kraj";238;1286;79;1365;NA;273296;317;2021-10-23;92834
2021-10-22;"Banskobystrický kraj";530;3816;185;4001;NA;273296;715;2021-10-22;92517
2021-10-21;"Banskobystrický kraj";416;4128;140;4268;NA;273296;556;2021-10-21;91802
2021-10-20;"Banskobystrický kraj";387;3615;123;3738;NA;273296;510;2021-10-20;91246
2021-10-19;"Banskobystrický kraj";419;4094;103;4197;NA;273296;522;2021-10-19;90736
2021-10-18;"Banskobystrický kraj";162;5286;175;5461;NA;273296;337;2021-10-18;90214
2021-10-17;"Banskobystrický kraj";26;1555;71;1626;NA;273296;97;2021-10-17;89877
2021-10-16;"Banskobystrický kraj";162;1387;50;1437;NA;273296;212;2021-10-16;89780
2021-10-15;"Banskobystrický kraj";187;3693;81;3774;NA;273296;268;2021-10-15;89568
2021-10-14;"Banskobystrický kraj";198;3705;47;3752;NA;273296;245;2021-10-14;89300
2021-10-13;"Banskobystrický kraj";217;3068;55;3123;NA;273296;272;2021-10-13;89055
2021-10-12;"Banskobystrický kraj";301;3743;59;3802;NA;273296;360;2021-10-12;88783
2021-10-11;"Banskobystrický kraj";128;4734;96;4830;NA;273296;224;2021-10-11;88423
2021-10-10;"Banskobystrický kraj";26;1815;53;1868;NA;273296;79;2021-10-10;88199
2021-10-09;"Banskobystrický kraj";73;1122;27;1149;NA;273296;100;2021-10-09;88120
2021-10-08;"Banskobystrický kraj";239;3027;61;3088;NA;273296;300;2021-10-08;88020
2021-10-07;"Banskobystrický kraj";179;3437;42;3479;NA;273296;221;2021-10-07;87720
2021-10-06;"Banskobystrický kraj";136;3862;48;3910;NA;273296;184;2021-10-06;87499
2021-10-05;"Banskobystrický kraj";209;2979;54;3033;NA;273296;263;2021-10-05;87315
2021-10-04;"Banskobystrický kraj";126;3725;64;3789;NA;273296;190;2021-10-04;87052
2021-10-03;"Banskobystrický kraj";11;1407;34;1441;NA;273296;45;2021-10-03;86862
2021-10-02;"Banskobystrický kraj";66;1042;26;1068;NA;273296;92;2021-10-02;86817
2021-10-01;"Banskobystrický kraj";158;3228;51;3279;NA;273296;209;2021-10-01;86725
2021-09-30;"Banskobystrický kraj";120;3362;30;3392;NA;273296;150;2021-09-30;86516
2021-09-29;"Banskobystrický kraj";118;2626;40;2666;NA;273296;158;2021-09-29;86366
2021-09-28;"Banskobystrický kraj";112;3061;45;3106;NA;273296;157;2021-09-28;86208
2021-09-27;"Banskobystrický kraj";90;4456;72;4528;NA;273296;162;2021-09-27;86051
2021-09-26;"Banskobystrický kraj";17;1498;31;1529;NA;273296;48;2021-09-26;85889
2021-09-25;"Banskobystrický kraj";17;1481;7;1488;NA;273296;24;2021-09-25;85841
2021-09-24;"Banskobystrický kraj";98;4254;32;4286;NA;273296;130;2021-09-24;85817
2021-09-23;"Banskobystrický kraj";63;3019;13;3032;NA;273296;76;2021-09-23;85687
2021-09-22;"Banskobystrický kraj";75;2442;19;2461;NA;273296;94;2021-09-22;85611
2021-09-21;"Banskobystrický kraj";125;2976;20;2996;NA;273296;145;2021-09-21;85517
2021-09-20;"Banskobystrický kraj";45;3951;30;3981;NA;273296;75;2021-09-20;85372
2021-09-19;"Banskobystrický kraj";6;1456;24;1480;NA;273296;30;2021-09-19;85297
2021-09-18;"Banskobystrický kraj";44;1318;15;1333;NA;273296;59;2021-09-18;85267
2021-09-17;"Banskobystrický kraj";73;3485;32;3517;NA;273296;105;2021-09-17;85208
2021-09-16;"Banskobystrický kraj";95;3019;29;3048;NA;273296;124;2021-09-16;85103
2021-09-15;"Banskobystrický kraj";22;394;1;395;NA;273296;23;2021-09-15;84979
2021-09-14;"Banskobystrický kraj";95;2508;28;2536;NA;273296;123;2021-09-14;84956
2021-09-13;"Banskobystrický kraj";29;3206;28;3234;NA;273296;57;2021-09-13;84833
2021-09-12;"Banskobystrický kraj";7;958;15;973;NA;273296;22;2021-09-12;84776
2021-09-11;"Banskobystrický kraj";31;865;11;876;NA;273296;42;2021-09-11;84754
2021-09-10;"Banskobystrický kraj";59;2250;24;2274;NA;273296;83;2021-09-10;84712
2021-09-09;"Banskobystrický kraj";46;2011;17;2028;NA;273296;63;2021-09-09;84629
2021-09-08;"Banskobystrický kraj";46;1713;27;1740;NA;273296;73;2021-09-08;84566
2021-09-07;"Banskobystrický kraj";27;1422;21;1443;NA;273296;48;2021-09-07;84493
2021-09-06;"Banskobystrický kraj";26;2570;13;2583;NA;273296;39;2021-09-06;84445
2021-09-05;"Banskobystrický kraj";9;742;2;744;NA;273296;11;2021-09-05;84406
2021-09-04;"Banskobystrický kraj";14;745;10;755;NA;273296;24;2021-09-04;84395
2021-09-03;"Banskobystrický kraj";49;2116;22;2138;NA;273296;71;2021-09-03;84371
2021-09-02;"Banskobystrický kraj";19;1730;25;1755;NA;273296;44;2021-09-02;84300
2021-09-01;"Banskobystrický kraj";6;230;6;236;NA;273296;12;2021-09-01;84256
2021-08-31;"Banskobystrický kraj";18;1406;13;1419;NA;273296;31;2021-08-31;84244
2021-08-30;"Banskobystrický kraj";23;1867;10;1877;NA;273296;33;2021-08-30;84213
2021-08-29;"Banskobystrický kraj";0;351;5;356;NA;273296;5;2021-08-29;84180
2021-08-28;"Banskobystrický kraj";9;827;5;832;NA;273296;14;2021-08-28;84175
2021-08-27;"Banskobystrický kraj";7;1608;12;1620;NA;273296;19;2021-08-27;84161
2021-08-26;"Banskobystrický kraj";7;1161;2;1163;NA;273296;9;2021-08-26;84142
2021-08-25;"Banskobystrický kraj";6;1052;1;1053;NA;273296;7;2021-08-25;84133
2021-08-24;"Banskobystrický kraj";12;1117;1;1118;NA;273296;13;2021-08-24;84126
2021-08-23;"Banskobystrický kraj";7;1368;5;1373;NA;273296;12;2021-08-23;84113
2021-08-22;"Banskobystrický kraj";0;773;2;775;NA;273296;2;2021-08-22;84101
2021-08-21;"Banskobystrický kraj";3;793;1;794;NA;273296;4;2021-08-21;84099
2021-08-20;"Banskobystrický kraj";5;1616;4;1620;NA;273296;9;2021-08-20;84095
2021-08-19;"Banskobystrický kraj";4;1092;3;1095;NA;273296;7;2021-08-19;84086
2021-08-18;"Banskobystrický kraj";1;1044;1;1045;NA;273296;2;2021-08-18;84079
2021-08-17;"Banskobystrický kraj";12;890;0;890;NA;273296;12;2021-08-17;84077
2021-08-16;"Banskobystrický kraj";7;1321;3;1324;NA;273296;10;2021-08-16;84065
2021-08-15;"Banskobystrický kraj";0;366;3;369;NA;273296;3;2021-08-15;84055
2021-08-14;"Banskobystrický kraj";6;435;1;436;NA;273296;7;2021-08-14;84052
2021-08-13;"Banskobystrický kraj";11;898;0;898;NA;273296;11;2021-08-13;84045
2021-08-12;"Banskobystrický kraj";10;951;1;952;NA;273296;11;2021-08-12;84034
2021-08-11;"Banskobystrický kraj";7;575;3;578;NA;273296;10;2021-08-11;84023
2021-08-10;"Banskobystrický kraj";7;678;2;680;NA;273296;9;2021-08-10;84013
2021-08-09;"Banskobystrický kraj";9;1064;0;1064;NA;273296;9;2021-08-09;84004
2021-08-08;"Banskobystrický kraj";4;335;1;336;NA;273296;5;2021-08-08;83995
2021-08-07;"Banskobystrický kraj";0;308;4;312;NA;273296;4;2021-08-07;83990
2021-08-06;"Banskobystrický kraj";5;929;2;931;NA;273296;7;2021-08-06;83986
2021-08-05;"Banskobystrický kraj";2;838;1;839;NA;273296;3;2021-08-05;83979
2021-08-04;"Banskobystrický kraj";2;579;1;580;NA;273296;3;2021-08-04;83976
2021-08-03;"Banskobystrický kraj";4;743;0;743;NA;273296;4;2021-08-03;83973
2021-08-02;"Banskobystrický kraj";6;934;0;934;NA;273296;6;2021-08-02;83969
2021-08-01;"Banskobystrický kraj";0;271;0;271;NA;273296;0;2021-08-01;83963
2021-07-31;"Banskobystrický kraj";1;370;4;374;NA;273296;5;2021-07-31;83963
2021-07-30;"Banskobystrický kraj";27;928;2;930;NA;273296;29;2021-07-30;83958
2021-07-29;"Banskobystrický kraj";2;890;1;891;NA;273296;3;2021-07-29;83929
2021-07-28;"Banskobystrický kraj";4;520;1;521;NA;273296;5;2021-07-28;83926
2021-07-27;"Banskobystrický kraj";15;1092;0;1092;NA;273296;15;2021-07-27;83921
2021-07-26;"Banskobystrický kraj";2;911;1;912;NA;273296;3;2021-07-26;83906
2021-07-25;"Banskobystrický kraj";0;367;1;368;NA;273296;1;2021-07-25;83903
2021-07-24;"Banskobystrický kraj";2;298;0;298;NA;273296;2;2021-07-24;83902
2021-07-23;"Banskobystrický kraj";7;840;0;840;NA;273296;7;2021-07-23;83900
2021-07-22;"Banskobystrický kraj";5;727;3;730;NA;273296;8;2021-07-22;83893
2021-07-21;"Banskobystrický kraj";2;560;0;560;NA;273296;2;2021-07-21;83885
2021-07-20;"Banskobystrický kraj";6;885;2;887;NA;273296;8;2021-07-20;83883
2021-07-19;"Banskobystrický kraj";1;854;3;857;NA;273296;4;2021-07-19;83875
2021-07-18;"Banskobystrický kraj";0;377;1;378;NA;273296;1;2021-07-18;83871
2021-07-17;"Banskobystrický kraj";1;324;0;324;NA;273296;1;2021-07-17;83870
2021-07-16;"Banskobystrický kraj";3;974;1;975;NA;273296;4;2021-07-16;83869
2021-07-15;"Banskobystrický kraj";1;1038;0;1038;NA;273296;1;2021-07-15;83865
2021-07-14;"Banskobystrický kraj";3;765;0;765;NA;273296;3;2021-07-14;83864
2021-07-13;"Banskobystrický kraj";2;695;0;695;NA;273296;2;2021-07-13;83861
2021-07-12;"Banskobystrický kraj";1;1057;0;1057;NA;273296;1;2021-07-12;83859
2021-07-11;"Banskobystrický kraj";0;446;0;446;NA;273296;0;2021-07-11;83858
2021-07-10;"Banskobystrický kraj";2;368;0;368;NA;273296;2;2021-07-10;83858
2021-07-09;"Banskobystrický kraj";3;1209;0;1209;NA;273296;3;2021-07-09;83856
2021-07-08;"Banskobystrický kraj";0;1083;1;1084;NA;273296;1;2021-07-08;83853
2021-07-07;"Banskobystrický kraj";1;798;0;798;NA;273296;1;2021-07-07;83852
2021-07-06;"Banskobystrický kraj";6;1365;0;1365;NA;273296;6;2021-07-06;83851
2021-07-05;"Banskobystrický kraj";2;392;1;393;NA;273296;3;2021-07-05;83845
2021-07-04;"Banskobystrický kraj";0;318;0;318;NA;273296;0;2021-07-04;83842
2021-07-03;"Banskobystrický kraj";1;413;1;414;NA;273296;2;2021-07-03;83842
2021-07-02;"Banskobystrický kraj";3;1045;0;1045;NA;273296;3;2021-07-02;83840
2021-07-01;"Banskobystrický kraj";0;705;1;706;NA;273296;1;2021-07-01;83837
2021-06-30;"Banskobystrický kraj";3;7607;1;7608;NA;273296;4;2021-06-30;83836
2021-06-29;"Banskobystrický kraj";2;4642;1;4643;NA;273296;3;2021-06-29;83832
2021-06-28;"Banskobystrický kraj";3;5695;1;5696;NA;273296;4;2021-06-28;83829
2021-06-27;"Banskobystrický kraj";0;4369;5;4374;NA;273296;5;2021-06-27;83825
2021-06-26;"Banskobystrický kraj";0;4289;4;4293;NA;273296;4;2021-06-26;83820
2021-06-25;"Banskobystrický kraj";2;6717;2;6719;NA;273296;4;2021-06-25;83816
2021-06-24;"Banskobystrický kraj";6;4585;2;4587;NA;273296;8;2021-06-24;83812
2021-06-23;"Banskobystrický kraj";4;4947;0;4947;NA;273296;4;2021-06-23;83804
2021-06-22;"Banskobystrický kraj";7;4527;0;4527;NA;273296;7;2021-06-22;83800
2021-06-21;"Banskobystrický kraj";6;5836;8;5844;NA;273296;14;2021-06-21;83793
2021-06-20;"Banskobystrický kraj";0;5055;7;5062;NA;273296;7;2021-06-20;83779
2021-06-19;"Banskobystrický kraj";0;5639;4;5643;NA;273296;4;2021-06-19;83772
2021-06-18;"Banskobystrický kraj";4;7642;1;7643;NA;273296;5;2021-06-18;83768
2021-06-17;"Banskobystrický kraj";2;5245;3;5248;NA;273296;5;2021-06-17;83763
2021-06-16;"Banskobystrický kraj";10;5951;5;5956;NA;273296;15;2021-06-16;83758
2021-06-15;"Banskobystrický kraj";9;5576;6;5582;NA;273296;15;2021-06-15;83743
2021-06-14;"Banskobystrický kraj";8;6922;7;6929;NA;273296;15;2021-06-14;83728
2021-06-13;"Banskobystrický kraj";0;6407;7;6414;NA;273296;7;2021-06-13;83713
2021-06-12;"Banskobystrický kraj";3;6338;6;6344;NA;273296;9;2021-06-12;83706
2021-06-11;"Banskobystrický kraj";5;9693;15;9708;NA;273296;20;2021-06-11;83697
2021-06-10;"Banskobystrický kraj";10;5726;8;5734;NA;273296;18;2021-06-10;83677
2021-06-09;"Banskobystrický kraj";9;5720;4;5724;NA;273296;13;2021-06-09;83659
2021-06-08;"Banskobystrický kraj";15;5645;10;5655;NA;273296;25;2021-06-08;83646
2021-06-07;"Banskobystrický kraj";4;7582;21;7603;NA;273296;25;2021-06-07;83621
2021-06-06;"Banskobystrický kraj";1;7497;12;7509;NA;273296;13;2021-06-06;83596
2021-06-05;"Banskobystrický kraj";15;7531;9;7540;NA;273296;24;2021-06-05;83583
2021-06-04;"Banskobystrický kraj";2;9352;14;9366;NA;273296;16;2021-06-04;83559
2021-06-03;"Banskobystrický kraj";8;6507;24;6531;NA;273296;32;2021-06-03;83543
2021-06-02;"Banskobystrický kraj";7;6837;6;6843;NA;273296;13;2021-06-02;83511
2021-06-01;"Banskobystrický kraj";12;7146;14;7160;NA;273296;26;2021-06-01;83498
2021-05-31;"Banskobystrický kraj";4;9546;31;9577;NA;273296;35;2021-05-31;83472
2021-05-30;"Banskobystrický kraj";3;8959;19;8978;NA;273296;22;2021-05-30;83437
2021-05-29;"Banskobystrický kraj";11;9763;18;9781;NA;273296;29;2021-05-29;83415
2021-05-28;"Banskobystrický kraj";13;11905;27;11932;NA;273296;40;2021-05-28;83386
2021-05-27;"Banskobystrický kraj";7;8760;12;8772;NA;273296;19;2021-05-27;83346
2021-05-26;"Banskobystrický kraj";18;7905;17;7922;NA;273296;35;2021-05-26;83327
2021-05-25;"Banskobystrický kraj";27;8951;30;8981;NA;273296;57;2021-05-25;83292
2021-05-24;"Banskobystrický kraj";9;12469;44;12513;NA;273296;53;2021-05-24;83235
2021-05-23;"Banskobystrický kraj";0;9798;27;9825;NA;273296;27;2021-05-23;83182
2021-05-22;"Banskobystrický kraj";20;9608;26;9634;NA;273296;46;2021-05-22;83155
2021-05-21;"Banskobystrický kraj";22;12796;25;12821;NA;273296;47;2021-05-21;83109
2021-05-20;"Banskobystrický kraj";14;8994;25;9019;NA;273296;39;2021-05-20;83062
2021-05-19;"Banskobystrický kraj";42;8608;21;8629;NA;273296;63;2021-05-19;83023
2021-05-18;"Banskobystrický kraj";27;9450;25;9475;NA;273296;52;2021-05-18;82960
2021-05-17;"Banskobystrický kraj";11;13399;33;13432;NA;273296;44;2021-05-17;82908
2021-05-16;"Banskobystrický kraj";15;14072;26;14098;NA;273296;41;2021-05-16;82864
2021-05-15;"Banskobystrický kraj";11;15356;29;15385;NA;273296;40;2021-05-15;82823
2021-05-14;"Banskobystrický kraj";35;18939;45;18984;NA;273296;80;2021-05-14;82783
2021-05-13;"Banskobystrický kraj";37;10605;40;10645;NA;273296;77;2021-05-13;82703
2021-05-12;"Banskobystrický kraj";31;10857;45;10902;NA;273296;76;2021-05-12;82626
2021-05-11;"Banskobystrický kraj";42;11325;48;11373;NA;273296;90;2021-05-11;82550
2021-05-10;"Banskobystrický kraj";28;17621;68;17689;NA;273296;96;2021-05-10;82460
2021-05-09;"Banskobystrický kraj";25;21902;68;21970;NA;273296;93;2021-05-09;82364
2021-05-08;"Banskobystrický kraj";11;14285;26;14311;NA;273296;37;2021-05-08;82271
2021-05-07;"Banskobystrický kraj";41;21806;78;21884;NA;273296;119;2021-05-07;82234
2021-05-06;"Banskobystrický kraj";36;12251;70;12321;NA;273296;106;2021-05-06;82115
2021-05-05;"Banskobystrický kraj";34;12592;63;12655;NA;273296;97;2021-05-05;82009
2021-05-04;"Banskobystrický kraj";83;13888;47;13935;NA;273296;130;2021-05-04;81912
2021-05-03;"Banskobystrický kraj";30;20872;80;20952;NA;273296;110;2021-05-03;81782
2021-05-02;"Banskobystrický kraj";6;33040;60;33100;NA;273296;66;2021-05-02;81672
2021-05-01;"Banskobystrický kraj";54;36900;67;36967;NA;273296;121;2021-05-01;81606
2021-04-30;"Banskobystrický kraj";38;34957;86;35043;NA;273296;124;2021-04-30;81485
2021-04-29;"Banskobystrický kraj";55;16839;68;16907;NA;273296;123;2021-04-29;81361
2021-04-28;"Banskobystrický kraj";66;17959;67;18026;NA;273296;133;2021-04-28;81238
2021-04-27;"Banskobystrický kraj";70;19152;73;19225;NA;273296;143;2021-04-27;81105
2021-04-26;"Banskobystrický kraj";34;28517;101;28618;NA;273296;135;2021-04-26;80962
2021-04-25;"Banskobystrický kraj";14;40601;106;40707;NA;273296;120;2021-04-25;80827
2021-04-24;"Banskobystrický kraj";40;51944;98;52042;NA;273296;138;2021-04-24;80707
2021-04-23;"Banskobystrický kraj";78;37922;88;38010;NA;273296;166;2021-04-23;80569
2021-04-22;"Banskobystrický kraj";51;17415;57;17472;NA;273296;108;2021-04-22;80403
2021-04-21;"Banskobystrický kraj";76;19218;94;19312;NA;273296;170;2021-04-21;80295
2021-04-20;"Banskobystrický kraj";116;21234;98;21332;NA;273296;214;2021-04-20;80125
2021-04-19;"Banskobystrický kraj";48;31408;105;31513;NA;273296;153;2021-04-19;79911
2021-04-18;"Banskobystrický kraj";16;43375;90;43465;NA;273296;106;2021-04-18;79758
2021-04-17;"Banskobystrický kraj";42;64939;92;65031;NA;273296;134;2021-04-17;79652
2021-04-16;"Banskobystrický kraj";72;37307;100;37407;NA;273296;172;2021-04-16;79518
2021-04-15;"Banskobystrický kraj";67;20127;83;20210;NA;273296;150;2021-04-15;79346
2021-04-14;"Banskobystrický kraj";69;21260;86;21346;NA;273296;155;2021-04-14;79196
2021-04-13;"Banskobystrický kraj";130;23076;77;23153;NA;273296;207;2021-04-13;79041
2021-04-12;"Banskobystrický kraj";60;32272;130;32402;NA;273296;190;2021-04-12;78834
2021-04-11;"Banskobystrický kraj";0;41367;88;41455;NA;273296;88;2021-04-11;78644
2021-04-10;"Banskobystrický kraj";56;64728;141;64869;NA;273296;197;2021-04-10;78556
2021-04-09;"Banskobystrický kraj";106;31570;118;31688;NA;273296;224;2021-04-09;78359
2021-04-08;"Banskobystrický kraj";132;19000;148;19148;NA;273296;280;2021-04-08;78135
2021-04-07;"Banskobystrický kraj";226;25121;94;25215;NA;273296;320;2021-04-07;77855
2021-04-06;"Banskobystrický kraj";93;42496;187;42683;NA;273296;280;2021-04-06;77535
2021-04-05;"Banskobystrický kraj";15;11797;87;11884;NA;273296;102;2021-04-05;77255
2021-04-04;"Banskobystrický kraj";24;19683;79;19762;NA;273296;103;2021-04-04;77153
2021-04-03;"Banskobystrický kraj";5;72553;211;72764;NA;273296;216;2021-04-03;77050
2021-04-02;"Banskobystrický kraj";71;13455;66;13521;NA;273296;137;2021-04-02;76834
2021-04-01;"Banskobystrický kraj";171;39407;200;39607;NA;273296;371;2021-04-01;76697
2021-03-31;"Banskobystrický kraj";147;25543;161;25704;NA;273296;308;2021-03-31;76326
2021-03-30;"Banskobystrický kraj";167;21442;159;21601;NA;273296;326;2021-03-30;76018
2021-03-29;"Banskobystrický kraj";119;29492;218;29710;NA;273296;337;2021-03-29;75692
2021-03-28;"Banskobystrický kraj";25;40610;189;40799;NA;273296;214;2021-03-28;75355
2021-03-27;"Banskobystrický kraj";85;63414;260;63674;NA;273296;345;2021-03-27;75141
2021-03-26;"Banskobystrický kraj";122;43671;240;43911;NA;273296;362;2021-03-26;74796
2021-03-25;"Banskobystrický kraj";120;21598;240;21838;NA;273296;360;2021-03-25;74434
2021-03-24;"Banskobystrický kraj";200;19337;227;19564;NA;273296;427;2021-03-24;74074
2021-03-23;"Banskobystrický kraj";241;21541;257;21798;NA;273296;498;2021-03-23;73647
2021-03-22;"Banskobystrický kraj";65;30480;274;30754;NA;273296;339;2021-03-22;73149
2021-03-21;"Banskobystrický kraj";31;40039;280;40319;NA;273296;311;2021-03-21;72810
2021-03-20;"Banskobystrický kraj";119;67926;383;68309;NA;273296;502;2021-03-20;72499
2021-03-19;"Banskobystrický kraj";240;44038;306;44344;NA;273296;546;2021-03-19;71997
2021-03-18;"Banskobystrický kraj";160;22469;273;22742;NA;273296;433;2021-03-18;71451
2021-03-17;"Banskobystrický kraj";262;21573;245;21818;NA;273296;507;2021-03-17;71018
2021-03-16;"Banskobystrický kraj";340;23349;224;23573;NA;273296;564;2021-03-16;70511
2021-03-15;"Banskobystrický kraj";95;32306;366;32672;NA;273296;461;2021-03-15;69947
2021-03-14;"Banskobystrický kraj";39;39212;218;39430;NA;273296;257;2021-03-14;69486
2021-03-13;"Banskobystrický kraj";209;67463;395;67858;NA;273296;604;2021-03-13;69229
2021-03-12;"Banskobystrický kraj";206;41444;330;41774;NA;273296;536;2021-03-12;68625
2021-03-11;"Banskobystrický kraj";228;21338;274;21612;NA;273296;502;2021-03-11;68089
2021-03-10;"Banskobystrický kraj";260;20408;241;20649;NA;273296;501;2021-03-10;67587
2021-03-09;"Banskobystrický kraj";352;21790;284;22074;NA;273296;636;2021-03-09;67086
2021-03-08;"Banskobystrický kraj";191;31471;427;31898;NA;273296;618;2021-03-08;66450
2021-03-07;"Banskobystrický kraj";60;39191;295;39486;NA;273296;355;2021-03-07;65832
2021-03-06;"Banskobystrický kraj";164;70897;410;71307;NA;273296;574;2021-03-06;65477
2021-03-05;"Banskobystrický kraj";221;42336;389;42725;NA;273296;610;2021-03-05;64903
2021-03-04;"Banskobystrický kraj";226;22009;334;22343;NA;273296;560;2021-03-04;64293
2021-03-03;"Banskobystrický kraj";317;21949;331;22280;NA;273296;648;2021-03-03;63733
2021-03-02;"Banskobystrický kraj";291;23160;354;23514;NA;273296;645;2021-03-02;63085
2021-03-01;"Banskobystrický kraj";151;31773;434;32207;NA;273296;585;2021-03-01;62440
2021-02-28;"Banskobystrický kraj";45;38665;336;39001;NA;273296;381;2021-02-28;61855
2021-02-27;"Banskobystrický kraj";289;66667;529;67196;NA;273296;818;2021-02-27;61474
2021-02-26;"Banskobystrický kraj";326;39674;468;40142;NA;273296;794;2021-02-26;60656
2021-02-25;"Banskobystrický kraj";375;18081;366;18447;NA;273296;741;2021-02-25;59862
2021-02-24;"Banskobystrický kraj";332;16735;373;17108;NA;273296;705;2021-02-24;59121
2021-02-23;"Banskobystrický kraj";462;19932;439;20371;NA;273296;901;2021-02-23;58416
2021-02-22;"Banskobystrický kraj";67;28643;598;29241;NA;273296;665;2021-02-22;57515
2021-02-21;"Banskobystrický kraj";68;37619;444;38063;NA;273296;512;2021-02-21;56850
2021-02-20;"Banskobystrický kraj";280;68851;598;69449;NA;273296;878;2021-02-20;56338
2021-02-19;"Banskobystrický kraj";420;39888;511;40399;NA;273296;931;2021-02-19;55460
2021-02-18;"Banskobystrický kraj";241;18618;396;19014;NA;273296;637;2021-02-18;54529
2021-02-17;"Banskobystrický kraj";415;16740;389;17129;NA;273296;804;2021-02-17;53892
2021-02-16;"Banskobystrický kraj";338;19731;368;20099;NA;273296;706;2021-02-16;53088
2021-02-15;"Banskobystrický kraj";118;35835;591;36426;NA;273296;709;2021-02-15;52382
2021-02-14;"Banskobystrický kraj";60;31894;386;32280;NA;273296;446;2021-02-14;51673
2021-02-13;"Banskobystrický kraj";202;53889;492;54381;NA;273296;694;2021-02-13;51227
2021-02-12;"Banskobystrický kraj";312;37270;533;37803;NA;273296;845;2021-02-12;50533
2021-02-11;"Banskobystrický kraj";305;21196;386;21582;NA;273296;691;2021-02-11;49688
2021-02-10;"Banskobystrický kraj";333;14790;344;15134;NA;273296;677;2021-02-10;48997
2021-02-09;"Banskobystrický kraj";329;18504;362;18866;NA;273296;691;2021-02-09;48320
2021-02-08;"Banskobystrický kraj";103;49716;695;50411;NA;273296;798;2021-02-08;47629
2021-02-07;"Banskobystrický kraj";70;37659;335;37994;NA;273296;405;2021-02-07;46831
2021-02-06;"Banskobystrický kraj";178;69388;570;69958;NA;273296;748;2021-02-06;46426
2021-02-05;"Banskobystrický kraj";282;24577;363;24940;NA;273296;645;2021-02-05;45678
2021-02-04;"Banskobystrický kraj";240;14367;430;14797;NA;273296;670;2021-02-04;45033
2021-02-03;"Banskobystrický kraj";350;9459;255;9714;NA;273296;605;2021-02-03;44363
2021-02-02;"Banskobystrický kraj";277;15741;334;16075;NA;273296;611;2021-02-02;43758
2021-02-01;"Banskobystrický kraj";75;24346;489;24835;NA;273296;564;2021-02-01;43147
2021-01-31;"Banskobystrický kraj";34;19983;201;20184;NA;273296;235;2021-01-31;42583
2021-01-30;"Banskobystrický kraj";163;63896;525;64421;NA;273296;688;2021-01-30;42348
2021-01-29;"Banskobystrický kraj";196;17368;274;17642;NA;273296;470;2021-01-29;41660
2021-01-28;"Banskobystrický kraj";218;15613;382;15995;NA;273296;600;2021-01-28;41190
2021-01-27;"Banskobystrický kraj";191;8132;200;8332;NA;273296;391;2021-01-27;40590
2021-01-26;"Banskobystrický kraj";238;19795;283;20078;NA;273296;521;2021-01-26;40199
2021-01-25;"Banskobystrický kraj";82;33666;412;34078;NA;273296;494;2021-01-25;39678
2021-01-24;"Banskobystrický kraj";38;35587;278;35865;NA;273296;316;2021-01-24;39184
2021-01-23;"Banskobystrický kraj";142;89058;523;89581;NA;273296;665;2021-01-23;38868
2021-01-22;"Banskobystrický kraj";175;25887;355;26242;NA;273296;530;2021-01-22;38203
2021-01-21;"Banskobystrický kraj";194;17063;279;17342;NA;273296;473;2021-01-21;37673
2021-01-20;"Banskobystrický kraj";231;9142;186;9328;NA;273296;417;2021-01-20;37200
2021-01-19;"Banskobystrický kraj";213;10708;311;11019;NA;273296;524;2021-01-19;36783
2021-01-18;"Banskobystrický kraj";94;7402;401;7803;NA;273296;495;2021-01-18;36259
2021-01-17;"Banskobystrický kraj";110;8154;77;8231;NA;273296;187;2021-01-17;35764
2021-01-16;"Banskobystrický kraj";58;2274;57;2331;NA;273296;115;2021-01-16;35577
2021-01-15;"Banskobystrický kraj";164;7673;217;7890;NA;273296;381;2021-01-15;35462
2021-01-14;"Banskobystrický kraj";220;5760;325;6085;NA;273296;545;2021-01-14;35081
2021-01-13;"Banskobystrický kraj";235;5974;217;6191;NA;273296;452;2021-01-13;34536
2021-01-12;"Banskobystrický kraj";194;6600;290;6890;NA;273296;484;2021-01-12;34084
2021-01-11;"Banskobystrický kraj";76;8231;481;8712;NA;273296;557;2021-01-11;33600
2021-01-10;"Banskobystrický kraj";110;433;4;437;NA;273296;114;2021-01-10;33043
2021-01-09;"Banskobystrický kraj";297;2378;81;2459;NA;273296;378;2021-01-09;32929
2021-01-08;"Banskobystrický kraj";435;9805;443;10248;NA;273296;878;2021-01-08;32551
2021-01-07;"Banskobystrický kraj";127;6322;366;6688;NA;273296;493;2021-01-07;31673
2021-01-06;"Banskobystrický kraj";305;3374;185;3559;NA;273296;490;2021-01-06;31180
2021-01-05;"Banskobystrický kraj";372;7349;533;7882;NA;273296;905;2021-01-05;30690
2021-01-04;"Banskobystrický kraj";130;7087;700;7787;NA;273296;830;2021-01-04;29785
2021-01-03;"Banskobystrický kraj";199;320;19;339;NA;273296;218;2021-01-03;28955
2021-01-02;"Banskobystrický kraj";123;702;85;787;NA;273296;208;2021-01-02;28737
2021-01-01;"Banskobystrický kraj";220;1958;132;2090;NA;273296;352;2021-01-01;28529
2020-12-31;"Banskobystrický kraj";499;7679;633;8312;NA;273296;1132;2020-12-31;28177
2020-12-30;"Banskobystrický kraj";593;7407;541;7948;NA;273296;1134;2020-12-30;27045
2020-12-29;"Banskobystrický kraj";240;7876;660;8536;NA;273296;900;2020-12-29;25911
2020-12-28;"Banskobystrický kraj";131;6120;720;6840;NA;273296;851;2020-12-28;25011
2020-12-27;"Banskobystrický kraj";116;541;25;566;NA;273296;141;2020-12-27;24160
2020-12-26;"Banskobystrický kraj";61;295;35;330;NA;273296;96;2020-12-26;24019
2020-12-25;"Banskobystrický kraj";65;888;10;898;NA;273296;75;2020-12-25;23923
2020-12-24;"Banskobystrický kraj";452;3685;135;3820;NA;273296;587;2020-12-24;23848
2020-12-23;"Banskobystrický kraj";368;9892;473;10365;NA;273296;841;2020-12-23;23261
2020-12-22;"Banskobystrický kraj";307;8468;619;9087;NA;273296;926;2020-12-22;22420
2020-12-21;"Banskobystrický kraj";286;4922;455;5377;NA;273296;741;2020-12-21;21494
2020-12-20;"Banskobystrický kraj";155;250;14;264;NA;273296;169;2020-12-20;20753
2020-12-19;"Banskobystrický kraj";170;3084;138;3222;NA;273296;308;2020-12-19;20584
2020-12-18;"Banskobystrický kraj";432;5959;331;6290;NA;273296;763;2020-12-18;20276
2020-12-17;"Banskobystrický kraj";468;8753;653;9406;NA;273296;1121;2020-12-17;19513
2020-12-16;"Banskobystrický kraj";379;10184;567;10751;NA;273296;946;2020-12-16;18392
2020-12-15;"Banskobystrický kraj";336;5281;425;5706;NA;273296;761;2020-12-15;17446
2020-12-14;"Banskobystrický kraj";148;4012;259;4271;NA;273296;407;2020-12-14;16685
2020-12-13;"Banskobystrický kraj";122;142;1;143;NA;273296;123;2020-12-13;16278
2020-12-12;"Banskobystrický kraj";137;2714;138;2852;NA;273296;275;2020-12-12;16155
2020-12-11;"Banskobystrický kraj";468;6633;362;6995;NA;273296;830;2020-12-11;15880
2020-12-10;"Banskobystrický kraj";280;5501;369;5870;NA;273296;649;2020-12-10;15050
2020-12-09;"Banskobystrický kraj";323;3941;205;4146;NA;273296;528;2020-12-09;14401
2020-12-08;"Banskobystrický kraj";256;3782;272;4054;NA;273296;528;2020-12-08;13873
2020-12-07;"Banskobystrický kraj";175;2633;177;2810;NA;273296;352;2020-12-07;13345
2020-12-06;"Banskobystrický kraj";121;507;11;518;NA;273296;132;2020-12-06;12993
2020-12-05;"Banskobystrický kraj";109;1099;34;1133;NA;273296;143;2020-12-05;12861
2020-12-04;"Banskobystrický kraj";339;3828;174;4002;NA;273296;513;2020-12-04;12718
2020-12-03;"Banskobystrický kraj";240;3193;234;3427;NA;273296;474;2020-12-03;12205
2020-12-02;"Banskobystrický kraj";217;4442;186;4628;NA;273296;403;2020-12-02;11731
2020-12-01;"Banskobystrický kraj";215;2702;134;2836;NA;273296;349;2020-12-01;11328
2020-11-30;"Banskobystrický kraj";74;4314;241;4555;NA;273296;315;2020-11-30;10979
2020-11-29;"Banskobystrický kraj";19;208;7;215;NA;273296;26;2020-11-29;10664
2020-11-28;"Banskobystrický kraj";81;1408;55;1463;NA;273296;136;2020-11-28;10638
2020-11-27;"Banskobystrický kraj";219;2566;123;2689;NA;273296;342;2020-11-27;10502
2020-11-26;"Banskobystrický kraj";208;2124;93;2217;NA;273296;301;2020-11-26;10160
2020-11-25;"Banskobystrický kraj";170;1952;86;2038;NA;273296;256;2020-11-25;9859
2020-11-24;"Banskobystrický kraj";166;2566;69;2635;NA;273296;235;2020-11-24;9603
2020-11-23;"Banskobystrický kraj";66;10147;193;10340;NA;273296;259;2020-11-23;9368
2020-11-22;"Banskobystrický kraj";38;104;1;105;NA;273296;39;2020-11-22;9109
2020-11-21;"Banskobystrický kraj";52;904;14;918;NA;273296;66;2020-11-21;9070
2020-11-20;"Banskobystrický kraj";127;2005;107;2112;NA;273296;234;2020-11-20;9004
2020-11-19;"Banskobystrický kraj";170;1218;82;1300;NA;273296;252;2020-11-19;8770
2020-11-18;"Banskobystrický kraj";153;698;65;763;NA;273296;218;2020-11-18;8518
2020-11-17;"Banskobystrický kraj";52;578;35;613;NA;273296;87;2020-11-17;8300
2020-11-16;"Banskobystrický kraj";106;470;25;495;NA;273296;131;2020-11-16;8213
2020-11-15;"Banskobystrický kraj";52;301;4;305;NA;273296;56;2020-11-15;8082
2020-11-14;"Banskobystrický kraj";73;305;2;307;NA;273296;75;2020-11-14;8026
2020-11-13;"Banskobystrický kraj";157;552;11;563;NA;273296;168;2020-11-13;7951
2020-11-12;"Banskobystrický kraj";218;952;44;996;NA;273296;262;2020-11-12;7783
2020-11-11;"Banskobystrický kraj";224;437;9;446;NA;273296;233;2020-11-11;7521
2020-11-10;"Banskobystrický kraj";263;463;18;481;NA;273296;281;2020-11-10;7288
2020-11-09;"Banskobystrický kraj";80;2678;31;2709;NA;273296;111;2020-11-09;7007
2020-11-08;"Banskobystrický kraj";82;981;16;997;NA;273296;98;2020-11-08;6896
2020-11-07;"Banskobystrický kraj";164;8828;94;8922;NA;273296;258;2020-11-07;6798
2020-11-06;"Banskobystrický kraj";227;2496;16;2512;NA;273296;243;2020-11-06;6540
2020-11-05;"Banskobystrický kraj";240;290;33;323;NA;273296;273;2020-11-05;6297
2020-11-04;"Banskobystrický kraj";254;1366;13;1379;NA;273296;267;2020-11-04;6024
2020-11-03;"Banskobystrický kraj";246;1332;4;1336;NA;273296;250;2020-11-03;5757
2020-11-02;"Banskobystrický kraj";90;2909;65;2974;NA;273296;155;2020-11-02;5507
2020-11-01;"Banskobystrický kraj";101;2671;42;2713;NA;273296;143;2020-11-01;5352
2020-10-31;"Banskobystrický kraj";199;13516;116;13632;NA;273296;315;2020-10-31;5209
2020-10-30;"Banskobystrický kraj";254;2829;20;2849;NA;273296;274;2020-10-30;4894
2020-10-29;"Banskobystrický kraj";372;969;42;1011;NA;273296;414;2020-10-29;4620
2020-10-28;"Banskobystrický kraj";285;302;30;332;NA;273296;315;2020-10-28;4206
2020-10-27;"Banskobystrický kraj";266;654;40;694;NA;273296;306;2020-10-27;3891
2020-10-26;"Banskobystrický kraj";38;234;29;263;NA;273296;67;2020-10-26;3585
2020-10-25;"Banskobystrický kraj";50;140;11;151;NA;273296;61;2020-10-25;3518
2020-10-24;"Banskobystrický kraj";315;114;12;126;NA;273296;327;2020-10-24;3457
2020-10-23;"Banskobystrický kraj";231;230;29;259;NA;273296;260;2020-10-23;3130
2020-10-22;"Banskobystrický kraj";264;253;24;277;NA;273296;288;2020-10-22;2870
2020-10-21;"Banskobystrický kraj";209;266;3;269;NA;273296;212;2020-10-21;2582
2020-10-20;"Banskobystrický kraj";210;66;3;69;NA;273296;213;2020-10-20;2370
2020-10-19;"Banskobystrický kraj";27;73;12;85;NA;273296;39;2020-10-19;2157
2020-10-18;"Banskobystrický kraj";49;0;0;0;NA;273296;49;2020-10-18;2118
2020-10-17;"Banskobystrický kraj";91;0;0;0;NA;273296;91;2020-10-17;2069
2020-10-16;"Banskobystrický kraj";224;37;3;40;NA;273296;227;2020-10-16;1978
2020-10-15;"Banskobystrický kraj";133;29;1;30;NA;273296;134;2020-10-15;1751
2020-10-14;"Banskobystrický kraj";139;31;1;32;NA;273296;140;2020-10-14;1617
2020-10-13;"Banskobystrický kraj";151;169;11;180;NA;273296;162;2020-10-13;1477
2020-10-12;"Banskobystrický kraj";11;110;4;114;NA;273296;15;2020-10-12;1315
2020-10-11;"Banskobystrický kraj";14;0;0;0;NA;273296;14;2020-10-11;1300
2020-10-10;"Banskobystrický kraj";53;0;0;0;NA;273296;53;2020-10-10;1286
2020-10-09;"Banskobystrický kraj";128;0;0;0;NA;273296;128;2020-10-09;1233
2020-10-08;"Banskobystrický kraj";99;0;0;0;NA;273296;99;2020-10-08;1105
2020-10-07;"Banskobystrický kraj";124;0;0;0;NA;273296;124;2020-10-07;1006
2020-10-06;"Banskobystrický kraj";68;0;0;0;NA;273296;68;2020-10-06;882
2020-10-05;"Banskobystrický kraj";49;0;0;0;NA;273296;49;2020-10-05;814
2020-10-04;"Banskobystrický kraj";8;0;0;0;NA;273296;8;2020-10-04;765
2020-10-03;"Banskobystrický kraj";37;0;0;0;NA;273296;37;2020-10-03;757
2020-10-02;"Banskobystrický kraj";74;0;0;0;NA;273296;74;2020-10-02;720
2020-10-01;"Banskobystrický kraj";49;16;0;16;NA;273296;49;2020-10-01;646
2020-09-30;"Banskobystrický kraj";60;0;0;0;NA;273296;60;2020-09-30;597
2020-09-29;"Banskobystrický kraj";24;0;0;0;NA;273296;24;2020-09-29;537
2020-09-28;"Banskobystrický kraj";0;0;0;0;NA;273296;0;2020-09-28;513
2020-09-27;"Banskobystrický kraj";20;0;0;0;NA;273296;20;2020-09-27;513
2020-09-26;"Banskobystrický kraj";24;0;0;0;NA;273296;24;2020-09-26;493
2020-09-25;"Banskobystrický kraj";29;0;0;0;NA;273296;29;2020-09-25;469
2020-09-24;"Banskobystrický kraj";25;0;0;0;NA;273296;25;2020-09-24;440
2020-09-23;"Banskobystrický kraj";17;0;0;0;NA;273296;17;2020-09-23;415
2020-09-22;"Banskobystrický kraj";25;0;0;0;NA;273296;25;2020-09-22;398
2020-09-21;"Banskobystrický kraj";3;0;0;0;NA;273296;3;2020-09-21;373
2020-09-20;"Banskobystrický kraj";0;0;0;0;NA;273296;0;2020-09-20;370
2020-09-19;"Banskobystrický kraj";3;0;0;0;NA;273296;3;2020-09-19;370
2020-09-18;"Banskobystrický kraj";24;0;0;0;NA;273296;24;2020-09-18;367
2020-09-17;"Banskobystrický kraj";14;0;0;0;NA;273296;14;2020-09-17;343
2020-09-16;"Banskobystrický kraj";6;0;0;0;NA;273296;6;2020-09-16;329
2020-09-15;"Banskobystrický kraj";2;0;0;0;NA;273296;2;2020-09-15;323
2020-09-14;"Banskobystrický kraj";13;0;0;0;NA;273296;13;2020-09-14;321
2020-09-13;"Banskobystrický kraj";1;0;0;0;NA;273296;1;2020-09-13;308
2020-09-12;"Banskobystrický kraj";5;0;0;0;NA;273296;5;2020-09-12;307
2020-09-11;"Banskobystrický kraj";19;0;0;0;NA;273296;19;2020-09-11;302
2020-09-10;"Banskobystrický kraj";11;0;0;0;NA;273296;11;2020-09-10;283
2020-09-09;"Banskobystrický kraj";13;0;0;0;NA;273296;13;2020-09-09;272
2020-09-08;"Banskobystrický kraj";5;0;0;0;NA;273296;5;2020-09-08;259
2020-09-07;"Banskobystrický kraj";2;0;0;0;NA;273296;2;2020-09-07;254
2020-09-06;"Banskobystrický kraj";0;0;0;0;NA;273296;0;2020-09-06;252
2020-09-05;"Banskobystrický kraj";0;0;0;0;NA;273296;0;2020-09-05;252
2020-09-04;"Banskobystrický kraj";9;0;0;0;NA;273296;9;2020-09-04;252
2020-09-03;"Banskobystrický kraj";5;0;0;0;NA;273296;5;2020-09-03;243
2020-09-02;"Banskobystrický kraj";6;0;0;0;NA;273296;6;2020-09-02;238
2020-09-01;"Banskobystrický kraj";2;0;0;0;NA;273296;2;2020-09-01;232
2020-08-31;"Banskobystrický kraj";6;0;0;0;NA;273296;6;2020-08-31;230
2020-08-30;"Banskobystrický kraj";0;0;0;0;NA;273296;0;2020-08-30;224
2020-08-29;"Banskobystrický kraj";1;0;0;0;NA;273296;1;2020-08-29;224
2020-08-28;"Banskobystrický kraj";3;0;0;0;NA;273296;3;2020-08-28;223
2020-08-27;"Banskobystrický kraj";1;0;0;0;NA;273296;1;2020-08-27;220
2020-08-26;"Banskobystrický kraj";2;0;0;0;NA;273296;2;2020-08-26;219
2020-08-25;"Banskobystrický kraj";2;0;0;0;NA;273296;2;2020-08-25;217
2020-08-24;"Banskobystrický kraj";0;0;0;0;NA;273296;0;2020-08-24;215
2020-08-23;"Banskobystrický kraj";0;0;0;0;NA;273296;0;2020-08-23;215
2020-08-22;"Banskobystrický kraj";0;0;0;0;NA;273296;0;2020-08-22;215
2020-08-21;"Banskobystrický kraj";4;0;0;0;NA;273296;4;2020-08-21;215
2020-08-20;"Banskobystrický kraj";1;0;0;0;NA;273296;1;2020-08-20;211
2020-08-19;"Banskobystrický kraj";4;0;0;0;NA;273296;4;2020-08-19;210
2020-08-18;"Banskobystrický kraj";0;0;0;0;NA;273296;0;2020-08-18;206
2020-08-17;"Banskobystrický kraj";1;0;0;0;NA;273296;1;2020-08-17;206
2020-08-16;"Banskobystrický kraj";0;0;0;0;NA;273296;0;2020-08-16;205
2020-08-15;"Banskobystrický kraj";0;0;0;0;NA;273296;0;2020-08-15;205
2020-08-14;"Banskobystrický kraj";5;0;0;0;NA;273296;5;2020-08-14;205
2020-08-13;"Banskobystrický kraj";0;0;0;0;NA;273296;0;2020-08-13;200
2020-08-12;"Banskobystrický kraj";0;0;0;0;NA;273296;0;2020-08-12;200
2020-08-11;"Banskobystrický kraj";2;0;0;0;NA;273296;2;2020-08-11;200
2020-08-10;"Banskobystrický kraj";3;0;0;0;NA;273296;3;2020-08-10;198
2020-08-09;"Banskobystrický kraj";0;0;0;0;NA;273296;0;2020-08-09;195
2020-08-08;"Banskobystrický kraj";2;0;0;0;NA;273296;2;2020-08-08;195
2020-08-07;"Banskobystrický kraj";1;0;0;0;NA;273296;1;2020-08-07;193
2020-08-06;"Banskobystrický kraj";1;0;0;0;NA;273296;1;2020-08-06;192
2020-08-05;"Banskobystrický kraj";0;0;0;0;NA;273296;0;2020-08-05;191
2020-08-04;"Banskobystrický kraj";3;0;0;0;NA;273296;3;2020-08-04;191
2020-08-03;"Banskobystrický kraj";0;0;0;0;NA;273296;0;2020-08-03;188
2020-08-02;"Banskobystrický kraj";0;0;0;0;NA;273296;0;2020-08-02;188
2020-08-01;"Banskobystrický kraj";1;0;0;0;NA;273296;1;2020-08-01;188
2020-07-31;"Banskobystrický kraj";2;0;0;0;NA;273296;2;2020-07-31;187
2020-07-30;"Banskobystrický kraj";1;0;0;0;NA;273296;1;2020-07-30;185
2020-07-29;"Banskobystrický kraj";0;0;0;0;NA;273296;0;2020-07-29;184
2020-07-28;"Banskobystrický kraj";2;0;0;0;NA;273296;2;2020-07-28;184
2020-07-27;"Banskobystrický kraj";3;0;0;0;NA;273296;3;2020-07-27;182
2020-07-26;"Banskobystrický kraj";0;0;0;0;NA;273296;0;2020-07-26;179
2020-07-25;"Banskobystrický kraj";0;0;0;0;NA;273296;0;2020-07-25;179
2020-07-24;"Banskobystrický kraj";9;0;0;0;NA;273296;9;2020-07-24;179
2020-07-23;"Banskobystrický kraj";0;0;0;0;NA;273296;0;2020-07-23;170
2020-07-22;"Banskobystrický kraj";3;0;0;0;NA;273296;3;2020-07-22;170
2020-07-21;"Banskobystrický kraj";3;0;0;0;NA;273296;3;2020-07-21;167
2020-07-20;"Banskobystrický kraj";1;0;0;0;NA;273296;1;2020-07-20;164
2020-07-19;"Banskobystrický kraj";1;0;0;0;NA;273296;1;2020-07-19;163
2020-07-18;"Banskobystrický kraj";0;0;0;0;NA;273296;0;2020-07-18;162
2020-07-17;"Banskobystrický kraj";2;0;0;0;NA;273296;2;2020-07-17;162
2020-07-16;"Banskobystrický kraj";1;0;0;0;NA;273296;1;2020-07-16;160
2020-07-15;"Banskobystrický kraj";4;0;0;0;NA;273296;4;2020-07-15;159
2020-07-14;"Banskobystrický kraj";2;0;0;0;NA;273296;2;2020-07-14;155
2020-07-13;"Banskobystrický kraj";1;0;0;0;NA;273296;1;2020-07-13;153
2020-07-12;"Banskobystrický kraj";0;0;0;0;NA;273296;0;2020-07-12;152
2020-07-11;"Banskobystrický kraj";0;0;0;0;NA;273296;0;2020-07-11;152
2020-07-10;"Banskobystrický kraj";3;0;0;0;NA;273296;3;2020-07-10;152
2020-07-09;"Banskobystrický kraj";9;0;0;0;NA;273296;9;2020-07-09;149
2020-07-08;"Banskobystrický kraj";0;0;0;0;NA;273296;0;2020-07-08;140
2020-07-07;"Banskobystrický kraj";4;0;0;0;NA;273296;4;2020-07-07;140
2020-07-06;"Banskobystrický kraj";0;0;0;0;NA;273296;0;2020-07-06;136
2020-07-05;"Banskobystrický kraj";0;0;0;0;NA;273296;0;2020-07-05;136
2020-07-04;"Banskobystrický kraj";1;0;0;0;NA;273296;1;2020-07-04;136
2020-07-03;"Banskobystrický kraj";4;0;0;0;NA;273296;4;2020-07-03;135
2020-07-02;"Banskobystrický kraj";0;0;0;0;NA;273296;0;2020-07-02;131
2020-07-01;"Banskobystrický kraj";1;0;0;0;NA;273296;1;2020-07-01;131
2020-06-30;"Banskobystrický kraj";0;12;0;12;NA;273296;0;2020-06-30;130
2020-06-29;"Banskobystrický kraj";0;0;0;0;NA;273296;0;2020-06-29;130
2020-06-28;"Banskobystrický kraj";0;0;0;0;NA;273296;0;2020-06-28;130
2020-06-27;"Banskobystrický kraj";0;0;0;0;NA;273296;0;2020-06-27;130
2020-06-26;"Banskobystrický kraj";0;0;0;0;NA;273296;0;2020-06-26;130
2020-06-25;"Banskobystrický kraj";1;0;0;0;NA;273296;1;2020-06-25;130
2020-06-24;"Banskobystrický kraj";0;0;0;0;NA;273296;0;2020-06-24;129
2020-06-23;"Banskobystrický kraj";6;0;0;0;NA;273296;6;2020-06-23;129
2020-06-22;"Banskobystrický kraj";0;0;0;0;NA;273296;0;2020-06-22;123
2020-06-21;"Banskobystrický kraj";0;0;0;0;NA;273296;0;2020-06-21;123
2020-06-20;"Banskobystrický kraj";0;0;0;0;NA;273296;0;2020-06-20;123
2020-06-19;"Banskobystrický kraj";2;0;0;0;NA;273296;2;2020-06-19;123
2020-06-18;"Banskobystrický kraj";10;0;0;0;NA;273296;10;2020-06-18;121
2020-06-17;"Banskobystrický kraj";1;0;0;0;NA;273296;1;2020-06-17;111
2020-06-16;"Banskobystrický kraj";0;0;0;0;NA;273296;0;2020-06-16;110
2020-06-14;"Banskobystrický kraj";2;0;0;0;NA;273296;2;2020-06-14;110
2020-06-13;"Banskobystrický kraj";2;0;0;0;NA;273296;2;2020-06-13;108
2020-06-12;"Banskobystrický kraj";0;0;0;0;NA;273296;0;2020-06-12;106
2020-06-11;"Banskobystrický kraj";1;0;0;0;NA;273296;1;2020-06-11;106
2020-06-10;"Banskobystrický kraj";0;0;0;0;NA;273296;0;2020-06-10;105
2020-06-09;"Banskobystrický kraj";0;0;0;0;NA;273296;0;2020-06-09;105
2020-06-08;"Banskobystrický kraj";0;0;0;0;NA;273296;0;2020-06-08;105
2020-06-07;"Banskobystrický kraj";0;0;0;0;NA;273296;0;2020-06-07;105
2020-06-05;"Banskobystrický kraj";2;0;0;0;NA;273296;2;2020-06-05;105
2020-06-03;"Banskobystrický kraj";0;0;0;0;NA;273296;0;2020-06-03;103
2020-06-02;"Banskobystrický kraj";0;0;0;0;NA;273296;0;2020-06-02;103
2020-05-31;"Banskobystrický kraj";0;0;0;0;NA;273296;0;2020-05-31;103
2020-05-29;"Banskobystrický kraj";0;0;0;0;NA;273296;0;2020-05-29;103
2020-05-27;"Banskobystrický kraj";1;0;0;0;NA;273296;1;2020-05-27;103
2020-05-26;"Banskobystrický kraj";0;0;0;0;NA;273296;0;2020-05-26;102
2020-05-25;"Banskobystrický kraj";0;0;0;0;NA;273296;0;2020-05-25;102
2020-05-24;"Banskobystrický kraj";0;0;0;0;NA;273296;0;2020-05-24;102
2020-05-23;"Banskobystrický kraj";1;0;0;0;NA;273296;1;2020-05-23;102
2020-05-22;"Banskobystrický kraj";0;0;0;0;NA;273296;0;2020-05-22;101
2020-05-21;"Banskobystrický kraj";0;0;0;0;NA;273296;0;2020-05-21;101
2020-05-20;"Banskobystrický kraj";1;0;0;0;NA;273296;1;2020-05-20;101
2020-05-19;"Banskobystrický kraj";0;0;0;0;NA;273296;0;2020-05-19;100
2020-05-17;"Banskobystrický kraj";0;0;0;0;NA;273296;0;2020-05-17;100
2020-05-16;"Banskobystrický kraj";0;0;0;0;NA;273296;0;2020-05-16;100
2020-05-15;"Banskobystrický kraj";0;0;0;0;NA;273296;0;2020-05-15;100
2020-05-14;"Banskobystrický kraj";0;0;0;0;NA;273296;0;2020-05-14;100
2020-05-13;"Banskobystrický kraj";0;0;0;0;NA;273296;0;2020-05-13;100
2020-05-12;"Banskobystrický kraj";1;0;0;0;NA;273296;1;2020-05-12;100
2020-05-11;"Banskobystrický kraj";0;0;0;0;NA;273296;0;2020-05-11;99
2020-05-09;"Banskobystrický kraj";0;0;0;0;NA;273296;0;2020-05-09;99
2020-05-07;"Banskobystrický kraj";2;0;0;0;NA;273296;2;2020-05-07;99
2020-05-06;"Banskobystrický kraj";1;0;0;0;NA;273296;1;2020-05-06;97
2020-05-05;"Banskobystrický kraj";2;0;0;0;NA;273296;2;2020-05-05;96
2020-05-04;"Banskobystrický kraj";0;0;0;0;NA;273296;0;2020-05-04;94
2020-05-03;"Banskobystrický kraj";0;0;0;0;NA;273296;0;2020-05-03;94
2020-05-02;"Banskobystrický kraj";0;0;0;0;NA;273296;0;2020-05-02;94
2020-05-01;"Banskobystrický kraj";0;0;0;0;NA;273296;0;2020-05-01;94
2020-04-30;"Banskobystrický kraj";1;0;0;0;NA;273296;1;2020-04-30;94
2020-04-29;"Banskobystrický kraj";1;0;0;0;NA;273296;1;2020-04-29;93
2020-04-28;"Banskobystrický kraj";0;0;0;0;NA;273296;0;2020-04-28;92
2020-04-27;"Banskobystrický kraj";0;0;0;0;NA;273296;0;2020-04-27;92
2020-04-26;"Banskobystrický kraj";0;0;0;0;NA;273296;0;2020-04-26;92
2020-04-25;"Banskobystrický kraj";2;0;0;0;NA;273296;2;2020-04-25;92
2020-04-24;"Banskobystrický kraj";3;0;0;0;NA;273296;3;2020-04-24;90
2020-04-23;"Banskobystrický kraj";2;0;0;0;NA;273296;2;2020-04-23;87
2020-04-22;"Banskobystrický kraj";2;0;0;0;NA;273296;2;2020-04-22;85
2020-04-21;"Banskobystrický kraj";2;0;0;0;NA;273296;2;2020-04-21;83
2020-04-20;"Banskobystrický kraj";0;0;0;0;NA;273296;0;2020-04-20;81
2020-04-19;"Banskobystrický kraj";0;0;0;0;NA;273296;0;2020-04-19;81
2020-04-18;"Banskobystrický kraj";8;0;0;0;NA;273296;8;2020-04-18;81
2020-04-17;"Banskobystrický kraj";2;0;0;0;NA;273296;2;2020-04-17;73
2020-04-16;"Banskobystrický kraj";0;0;0;0;NA;273296;0;2020-04-16;71
2020-04-15;"Banskobystrický kraj";10;0;0;0;NA;273296;10;2020-04-15;71
2020-04-14;"Banskobystrický kraj";0;0;0;0;NA;273296;0;2020-04-14;61
2020-04-13;"Banskobystrický kraj";2;0;0;0;NA;273296;2;2020-04-13;61
2020-04-12;"Banskobystrický kraj";4;0;0;0;NA;273296;4;2020-04-12;59
2020-04-11;"Banskobystrický kraj";1;0;0;0;NA;273296;1;2020-04-11;55
2020-04-10;"Banskobystrický kraj";0;0;0;0;NA;273296;0;2020-04-10;54
2020-04-09;"Banskobystrický kraj";2;0;0;0;NA;273296;2;2020-04-09;54
2020-04-08;"Banskobystrický kraj";0;0;0;0;NA;273296;0;2020-04-08;52
2020-04-07;"Banskobystrický kraj";4;0;0;0;NA;273296;4;2020-04-07;52
2020-04-06;"Banskobystrický kraj";10;0;0;0;NA;273296;10;2020-04-06;48
2020-04-05;"Banskobystrický kraj";9;0;0;0;NA;273296;9;2020-04-05;38
2020-04-04;"Banskobystrický kraj";0;0;0;0;NA;273296;0;2020-04-04;29
2020-04-03;"Banskobystrický kraj";2;0;0;0;NA;273296;2;2020-04-03;29
2020-04-02;"Banskobystrický kraj";2;0;0;0;NA;273296;2;2020-04-02;27
2020-04-01;"Banskobystrický kraj";5;0;0;0;NA;273296;5;2020-04-01;25
2020-03-31;"Banskobystrický kraj";3;0;0;0;NA;273296;3;2020-03-31;20
2020-03-30;"Banskobystrický kraj";1;0;0;0;NA;273296;1;2020-03-30;17
2020-03-29;"Banskobystrický kraj";2;0;0;0;NA;273296;2;2020-03-29;16
2020-03-28;"Banskobystrický kraj";1;0;0;0;NA;273296;1;2020-03-28;14
2020-03-27;"Banskobystrický kraj";1;0;0;0;NA;273296;1;2020-03-27;13
2020-03-26;"Banskobystrický kraj";1;0;0;0;NA;273296;1;2020-03-26;12
2020-03-25;"Banskobystrický kraj";0;0;0;0;NA;273296;0;2020-03-25;11
2020-03-24;"Banskobystrický kraj";1;0;0;0;NA;273296;1;2020-03-24;11
2020-03-23;"Banskobystrický kraj";1;0;0;0;NA;273296;1;2020-03-23;10
2020-03-22;"Banskobystrický kraj";0;0;0;0;NA;273296;0;2020-03-22;9
2020-03-21;"Banskobystrický kraj";3;0;0;0;NA;273296;3;2020-03-21;9
2020-03-20;"Banskobystrický kraj";0;0;0;0;NA;273296;0;2020-03-20;6
2020-03-19;"Banskobystrický kraj";2;0;0;0;NA;273296;2;2020-03-19;6
2020-03-18;"Banskobystrický kraj";1;0;0;0;NA;273296;1;2020-03-18;4
2020-03-17;"Banskobystrický kraj";1;0;0;0;NA;273296;1;2020-03-17;3
2020-03-16;"Banskobystrický kraj";0;0;0;0;NA;273296;0;2020-03-16;2
2020-03-15;"Banskobystrický kraj";1;0;0;0;NA;273296;1;2020-03-15;2
2020-03-14;"Banskobystrický kraj";0;0;0;0;NA;273296;0;2020-03-14;1
2020-03-13;"Banskobystrický kraj";1;0;0;0;NA;273296;1;2020-03-13;1
2020-03-12;"Banskobystrický kraj";0;0;0;0;NA;273296;0;2020-03-12;0
2020-03-11;"Banskobystrický kraj";0;0;0;0;NA;273296;0;2020-03-11;0
2020-03-09;"Banskobystrický kraj";0;0;0;0;NA;273296;0;2020-03-09;0
2020-03-08;"Banskobystrický kraj";0;0;0;0;NA;273296;0;2020-03-08;0
2020-03-07;"Banskobystrický kraj";0;0;0;0;NA;273296;0;2020-03-07;0
2020-03-06;"Banskobystrický kraj";0;0;0;0;NA;273296;0;2020-03-06;0
2022-04-25;"Bratislavský kraj";199;0;0;0;248499;341272;199;2022-04-25;341272
2022-04-24;"Bratislavský kraj";126;554;30;584;NA;341272;156;2022-04-24;341073
2022-04-23;"Bratislavský kraj";216;536;14;550;NA;341272;230;2022-04-23;340917
2022-04-22;"Bratislavský kraj";343;1550;39;1589;NA;341272;382;2022-04-22;340687
2022-04-21;"Bratislavský kraj";359;1878;59;1937;NA;341272;418;2022-04-21;340305
2022-04-20;"Bratislavský kraj";543;2153;48;2201;NA;341272;591;2022-04-20;339887
2022-04-19;"Bratislavský kraj";253;2834;96;2930;NA;341272;349;2022-04-19;339296
2022-04-18;"Bratislavský kraj";174;710;26;736;NA;341272;200;2022-04-18;338947
2022-04-17;"Bratislavský kraj";315;655;27;682;NA;341272;342;2022-04-17;338747
2022-04-16;"Bratislavský kraj";170;761;33;794;NA;341272;203;2022-04-16;338405
2022-04-15;"Bratislavský kraj";281;823;25;848;NA;341272;306;2022-04-15;338202
2022-04-14;"Bratislavský kraj";538;1896;63;1959;NA;341272;601;2022-04-14;337896
2022-04-13;"Bratislavský kraj";555;1917;47;1964;NA;341272;602;2022-04-13;337295
2022-04-12;"Bratislavský kraj";612;2239;68;2307;NA;341272;680;2022-04-12;336693
2022-04-11;"Bratislavský kraj";514;2967;105;3072;NA;341272;619;2022-04-11;336013
2022-04-10;"Bratislavský kraj";293;963;63;1026;NA;341272;356;2022-04-10;335394
2022-04-09;"Bratislavský kraj";610;898;43;941;NA;341272;653;2022-04-09;335038
2022-04-08;"Bratislavský kraj";668;1746;82;1828;NA;341272;750;2022-04-08;334385
2022-04-07;"Bratislavský kraj";833;2348;96;2444;NA;341272;929;2022-04-07;333635
2022-04-06;"Bratislavský kraj";865;2042;100;2142;NA;341272;965;2022-04-06;332706
2022-04-05;"Bratislavský kraj";914;2358;127;2485;NA;341272;1041;2022-04-05;331741
2022-04-04;"Bratislavský kraj";827;3232;167;3399;NA;341272;994;2022-04-04;330700
2022-04-03;"Bratislavský kraj";589;1031;70;1101;NA;341272;659;2022-04-03;329706
2022-04-02;"Bratislavský kraj";863;1128;75;1203;NA;341272;938;2022-04-02;329047
2022-04-01;"Bratislavský kraj";1381;2274;128;2402;NA;341272;1509;2022-04-01;328109
2022-03-31;"Bratislavský kraj";1305;2861;154;3015;NA;341272;1459;2022-03-31;326600
2022-03-30;"Bratislavský kraj";1516;2133;161;2294;NA;341272;1677;2022-03-30;325141
2022-03-29;"Bratislavský kraj";1327;2570;216;2786;NA;341272;1543;2022-03-29;323464
2022-03-28;"Bratislavský kraj";1275;4214;267;4481;NA;341272;1542;2022-03-28;321921
2022-03-27;"Bratislavský kraj";962;1236;151;1387;NA;341272;1113;2022-03-27;320379
2022-03-26;"Bratislavský kraj";1391;1170;105;1275;NA;341272;1496;2022-03-26;319266
2022-03-25;"Bratislavský kraj";1793;2513;170;2683;NA;341272;1963;2022-03-25;317770
2022-03-24;"Bratislavský kraj";1708;2866;197;3063;NA;341272;1905;2022-03-24;315807
2022-03-23;"Bratislavský kraj";2093;2832;200;3032;NA;341272;2293;2022-03-23;313902
2022-03-22;"Bratislavský kraj";1857;2889;236;3125;NA;341272;2093;2022-03-22;311609
2022-03-21;"Bratislavský kraj";1469;4361;383;4744;NA;341272;1852;2022-03-21;309516
2022-03-20;"Bratislavský kraj";935;1359;181;1540;NA;341272;1116;2022-03-20;307664
2022-03-19;"Bratislavský kraj";1672;1510;142;1652;NA;341272;1814;2022-03-19;306548
2022-03-18;"Bratislavský kraj";1977;2942;209;3151;NA;341272;2186;2022-03-18;304734
2022-03-17;"Bratislavský kraj";2024;3501;253;3754;NA;341272;2277;2022-03-17;302548
2022-03-16;"Bratislavský kraj";1895;2773;265;3038;NA;341272;2160;2022-03-16;300271
2022-03-15;"Bratislavský kraj";1982;3813;343;4156;NA;341272;2325;2022-03-15;298111
2022-03-14;"Bratislavský kraj";1557;4138;348;4486;NA;341272;1905;2022-03-14;295786
2022-03-13;"Bratislavský kraj";738;1324;166;1490;NA;341272;904;2022-03-13;293881
2022-03-12;"Bratislavský kraj";1632;1264;110;1374;NA;341272;1742;2022-03-12;292977
2022-03-11;"Bratislavský kraj";1184;3161;318;3479;NA;341272;1502;2022-03-11;291235
2022-03-10;"Bratislavský kraj";1706;3603;355;3958;NA;341272;2061;2022-03-10;289733
2022-03-09;"Bratislavský kraj";1723;2818;276;3094;NA;341272;1999;2022-03-09;287672
2022-03-08;"Bratislavský kraj";1925;3830;342;4172;NA;341272;2267;2022-03-08;285673
2022-03-07;"Bratislavský kraj";1451;4303;486;4789;NA;341272;1937;2022-03-07;283406
2022-03-06;"Bratislavský kraj";850;1557;217;1774;NA;341272;1067;2022-03-06;281469
2022-03-05;"Bratislavský kraj";1203;1345;183;1528;NA;341272;1386;2022-03-05;280402
2022-03-04;"Bratislavský kraj";1443;3024;309;3333;NA;341272;1752;2022-03-04;279016
2022-03-03;"Bratislavský kraj";1599;3287;330;3617;NA;341272;1929;2022-03-03;277264
2022-03-02;"Bratislavský kraj";1677;2555;319;2874;NA;341272;1996;2022-03-02;275335
2022-03-01;"Bratislavský kraj";1560;3676;344;4020;NA;341272;1904;2022-03-01;273339
2022-02-28;"Bratislavský kraj";1593;4052;472;4524;NA;341272;2065;2022-02-28;271435
2022-02-27;"Bratislavský kraj";1156;1746;227;1973;NA;341272;1383;2022-02-27;269370
2022-02-26;"Bratislavský kraj";1228;1749;209;1958;NA;341272;1437;2022-02-26;267987
2022-02-25;"Bratislavský kraj";1692;3604;323;3927;NA;341272;2015;2022-02-25;266550
2022-02-24;"Bratislavský kraj";1760;3992;324;4316;NA;341272;2084;2022-02-24;264535
2022-02-23;"Bratislavský kraj";2105;3450;393;3843;NA;341272;2498;2022-02-23;262451
2022-02-22;"Bratislavský kraj";2951;4213;384;4597;NA;341272;3335;2022-02-22;259953
2022-02-21;"Bratislavský kraj";781;5116;517;5633;NA;341272;1298;2022-02-21;256618
2022-02-20;"Bratislavský kraj";1314;2005;294;2299;NA;341272;1608;2022-02-20;255320
2022-02-19;"Bratislavský kraj";1510;1929;235;2164;NA;341272;1745;2022-02-19;253712
2022-02-18;"Bratislavský kraj";2315;3835;378;4213;NA;341272;2693;2022-02-18;251967
2022-02-17;"Bratislavský kraj";2279;4412;416;4828;NA;341272;2695;2022-02-17;249274
2022-02-16;"Bratislavský kraj";2137;3749;419;4168;NA;341272;2556;2022-02-16;246579
2022-02-15;"Bratislavský kraj";2276;4894;475;5369;NA;341272;2751;2022-02-15;244023
2022-02-14;"Bratislavský kraj";2700;6170;601;6771;NA;341272;3301;2022-02-14;241272
2022-02-13;"Bratislavský kraj";1343;2248;395;2643;NA;341272;1738;2022-02-13;237971
2022-02-12;"Bratislavský kraj";1872;2273;336;2609;NA;341272;2208;2022-02-12;236233
2022-02-11;"Bratislavský kraj";2431;5054;419;5473;NA;341272;2850;2022-02-11;234025
2022-02-10;"Bratislavský kraj";2595;4563;427;4990;NA;341272;3022;2022-02-10;231175
2022-02-09;"Bratislavský kraj";2414;4706;477;5183;NA;341272;2891;2022-02-09;228153
2022-02-08;"Bratislavský kraj";2878;5134;512;5646;NA;341272;3390;2022-02-08;225262
2022-02-07;"Bratislavský kraj";2636;6970;668;7638;NA;341272;3304;2022-02-07;221872
2022-02-06;"Bratislavský kraj";1680;3005;382;3387;NA;341272;2062;2022-02-06;218568
2022-02-05;"Bratislavský kraj";2156;2456;315;2771;NA;341272;2471;2022-02-05;216506
2022-02-04;"Bratislavský kraj";2586;4679;408;5087;NA;341272;2994;2022-02-04;214035
2022-02-03;"Bratislavský kraj";2540;6005;435;6440;NA;341272;2975;2022-02-03;211041
2022-02-02;"Bratislavský kraj";2655;5035;465;5500;NA;341272;3120;2022-02-02;208066
2022-02-01;"Bratislavský kraj";2758;6001;469;6470;NA;341272;3227;2022-02-01;204946
2022-01-31;"Bratislavský kraj";2172;8357;712;9069;NA;341272;2884;2022-01-31;201719
2022-01-30;"Bratislavský kraj";1418;3314;362;3676;NA;341272;1780;2022-01-30;198835
2022-01-29;"Bratislavský kraj";1762;3138;326;3464;NA;341272;2088;2022-01-29;197055
2022-01-28;"Bratislavský kraj";2237;5047;389;5436;NA;341272;2626;2022-01-28;194967
2022-01-27;"Bratislavský kraj";2014;5975;334;6309;NA;341272;2348;2022-01-27;192341
2022-01-26;"Bratislavský kraj";1792;4895;367;5262;NA;341272;2159;2022-01-26;189993
2022-01-25;"Bratislavský kraj";1933;5551;385;5936;NA;341272;2318;2022-01-25;187834
2022-01-24;"Bratislavský kraj";1173;7911;315;8226;NA;341272;1488;2022-01-24;185516
2022-01-23;"Bratislavský kraj";862;3289;151;3440;NA;341272;1013;2022-01-23;184028
2022-01-22;"Bratislavský kraj";1130;2802;125;2927;NA;341272;1255;2022-01-22;183015
2022-01-21;"Bratislavský kraj";1057;4656;166;4822;NA;341272;1223;2022-01-21;181760
2022-01-20;"Bratislavský kraj";940;4893;146;5039;NA;341272;1086;2022-01-20;180537
2022-01-19;"Bratislavský kraj";857;4618;169;4787;NA;341272;1026;2022-01-19;179451
2022-01-18;"Bratislavský kraj";794;5002;163;5165;NA;341272;957;2022-01-18;178425
2022-01-17;"Bratislavský kraj";534;7242;150;7392;NA;341272;684;2022-01-17;177468
2022-01-16;"Bratislavský kraj";300;2854;77;2931;NA;341272;377;2022-01-16;176784
2022-01-15;"Bratislavský kraj";543;2139;71;2210;NA;341272;614;2022-01-15;176407
2022-01-14;"Bratislavský kraj";356;3692;70;3762;NA;341272;426;2022-01-14;175793
2022-01-13;"Bratislavský kraj";382;4579;82;4661;NA;341272;464;2022-01-13;175367
2022-01-12;"Bratislavský kraj";415;4014;71;4085;NA;341272;486;2022-01-12;174903
2022-01-11;"Bratislavský kraj";407;4910;110;5020;NA;341272;517;2022-01-11;174417
2022-01-10;"Bratislavský kraj";413;6380;101;6481;NA;341272;514;2022-01-10;173900
2022-01-09;"Bratislavský kraj";187;3080;71;3151;NA;341272;258;2022-01-09;173386
2022-01-08;"Bratislavský kraj";323;1951;58;2009;NA;341272;381;2022-01-08;173128
2022-01-07;"Bratislavský kraj";436;3809;100;3909;NA;341272;536;2022-01-07;172747
2022-01-06;"Bratislavský kraj";192;2163;51;2214;NA;341272;243;2022-01-06;172211
2022-01-05;"Bratislavský kraj";426;4047;69;4116;NA;341272;495;2022-01-05;171968
2022-01-04;"Bratislavský kraj";446;4467;101;4568;NA;341272;547;2022-01-04;171473
2022-01-03;"Bratislavský kraj";578;5672;129;5801;NA;341272;707;2022-01-03;170926
2022-01-02;"Bratislavský kraj";198;3137;80;3217;NA;341272;278;2022-01-02;170219
2022-01-01;"Bratislavský kraj";7;1103;36;1139;NA;341272;43;2022-01-01;169941
2021-12-31;"Bratislavský kraj";371;3443;92;3535;NA;341272;463;2021-12-31;169898
2021-12-30;"Bratislavský kraj";468;3619;119;3738;NA;341272;587;2021-12-30;169435
2021-12-29;"Bratislavský kraj";404;3598;85;3683;NA;341272;489;2021-12-29;168848
2021-12-28;"Bratislavský kraj";578;4329;121;4450;NA;341272;699;2021-12-28;168359
2021-12-27;"Bratislavský kraj";656;4693;108;4801;NA;341272;764;2021-12-27;167660
2021-12-26;"Bratislavský kraj";198;2549;83;2632;NA;341272;281;2021-12-26;166896
2021-12-25;"Bratislavský kraj";34;1160;53;1213;NA;341272;87;2021-12-25;166615
2021-12-24;"Bratislavský kraj";171;2214;55;2269;NA;341272;226;2021-12-24;166528
2021-12-23;"Bratislavský kraj";678;4134;115;4249;NA;341272;793;2021-12-23;166302
2021-12-22;"Bratislavský kraj";575;4919;118;5037;NA;341272;693;2021-12-22;165509
2021-12-21;"Bratislavský kraj";625;5628;167;5795;NA;341272;792;2021-12-21;164816
2021-12-20;"Bratislavský kraj";528;6163;158;6321;NA;341272;686;2021-12-20;164024
2021-12-19;"Bratislavský kraj";250;3042;98;3140;NA;341272;348;2021-12-19;163338
2021-12-18;"Bratislavský kraj";528;2654;103;2757;NA;341272;631;2021-12-18;162990
2021-12-17;"Bratislavský kraj";683;4917;145;5062;NA;341272;828;2021-12-17;162359
2021-12-16;"Bratislavský kraj";730;5576;162;5738;NA;341272;892;2021-12-16;161531
2021-12-15;"Bratislavský kraj";881;4884;158;5042;NA;341272;1039;2021-12-15;160639
2021-12-14;"Bratislavský kraj";869;5397;179;5576;NA;341272;1048;2021-12-14;159600
2021-12-13;"Bratislavský kraj";648;7614;239;7853;NA;341272;887;2021-12-13;158552
2021-12-12;"Bratislavský kraj";534;3474;129;3603;NA;341272;663;2021-12-12;157665
2021-12-11;"Bratislavský kraj";698;2377;153;2530;NA;341272;851;2021-12-11;157002
2021-12-10;"Bratislavský kraj";796;4728;186;4914;NA;341272;982;2021-12-10;156151
2021-12-09;"Bratislavský kraj";1040;4152;174;4326;NA;341272;1214;2021-12-09;155169
2021-12-08;"Bratislavský kraj";1172;4602;196;4798;NA;341272;1368;2021-12-08;153955
2021-12-07;"Bratislavský kraj";1236;5173;257;5430;NA;341272;1493;2021-12-07;152587
2021-12-06;"Bratislavský kraj";1434;8714;312;9026;NA;341272;1746;2021-12-06;151094
2021-12-05;"Bratislavský kraj";633;3874;197;4071;NA;341272;830;2021-12-05;149348
2021-12-04;"Bratislavský kraj";936;4332;195;4527;NA;341272;1131;2021-12-04;148518
2021-12-03;"Bratislavský kraj";1222;4351;269;4620;NA;341272;1491;2021-12-03;147387
2021-12-02;"Bratislavský kraj";2053;5097;311;5408;NA;341272;2364;2021-12-02;145896
2021-12-01;"Bratislavský kraj";1161;9058;295;9353;NA;341272;1456;2021-12-01;143532
2021-11-30;"Bratislavský kraj";1442;6508;355;6863;NA;341272;1797;2021-11-30;142076
2021-11-29;"Bratislavský kraj";863;8823;452;9275;NA;341272;1315;2021-11-29;140279
2021-11-28;"Bratislavský kraj";617;5102;295;5397;NA;341272;912;2021-11-28;138964
2021-11-27;"Bratislavský kraj";1026;3497;329;3826;NA;341272;1355;2021-11-27;138052
2021-11-26;"Bratislavský kraj";1346;5483;422;5905;NA;341272;1768;2021-11-26;136697
2021-11-25;"Bratislavský kraj";1415;6383;451;6834;NA;341272;1866;2021-11-25;134929
2021-11-24;"Bratislavský kraj";1286;6849;467;7316;NA;341272;1753;2021-11-24;133063
2021-11-23;"Bratislavský kraj";1651;6351;433;6784;NA;341272;2084;2021-11-23;131310
2021-11-22;"Bratislavský kraj";1197;8722;584;9306;NA;341272;1781;2021-11-22;129226
2021-11-21;"Bratislavský kraj";702;4324;320;4644;NA;341272;1022;2021-11-21;127445
2021-11-20;"Bratislavský kraj";1005;3514;360;3874;NA;341272;1365;2021-11-20;126423
2021-11-19;"Bratislavský kraj";1444;5927;549;6476;NA;341272;1993;2021-11-19;125058
2021-11-18;"Bratislavský kraj";1052;6358;548;6906;NA;341272;1600;2021-11-18;123065
2021-11-17;"Bratislavský kraj";832;2439;308;2747;NA;341272;1140;2021-11-17;121465
2021-11-16;"Bratislavský kraj";1067;5792;443;6235;NA;341272;1510;2021-11-16;120325
2021-11-15;"Bratislavský kraj";1014;6330;519;6849;NA;341272;1533;2021-11-15;118815
2021-11-14;"Bratislavský kraj";448;3202;335;3537;NA;341272;783;2021-11-14;117282
2021-11-13;"Bratislavský kraj";587;3251;313;3564;NA;341272;900;2021-11-13;116499
2021-11-12;"Bratislavský kraj";856;5723;357;6080;NA;341272;1213;2021-11-12;115599
2021-11-11;"Bratislavský kraj";787;6028;355;6383;NA;341272;1142;2021-11-11;114386
2021-11-10;"Bratislavský kraj";840;5903;385;6288;NA;341272;1225;2021-11-10;113244
2021-11-09;"Bratislavský kraj";939;5733;350;6083;NA;341272;1289;2021-11-09;112019
2021-11-08;"Bratislavský kraj";579;5641;404;6045;NA;341272;983;2021-11-08;110730
2021-11-07;"Bratislavský kraj";363;2836;244;3080;NA;341272;607;2021-11-07;109747
2021-11-06;"Bratislavský kraj";538;2901;243;3144;NA;341272;781;2021-11-06;109140
2021-11-05;"Bratislavský kraj";801;5640;318;5958;NA;341272;1119;2021-11-05;108359
2021-11-04;"Bratislavský kraj";768;5233;273;5506;NA;341272;1041;2021-11-04;107240
2021-11-03;"Bratislavský kraj";690;5120;290;5410;NA;341272;980;2021-11-03;106199
2021-11-02;"Bratislavský kraj";422;6356;327;6683;NA;341272;749;2021-11-02;105219
2021-11-01;"Bratislavský kraj";395;1733;136;1869;NA;341272;531;2021-11-01;104470
2021-10-31;"Bratislavský kraj";209;2280;163;2443;NA;341272;372;2021-10-31;103939
2021-10-30;"Bratislavský kraj";429;2138;118;2256;NA;341272;547;2021-10-30;103567
2021-10-29;"Bratislavský kraj";445;4757;219;4976;NA;341272;664;2021-10-29;103020
2021-10-28;"Bratislavský kraj";372;4777;179;4956;NA;341272;551;2021-10-28;102356
2021-10-27;"Bratislavský kraj";376;4522;164;4686;NA;341272;540;2021-10-27;101805
2021-10-26;"Bratislavský kraj";461;4492;188;4680;NA;341272;649;2021-10-26;101265
2021-10-25;"Bratislavský kraj";379;5347;192;5539;NA;341272;571;2021-10-25;100616
2021-10-24;"Bratislavský kraj";114;2369;91;2460;NA;341272;205;2021-10-24;100045
2021-10-23;"Bratislavský kraj";301;2666;91;2757;NA;341272;392;2021-10-23;99840
2021-10-22;"Bratislavský kraj";309;4466;122;4588;NA;341272;431;2021-10-22;99448
2021-10-21;"Bratislavský kraj";244;4544;101;4645;NA;341272;345;2021-10-21;99017
2021-10-20;"Bratislavský kraj";262;3897;95;3992;NA;341272;357;2021-10-20;98672
2021-10-19;"Bratislavský kraj";260;4116;68;4184;NA;341272;328;2021-10-19;98315
2021-10-18;"Bratislavský kraj";250;5014;114;5128;NA;341272;364;2021-10-18;97987
2021-10-17;"Bratislavský kraj";54;2460;73;2533;NA;341272;127;2021-10-17;97623
2021-10-16;"Bratislavský kraj";185;2687;63;2750;NA;341272;248;2021-10-16;97496
2021-10-15;"Bratislavský kraj";169;4200;64;4264;NA;341272;233;2021-10-15;97248
2021-10-14;"Bratislavský kraj";173;4714;61;4775;NA;341272;234;2021-10-14;97015
2021-10-13;"Bratislavský kraj";143;3671;76;3747;NA;341272;219;2021-10-13;96781
2021-10-12;"Bratislavský kraj";183;4037;78;4115;NA;341272;261;2021-10-12;96562
2021-10-11;"Bratislavský kraj";191;4798;88;4886;NA;341272;279;2021-10-11;96301
2021-10-10;"Bratislavský kraj";29;2176;43;2219;NA;341272;72;2021-10-10;96022
2021-10-09;"Bratislavský kraj";141;2419;34;2453;NA;341272;175;2021-10-09;95950
2021-10-08;"Bratislavský kraj";130;4511;63;4574;NA;341272;193;2021-10-08;95775
2021-10-07;"Bratislavský kraj";92;4137;61;4198;NA;341272;153;2021-10-07;95582
2021-10-06;"Bratislavský kraj";147;4028;68;4096;NA;341272;215;2021-10-06;95429
2021-10-05;"Bratislavský kraj";164;4468;70;4538;NA;341272;234;2021-10-05;95214
2021-10-04;"Bratislavský kraj";129;4653;79;4732;NA;341272;208;2021-10-04;94980
2021-10-03;"Bratislavský kraj";41;2144;42;2186;NA;341272;83;2021-10-03;94772
2021-10-02;"Bratislavský kraj";104;2605;40;2645;NA;341272;144;2021-10-02;94689
2021-10-01;"Bratislavský kraj";108;4818;57;4875;NA;341272;165;2021-10-01;94545
2021-09-30;"Bratislavský kraj";90;3854;60;3914;NA;341272;150;2021-09-30;94380
2021-09-29;"Bratislavský kraj";115;3508;58;3566;NA;341272;173;2021-09-29;94230
2021-09-28;"Bratislavský kraj";144;4003;48;4051;NA;341272;192;2021-09-28;94057
2021-09-27;"Bratislavský kraj";123;4427;70;4497;NA;341272;193;2021-09-27;93865
2021-09-26;"Bratislavský kraj";32;2194;31;2225;NA;341272;63;2021-09-26;93672
2021-09-25;"Bratislavský kraj";85;2742;38;2780;NA;341272;123;2021-09-25;93609
2021-09-24;"Bratislavský kraj";82;4212;59;4271;NA;341272;141;2021-09-24;93486
2021-09-23;"Bratislavský kraj";90;3975;51;4026;NA;341272;141;2021-09-23;93345
2021-09-22;"Bratislavský kraj";84;3757;63;3820;NA;341272;147;2021-09-22;93204
2021-09-21;"Bratislavský kraj";95;3574;39;3613;NA;341272;134;2021-09-21;93057
2021-09-20;"Bratislavský kraj";84;3937;31;3968;NA;341272;115;2021-09-20;92923
2021-09-19;"Bratislavský kraj";31;1850;28;1878;NA;341272;59;2021-09-19;92808
2021-09-18;"Bratislavský kraj";60;1989;19;2008;NA;341272;79;2021-09-18;92749
2021-09-17;"Bratislavský kraj";87;3443;27;3470;NA;341272;114;2021-09-17;92670
2021-09-16;"Bratislavský kraj";57;3781;43;3824;NA;341272;100;2021-09-16;92556
2021-09-15;"Bratislavský kraj";41;1104;21;1125;NA;341272;62;2021-09-15;92456
2021-09-14;"Bratislavský kraj";78;3518;31;3549;NA;341272;109;2021-09-14;92394
2021-09-13;"Bratislavský kraj";47;3191;28;3219;NA;341272;75;2021-09-13;92285
2021-09-12;"Bratislavský kraj";13;1713;21;1734;NA;341272;34;2021-09-12;92210
2021-09-11;"Bratislavský kraj";36;2064;13;2077;NA;341272;49;2021-09-11;92176
2021-09-10;"Bratislavský kraj";47;3628;18;3646;NA;341272;65;2021-09-10;92127
2021-09-09;"Bratislavský kraj";50;3010;30;3040;NA;341272;80;2021-09-09;92062
2021-09-08;"Bratislavský kraj";56;2925;20;2945;NA;341272;76;2021-09-08;91982
2021-09-07;"Bratislavský kraj";50;3272;18;3290;NA;341272;68;2021-09-07;91906
2021-09-06;"Bratislavský kraj";63;2821;29;2850;NA;341272;92;2021-09-06;91838
2021-09-05;"Bratislavský kraj";10;1682;14;1696;NA;341272;24;2021-09-05;91746
2021-09-04;"Bratislavský kraj";41;2612;11;2623;NA;341272;52;2021-09-04;91722
2021-09-03;"Bratislavský kraj";55;3016;14;3030;NA;341272;69;2021-09-03;91670
2021-09-02;"Bratislavský kraj";35;2423;23;2446;NA;341272;58;2021-09-02;91601
2021-09-01;"Bratislavský kraj";16;929;9;938;NA;341272;25;2021-09-01;91543
2021-08-31;"Bratislavský kraj";28;5197;22;5219;NA;341272;50;2021-08-31;91518
2021-08-30;"Bratislavský kraj";24;2403;13;2416;NA;341272;37;2021-08-30;91468
2021-08-29;"Bratislavský kraj";11;1016;6;1022;NA;341272;17;2021-08-29;91431
2021-08-28;"Bratislavský kraj";24;1714;11;1725;NA;341272;35;2021-08-28;91414
2021-08-27;"Bratislavský kraj";19;2850;9;2859;NA;341272;28;2021-08-27;91379
2021-08-26;"Bratislavský kraj";15;2382;19;2401;NA;341272;34;2021-08-26;91351
2021-08-25;"Bratislavský kraj";29;1888;10;1898;NA;341272;39;2021-08-25;91317
2021-08-24;"Bratislavský kraj";22;1785;4;1789;NA;341272;26;2021-08-24;91278
2021-08-23;"Bratislavský kraj";21;2183;7;2190;NA;341272;28;2021-08-23;91252
2021-08-22;"Bratislavský kraj";5;1383;8;1391;NA;341272;13;2021-08-22;91224
2021-08-21;"Bratislavský kraj";18;1681;4;1685;NA;341272;22;2021-08-21;91211
2021-08-20;"Bratislavský kraj";27;2747;19;2766;NA;341272;46;2021-08-20;91189
2021-08-19;"Bratislavský kraj";15;2122;9;2131;NA;341272;24;2021-08-19;91143
2021-08-18;"Bratislavský kraj";16;1659;11;1670;NA;341272;27;2021-08-18;91119
2021-08-17;"Bratislavský kraj";18;1608;5;1613;NA;341272;23;2021-08-17;91092
2021-08-16;"Bratislavský kraj";18;2559;12;2571;NA;341272;30;2021-08-16;91069
2021-08-15;"Bratislavský kraj";3;1169;6;1175;NA;341272;9;2021-08-15;91039
2021-08-14;"Bratislavský kraj";11;1519;4;1523;NA;341272;15;2021-08-14;91030
2021-08-13;"Bratislavský kraj";32;2634;7;2641;NA;341272;39;2021-08-13;91015
2021-08-12;"Bratislavský kraj";16;1824;9;1833;NA;341272;25;2021-08-12;90976
2021-08-11;"Bratislavský kraj";22;1621;5;1626;NA;341272;27;2021-08-11;90951
2021-08-10;"Bratislavský kraj";15;1630;7;1637;NA;341272;22;2021-08-10;90924
2021-08-09;"Bratislavský kraj";35;1927;9;1936;NA;341272;44;2021-08-09;90902
2021-08-08;"Bratislavský kraj";3;1152;4;1156;NA;341272;7;2021-08-08;90858
2021-08-07;"Bratislavský kraj";6;1572;9;1581;NA;341272;15;2021-08-07;90851
2021-08-06;"Bratislavský kraj";9;2510;10;2520;NA;341272;19;2021-08-06;90836
2021-08-05;"Bratislavský kraj";10;1651;7;1658;NA;341272;17;2021-08-05;90817
2021-08-04;"Bratislavský kraj";9;1578;0;1578;NA;341272;9;2021-08-04;90800
2021-08-03;"Bratislavský kraj";11;1507;5;1512;NA;341272;16;2021-08-03;90791
2021-08-02;"Bratislavský kraj";15;1749;11;1760;NA;341272;26;2021-08-02;90775
2021-08-01;"Bratislavský kraj";4;1224;8;1232;NA;341272;12;2021-08-01;90749
2021-07-31;"Bratislavský kraj";7;1623;2;1625;NA;341272;9;2021-07-31;90737
2021-07-30;"Bratislavský kraj";15;2540;7;2547;NA;341272;22;2021-07-30;90728
2021-07-29;"Bratislavský kraj";19;1790;7;1797;NA;341272;26;2021-07-29;90706
2021-07-28;"Bratislavský kraj";8;1538;11;1549;NA;341272;19;2021-07-28;90680
2021-07-27;"Bratislavský kraj";9;1476;5;1481;NA;341272;14;2021-07-27;90661
2021-07-26;"Bratislavský kraj";17;1806;7;1813;NA;341272;24;2021-07-26;90647
2021-07-25;"Bratislavský kraj";4;1411;2;1413;NA;341272;6;2021-07-25;90623
2021-07-24;"Bratislavský kraj";9;1732;3;1735;NA;341272;12;2021-07-24;90617
2021-07-23;"Bratislavský kraj";6;2400;3;2403;NA;341272;9;2021-07-23;90605
2021-07-22;"Bratislavský kraj";12;1944;6;1950;NA;341272;18;2021-07-22;90596
2021-07-21;"Bratislavský kraj";5;1860;6;1866;NA;341272;11;2021-07-21;90578
2021-07-20;"Bratislavský kraj";19;1559;1;1560;NA;341272;20;2021-07-20;90567
2021-07-19;"Bratislavský kraj";15;2259;3;2262;NA;341272;18;2021-07-19;90547
2021-07-18;"Bratislavský kraj";2;1462;3;1465;NA;341272;5;2021-07-18;90529
2021-07-17;"Bratislavský kraj";3;1870;2;1872;NA;341272;5;2021-07-17;90524
2021-07-16;"Bratislavský kraj";8;2834;4;2838;NA;341272;12;2021-07-16;90519
2021-07-15;"Bratislavský kraj";5;1677;0;1677;NA;341272;5;2021-07-15;90507
2021-07-14;"Bratislavský kraj";5;1904;3;1907;NA;341272;8;2021-07-14;90502
2021-07-13;"Bratislavský kraj";4;1584;4;1588;NA;341272;8;2021-07-13;90494
2021-07-12;"Bratislavský kraj";6;1780;5;1785;NA;341272;11;2021-07-12;90486
2021-07-11;"Bratislavský kraj";3;1896;3;1899;NA;341272;6;2021-07-11;90475
2021-07-10;"Bratislavský kraj";5;2240;3;2243;NA;341272;8;2021-07-10;90469
2021-07-09;"Bratislavský kraj";13;3546;7;3553;NA;341272;20;2021-07-09;90461
2021-07-08;"Bratislavský kraj";9;2433;4;2437;NA;341272;13;2021-07-08;90441
2021-07-07;"Bratislavský kraj";5;2792;4;2796;NA;341272;9;2021-07-07;90428
2021-07-06;"Bratislavský kraj";19;2771;4;2775;NA;341272;23;2021-07-06;90419
2021-07-05;"Bratislavský kraj";5;2481;5;2486;NA;341272;10;2021-07-05;90396
2021-07-04;"Bratislavský kraj";3;1824;2;1826;NA;341272;5;2021-07-04;90386
2021-07-03;"Bratislavský kraj";8;2205;5;2210;NA;341272;13;2021-07-03;90381
2021-07-02;"Bratislavský kraj";4;2227;4;2231;NA;341272;8;2021-07-02;90368
2021-07-01;"Bratislavský kraj";6;1809;5;1814;NA;341272;11;2021-07-01;90360
2021-06-30;"Bratislavský kraj";2;11548;11;11559;NA;341272;13;2021-06-30;90349
2021-06-29;"Bratislavský kraj";5;6831;7;6838;NA;341272;12;2021-06-29;90336
2021-06-28;"Bratislavský kraj";16;6654;24;6678;NA;341272;40;2021-06-28;90324
2021-06-27;"Bratislavský kraj";4;6689;11;6700;NA;341272;15;2021-06-27;90284
2021-06-26;"Bratislavský kraj";3;8741;6;8747;NA;341272;9;2021-06-26;90269
2021-06-25;"Bratislavský kraj";7;10285;15;10300;NA;341272;22;2021-06-25;90260
2021-06-24;"Bratislavský kraj";3;7384;16;7400;NA;341272;19;2021-06-24;90238
2021-06-23;"Bratislavský kraj";4;7346;12;7358;NA;341272;16;2021-06-23;90219
2021-06-22;"Bratislavský kraj";6;7244;10;7254;NA;341272;16;2021-06-22;90203
2021-06-21;"Bratislavský kraj";5;7641;9;7650;NA;341272;14;2021-06-21;90187
2021-06-20;"Bratislavský kraj";0;7369;5;7374;NA;341272;5;2021-06-20;90173
2021-06-19;"Bratislavský kraj";3;9226;4;9230;NA;341272;7;2021-06-19;90168
2021-06-18;"Bratislavský kraj";5;12763;9;12772;NA;341272;14;2021-06-18;90161
2021-06-17;"Bratislavský kraj";3;8625;13;8638;NA;341272;16;2021-06-17;90147
2021-06-16;"Bratislavský kraj";3;7105;4;7109;NA;341272;7;2021-06-16;90131
2021-06-15;"Bratislavský kraj";7;7309;17;7326;NA;341272;24;2021-06-15;90124
2021-06-14;"Bratislavský kraj";4;8231;9;8240;NA;341272;13;2021-06-14;90100
2021-06-13;"Bratislavský kraj";2;8791;11;8802;NA;341272;13;2021-06-13;90087
2021-06-12;"Bratislavský kraj";4;11152;11;11163;NA;341272;15;2021-06-12;90074
2021-06-11;"Bratislavský kraj";9;13644;21;13665;NA;341272;30;2021-06-11;90059
2021-06-10;"Bratislavský kraj";12;8637;15;8652;NA;341272;27;2021-06-10;90029
2021-06-09;"Bratislavský kraj";12;7596;12;7608;NA;341272;24;2021-06-09;90002
2021-06-08;"Bratislavský kraj";13;7907;29;7936;NA;341272;42;2021-06-08;89978
2021-06-07;"Bratislavský kraj";13;9247;43;9290;NA;341272;56;2021-06-07;89936
2021-06-06;"Bratislavský kraj";3;10350;20;10370;NA;341272;23;2021-06-06;89880
2021-06-05;"Bratislavský kraj";2;12692;15;12707;NA;341272;17;2021-06-05;89857
2021-06-04;"Bratislavský kraj";10;13846;31;13877;NA;341272;41;2021-06-04;89840
2021-06-03;"Bratislavský kraj";12;9615;19;9634;NA;341272;31;2021-06-03;89799
2021-06-02;"Bratislavský kraj";10;8684;17;8701;NA;341272;27;2021-06-02;89768
2021-06-01;"Bratislavský kraj";3;8812;25;8837;NA;341272;28;2021-06-01;89741
2021-05-31;"Bratislavský kraj";18;11248;32;11280;NA;341272;50;2021-05-31;89713
2021-05-30;"Bratislavský kraj";1;11758;17;11775;NA;341272;18;2021-05-30;89663
2021-05-29;"Bratislavský kraj";4;12245;8;12253;NA;341272;12;2021-05-29;89645
2021-05-28;"Bratislavský kraj";14;15865;23;15888;NA;341272;37;2021-05-28;89633
2021-05-27;"Bratislavský kraj";5;11321;18;11339;NA;341272;23;2021-05-27;89596
2021-05-26;"Bratislavský kraj";20;10709;17;10726;NA;341272;37;2021-05-26;89573
2021-05-25;"Bratislavský kraj";19;11864;31;11895;NA;341272;50;2021-05-25;89536
2021-05-24;"Bratislavský kraj";12;12966;23;12989;NA;341272;35;2021-05-24;89486
2021-05-23;"Bratislavský kraj";7;13074;24;13098;NA;341272;31;2021-05-23;89451
2021-05-22;"Bratislavský kraj";6;14044;22;14066;NA;341272;28;2021-05-22;89420
2021-05-21;"Bratislavský kraj";15;18996;22;19018;NA;341272;37;2021-05-21;89392
2021-05-20;"Bratislavský kraj";15;14112;17;14129;NA;341272;32;2021-05-20;89355
2021-05-19;"Bratislavský kraj";21;11958;24;11982;NA;341272;45;2021-05-19;89323
2021-05-18;"Bratislavský kraj";14;13005;33;13038;NA;341272;47;2021-05-18;89278
2021-05-17;"Bratislavský kraj";15;13854;29;13883;NA;341272;44;2021-05-17;89231
2021-05-16;"Bratislavský kraj";12;19797;32;19829;NA;341272;44;2021-05-16;89187
2021-05-15;"Bratislavský kraj";1;18113;30;18143;NA;341272;31;2021-05-15;89143
2021-05-14;"Bratislavský kraj";15;22228;30;22258;NA;341272;45;2021-05-14;89112
2021-05-13;"Bratislavský kraj";9;16211;17;16228;NA;341272;26;2021-05-13;89067
2021-05-12;"Bratislavský kraj";11;14638;28;14666;NA;341272;39;2021-05-12;89041
2021-05-11;"Bratislavský kraj";29;16741;32;16773;NA;341272;61;2021-05-11;89002
2021-05-10;"Bratislavský kraj";27;19991;64;20055;NA;341272;91;2021-05-10;88941
2021-05-09;"Bratislavský kraj";9;29358;32;29390;NA;341272;41;2021-05-09;88850
2021-05-08;"Bratislavský kraj";5;19451;24;19475;NA;341272;29;2021-05-08;88809
2021-05-07;"Bratislavský kraj";32;28211;65;28276;NA;341272;97;2021-05-07;88780
2021-05-06;"Bratislavský kraj";19;20079;52;20131;NA;341272;71;2021-05-06;88683
2021-05-05;"Bratislavský kraj";29;15526;31;15557;NA;341272;60;2021-05-05;88612
2021-05-04;"Bratislavský kraj";46;19143;53;19196;NA;341272;99;2021-05-04;88552
2021-05-03;"Bratislavský kraj";37;22322;64;22386;NA;341272;101;2021-05-03;88453
2021-05-02;"Bratislavský kraj";38;43064;75;43139;NA;341272;113;2021-05-02;88352
2021-05-01;"Bratislavský kraj";11;39905;40;39945;NA;341272;51;2021-05-01;88239
2021-04-30;"Bratislavský kraj";43;47403;82;47485;NA;341272;125;2021-04-30;88188
2021-04-29;"Bratislavský kraj";48;30257;96;30353;NA;341272;144;2021-04-29;88063
2021-04-28;"Bratislavský kraj";40;28905;78;28983;NA;341272;118;2021-04-28;87919
2021-04-27;"Bratislavský kraj";41;30168;52;30220;NA;341272;93;2021-04-27;87801
2021-04-26;"Bratislavský kraj";59;34733;97;34830;NA;341272;156;2021-04-26;87708
2021-04-25;"Bratislavský kraj";8;57615;74;57689;NA;341272;82;2021-04-25;87552
2021-04-24;"Bratislavský kraj";28;74858;66;74924;NA;341272;94;2021-04-24;87470
2021-04-23;"Bratislavský kraj";70;48614;62;48676;NA;341272;132;2021-04-23;87376
2021-04-22;"Bratislavský kraj";39;31037;72;31109;NA;341272;111;2021-04-22;87244
2021-04-21;"Bratislavský kraj";48;30442;62;30504;NA;341272;110;2021-04-21;87133
2021-04-20;"Bratislavský kraj";58;35216;63;35279;NA;341272;121;2021-04-20;87023
2021-04-19;"Bratislavský kraj";48;39500;80;39580;NA;341272;128;2021-04-19;86902
2021-04-18;"Bratislavský kraj";35;62300;76;62376;NA;341272;111;2021-04-18;86774
2021-04-17;"Bratislavský kraj";13;80359;111;80470;NA;341272;124;2021-04-17;86663
2021-04-16;"Bratislavský kraj";62;47296;80;47376;NA;341272;142;2021-04-16;86539
2021-04-15;"Bratislavský kraj";34;32176;74;32250;NA;341272;108;2021-04-15;86397
2021-04-14;"Bratislavský kraj";65;33961;88;34049;NA;341272;153;2021-04-14;86289
2021-04-13;"Bratislavský kraj";82;35512;82;35594;NA;341272;164;2021-04-13;86136
2021-04-12;"Bratislavský kraj";77;42286;115;42401;NA;341272;192;2021-04-12;85972
2021-04-11;"Bratislavský kraj";42;61151;123;61274;NA;341272;165;2021-04-11;85780
2021-04-10;"Bratislavský kraj";14;77874;167;78041;NA;341272;181;2021-04-10;85615
2021-04-09;"Bratislavský kraj";72;41556;97;41653;NA;341272;169;2021-04-09;85434
2021-04-08;"Bratislavský kraj";71;28866;95;28961;NA;341272;166;2021-04-08;85265
2021-04-07;"Bratislavský kraj";96;38061;101;38162;NA;341272;197;2021-04-07;85099
2021-04-06;"Bratislavský kraj";94;56204;179;56383;NA;341272;273;2021-04-06;84902
2021-04-05;"Bratislavský kraj";85;18538;85;18623;NA;341272;170;2021-04-05;84629
2021-04-04;"Bratislavský kraj";37;29225;75;29300;NA;341272;112;2021-04-04;84459
2021-04-03;"Bratislavský kraj";52;79865;220;80085;NA;341272;272;2021-04-03;84347
2021-04-02;"Bratislavský kraj";33;23790;104;23894;NA;341272;137;2021-04-02;84075
2021-04-01;"Bratislavský kraj";119;57388;159;57547;NA;341272;278;2021-04-01;83938
2021-03-31;"Bratislavský kraj";105;46371;177;46548;NA;341272;282;2021-03-31;83660
2021-03-30;"Bratislavský kraj";100;39599;144;39743;NA;341272;244;2021-03-30;83378
2021-03-29;"Bratislavský kraj";153;40364;178;40542;NA;341272;331;2021-03-29;83134
2021-03-28;"Bratislavský kraj";59;53372;137;53509;NA;341272;196;2021-03-28;82803
2021-03-27;"Bratislavský kraj";53;79834;240;80074;NA;341272;293;2021-03-27;82607
2021-03-26;"Bratislavský kraj";114;56108;191;56299;NA;341272;305;2021-03-26;82314
2021-03-25;"Bratislavský kraj";76;36859;172;37031;NA;341272;248;2021-03-25;82009
2021-03-24;"Bratislavský kraj";120;30567;201;30768;NA;341272;321;2021-03-24;81761
2021-03-23;"Bratislavský kraj";138;36438;190;36628;NA;341272;328;2021-03-23;81440
2021-03-22;"Bratislavský kraj";110;42756;220;42976;NA;341272;330;2021-03-22;81112
2021-03-21;"Bratislavský kraj";54;61299;212;61511;NA;341272;266;2021-03-21;80782
2021-03-20;"Bratislavský kraj";59;73300;228;73528;NA;341272;287;2021-03-20;80516
2021-03-19;"Bratislavský kraj";139;54576;257;54833;NA;341272;396;2021-03-19;80229
2021-03-18;"Bratislavský kraj";142;34611;192;34803;NA;341272;334;2021-03-18;79833
2021-03-17;"Bratislavský kraj";177;30482;217;30699;NA;341272;394;2021-03-17;79499
2021-03-16;"Bratislavský kraj";258;36798;287;37085;NA;341272;545;2021-03-16;79105
2021-03-15;"Bratislavský kraj";180;38226;255;38481;NA;341272;435;2021-03-15;78560
2021-03-14;"Bratislavský kraj";75;52611;275;52886;NA;341272;350;2021-03-14;78125
2021-03-13;"Bratislavský kraj";110;81405;341;81746;NA;341272;451;2021-03-13;77775
2021-03-12;"Bratislavský kraj";152;55233;312;55545;NA;341272;464;2021-03-12;77324
2021-03-11;"Bratislavský kraj";178;34678;286;34964;NA;341272;464;2021-03-11;76860
2021-03-10;"Bratislavský kraj";164;31061;280;31341;NA;341272;444;2021-03-10;76396
2021-03-09;"Bratislavský kraj";242;37687;267;37954;NA;341272;509;2021-03-09;75952
2021-03-08;"Bratislavský kraj";255;41199;348;41547;NA;341272;603;2021-03-08;75443
2021-03-07;"Bratislavský kraj";142;52812;301;53113;NA;341272;443;2021-03-07;74840
2021-03-06;"Bratislavský kraj";79;71821;415;72236;NA;341272;494;2021-03-06;74397
2021-03-05;"Bratislavský kraj";238;50653;293;50946;NA;341272;531;2021-03-05;73903
2021-03-04;"Bratislavský kraj";204;34544;344;34888;NA;341272;548;2021-03-04;73372
2021-03-03;"Bratislavský kraj";250;30527;364;30891;NA;341272;614;2021-03-03;72824
2021-03-02;"Bratislavský kraj";267;39735;388;40123;NA;341272;655;2021-03-02;72210
2021-03-01;"Bratislavský kraj";320;38222;432;38654;NA;341272;752;2021-03-01;71555
2021-02-28;"Bratislavský kraj";184;50323;323;50646;NA;341272;507;2021-02-28;70803
2021-02-27;"Bratislavský kraj";151;76580;464;77044;NA;341272;615;2021-02-27;70296
2021-02-26;"Bratislavský kraj";277;47326;401;47727;NA;341272;678;2021-02-26;69681
2021-02-25;"Bratislavský kraj";277;28769;405;29174;NA;341272;682;2021-02-25;69003
2021-02-24;"Bratislavský kraj";217;27095;412;27507;NA;341272;629;2021-02-24;68321
2021-02-23;"Bratislavský kraj";257;31297;395;31692;NA;341272;652;2021-02-23;67692
2021-02-22;"Bratislavský kraj";353;36607;483;37090;NA;341272;836;2021-02-22;67040
2021-02-21;"Bratislavský kraj";185;54150;396;54546;NA;341272;581;2021-02-21;66204
2021-02-20;"Bratislavský kraj";167;74814;550;75364;NA;341272;717;2021-02-20;65623
2021-02-19;"Bratislavský kraj";280;44882;416;45298;NA;341272;696;2021-02-19;64906
2021-02-18;"Bratislavský kraj";263;26379;371;26750;NA;341272;634;2021-02-18;64210
2021-02-17;"Bratislavský kraj";264;22820;316;23136;NA;341272;580;2021-02-17;63576
2021-02-16;"Bratislavský kraj";289;28262;352;28614;NA;341272;641;2021-02-16;62996
2021-02-15;"Bratislavský kraj";248;36893;396;37289;NA;341272;644;2021-02-15;62355
2021-02-14;"Bratislavský kraj";153;47948;323;48271;NA;341272;476;2021-02-14;61711
2021-02-13;"Bratislavský kraj";173;68589;515;69104;NA;341272;688;2021-02-13;61235
2021-02-12;"Bratislavský kraj";282;35729;327;36056;NA;341272;609;2021-02-12;60547
2021-02-11;"Bratislavský kraj";337;24565;285;24850;NA;341272;622;2021-02-11;59938
2021-02-10;"Bratislavský kraj";314;22944;356;23300;NA;341272;670;2021-02-10;59316
2021-02-09;"Bratislavský kraj";288;36565;454;37019;NA;341272;742;2021-02-09;58646
2021-02-08;"Bratislavský kraj";484;31896;397;32293;NA;341272;881;2021-02-08;57904
2021-02-07;"Bratislavský kraj";243;51290;425;51715;NA;341272;668;2021-02-07;57023
2021-02-06;"Bratislavský kraj";116;61682;501;62183;NA;341272;617;2021-02-06;56355
2021-02-05;"Bratislavský kraj";327;27033;375;27408;NA;341272;702;2021-02-05;55738
2021-02-04;"Bratislavský kraj";555;17260;348;17608;NA;341272;903;2021-02-04;55036
2021-02-03;"Bratislavský kraj";161;13020;352;13372;NA;341272;513;2021-02-03;54133
2021-02-02;"Bratislavský kraj";397;25947;480;26427;NA;341272;877;2021-02-02;53620
2021-02-01;"Bratislavský kraj";221;35541;513;36054;NA;341272;734;2021-02-01;52743
2021-01-31;"Bratislavský kraj";180;35693;425;36118;NA;341272;605;2021-01-31;52009
2021-01-30;"Bratislavský kraj";310;49588;521;50109;NA;341272;831;2021-01-30;51404
2021-01-29;"Bratislavský kraj";344;16568;344;16912;NA;341272;688;2021-01-29;50573
2021-01-28;"Bratislavský kraj";307;10715;297;11012;NA;341272;604;2021-01-28;49885
2021-01-27;"Bratislavský kraj";336;22222;345;22567;NA;341272;681;2021-01-27;49281
2021-01-26;"Bratislavský kraj";297;21894;300;22194;NA;341272;597;2021-01-26;48600
2021-01-25;"Bratislavský kraj";356;23335;249;23584;NA;341272;605;2021-01-25;48003
2021-01-24;"Bratislavský kraj";175;37903;404;38307;NA;341272;579;2021-01-24;47398
2021-01-23;"Bratislavský kraj";396;79453;690;80143;NA;341272;1086;2021-01-23;46819
2021-01-22;"Bratislavský kraj";199;42055;365;42420;NA;341272;564;2021-01-22;45733
2021-01-21;"Bratislavský kraj";255;105746;1317;107063;NA;341272;1572;2021-01-21;45169
2021-01-20;"Bratislavský kraj";360;27289;452;27741;NA;341272;812;2021-01-20;43597
2021-01-19;"Bratislavský kraj";375;15318;346;15664;NA;341272;721;2021-01-19;42785
2021-01-18;"Bratislavský kraj";357;12533;707;13240;NA;341272;1064;2021-01-18;42064
2021-01-17;"Bratislavský kraj";244;482;26;508;NA;341272;270;2021-01-17;41000
2021-01-16;"Bratislavský kraj";70;3016;156;3172;NA;341272;226;2021-01-16;40730
2021-01-15;"Bratislavský kraj";251;7896;256;8152;NA;341272;507;2021-01-15;40504
2021-01-14;"Bratislavský kraj";363;8523;273;8796;NA;341272;636;2021-01-14;39997
2021-01-13;"Bratislavský kraj";336;8490;327;8817;NA;341272;663;2021-01-13;39361
2021-01-12;"Bratislavský kraj";450;10509;455;10964;NA;341272;905;2021-01-12;38698
2021-01-11;"Bratislavský kraj";397;19863;364;20227;NA;341272;761;2021-01-11;37793
2021-01-10;"Bratislavský kraj";252;1507;79;1586;NA;341272;331;2021-01-10;37032
2021-01-09;"Bratislavský kraj";351;4721;277;4998;NA;341272;628;2021-01-09;36701
2021-01-08;"Bratislavský kraj";556;10045;436;10481;NA;341272;992;2021-01-08;36073
2021-01-07;"Bratislavský kraj";537;6872;352;7224;NA;341272;889;2021-01-07;35081
2021-01-06;"Bratislavský kraj";271;3329;216;3545;NA;341272;487;2021-01-06;34192
2021-01-05;"Bratislavský kraj";619;10635;814;11449;NA;341272;1433;2021-01-05;33705
2021-01-04;"Bratislavský kraj";601;8226;538;8764;NA;341272;1139;2021-01-04;32272
2021-01-03;"Bratislavský kraj";77;433;41;474;NA;341272;118;2021-01-03;31133
2021-01-02;"Bratislavský kraj";185;462;57;519;NA;341272;242;2021-01-02;31015
2021-01-01;"Bratislavský kraj";235;3277;131;3408;NA;341272;366;2021-01-01;30773
2020-12-31;"Bratislavský kraj";925;14135;519;14654;NA;341272;1444;2020-12-31;30407
2020-12-30;"Bratislavský kraj";650;9164;533;9697;NA;341272;1183;2020-12-30;28963
2020-12-29;"Bratislavský kraj";303;10108;699;10807;NA;341272;1002;2020-12-29;27780
2020-12-28;"Bratislavský kraj";255;7784;473;8257;NA;341272;728;2020-12-28;26778
2020-12-27;"Bratislavský kraj";160;709;76;785;NA;341272;236;2020-12-27;26050
2020-12-26;"Bratislavský kraj";75;480;27;507;NA;341272;102;2020-12-26;25814
2020-12-25;"Bratislavský kraj";114;503;38;541;NA;341272;152;2020-12-25;25712
2020-12-24;"Bratislavský kraj";536;3367;104;3471;NA;341272;640;2020-12-24;25560
2020-12-23;"Bratislavský kraj";416;12590;447;13037;NA;341272;863;2020-12-23;24920
2020-12-22;"Bratislavský kraj";327;14587;699;15286;NA;341272;1026;2020-12-22;24057
2020-12-21;"Bratislavský kraj";392;14972;1946;16918;NA;341272;2338;2020-12-21;23031
2020-12-20;"Bratislavský kraj";180;797;57;854;NA;341272;237;2020-12-20;20693
2020-12-19;"Bratislavský kraj";396;3314;130;3444;NA;341272;526;2020-12-19;20456
2020-12-18;"Bratislavský kraj";306;9938;345;10283;NA;341272;651;2020-12-18;19930
2020-12-17;"Bratislavský kraj";502;9739;386;10125;NA;341272;888;2020-12-17;19279
2020-12-16;"Bratislavský kraj";282;10201;418;10619;NA;341272;700;2020-12-16;18391
2020-12-15;"Bratislavský kraj";423;10450;454;10904;NA;341272;877;2020-12-15;17691
2020-12-14;"Bratislavský kraj";279;6793;261;7054;NA;341272;540;2020-12-14;16814
2020-12-13;"Bratislavský kraj";125;139;10;149;NA;341272;135;2020-12-13;16274
2020-12-12;"Bratislavský kraj";361;3886;157;4043;NA;341272;518;2020-12-12;16139
2020-12-11;"Bratislavský kraj";326;6824;235;7059;NA;341272;561;2020-12-11;15621
2020-12-10;"Bratislavský kraj";286;5279;166;5445;NA;341272;452;2020-12-10;15060
2020-12-09;"Bratislavský kraj";382;4778;177;4955;NA;341272;559;2020-12-09;14608
2020-12-08;"Bratislavský kraj";234;6243;207;6450;NA;341272;441;2020-12-08;14049
2020-12-07;"Bratislavský kraj";272;4639;152;4791;NA;341272;424;2020-12-07;13608
2020-12-06;"Bratislavský kraj";61;1625;52;1677;NA;341272;113;2020-12-06;13184
2020-12-05;"Bratislavský kraj";266;2221;41;2262;NA;341272;307;2020-12-05;13071
2020-12-04;"Bratislavský kraj";200;4954;99;5053;NA;341272;299;2020-12-04;12764
2020-12-03;"Bratislavský kraj";213;5672;95;5767;NA;341272;308;2020-12-03;12465
2020-12-02;"Bratislavský kraj";205;3462;103;3565;NA;341272;308;2020-12-02;12157
2020-12-01;"Bratislavský kraj";255;3889;172;4061;NA;341272;427;2020-12-01;11849
2020-11-30;"Bratislavský kraj";152;2153;121;2274;NA;341272;273;2020-11-30;11422
2020-11-29;"Bratislavský kraj";52;201;24;225;NA;341272;76;2020-11-29;11149
2020-11-28;"Bratislavský kraj";232;2624;33;2657;NA;341272;265;2020-11-28;11073
2020-11-27;"Bratislavský kraj";54;2540;64;2604;NA;341272;118;2020-11-27;10808
2020-11-26;"Bratislavský kraj";129;1976;60;2036;NA;341272;189;2020-11-26;10690
2020-11-25;"Bratislavský kraj";140;1770;47;1817;NA;341272;187;2020-11-25;10501
2020-11-24;"Bratislavský kraj";81;2988;67;3055;NA;341272;148;2020-11-24;10314
2020-11-23;"Bratislavský kraj";67;7083;58;7141;NA;341272;125;2020-11-23;10166
2020-11-22;"Bratislavský kraj";36;81;7;88;NA;341272;43;2020-11-22;10041
2020-11-21;"Bratislavský kraj";109;2126;47;2173;NA;341272;156;2020-11-21;9998
2020-11-20;"Bratislavský kraj";118;2876;48;2924;NA;341272;166;2020-11-20;9842
2020-11-19;"Bratislavský kraj";173;987;29;1016;NA;341272;202;2020-11-19;9676
2020-11-18;"Bratislavský kraj";118;616;75;691;NA;341272;193;2020-11-18;9474
2020-11-17;"Bratislavský kraj";108;928;23;951;NA;341272;131;2020-11-17;9281
2020-11-16;"Bratislavský kraj";82;651;9;660;NA;341272;91;2020-11-16;9150
2020-11-15;"Bratislavský kraj";47;236;0;236;NA;341272;47;2020-11-15;9059
2020-11-14;"Bratislavský kraj";53;1834;15;1849;NA;341272;68;2020-11-14;9012
2020-11-13;"Bratislavský kraj";94;2096;21;2117;NA;341272;115;2020-11-13;8944
2020-11-12;"Bratislavský kraj";141;1727;6;1733;NA;341272;147;2020-11-12;8829
2020-11-11;"Bratislavský kraj";159;1429;12;1441;NA;341272;171;2020-11-11;8682
2020-11-10;"Bratislavský kraj";136;805;14;819;NA;341272;150;2020-11-10;8511
2020-11-09;"Bratislavský kraj";70;616;8;624;NA;341272;78;2020-11-09;8361
2020-11-08;"Bratislavský kraj";82;869;6;875;NA;341272;88;2020-11-08;8283
2020-11-07;"Bratislavský kraj";88;4039;17;4056;NA;341272;105;2020-11-07;8195
2020-11-06;"Bratislavský kraj";281;6441;25;6466;NA;341272;306;2020-11-06;8090
2020-11-05;"Bratislavský kraj";175;476;11;487;NA;341272;186;2020-11-05;7784
2020-11-04;"Bratislavský kraj";65;411;10;421;NA;341272;75;2020-11-04;7598
2020-11-03;"Bratislavský kraj";251;1085;12;1097;NA;341272;263;2020-11-03;7523
2020-11-02;"Bratislavský kraj";202;3365;22;3387;NA;341272;224;2020-11-02;7260
2020-11-01;"Bratislavský kraj";227;8694;39;8733;NA;341272;266;2020-11-01;7036
2020-10-31;"Bratislavský kraj";173;22407;123;22530;NA;341272;296;2020-10-31;6770
2020-10-30;"Bratislavský kraj";158;17350;138;17488;NA;341272;296;2020-10-30;6474
2020-10-29;"Bratislavský kraj";262;116;4;120;NA;341272;266;2020-10-29;6178
2020-10-28;"Bratislavský kraj";220;260;15;275;NA;341272;235;2020-10-28;5912
2020-10-27;"Bratislavský kraj";256;145;4;149;NA;341272;260;2020-10-27;5677
2020-10-26;"Bratislavský kraj";123;229;11;240;NA;341272;134;2020-10-26;5417
2020-10-25;"Bratislavský kraj";152;33;2;35;NA;341272;154;2020-10-25;5283
2020-10-24;"Bratislavský kraj";170;221;6;227;NA;341272;176;2020-10-24;5129
2020-10-23;"Bratislavský kraj";151;144;8;152;NA;341272;159;2020-10-23;4953
2020-10-22;"Bratislavský kraj";192;204;15;219;NA;341272;207;2020-10-22;4794
2020-10-21;"Bratislavský kraj";66;90;6;96;NA;341272;72;2020-10-21;4587
2020-10-20;"Bratislavský kraj";183;97;4;101;NA;341272;187;2020-10-20;4515
2020-10-19;"Bratislavský kraj";148;80;3;83;NA;341272;151;2020-10-19;4328
2020-10-18;"Bratislavský kraj";75;92;0;92;NA;341272;75;2020-10-18;4177
2020-10-17;"Bratislavský kraj";136;0;0;0;NA;341272;136;2020-10-17;4102
2020-10-16;"Bratislavský kraj";103;14;1;15;NA;341272;104;2020-10-16;3966
2020-10-15;"Bratislavský kraj";135;6;1;7;NA;341272;136;2020-10-15;3862
2020-10-14;"Bratislavský kraj";127;4;0;4;NA;341272;127;2020-10-14;3726
2020-10-13;"Bratislavský kraj";86;108;8;116;NA;341272;94;2020-10-13;3599
2020-10-12;"Bratislavský kraj";46;0;0;0;NA;341272;46;2020-10-12;3505
2020-10-11;"Bratislavský kraj";80;0;0;0;NA;341272;80;2020-10-11;3459
2020-10-10;"Bratislavský kraj";55;0;0;0;NA;341272;55;2020-10-10;3379
2020-10-09;"Bratislavský kraj";148;0;0;0;NA;341272;148;2020-10-09;3324
2020-10-08;"Bratislavský kraj";100;0;0;0;NA;341272;100;2020-10-08;3176
2020-10-07;"Bratislavský kraj";107;0;0;0;NA;341272;107;2020-10-07;3076
2020-10-06;"Bratislavský kraj";108;0;0;0;NA;341272;108;2020-10-06;2969
2020-10-05;"Bratislavský kraj";30;0;0;0;NA;341272;30;2020-10-05;2861
2020-10-04;"Bratislavský kraj";49;0;0;0;NA;341272;49;2020-10-04;2831
2020-10-03;"Bratislavský kraj";82;0;0;0;NA;341272;82;2020-10-03;2782
2020-10-02;"Bratislavský kraj";101;0;0;0;NA;341272;101;2020-10-02;2700
2020-10-01;"Bratislavský kraj";72;0;0;0;NA;341272;72;2020-10-01;2599
2020-09-30;"Bratislavský kraj";91;0;0;0;NA;341272;91;2020-09-30;2527
2020-09-29;"Bratislavský kraj";74;0;0;0;NA;341272;74;2020-09-29;2436
2020-09-28;"Bratislavský kraj";29;0;0;0;NA;341272;29;2020-09-28;2362
2020-09-27;"Bratislavský kraj";48;0;0;0;NA;341272;48;2020-09-27;2333
2020-09-26;"Bratislavský kraj";86;0;0;0;NA;341272;86;2020-09-26;2285
2020-09-25;"Bratislavský kraj";97;0;0;0;NA;341272;97;2020-09-25;2199
2020-09-24;"Bratislavský kraj";73;0;0;0;NA;341272;73;2020-09-24;2102
2020-09-23;"Bratislavský kraj";55;0;0;0;NA;341272;55;2020-09-23;2029
2020-09-22;"Bratislavský kraj";81;0;0;0;NA;341272;81;2020-09-22;1974
2020-09-21;"Bratislavský kraj";32;0;0;0;NA;341272;32;2020-09-21;1893
2020-09-20;"Bratislavský kraj";25;0;0;0;NA;341272;25;2020-09-20;1861
2020-09-19;"Bratislavský kraj";59;0;0;0;NA;341272;59;2020-09-19;1836
2020-09-18;"Bratislavský kraj";42;0;0;0;NA;341272;42;2020-09-18;1777
2020-09-17;"Bratislavský kraj";52;0;0;0;NA;341272;52;2020-09-17;1735
2020-09-16;"Bratislavský kraj";32;0;0;0;NA;341272;32;2020-09-16;1683
2020-09-15;"Bratislavský kraj";26;0;0;0;NA;341272;26;2020-09-15;1651
2020-09-14;"Bratislavský kraj";24;0;0;0;NA;341272;24;2020-09-14;1625
2020-09-13;"Bratislavský kraj";11;0;0;0;NA;341272;11;2020-09-13;1601
2020-09-12;"Bratislavský kraj";24;0;0;0;NA;341272;24;2020-09-12;1590
2020-09-11;"Bratislavský kraj";50;0;0;0;NA;341272;50;2020-09-11;1566
2020-09-10;"Bratislavský kraj";47;0;0;0;NA;341272;47;2020-09-10;1516
2020-09-09;"Bratislavský kraj";40;0;0;0;NA;341272;40;2020-09-09;1469
2020-09-08;"Bratislavský kraj";58;0;0;0;NA;341272;58;2020-09-08;1429
2020-09-07;"Bratislavský kraj";39;0;0;0;NA;341272;39;2020-09-07;1371
2020-09-06;"Bratislavský kraj";11;0;0;0;NA;341272;11;2020-09-06;1332
2020-09-05;"Bratislavský kraj";37;0;0;0;NA;341272;37;2020-09-05;1321
2020-09-04;"Bratislavský kraj";87;0;0;0;NA;341272;87;2020-09-04;1284
2020-09-03;"Bratislavský kraj";51;0;0;0;NA;341272;51;2020-09-03;1197
2020-09-02;"Bratislavský kraj";50;0;0;0;NA;341272;50;2020-09-02;1146
2020-09-01;"Bratislavský kraj";16;0;0;0;NA;341272;16;2020-09-01;1096
2020-08-31;"Bratislavský kraj";19;0;0;0;NA;341272;19;2020-08-31;1080
2020-08-30;"Bratislavský kraj";9;0;0;0;NA;341272;9;2020-08-30;1061
2020-08-29;"Bratislavský kraj";12;0;0;0;NA;341272;12;2020-08-29;1052
2020-08-28;"Bratislavský kraj";35;0;0;0;NA;341272;35;2020-08-28;1040
2020-08-27;"Bratislavský kraj";33;0;0;0;NA;341272;33;2020-08-27;1005
2020-08-26;"Bratislavský kraj";27;0;0;0;NA;341272;27;2020-08-26;972
2020-08-25;"Bratislavský kraj";29;0;0;0;NA;341272;29;2020-08-25;945
2020-08-24;"Bratislavský kraj";6;0;0;0;NA;341272;6;2020-08-24;916
2020-08-23;"Bratislavský kraj";45;0;0;0;NA;341272;45;2020-08-23;910
2020-08-22;"Bratislavský kraj";13;0;0;0;NA;341272;13;2020-08-22;865
2020-08-21;"Bratislavský kraj";46;0;0;0;NA;341272;46;2020-08-21;852
2020-08-20;"Bratislavský kraj";41;0;0;0;NA;341272;41;2020-08-20;806
2020-08-19;"Bratislavský kraj";27;0;0;0;NA;341272;27;2020-08-19;765
2020-08-18;"Bratislavský kraj";47;0;0;0;NA;341272;47;2020-08-18;738
2020-08-17;"Bratislavský kraj";2;0;0;0;NA;341272;2;2020-08-17;691
2020-08-16;"Bratislavský kraj";3;0;0;0;NA;341272;3;2020-08-16;689
2020-08-15;"Bratislavský kraj";18;0;0;0;NA;341272;18;2020-08-15;686
2020-08-14;"Bratislavský kraj";16;0;0;0;NA;341272;16;2020-08-14;668
2020-08-13;"Bratislavský kraj";12;0;0;0;NA;341272;12;2020-08-13;652
2020-08-12;"Bratislavský kraj";10;0;0;0;NA;341272;10;2020-08-12;640
2020-08-11;"Bratislavský kraj";23;0;0;0;NA;341272;23;2020-08-11;630
2020-08-10;"Bratislavský kraj";2;0;0;0;NA;341272;2;2020-08-10;607
2020-08-09;"Bratislavský kraj";2;0;0;0;NA;341272;2;2020-08-09;605
2020-08-08;"Bratislavský kraj";1;0;0;0;NA;341272;1;2020-08-08;603
2020-08-07;"Bratislavský kraj";9;0;0;0;NA;341272;9;2020-08-07;602
2020-08-06;"Bratislavský kraj";15;0;0;0;NA;341272;15;2020-08-06;593
2020-08-05;"Bratislavský kraj";11;0;0;0;NA;341272;11;2020-08-05;578
2020-08-04;"Bratislavský kraj";21;0;0;0;NA;341272;21;2020-08-04;567
2020-08-03;"Bratislavský kraj";7;0;0;0;NA;341272;7;2020-08-03;546
2020-08-02;"Bratislavský kraj";0;0;0;0;NA;341272;0;2020-08-02;539
2020-08-01;"Bratislavský kraj";0;0;0;0;NA;341272;0;2020-08-01;539
2020-07-31;"Bratislavský kraj";14;0;0;0;NA;341272;14;2020-07-31;539
2020-07-30;"Bratislavský kraj";6;0;0;0;NA;341272;6;2020-07-30;525
2020-07-29;"Bratislavský kraj";7;0;0;0;NA;341272;7;2020-07-29;519
2020-07-28;"Bratislavský kraj";14;0;0;0;NA;341272;14;2020-07-28;512
2020-07-27;"Bratislavský kraj";3;0;0;0;NA;341272;3;2020-07-27;498
2020-07-26;"Bratislavský kraj";0;0;0;0;NA;341272;0;2020-07-26;495
2020-07-25;"Bratislavský kraj";8;0;0;0;NA;341272;8;2020-07-25;495
2020-07-24;"Bratislavský kraj";2;0;0;0;NA;341272;2;2020-07-24;487
2020-07-23;"Bratislavský kraj";8;0;0;0;NA;341272;8;2020-07-23;485
2020-07-22;"Bratislavský kraj";11;0;0;0;NA;341272;11;2020-07-22;477
2020-07-21;"Bratislavský kraj";8;0;0;0;NA;341272;8;2020-07-21;466
2020-07-20;"Bratislavský kraj";12;0;0;0;NA;341272;12;2020-07-20;458
2020-07-19;"Bratislavský kraj";0;0;0;0;NA;341272;0;2020-07-19;446
2020-07-18;"Bratislavský kraj";2;0;0;0;NA;341272;2;2020-07-18;446
2020-07-17;"Bratislavský kraj";2;0;0;0;NA;341272;2;2020-07-17;444
2020-07-16;"Bratislavský kraj";6;0;0;0;NA;341272;6;2020-07-16;442
2020-07-15;"Bratislavský kraj";3;0;0;0;NA;341272;3;2020-07-15;436
2020-07-14;"Bratislavský kraj";2;0;0;0;NA;341272;2;2020-07-14;433
2020-07-13;"Bratislavský kraj";2;0;0;0;NA;341272;2;2020-07-13;431
2020-07-12;"Bratislavský kraj";0;0;0;0;NA;341272;0;2020-07-12;429
2020-07-11;"Bratislavský kraj";0;0;0;0;NA;341272;0;2020-07-11;429
2020-07-10;"Bratislavský kraj";8;0;0;0;NA;341272;8;2020-07-10;429
2020-07-09;"Bratislavský kraj";2;0;0;0;NA;341272;2;2020-07-09;421
2020-07-08;"Bratislavský kraj";11;0;0;0;NA;341272;11;2020-07-08;419
2020-07-07;"Bratislavský kraj";5;0;0;0;NA;341272;5;2020-07-07;408
2020-07-06;"Bratislavský kraj";1;0;0;0;NA;341272;1;2020-07-06;403
2020-07-05;"Bratislavský kraj";0;0;0;0;NA;341272;0;2020-07-05;402
2020-07-04;"Bratislavský kraj";3;0;0;0;NA;341272;3;2020-07-04;402
2020-07-03;"Bratislavský kraj";1;0;0;0;NA;341272;1;2020-07-03;399
2020-07-02;"Bratislavský kraj";0;0;0;0;NA;341272;0;2020-07-02;398
2020-07-01;"Bratislavský kraj";7;0;0;0;NA;341272;7;2020-07-01;398
2020-06-30;"Bratislavský kraj";3;0;0;0;NA;341272;3;2020-06-30;391
2020-06-29;"Bratislavský kraj";1;0;0;0;NA;341272;1;2020-06-29;388
2020-06-28;"Bratislavský kraj";0;0;0;0;NA;341272;0;2020-06-28;387
2020-06-27;"Bratislavský kraj";1;0;0;0;NA;341272;1;2020-06-27;387
2020-06-26;"Bratislavský kraj";6;0;0;0;NA;341272;6;2020-06-26;386
2020-06-25;"Bratislavský kraj";0;0;0;0;NA;341272;0;2020-06-25;380
2020-06-24;"Bratislavský kraj";3;0;0;0;NA;341272;3;2020-06-24;380
2020-06-23;"Bratislavský kraj";0;0;0;0;NA;341272;0;2020-06-23;377
2020-06-22;"Bratislavský kraj";1;0;0;0;NA;341272;1;2020-06-22;377
2020-06-21;"Bratislavský kraj";0;0;0;0;NA;341272;0;2020-06-21;376
2020-06-20;"Bratislavský kraj";0;0;0;0;NA;341272;0;2020-06-20;376
2020-06-19;"Bratislavský kraj";3;0;0;0;NA;341272;3;2020-06-19;376
2020-06-18;"Bratislavský kraj";0;0;0;0;NA;341272;0;2020-06-18;373
2020-06-17;"Bratislavský kraj";0;0;0;0;NA;341272;0;2020-06-17;373
2020-06-16;"Bratislavský kraj";0;0;0;0;NA;341272;0;2020-06-16;373
2020-06-14;"Bratislavský kraj";2;0;0;0;NA;341272;2;2020-06-14;373
2020-06-13;"Bratislavský kraj";1;0;0;0;NA;341272;1;2020-06-13;371
2020-06-12;"Bratislavský kraj";2;0;0;0;NA;341272;2;2020-06-12;370
2020-06-11;"Bratislavský kraj";0;0;0;0;NA;341272;0;2020-06-11;368
2020-06-10;"Bratislavský kraj";0;0;0;0;NA;341272;0;2020-06-10;368
2020-06-09;"Bratislavský kraj";0;0;0;0;NA;341272;0;2020-06-09;368
2020-06-08;"Bratislavský kraj";1;0;0;0;NA;341272;1;2020-06-08;368
2020-06-07;"Bratislavský kraj";0;0;0;0;NA;341272;0;2020-06-07;367
2020-06-05;"Bratislavský kraj";0;0;0;0;NA;341272;0;2020-06-05;367
2020-06-03;"Bratislavský kraj";1;0;0;0;NA;341272;1;2020-06-03;367
2020-06-02;"Bratislavský kraj";0;0;0;0;NA;341272;0;2020-06-02;366
2020-05-31;"Bratislavský kraj";0;0;0;0;NA;341272;0;2020-05-31;366
2020-05-29;"Bratislavský kraj";0;0;0;0;NA;341272;0;2020-05-29;366
2020-05-27;"Bratislavský kraj";1;0;0;0;NA;341272;1;2020-05-27;366
2020-05-26;"Bratislavský kraj";0;0;0;0;NA;341272;0;2020-05-26;365
2020-05-25;"Bratislavský kraj";0;0;0;0;NA;341272;0;2020-05-25;365
2020-05-24;"Bratislavský kraj";0;0;0;0;NA;341272;0;2020-05-24;365
2020-05-23;"Bratislavský kraj";2;0;0;0;NA;341272;2;2020-05-23;365
2020-05-22;"Bratislavský kraj";0;0;0;0;NA;341272;0;2020-05-22;363
2020-05-21;"Bratislavský kraj";0;0;0;0;NA;341272;0;2020-05-21;363
2020-05-20;"Bratislavský kraj";0;0;0;0;NA;341272;0;2020-05-20;363
2020-05-19;"Bratislavský kraj";0;0;0;0;NA;341272;0;2020-05-19;363
2020-05-17;"Bratislavský kraj";0;0;0;0;NA;341272;0;2020-05-17;363
2020-05-16;"Bratislavský kraj";0;0;0;0;NA;341272;0;2020-05-16;363
2020-05-15;"Bratislavský kraj";0;0;0;0;NA;341272;0;2020-05-15;363
2020-05-14;"Bratislavský kraj";0;0;0;0;NA;341272;0;2020-05-14;363
2020-05-13;"Bratislavský kraj";0;0;0;0;NA;341272;0;2020-05-13;363
2020-05-12;"Bratislavský kraj";2;0;0;0;NA;341272;2;2020-05-12;363
2020-05-11;"Bratislavský kraj";0;0;0;0;NA;341272;0;2020-05-11;361
2020-05-09;"Bratislavský kraj";0;0;0;0;NA;341272;0;2020-05-09;361
2020-05-07;"Bratislavský kraj";1;0;0;0;NA;341272;1;2020-05-07;361
2020-05-06;"Bratislavský kraj";3;0;0;0;NA;341272;3;2020-05-06;360
2020-05-05;"Bratislavský kraj";0;0;0;0;NA;341272;0;2020-05-05;357
2020-05-04;"Bratislavský kraj";0;0;0;0;NA;341272;0;2020-05-04;357
2020-05-03;"Bratislavský kraj";2;0;0;0;NA;341272;2;2020-05-03;357
2020-05-02;"Bratislavský kraj";0;0;0;0;NA;341272;0;2020-05-02;355
2020-05-01;"Bratislavský kraj";0;0;0;0;NA;341272;0;2020-05-01;355
2020-04-30;"Bratislavský kraj";5;0;0;0;NA;341272;5;2020-04-30;355
2020-04-29;"Bratislavský kraj";0;0;0;0;NA;341272;0;2020-04-29;350
2020-04-28;"Bratislavský kraj";2;0;0;0;NA;341272;2;2020-04-28;350
2020-04-27;"Bratislavský kraj";0;0;0;0;NA;341272;0;2020-04-27;348
2020-04-26;"Bratislavský kraj";1;0;0;0;NA;341272;1;2020-04-26;348
2020-04-25;"Bratislavský kraj";0;0;0;0;NA;341272;0;2020-04-25;347
2020-04-24;"Bratislavský kraj";2;0;0;0;NA;341272;2;2020-04-24;347
2020-04-23;"Bratislavský kraj";6;0;0;0;NA;341272;6;2020-04-23;345
2020-04-22;"Bratislavský kraj";11;0;0;0;NA;341272;11;2020-04-22;339
2020-04-21;"Bratislavský kraj";4;0;0;0;NA;341272;4;2020-04-21;328
2020-04-20;"Bratislavský kraj";0;0;0;0;NA;341272;0;2020-04-20;324
2020-04-19;"Bratislavský kraj";4;0;0;0;NA;341272;4;2020-04-19;324
2020-04-18;"Bratislavský kraj";5;0;0;0;NA;341272;5;2020-04-18;320
2020-04-17;"Bratislavský kraj";6;0;0;0;NA;341272;6;2020-04-17;315
2020-04-16;"Bratislavský kraj";15;0;0;0;NA;341272;15;2020-04-16;309
2020-04-15;"Bratislavský kraj";11;0;0;0;NA;341272;11;2020-04-15;294
2020-04-14;"Bratislavský kraj";19;0;0;0;NA;341272;19;2020-04-14;283
2020-04-13;"Bratislavský kraj";53;0;0;0;NA;341272;53;2020-04-13;264
2020-04-12;"Bratislavský kraj";3;0;0;0;NA;341272;3;2020-04-12;211
2020-04-11;"Bratislavský kraj";1;0;0;0;NA;341272;1;2020-04-11;208
2020-04-10;"Bratislavský kraj";8;0;0;0;NA;341272;8;2020-04-10;207
2020-04-09;"Bratislavský kraj";3;0;0;0;NA;341272;3;2020-04-09;199
2020-04-08;"Bratislavský kraj";3;0;0;0;NA;341272;3;2020-04-08;196
2020-04-07;"Bratislavský kraj";24;0;0;0;NA;341272;24;2020-04-07;193
2020-04-06;"Bratislavský kraj";5;0;0;0;NA;341272;5;2020-04-06;169
2020-04-05;"Bratislavský kraj";6;0;0;0;NA;341272;6;2020-04-05;164
2020-04-04;"Bratislavský kraj";2;0;0;0;NA;341272;2;2020-04-04;158
2020-04-03;"Bratislavský kraj";1;0;0;0;NA;341272;1;2020-04-03;156
2020-04-02;"Bratislavský kraj";2;0;0;0;NA;341272;2;2020-04-02;155
2020-04-01;"Bratislavský kraj";5;0;0;0;NA;341272;5;2020-04-01;153
2020-03-31;"Bratislavský kraj";19;0;0;0;NA;341272;19;2020-03-31;148
2020-03-30;"Bratislavský kraj";6;0;0;0;NA;341272;6;2020-03-30;129
2020-03-29;"Bratislavský kraj";8;0;0;0;NA;341272;8;2020-03-29;123
2020-03-28;"Bratislavský kraj";4;0;0;0;NA;341272;4;2020-03-28;115
2020-03-27;"Bratislavský kraj";3;0;0;0;NA;341272;3;2020-03-27;111
2020-03-26;"Bratislavský kraj";15;0;0;0;NA;341272;15;2020-03-26;108
2020-03-25;"Bratislavský kraj";1;0;0;0;NA;341272;1;2020-03-25;93
2020-03-24;"Bratislavský kraj";4;0;0;0;NA;341272;4;2020-03-24;92
2020-03-23;"Bratislavský kraj";9;0;0;0;NA;341272;9;2020-03-23;88
2020-03-22;"Bratislavský kraj";2;0;0;0;NA;341272;2;2020-03-22;79
2020-03-21;"Bratislavský kraj";22;0;0;0;NA;341272;22;2020-03-21;77
2020-03-20;"Bratislavský kraj";3;0;0;0;NA;341272;3;2020-03-20;55
2020-03-19;"Bratislavský kraj";4;0;0;0;NA;341272;4;2020-03-19;52
2020-03-18;"Bratislavský kraj";3;0;0;0;NA;341272;3;2020-03-18;48
2020-03-17;"Bratislavský kraj";13;0;0;0;NA;341272;13;2020-03-17;45
2020-03-16;"Bratislavský kraj";1;0;0;0;NA;341272;1;2020-03-16;32
2020-03-15;"Bratislavský kraj";4;0;0;0;NA;341272;4;2020-03-15;31
2020-03-14;"Bratislavský kraj";9;0;0;0;NA;341272;9;2020-03-14;27
2020-03-13;"Bratislavský kraj";2;0;0;0;NA;341272;2;2020-03-13;18
2020-03-12;"Bratislavský kraj";8;0;0;0;NA;341272;8;2020-03-12;16
2020-03-11;"Bratislavský kraj";3;0;0;0;NA;341272;3;2020-03-11;8
2020-03-09;"Bratislavský kraj";0;0;0;0;NA;341272;0;2020-03-09;5
2020-03-08;"Bratislavský kraj";2;0;0;0;NA;341272;2;2020-03-08;5
2020-03-07;"Bratislavský kraj";2;0;0;0;NA;341272;2;2020-03-07;3
2020-03-06;"Bratislavský kraj";1;0;0;0;NA;341272;1;2020-03-06;1
2022-04-25;"Košický kraj";208;0;0;0;234290;343484;208;2022-04-25;343484
2022-04-24;"Košický kraj";43;114;15;129;NA;343484;58;2022-04-24;343276
2022-04-23;"Košický kraj";183;260;19;279;NA;343484;202;2022-04-23;343218
2022-04-22;"Košický kraj";237;740;45;785;NA;343484;282;2022-04-22;343016
2022-04-21;"Košický kraj";169;1547;108;1655;NA;343484;277;2022-04-21;342734
2022-04-20;"Košický kraj";331;1775;88;1863;NA;343484;419;2022-04-20;342457
2022-04-19;"Košický kraj";306;2550;178;2728;NA;343484;484;2022-04-19;342038
2022-04-18;"Košický kraj";63;715;60;775;NA;343484;123;2022-04-18;341554
2022-04-17;"Košický kraj";163;305;32;337;NA;343484;195;2022-04-17;341431
2022-04-16;"Košický kraj";129;540;88;628;NA;343484;217;2022-04-16;341236
2022-04-15;"Košický kraj";65;410;25;435;NA;343484;90;2022-04-15;341019
2022-04-14;"Košický kraj";364;1666;103;1769;NA;343484;467;2022-04-14;340929
2022-04-13;"Košický kraj";417;1865;103;1968;NA;343484;520;2022-04-13;340462
2022-04-12;"Košický kraj";254;1690;135;1825;NA;343484;389;2022-04-12;339942
2022-04-11;"Košický kraj";418;2737;179;2916;NA;343484;597;2022-04-11;339553
2022-04-10;"Košický kraj";164;777;66;843;NA;343484;230;2022-04-10;338956
2022-04-09;"Košický kraj";210;623;55;678;NA;343484;265;2022-04-09;338726
2022-04-08;"Košický kraj";373;1688;144;1832;NA;343484;517;2022-04-08;338461
2022-04-07;"Košický kraj";428;2157;170;2327;NA;343484;598;2022-04-07;337944
2022-04-06;"Košický kraj";580;1816;163;1979;NA;343484;743;2022-04-06;337346
2022-04-05;"Košický kraj";721;1776;179;1955;NA;343484;900;2022-04-05;336603
2022-04-04;"Košický kraj";694;2981;313;3294;NA;343484;1007;2022-04-04;335703
2022-04-03;"Košický kraj";208;836;130;966;NA;343484;338;2022-04-03;334696
2022-04-02;"Košický kraj";331;628;86;714;NA;343484;417;2022-04-02;334358
2022-04-01;"Košický kraj";714;1894;224;2118;NA;343484;938;2022-04-01;333941
2022-03-31;"Košický kraj";745;1899;205;2104;NA;343484;950;2022-03-31;333003
2022-03-30;"Košický kraj";1081;2171;241;2412;NA;343484;1322;2022-03-30;332053
2022-03-29;"Košický kraj";683;2337;310;2647;NA;343484;993;2022-03-29;330731
2022-03-28;"Košický kraj";886;3310;435;3745;NA;343484;1321;2022-03-28;329738
2022-03-27;"Košický kraj";355;1168;230;1398;NA;343484;585;2022-03-27;328417
2022-03-26;"Košický kraj";593;940;165;1105;NA;343484;758;2022-03-26;327832
2022-03-25;"Košický kraj";958;1831;316;2147;NA;343484;1274;2022-03-25;327074
2022-03-24;"Košický kraj";998;2433;328;2761;NA;343484;1326;2022-03-24;325800
2022-03-23;"Košický kraj";1143;2615;348;2963;NA;343484;1491;2022-03-23;324474
2022-03-22;"Košický kraj";1508;2766;378;3144;NA;343484;1886;2022-03-22;322983
2022-03-21;"Košický kraj";1241;3484;530;4014;NA;343484;1771;2022-03-21;321097
2022-03-20;"Košický kraj";199;1514;318;1832;NA;343484;517;2022-03-20;319326
2022-03-19;"Košický kraj";952;1133;241;1374;NA;343484;1193;2022-03-19;318809
2022-03-18;"Košický kraj";1382;2278;343;2621;NA;343484;1725;2022-03-18;317616
2022-03-17;"Košický kraj";1181;2717;358;3075;NA;343484;1539;2022-03-17;315891
2022-03-16;"Košický kraj";1631;4800;372;5172;NA;343484;2003;2022-03-16;314352
2022-03-15;"Košický kraj";1591;2889;436;3325;NA;343484;2027;2022-03-15;312349
2022-03-14;"Košický kraj";1424;3479;585;4064;NA;343484;2009;2022-03-14;310322
2022-03-13;"Košický kraj";565;1711;375;2086;NA;343484;940;2022-03-13;308313
2022-03-12;"Košický kraj";1227;1263;218;1481;NA;343484;1445;2022-03-12;307373
2022-03-11;"Košický kraj";1451;2815;513;3328;NA;343484;1964;2022-03-11;305928
2022-03-10;"Košický kraj";990;3158;406;3564;NA;343484;1396;2022-03-10;303964
2022-03-09;"Košický kraj";1545;3322;397;3719;NA;343484;1942;2022-03-09;302568
2022-03-08;"Košický kraj";1487;3633;441;4074;NA;343484;1928;2022-03-08;300626
2022-03-07;"Košický kraj";1347;4968;713;5681;NA;343484;2060;2022-03-07;298698
2022-03-06;"Košický kraj";297;1811;372;2183;NA;343484;669;2022-03-06;296638
2022-03-05;"Košický kraj";874;1317;264;1581;NA;343484;1138;2022-03-05;295969
2022-03-04;"Košický kraj";1255;3130;424;3554;NA;343484;1679;2022-03-04;294831
2022-03-03;"Košický kraj";1111;3543;433;3976;NA;343484;1544;2022-03-03;293152
2022-03-02;"Košický kraj";1458;3437;455;3892;NA;343484;1913;2022-03-02;291608
2022-03-01;"Košický kraj";1723;3720;487;4207;NA;343484;2210;2022-03-01;289695
2022-02-28;"Košický kraj";1345;5497;805;6302;NA;343484;2150;2022-02-28;287485
2022-02-27;"Košický kraj";465;2397;440;2837;NA;343484;905;2022-02-27;285335
2022-02-26;"Košický kraj";979;1348;329;1677;NA;343484;1308;2022-02-26;284430
2022-02-25;"Košický kraj";1691;3274;510;3784;NA;343484;2201;2022-02-25;283122
2022-02-24;"Košický kraj";1988;4033;594;4627;NA;343484;2582;2022-02-24;280921
2022-02-23;"Košický kraj";1787;4151;558;4709;NA;343484;2345;2022-02-23;278339
2022-02-22;"Košický kraj";2649;4695;660;5355;NA;343484;3309;2022-02-22;275994
2022-02-21;"Košický kraj";1646;6499;910;7409;NA;343484;2556;2022-02-21;272685
2022-02-20;"Košický kraj";577;2919;578;3497;NA;343484;1155;2022-02-20;270129
2022-02-19;"Košický kraj";1941;2169;409;2578;NA;343484;2350;2022-02-19;268974
2022-02-18;"Košický kraj";2210;4534;640;5174;NA;343484;2850;2022-02-18;266624
2022-02-17;"Košický kraj";2555;4668;675;5343;NA;343484;3230;2022-02-17;263774
2022-02-16;"Košický kraj";2153;5477;736;6213;NA;343484;2889;2022-02-16;260544
2022-02-15;"Košický kraj";2768;5507;830;6337;NA;343484;3598;2022-02-15;257655
2022-02-14;"Košický kraj";2337;8076;1104;9180;NA;343484;3441;2022-02-14;254057
2022-02-13;"Košický kraj";1235;4248;809;5057;NA;343484;2044;2022-02-13;250616
2022-02-12;"Košický kraj";1728;2014;524;2538;NA;343484;2252;2022-02-12;248572
2022-02-11;"Košický kraj";2665;4797;633;5430;NA;343484;3298;2022-02-11;246320
2022-02-10;"Košický kraj";2135;5323;728;6051;NA;343484;2863;2022-02-10;243022
2022-02-09;"Košický kraj";2067;5940;743;6683;NA;343484;2810;2022-02-09;240159
2022-02-08;"Košický kraj";2993;6143;762;6905;NA;343484;3755;2022-02-08;237349
2022-02-07;"Košický kraj";1939;7973;978;8951;NA;343484;2917;2022-02-07;233594
2022-02-06;"Košický kraj";998;4482;680;5162;NA;343484;1678;2022-02-06;230677
2022-02-05;"Košický kraj";2209;2454;434;2888;NA;343484;2643;2022-02-05;228999
2022-02-04;"Košický kraj";2563;5634;632;6266;NA;343484;3195;2022-02-04;226356
2022-02-03;"Košický kraj";1916;6379;659;7038;NA;343484;2575;2022-02-03;223161
2022-02-02;"Košický kraj";2498;6923;629;7552;NA;343484;3127;2022-02-02;220586
2022-02-01;"Košický kraj";2173;6706;678;7384;NA;343484;2851;2022-02-01;217459
2022-01-31;"Košický kraj";2020;9960;841;10801;NA;343484;2861;2022-01-31;214608
2022-01-30;"Košický kraj";1002;5716;541;6257;NA;343484;1543;2022-01-30;211747
2022-01-29;"Košický kraj";1731;2720;387;3107;NA;343484;2118;2022-01-29;210204
2022-01-28;"Košický kraj";1743;5571;492;6063;NA;343484;2235;2022-01-28;208086
2022-01-27;"Košický kraj";1553;5792;413;6205;NA;343484;1966;2022-01-27;205851
2022-01-26;"Košický kraj";1683;5613;399;6012;NA;343484;2082;2022-01-26;203885
2022-01-25;"Košický kraj";1409;6210;404;6614;NA;343484;1813;2022-01-25;201803
2022-01-24;"Košický kraj";1141;8669;431;9100;NA;343484;1572;2022-01-24;199990
2022-01-23;"Košický kraj";516;5418;287;5705;NA;343484;803;2022-01-23;198418
2022-01-22;"Košický kraj";914;2528;177;2705;NA;343484;1091;2022-01-22;197615
2022-01-21;"Košický kraj";589;5194;227;5421;NA;343484;816;2022-01-21;196524
2022-01-20;"Košický kraj";769;5379;200;5579;NA;343484;969;2022-01-20;195708
2022-01-19;"Košický kraj";629;5329;178;5507;NA;343484;807;2022-01-19;194739
2022-01-18;"Košický kraj";716;5758;140;5898;NA;343484;856;2022-01-18;193932
2022-01-17;"Košický kraj";486;9004;187;9191;NA;343484;673;2022-01-17;193076
2022-01-16;"Košický kraj";51;5264;137;5401;NA;343484;188;2022-01-16;192403
2022-01-15;"Košický kraj";422;2208;69;2277;NA;343484;491;2022-01-15;192215
2022-01-14;"Košický kraj";175;4208;93;4301;NA;343484;268;2022-01-14;191724
2022-01-13;"Košický kraj";165;4919;77;4996;NA;343484;242;2022-01-13;191456
2022-01-12;"Košický kraj";295;4609;78;4687;NA;343484;373;2022-01-12;191214
2022-01-11;"Košický kraj";349;5295;70;5365;NA;343484;419;2022-01-11;190841
2022-01-10;"Košický kraj";290;8254;128;8382;NA;343484;418;2022-01-10;190422
2022-01-09;"Košický kraj";230;5838;86;5924;NA;343484;316;2022-01-09;190004
2022-01-08;"Košický kraj";157;2417;57;2474;NA;343484;214;2022-01-08;189688
2022-01-07;"Košický kraj";388;5017;129;5146;NA;343484;517;2022-01-07;189474
2022-01-06;"Košický kraj";118;1576;55;1631;NA;343484;173;2022-01-06;188957
2022-01-05;"Košický kraj";354;5082;102;5184;NA;343484;456;2022-01-05;188784
2022-01-04;"Košický kraj";450;5273;84;5357;NA;343484;534;2022-01-04;188328
2022-01-03;"Košický kraj";439;7970;140;8110;NA;343484;579;2022-01-03;187794
2022-01-02;"Košický kraj";284;4614;109;4723;NA;343484;393;2022-01-02;187215
2022-01-01;"Košický kraj";28;360;18;378;NA;343484;46;2022-01-01;186822
2021-12-31;"Košický kraj";122;2999;86;3085;NA;343484;208;2021-12-31;186776
2021-12-30;"Košický kraj";401;3949;118;4067;NA;343484;519;2021-12-30;186568
2021-12-29;"Košický kraj";378;4194;111;4305;NA;343484;489;2021-12-29;186049
2021-12-28;"Košický kraj";509;4450;125;4575;NA;343484;634;2021-12-28;185560
2021-12-27;"Košický kraj";495;6822;205;7027;NA;343484;700;2021-12-27;184926
2021-12-26;"Košický kraj";109;2510;115;2625;NA;343484;224;2021-12-26;184226
2021-12-25;"Košický kraj";30;644;43;687;NA;343484;73;2021-12-25;184002
2021-12-24;"Košický kraj";95;1055;50;1105;NA;343484;145;2021-12-24;183929
2021-12-23;"Košický kraj";644;4479;131;4610;NA;343484;775;2021-12-23;183784
2021-12-22;"Košický kraj";224;4309;106;4415;NA;343484;330;2021-12-22;183009
2021-12-21;"Košický kraj";544;6491;138;6629;NA;343484;682;2021-12-21;182679
2021-12-20;"Košický kraj";464;8630;196;8826;NA;343484;660;2021-12-20;181997
2021-12-19;"Košický kraj";137;5447;177;5624;NA;343484;314;2021-12-19;181337
2021-12-18;"Košický kraj";414;2555;102;2657;NA;343484;516;2021-12-18;181023
2021-12-17;"Košický kraj";428;4832;145;4977;NA;343484;573;2021-12-17;180507
2021-12-16;"Košický kraj";476;5845;168;6013;NA;343484;644;2021-12-16;179934
2021-12-15;"Košický kraj";508;5956;172;6128;NA;343484;680;2021-12-15;179290
2021-12-14;"Košický kraj";957;5789;172;5961;NA;343484;1129;2021-12-14;178610
2021-12-13;"Košický kraj";679;9657;248;9905;NA;343484;927;2021-12-13;177481
2021-12-12;"Košický kraj";243;6657;198;6855;NA;343484;441;2021-12-12;176554
2021-12-11;"Košický kraj";519;2996;134;3130;NA;343484;653;2021-12-11;176113
2021-12-10;"Košický kraj";936;5465;185;5650;NA;343484;1121;2021-12-10;175460
2021-12-09;"Košický kraj";755;5779;198;5977;NA;343484;953;2021-12-09;174339
2021-12-08;"Košický kraj";1095;6574;275;6849;NA;343484;1370;2021-12-08;173386
2021-12-07;"Košický kraj";1212;6323;267;6590;NA;343484;1479;2021-12-07;172016
2021-12-06;"Košický kraj";904;10627;313;10940;NA;343484;1217;2021-12-06;170537
2021-12-05;"Košický kraj";404;7756;263;8019;NA;343484;667;2021-12-05;169320
2021-12-04;"Košický kraj";1007;3097;180;3277;NA;343484;1187;2021-12-04;168653
2021-12-03;"Košický kraj";1338;6065;271;6336;NA;343484;1609;2021-12-03;167466
2021-12-02;"Košický kraj";2209;5654;302;5956;NA;343484;2511;2021-12-02;165857
2021-12-01;"Košický kraj";1016;6483;388;6871;NA;343484;1404;2021-12-01;163346
2021-11-30;"Košický kraj";1125;8173;471;8644;NA;343484;1596;2021-11-30;161942
2021-11-29;"Košický kraj";993;14057;634;14691;NA;343484;1627;2021-11-29;160346
2021-11-28;"Košický kraj";972;10211;473;10684;NA;343484;1445;2021-11-28;158719
2021-11-27;"Košický kraj";1103;3566;219;3785;NA;343484;1322;2021-11-27;157274
2021-11-26;"Košický kraj";1395;6059;383;6442;NA;343484;1778;2021-11-26;155952
2021-11-25;"Košický kraj";1373;7016;499;7515;NA;343484;1872;2021-11-25;154174
2021-11-24;"Košický kraj";1194;7067;473;7540;NA;343484;1667;2021-11-24;152302
2021-11-23;"Košický kraj";1178;7185;488;7673;NA;343484;1666;2021-11-23;150635
2021-11-22;"Košický kraj";861;10709;741;11450;NA;343484;1602;2021-11-22;148969
2021-11-21;"Košický kraj";985;7394;657;8051;NA;343484;1642;2021-11-21;147367
2021-11-20;"Košický kraj";1083;2859;295;3154;NA;343484;1378;2021-11-20;145725
2021-11-19;"Košický kraj";1078;7543;516;8059;NA;343484;1594;2021-11-19;144347
2021-11-18;"Košický kraj";1061;9410;719;10129;NA;343484;1780;2021-11-18;142753
2021-11-17;"Košický kraj";1319;2824;262;3086;NA;343484;1581;2021-11-17;140973
2021-11-16;"Košický kraj";1484;7135;543;7678;NA;343484;2027;2021-11-16;139392
2021-11-15;"Košický kraj";902;10812;754;11566;NA;343484;1656;2021-11-15;137365
2021-11-14;"Košický kraj";715;5756;455;6211;NA;343484;1170;2021-11-14;135709
2021-11-13;"Košický kraj";869;2686;312;2998;NA;343484;1181;2021-11-13;134539
2021-11-12;"Košický kraj";1132;5616;410;6026;NA;343484;1542;2021-11-12;133358
2021-11-11;"Košický kraj";1035;6139;460;6599;NA;343484;1495;2021-11-11;131816
2021-11-10;"Košický kraj";933;6633;497;7130;NA;343484;1430;2021-11-10;130321
2021-11-09;"Košický kraj";967;5540;389;5929;NA;343484;1356;2021-11-09;128891
2021-11-08;"Košický kraj";701;7838;601;8439;NA;343484;1302;2021-11-08;127535
2021-11-07;"Košický kraj";691;4578;425;5003;NA;343484;1116;2021-11-07;126233
2021-11-06;"Košický kraj";996;2276;217;2493;NA;343484;1213;2021-11-06;125117
2021-11-05;"Košický kraj";1029;4905;367;5272;NA;343484;1396;2021-11-05;123904
2021-11-04;"Košický kraj";1000;5354;360;5714;NA;343484;1360;2021-11-04;122508
2021-11-03;"Košický kraj";1051;5749;361;6110;NA;343484;1412;2021-11-03;121148
2021-11-02;"Košický kraj";915;8775;566;9341;NA;343484;1481;2021-11-02;119736
2021-11-01;"Košický kraj";181;1999;265;2264;NA;343484;446;2021-11-01;118255
2021-10-31;"Košický kraj";385;2337;227;2564;NA;343484;612;2021-10-31;117809
2021-10-30;"Košický kraj";641;2380;180;2560;NA;343484;821;2021-10-30;117197
2021-10-29;"Košický kraj";750;4608;289;4897;NA;343484;1039;2021-10-29;116376
2021-10-28;"Košický kraj";823;5115;255;5370;NA;343484;1078;2021-10-28;115337
2021-10-27;"Košický kraj";723;4831;259;5090;NA;343484;982;2021-10-27;114259
2021-10-26;"Košický kraj";618;5049;225;5274;NA;343484;843;2021-10-26;113277
2021-10-25;"Košický kraj";268;6747;292;7039;NA;343484;560;2021-10-25;112434
2021-10-24;"Košický kraj";170;3447;205;3652;NA;343484;375;2021-10-24;111874
2021-10-23;"Košický kraj";397;1953;86;2039;NA;343484;483;2021-10-23;111499
2021-10-22;"Košický kraj";474;4679;130;4809;NA;343484;604;2021-10-22;111016
2021-10-21;"Košický kraj";669;5094;172;5266;NA;343484;841;2021-10-21;110412
2021-10-20;"Košický kraj";398;4963;152;5115;NA;343484;550;2021-10-20;109571
2021-10-19;"Košický kraj";579;4870;161;5031;NA;343484;740;2021-10-19;109021
2021-10-18;"Košický kraj";180;7090;171;7261;NA;343484;351;2021-10-18;108281
2021-10-17;"Košický kraj";70;3614;125;3739;NA;343484;195;2021-10-17;107930
2021-10-16;"Košický kraj";312;1839;40;1879;NA;343484;352;2021-10-16;107735
2021-10-15;"Košický kraj";312;4530;77;4607;NA;343484;389;2021-10-15;107383
2021-10-14;"Košický kraj";327;4652;95;4747;NA;343484;422;2021-10-14;106994
2021-10-13;"Košický kraj";168;4168;88;4256;NA;343484;256;2021-10-13;106572
2021-10-12;"Košický kraj";391;4119;75;4194;NA;343484;466;2021-10-12;106316
2021-10-11;"Košický kraj";119;6351;121;6472;NA;343484;240;2021-10-11;105850
2021-10-10;"Košický kraj";104;2921;63;2984;NA;343484;167;2021-10-10;105610
2021-10-09;"Košický kraj";111;1687;43;1730;NA;343484;154;2021-10-09;105443
2021-10-08;"Košický kraj";274;4143;68;4211;NA;343484;342;2021-10-08;105289
2021-10-07;"Košický kraj";277;4399;74;4473;NA;343484;351;2021-10-07;104947
2021-10-06;"Košický kraj";178;4369;89;4458;NA;343484;267;2021-10-06;104596
2021-10-05;"Košický kraj";345;4542;78;4620;NA;343484;423;2021-10-05;104329
2021-10-04;"Košický kraj";122;6094;110;6204;NA;343484;232;2021-10-04;103906
2021-10-03;"Košický kraj";133;3176;74;3250;NA;343484;207;2021-10-03;103674
2021-10-02;"Košický kraj";124;2567;41;2608;NA;343484;165;2021-10-02;103467
2021-10-01;"Košický kraj";181;4251;73;4324;NA;343484;254;2021-10-01;103302
2021-09-30;"Košický kraj";244;4780;71;4851;NA;343484;315;2021-09-30;103048
2021-09-29;"Košický kraj";183;3824;64;3888;NA;343484;247;2021-09-29;102733
2021-09-28;"Košický kraj";303;4339;80;4419;NA;343484;383;2021-09-28;102486
2021-09-27;"Košický kraj";117;6358;77;6435;NA;343484;194;2021-09-27;102103
2021-09-26;"Košický kraj";13;2809;44;2853;NA;343484;57;2021-09-26;101909
2021-09-25;"Košický kraj";162;2521;35;2556;NA;343484;197;2021-09-25;101852
2021-09-24;"Košický kraj";183;4756;43;4799;NA;343484;226;2021-09-24;101655
2021-09-23;"Košický kraj";142;3880;51;3931;NA;343484;193;2021-09-23;101429
2021-09-22;"Košický kraj";151;4436;52;4488;NA;343484;203;2021-09-22;101236
2021-09-21;"Košický kraj";234;4441;44;4485;NA;343484;278;2021-09-21;101033
2021-09-20;"Košický kraj";158;6017;73;6090;NA;343484;231;2021-09-20;100755
2021-09-19;"Košický kraj";15;2487;30;2517;NA;343484;45;2021-09-19;100524
2021-09-18;"Košický kraj";187;2504;24;2528;NA;343484;211;2021-09-18;100479
2021-09-17;"Košický kraj";121;4797;41;4838;NA;343484;162;2021-09-17;100268
2021-09-16;"Košický kraj";228;4503;71;4574;NA;343484;299;2021-09-16;100106
2021-09-15;"Košický kraj";52;989;16;1005;NA;343484;68;2021-09-15;99807
2021-09-14;"Košický kraj";142;3456;47;3503;NA;343484;189;2021-09-14;99739
2021-09-13;"Košický kraj";96;4949;48;4997;NA;343484;144;2021-09-13;99550
2021-09-12;"Košický kraj";14;2003;31;2034;NA;343484;45;2021-09-12;99406
2021-09-11;"Košický kraj";105;2186;19;2205;NA;343484;124;2021-09-11;99361
2021-09-10;"Košický kraj";125;4293;42;4335;NA;343484;167;2021-09-10;99237
2021-09-09;"Košický kraj";115;3226;30;3256;NA;343484;145;2021-09-09;99070
2021-09-08;"Košický kraj";86;2753;36;2789;NA;343484;122;2021-09-08;98925
2021-09-07;"Košický kraj";79;2686;53;2739;NA;343484;132;2021-09-07;98803
2021-09-06;"Košický kraj";41;2786;36;2822;NA;343484;77;2021-09-06;98671
2021-09-05;"Košický kraj";52;1393;18;1411;NA;343484;70;2021-09-05;98594
2021-09-04;"Košický kraj";37;1678;12;1690;NA;343484;49;2021-09-04;98524
2021-09-03;"Košický kraj";47;2913;35;2948;NA;343484;82;2021-09-03;98475
2021-09-02;"Košický kraj";56;2686;26;2712;NA;343484;82;2021-09-02;98393
2021-09-01;"Košický kraj";95;629;13;642;NA;343484;108;2021-09-01;98311
2021-08-31;"Košický kraj";30;2525;22;2547;NA;343484;52;2021-08-31;98203
2021-08-30;"Košický kraj";8;2404;28;2432;NA;343484;36;2021-08-30;98151
2021-08-29;"Košický kraj";16;603;1;604;NA;343484;17;2021-08-29;98115
2021-08-28;"Košický kraj";14;2103;11;2114;NA;343484;25;2021-08-28;98098
2021-08-27;"Košický kraj";22;2908;16;2924;NA;343484;38;2021-08-27;98073
2021-08-26;"Košický kraj";19;2292;13;2305;NA;343484;32;2021-08-26;98035
2021-08-25;"Košický kraj";33;2010;6;2016;NA;343484;39;2021-08-25;98003
2021-08-24;"Košický kraj";14;2337;3;2340;NA;343484;17;2021-08-24;97964
2021-08-23;"Košický kraj";33;2461;5;2466;NA;343484;38;2021-08-23;97947
2021-08-22;"Košický kraj";4;1457;8;1465;NA;343484;12;2021-08-22;97909
2021-08-21;"Košický kraj";35;2134;5;2139;NA;343484;40;2021-08-21;97897
2021-08-20;"Košický kraj";13;3215;5;3220;NA;343484;18;2021-08-20;97857
2021-08-19;"Košický kraj";14;2178;6;2184;NA;343484;20;2021-08-19;97839
2021-08-18;"Košický kraj";30;1827;8;1835;NA;343484;38;2021-08-18;97819
2021-08-17;"Košický kraj";24;1619;3;1622;NA;343484;27;2021-08-17;97781
2021-08-16;"Košický kraj";3;2236;10;2246;NA;343484;13;2021-08-16;97754
2021-08-15;"Košický kraj";1;778;5;783;NA;343484;6;2021-08-15;97741
2021-08-14;"Košický kraj";15;1222;1;1223;NA;343484;16;2021-08-14;97735
2021-08-13;"Košický kraj";14;1928;8;1936;NA;343484;22;2021-08-13;97719
2021-08-12;"Košický kraj";10;1248;3;1251;NA;343484;13;2021-08-12;97697
2021-08-11;"Košický kraj";6;1368;5;1373;NA;343484;11;2021-08-11;97684
2021-08-10;"Košický kraj";10;1352;8;1360;NA;343484;18;2021-08-10;97673
2021-08-09;"Košický kraj";12;1651;3;1654;NA;343484;15;2021-08-09;97655
2021-08-08;"Košický kraj";8;688;1;689;NA;343484;9;2021-08-08;97640
2021-08-07;"Košický kraj";3;1125;3;1128;NA;343484;6;2021-08-07;97631
2021-08-06;"Košický kraj";9;1614;6;1620;NA;343484;15;2021-08-06;97625
2021-08-05;"Košický kraj";26;1254;6;1260;NA;343484;32;2021-08-05;97610
2021-08-04;"Košický kraj";8;1373;5;1378;NA;343484;13;2021-08-04;97578
2021-08-03;"Košický kraj";33;1121;3;1124;NA;343484;36;2021-08-03;97565
2021-08-02;"Košický kraj";6;1702;8;1710;NA;343484;14;2021-08-02;97529
2021-08-01;"Košický kraj";1;662;1;663;NA;343484;2;2021-08-01;97515
2021-07-31;"Košický kraj";17;1153;2;1155;NA;343484;19;2021-07-31;97513
2021-07-30;"Košický kraj";12;1657;7;1664;NA;343484;19;2021-07-30;97494
2021-07-29;"Košický kraj";7;1242;5;1247;NA;343484;12;2021-07-29;97475
2021-07-28;"Košický kraj";15;956;5;961;NA;343484;20;2021-07-28;97463
2021-07-27;"Košický kraj";17;1180;7;1187;NA;343484;24;2021-07-27;97443
2021-07-26;"Košický kraj";3;1666;9;1675;NA;343484;12;2021-07-26;97419
2021-07-25;"Košický kraj";0;719;3;722;NA;343484;3;2021-07-25;97407
2021-07-24;"Košický kraj";18;996;4;1000;NA;343484;22;2021-07-24;97404
2021-07-23;"Košický kraj";9;1524;5;1529;NA;343484;14;2021-07-23;97382
2021-07-22;"Košický kraj";1;1254;4;1258;NA;343484;5;2021-07-22;97368
2021-07-21;"Košický kraj";4;1117;3;1120;NA;343484;7;2021-07-21;97363
2021-07-20;"Košický kraj";6;1355;1;1356;NA;343484;7;2021-07-20;97356
2021-07-19;"Košický kraj";2;1517;2;1519;NA;343484;4;2021-07-19;97349
2021-07-18;"Košický kraj";0;644;0;644;NA;343484;0;2021-07-18;97345
2021-07-17;"Košický kraj";3;1101;5;1106;NA;343484;8;2021-07-17;97345
2021-07-16;"Košický kraj";3;1609;4;1613;NA;343484;7;2021-07-16;97337
2021-07-15;"Košický kraj";4;1383;4;1387;NA;343484;8;2021-07-15;97330
2021-07-14;"Košický kraj";2;1175;4;1179;NA;343484;6;2021-07-14;97322
2021-07-13;"Košický kraj";4;1331;1;1332;NA;343484;5;2021-07-13;97316
2021-07-12;"Košický kraj";3;1894;3;1897;NA;343484;6;2021-07-12;97311
2021-07-11;"Košický kraj";1;537;2;539;NA;343484;3;2021-07-11;97305
2021-07-10;"Košický kraj";9;1167;0;1167;NA;343484;9;2021-07-10;97302
2021-07-09;"Košický kraj";5;2005;5;2010;NA;343484;10;2021-07-09;97293
2021-07-08;"Košický kraj";13;1282;2;1284;NA;343484;15;2021-07-08;97283
2021-07-07;"Košický kraj";6;1524;1;1525;NA;343484;7;2021-07-07;97268
2021-07-06;"Košický kraj";4;1886;2;1888;NA;343484;6;2021-07-06;97261
2021-07-05;"Košický kraj";1;573;1;574;NA;343484;2;2021-07-05;97255
2021-07-04;"Košický kraj";0;482;2;484;NA;343484;2;2021-07-04;97253
2021-07-03;"Košický kraj";2;1227;0;1227;NA;343484;2;2021-07-03;97251
2021-07-02;"Košický kraj";2;1883;3;1886;NA;343484;5;2021-07-02;97249
2021-07-01;"Košický kraj";0;1211;2;1213;NA;343484;2;2021-07-01;97244
2021-06-30;"Košický kraj";5;9306;7;9313;NA;343484;12;2021-06-30;97242
2021-06-29;"Košický kraj";6;5692;7;5699;NA;343484;13;2021-06-29;97230
2021-06-28;"Košický kraj";5;6129;2;6131;NA;343484;7;2021-06-28;97217
2021-06-27;"Košický kraj";8;4636;3;4639;NA;343484;11;2021-06-27;97210
2021-06-26;"Košický kraj";4;5699;14;5713;NA;343484;18;2021-06-26;97199
2021-06-25;"Košický kraj";5;6981;2;6983;NA;343484;7;2021-06-25;97181
2021-06-24;"Košický kraj";1;5072;3;5075;NA;343484;4;2021-06-24;97174
2021-06-23;"Košický kraj";8;5373;3;5376;NA;343484;11;2021-06-23;97170
2021-06-22;"Košický kraj";1;5269;3;5272;NA;343484;4;2021-06-22;97159
2021-06-21;"Košický kraj";5;6830;11;6841;NA;343484;16;2021-06-21;97155
2021-06-20;"Košický kraj";0;4882;6;4888;NA;343484;6;2021-06-20;97139
2021-06-19;"Košický kraj";7;6473;1;6474;NA;343484;8;2021-06-19;97133
2021-06-18;"Košický kraj";4;7969;8;7977;NA;343484;12;2021-06-18;97125
2021-06-17;"Košický kraj";6;6128;3;6131;NA;343484;9;2021-06-17;97113
2021-06-16;"Košický kraj";11;6059;7;6066;NA;343484;18;2021-06-16;97104
2021-06-15;"Košický kraj";12;6301;2;6303;NA;343484;14;2021-06-15;97086
2021-06-14;"Košický kraj";10;7076;9;7085;NA;343484;19;2021-06-14;97072
2021-06-13;"Košický kraj";7;6948;8;6956;NA;343484;15;2021-06-13;97053
2021-06-12;"Košický kraj";7;7485;9;7494;NA;343484;16;2021-06-12;97038
2021-06-11;"Košický kraj";15;8973;6;8979;NA;343484;21;2021-06-11;97022
2021-06-10;"Košický kraj";11;6588;16;6604;NA;343484;27;2021-06-10;97001
2021-06-09;"Košický kraj";37;6056;7;6063;NA;343484;44;2021-06-09;96974
2021-06-08;"Košický kraj";33;7019;13;7032;NA;343484;46;2021-06-08;96930
2021-06-07;"Košický kraj";11;8106;22;8128;NA;343484;33;2021-06-07;96884
2021-06-06;"Košický kraj";1;7843;7;7850;NA;343484;8;2021-06-06;96851
2021-06-05;"Košický kraj";21;9286;3;9289;NA;343484;24;2021-06-05;96843
2021-06-04;"Košický kraj";26;11418;20;11438;NA;343484;46;2021-06-04;96819
2021-06-03;"Košický kraj";23;6467;14;6481;NA;343484;37;2021-06-03;96773
2021-06-02;"Košický kraj";15;7180;24;7204;NA;343484;39;2021-06-02;96736
2021-06-01;"Košický kraj";13;7562;10;7572;NA;343484;23;2021-06-01;96697
2021-05-31;"Košický kraj";13;9256;18;9274;NA;343484;31;2021-05-31;96674
2021-05-30;"Košický kraj";3;11215;10;11225;NA;343484;13;2021-05-30;96643
2021-05-29;"Košický kraj";25;10942;22;10964;NA;343484;47;2021-05-29;96630
2021-05-28;"Košický kraj";17;13055;29;13084;NA;343484;46;2021-05-28;96583
2021-05-27;"Košický kraj";19;7924;26;7950;NA;343484;45;2021-05-27;96537
2021-05-26;"Košický kraj";35;8118;27;8145;NA;343484;62;2021-05-26;96492
2021-05-25;"Košický kraj";33;9296;29;9325;NA;343484;62;2021-05-25;96430
2021-05-24;"Košický kraj";10;10855;27;10882;NA;343484;37;2021-05-24;96368
2021-05-23;"Košický kraj";4;12151;15;12166;NA;343484;19;2021-05-23;96331
2021-05-22;"Košický kraj";27;12601;19;12620;NA;343484;46;2021-05-22;96312
2021-05-21;"Košický kraj";24;14910;27;14937;NA;343484;51;2021-05-21;96266
2021-05-20;"Košický kraj";20;9422;28;9450;NA;343484;48;2021-05-20;96215
2021-05-19;"Košický kraj";30;10421;21;10442;NA;343484;51;2021-05-19;96167
2021-05-18;"Košický kraj";34;10254;36;10290;NA;343484;70;2021-05-18;96116
2021-05-17;"Košický kraj";20;12686;38;12724;NA;343484;58;2021-05-17;96046
2021-05-16;"Košický kraj";37;17865;20;17885;NA;343484;57;2021-05-16;95988
2021-05-15;"Košický kraj";22;25602;28;25630;NA;343484;50;2021-05-15;95931
2021-05-14;"Košický kraj";32;21824;42;21866;NA;343484;74;2021-05-14;95881
2021-05-13;"Košický kraj";39;10172;32;10204;NA;343484;71;2021-05-13;95807
2021-05-12;"Košický kraj";85;10868;33;10901;NA;343484;118;2021-05-12;95736
2021-05-11;"Košický kraj";68;11166;32;11198;NA;343484;100;2021-05-11;95618
2021-05-10;"Košický kraj";25;17044;42;17086;NA;343484;67;2021-05-10;95518
2021-05-09;"Košický kraj";84;25594;55;25649;NA;343484;139;2021-05-09;95451
2021-05-08;"Košický kraj";18;23399;23;23422;NA;343484;41;2021-05-08;95312
2021-05-07;"Košický kraj";51;24497;57;24554;NA;343484;108;2021-05-07;95271
2021-05-06;"Košický kraj";55;11847;43;11890;NA;343484;98;2021-05-06;95163
2021-05-05;"Košický kraj";23;12124;35;12159;NA;343484;58;2021-05-05;95065
2021-05-04;"Košický kraj";143;13562;38;13600;NA;343484;181;2021-05-04;95007
2021-05-03;"Košický kraj";37;16944;68;17012;NA;343484;105;2021-05-03;94826
2021-05-02;"Košický kraj";45;36096;56;36152;NA;343484;101;2021-05-02;94721
2021-05-01;"Košický kraj";54;52075;76;52151;NA;343484;130;2021-05-01;94620
2021-04-30;"Košický kraj";59;44602;94;44696;NA;343484;153;2021-04-30;94490
2021-04-29;"Košický kraj";76;17014;53;17067;NA;343484;129;2021-04-29;94337
2021-04-28;"Košický kraj";99;17970;52;18022;NA;343484;151;2021-04-28;94208
2021-04-27;"Košický kraj";108;20670;43;20713;NA;343484;151;2021-04-27;94057
2021-04-26;"Košický kraj";39;25915;96;26011;NA;343484;135;2021-04-26;93906
2021-04-25;"Košický kraj";23;48355;57;48412;NA;343484;80;2021-04-25;93771
2021-04-24;"Košický kraj";68;90124;114;90238;NA;343484;182;2021-04-24;93691
2021-04-23;"Košický kraj";110;41232;72;41304;NA;343484;182;2021-04-23;93509
2021-04-22;"Košický kraj";56;16772;44;16816;NA;343484;100;2021-04-22;93327
2021-04-21;"Košický kraj";114;19519;61;19580;NA;343484;175;2021-04-21;93227
2021-04-20;"Košický kraj";81;25432;63;25495;NA;343484;144;2021-04-20;93052
2021-04-19;"Košický kraj";93;29950;108;30058;NA;343484;201;2021-04-19;92908
2021-04-18;"Košický kraj";10;48913;82;48995;NA;343484;92;2021-04-18;92707
2021-04-17;"Košický kraj";187;83856;103;83959;NA;343484;290;2021-04-17;92615
2021-04-16;"Košický kraj";83;41568;127;41695;NA;343484;210;2021-04-16;92325
2021-04-15;"Košický kraj";104;18522;93;18615;NA;343484;197;2021-04-15;92115
2021-04-14;"Košický kraj";119;20089;64;20153;NA;343484;183;2021-04-14;91918
2021-04-13;"Košický kraj";81;23175;120;23295;NA;343484;201;2021-04-13;91735
2021-04-12;"Košický kraj";129;26573;124;26697;NA;343484;253;2021-04-12;91534
2021-04-11;"Košický kraj";29;46949;80;47029;NA;343484;109;2021-04-11;91281
2021-04-10;"Košický kraj";138;100114;183;100297;NA;343484;321;2021-04-10;91172
2021-04-09;"Košický kraj";168;35206;133;35339;NA;343484;301;2021-04-09;90851
2021-04-08;"Košický kraj";81;18530;90;18620;NA;343484;171;2021-04-08;90550
2021-04-07;"Košický kraj";232;28027;194;28221;NA;343484;426;2021-04-07;90379
2021-04-06;"Košický kraj";121;36495;164;36659;NA;343484;285;2021-04-06;89953
2021-04-05;"Košický kraj";19;14361;66;14427;NA;343484;85;2021-04-05;89668
2021-04-04;"Košický kraj";33;15089;66;15155;NA;343484;99;2021-04-04;89583
2021-04-03;"Košický kraj";138;97664;241;97905;NA;343484;379;2021-04-03;89484
2021-04-02;"Košický kraj";128;24515;76;24591;NA;343484;204;2021-04-02;89105
2021-04-01;"Košický kraj";165;46151;156;46307;NA;343484;321;2021-04-01;88901
2021-03-31;"Košický kraj";160;29659;124;29783;NA;343484;284;2021-03-31;88580
2021-03-30;"Košický kraj";229;24038;163;24201;NA;343484;392;2021-03-30;88296
2021-03-29;"Košický kraj";78;28843;194;29037;NA;343484;272;2021-03-29;87904
2021-03-28;"Košický kraj";39;44263;128;44391;NA;343484;167;2021-03-28;87632
2021-03-27;"Košický kraj";222;96602;265;96867;NA;343484;487;2021-03-27;87465
2021-03-26;"Košický kraj";233;45252;202;45454;NA;343484;435;2021-03-26;86978
2021-03-25;"Košický kraj";133;23804;175;23979;NA;343484;308;2021-03-25;86543
2021-03-24;"Košický kraj";165;20696;155;20851;NA;343484;320;2021-03-24;86235
2021-03-23;"Košický kraj";202;22434;192;22626;NA;343484;394;2021-03-23;85915
2021-03-22;"Košický kraj";169;26890;228;27118;NA;343484;397;2021-03-22;85521
2021-03-21;"Košický kraj";109;46746;167;46913;NA;343484;276;2021-03-21;85124
2021-03-20;"Košický kraj";126;101334;311;101645;NA;343484;437;2021-03-20;84848
2021-03-19;"Košický kraj";205;45632;260;45892;NA;343484;465;2021-03-19;84411
2021-03-18;"Košický kraj";274;23827;212;24039;NA;343484;486;2021-03-18;83946
2021-03-17;"Košický kraj";177;21548;195;21743;NA;343484;372;2021-03-17;83460
2021-03-16;"Košický kraj";386;23454;226;23680;NA;343484;612;2021-03-16;83088
2021-03-15;"Košický kraj";173;27900;297;28197;NA;343484;470;2021-03-15;82476
2021-03-14;"Košický kraj";145;44354;220;44574;NA;343484;365;2021-03-14;82006
2021-03-13;"Košický kraj";146;103790;483;104273;NA;343484;629;2021-03-13;81641
2021-03-12;"Košický kraj";366;47871;321;48192;NA;343484;687;2021-03-12;81012
2021-03-11;"Košický kraj";396;23229;263;23492;NA;343484;659;2021-03-11;80325
2021-03-10;"Košický kraj";121;22205;269;22474;NA;343484;390;2021-03-10;79666
2021-03-09;"Košický kraj";676;24509;300;24809;NA;343484;976;2021-03-09;79276
2021-03-08;"Košický kraj";559;29852;344;30196;NA;343484;903;2021-03-08;78300
2021-03-07;"Košický kraj";45;44230;299;44529;NA;343484;344;2021-03-07;77397
2021-03-06;"Košický kraj";177;105598;532;106130;NA;343484;709;2021-03-06;77053
2021-03-05;"Košický kraj";439;45567;424;45991;NA;343484;863;2021-03-05;76344
2021-03-04;"Košický kraj";417;23862;320;24182;NA;343484;737;2021-03-04;75481
2021-03-03;"Košický kraj";390;23169;298;23467;NA;343484;688;2021-03-03;74744
2021-03-02;"Košický kraj";464;24158;368;24526;NA;343484;832;2021-03-02;74056
2021-03-01;"Košický kraj";389;30013;514;30527;NA;343484;903;2021-03-01;73224
2021-02-28;"Košický kraj";265;43053;334;43387;NA;343484;599;2021-02-28;72321
2021-02-27;"Košický kraj";301;100559;784;101343;NA;343484;1085;2021-02-27;71722
2021-02-26;"Košický kraj";440;45466;492;45958;NA;343484;932;2021-02-26;70637
2021-02-25;"Košický kraj";331;19872;342;20214;NA;343484;673;2021-02-25;69705
2021-02-24;"Košický kraj";263;18751;505;19256;NA;343484;768;2021-02-24;69032
2021-02-23;"Košický kraj";642;21605;341;21946;NA;343484;983;2021-02-23;68264
2021-02-22;"Košický kraj";362;30858;434;31292;NA;343484;796;2021-02-22;67281
2021-02-21;"Košický kraj";170;40464;385;40849;NA;343484;555;2021-02-21;66485
2021-02-20;"Košický kraj";283;92550;770;93320;NA;343484;1053;2021-02-20;65930
2021-02-19;"Košický kraj";507;41579;583;42162;NA;343484;1090;2021-02-19;64877
2021-02-18;"Košický kraj";397;18442;345;18787;NA;343484;742;2021-02-18;63787
2021-02-17;"Košický kraj";322;18080;387;18467;NA;343484;709;2021-02-17;63045
2021-02-16;"Košický kraj";600;22111;463;22574;NA;343484;1063;2021-02-16;62336
2021-02-15;"Košický kraj";216;27633;419;28052;NA;343484;635;2021-02-15;61273
2021-02-14;"Košický kraj";241;56743;524;57267;NA;343484;765;2021-02-14;60638
2021-02-13;"Košický kraj";206;93745;765;94510;NA;343484;971;2021-02-13;59873
2021-02-12;"Košický kraj";448;49924;611;50535;NA;343484;1059;2021-02-12;58902
2021-02-11;"Košický kraj";435;14524;323;14847;NA;343484;758;2021-02-11;57843
2021-02-10;"Košický kraj";360;18475;431;18906;NA;343484;791;2021-02-10;57085
2021-02-09;"Košický kraj";544;24841;463;25304;NA;343484;1007;2021-02-09;56294
2021-02-08;"Košický kraj";237;24836;392;25228;NA;343484;629;2021-02-08;55287
2021-02-07;"Košický kraj";208;56897;612;57509;NA;343484;820;2021-02-07;54658
2021-02-06;"Košický kraj";318;104357;884;105241;NA;343484;1202;2021-02-06;53838
2021-02-05;"Košický kraj";384;43186;494;43680;NA;343484;878;2021-02-05;52636
2021-02-04;"Košický kraj";391;14512;371;14883;NA;343484;762;2021-02-04;51758
2021-02-03;"Košický kraj";296;12599;339;12938;NA;343484;635;2021-02-03;50996
2021-02-02;"Košický kraj";473;43883;1212;45095;NA;343484;1685;2021-02-02;50361
2021-02-01;"Košický kraj";415;21984;362;22346;NA;343484;777;2021-02-01;48676
2021-01-31;"Košický kraj";142;54690;617;55307;NA;343484;759;2021-01-31;47899
2021-01-30;"Košický kraj";320;76722;661;77383;NA;343484;981;2021-01-30;47140
2021-01-29;"Košický kraj";311;37164;466;37630;NA;343484;777;2021-01-29;46159
2021-01-28;"Košický kraj";540;9006;244;9250;NA;343484;784;2021-01-28;45382
2021-01-27;"Košický kraj";265;7575;211;7786;NA;343484;476;2021-01-27;44598
2021-01-26;"Košický kraj";530;14210;245;14455;NA;343484;775;2021-01-26;44122
2021-01-25;"Košický kraj";226;26431;413;26844;NA;343484;639;2021-01-25;43347
2021-01-24;"Košický kraj";150;44419;581;45000;NA;343484;731;2021-01-24;42708
2021-01-23;"Košický kraj";232;82705;857;83562;NA;343484;1089;2021-01-23;41977
2021-01-22;"Košický kraj";316;19997;265;20262;NA;343484;581;2021-01-22;40888
2021-01-21;"Košický kraj";274;14053;159;14212;NA;343484;433;2021-01-21;40307
2021-01-20;"Košický kraj";374;10844;201;11045;NA;343484;575;2021-01-20;39874
2021-01-19;"Košický kraj";248;9717;181;9898;NA;343484;429;2021-01-19;39299
2021-01-18;"Košický kraj";333;7659;262;7921;NA;343484;595;2021-01-18;38870
2021-01-17;"Košický kraj";155;535;14;549;NA;343484;169;2021-01-17;38275
2021-01-16;"Košický kraj";153;1403;47;1450;NA;343484;200;2021-01-16;38106
2021-01-15;"Košický kraj";308;6443;213;6656;NA;343484;521;2021-01-15;37906
2021-01-14;"Košický kraj";358;5471;221;5692;NA;343484;579;2021-01-14;37385
2021-01-13;"Košický kraj";421;4897;226;5123;NA;343484;647;2021-01-13;36806
2021-01-12;"Košický kraj";482;6473;237;6710;NA;343484;719;2021-01-12;36159
2021-01-11;"Košický kraj";309;7553;286;7839;NA;343484;595;2021-01-11;35440
2021-01-10;"Košický kraj";193;136;6;142;NA;343484;199;2021-01-10;34845
2021-01-09;"Košický kraj";469;1134;45;1179;NA;343484;514;2021-01-09;34646
2021-01-08;"Košický kraj";551;7106;348;7454;NA;343484;899;2021-01-08;34132
2021-01-07;"Košický kraj";251;5853;398;6251;NA;343484;649;2021-01-07;33233
2021-01-06;"Košický kraj";442;429;33;462;NA;343484;475;2021-01-06;32584
2021-01-05;"Košický kraj";584;7633;527;8160;NA;343484;1111;2021-01-05;32109
2021-01-04;"Košický kraj";407;6479;660;7139;NA;343484;1067;2021-01-04;30998
2021-01-03;"Košický kraj";118;661;22;683;NA;343484;140;2021-01-03;29931
2021-01-02;"Košický kraj";88;440;52;492;NA;343484;140;2021-01-02;29791
2021-01-01;"Košický kraj";398;725;49;774;NA;343484;447;2021-01-01;29651
2020-12-31;"Košický kraj";625;7509;453;7962;NA;343484;1078;2020-12-31;29204
2020-12-30;"Košický kraj";590;6076;395;6471;NA;343484;985;2020-12-30;28126
2020-12-29;"Košický kraj";419;7454;596;8050;NA;343484;1015;2020-12-29;27141
2020-12-28;"Košický kraj";356;7933;756;8689;NA;343484;1112;2020-12-28;26126
2020-12-27;"Košický kraj";159;147;16;163;NA;343484;175;2020-12-27;25014
2020-12-26;"Košický kraj";163;274;23;297;NA;343484;186;2020-12-26;24839
2020-12-25;"Košický kraj";237;140;10;150;NA;343484;247;2020-12-25;24653
2020-12-24;"Košický kraj";564;1470;90;1560;NA;343484;654;2020-12-24;24406
2020-12-23;"Košický kraj";304;7339;327;7666;NA;343484;631;2020-12-23;23752
2020-12-22;"Košický kraj";438;7284;429;7713;NA;343484;867;2020-12-22;23121
2020-12-21;"Košický kraj";405;6703;504;7207;NA;343484;909;2020-12-21;22254
2020-12-20;"Košický kraj";215;73;11;84;NA;343484;226;2020-12-20;21345
2020-12-19;"Košický kraj";207;1309;63;1372;NA;343484;270;2020-12-19;21119
2020-12-18;"Košický kraj";310;7707;292;7999;NA;343484;602;2020-12-18;20849
2020-12-17;"Košický kraj";463;5101;253;5354;NA;343484;716;2020-12-17;20247
2020-12-16;"Košický kraj";455;5725;295;6020;NA;343484;750;2020-12-16;19531
2020-12-15;"Košický kraj";319;4787;327;5114;NA;343484;646;2020-12-15;18781
2020-12-14;"Košický kraj";256;2905;225;3130;NA;343484;481;2020-12-14;18135
2020-12-13;"Košický kraj";47;181;2;183;NA;343484;49;2020-12-13;17654
2020-12-12;"Košický kraj";369;1587;118;1705;NA;343484;487;2020-12-12;17605
2020-12-11;"Košický kraj";354;5328;256;5584;NA;343484;610;2020-12-11;17118
2020-12-10;"Košický kraj";283;3987;174;4161;NA;343484;457;2020-12-10;16508
2020-12-09;"Košický kraj";279;3786;166;3952;NA;343484;445;2020-12-09;16051
2020-12-08;"Košický kraj";226;4105;355;4460;NA;343484;581;2020-12-08;15606
2020-12-07;"Košický kraj";270;2383;106;2489;NA;343484;376;2020-12-07;15025
2020-12-06;"Košický kraj";121;482;33;515;NA;343484;154;2020-12-06;14649
2020-12-05;"Košický kraj";90;1096;48;1144;NA;343484;138;2020-12-05;14495
2020-12-04;"Košický kraj";224;2680;82;2762;NA;343484;306;2020-12-04;14357
2020-12-03;"Košický kraj";211;7717;173;7890;NA;343484;384;2020-12-03;14051
2020-12-02;"Košický kraj";193;8132;496;8628;NA;343484;689;2020-12-02;13667
2020-12-01;"Košický kraj";178;2237;124;2361;NA;343484;302;2020-12-01;12978
2020-11-30;"Košický kraj";171;3598;59;3657;NA;343484;230;2020-11-30;12676
2020-11-29;"Košický kraj";31;325;17;342;NA;343484;48;2020-11-29;12446
2020-11-28;"Košický kraj";69;721;52;773;NA;343484;121;2020-11-28;12398
2020-11-27;"Košický kraj";149;2921;78;2999;NA;343484;227;2020-11-27;12277
2020-11-26;"Košický kraj";239;1234;60;1294;NA;343484;299;2020-11-26;12050
2020-11-25;"Košický kraj";237;1785;123;1908;NA;343484;360;2020-11-25;11751
2020-11-24;"Košický kraj";196;1976;67;2043;NA;343484;263;2020-11-24;11391
2020-11-23;"Košický kraj";51;4115;63;4178;NA;343484;114;2020-11-23;11128
2020-11-22;"Košický kraj";57;57;5;62;NA;343484;62;2020-11-22;11014
2020-11-21;"Košický kraj";87;858;36;894;NA;343484;123;2020-11-21;10952
2020-11-20;"Košický kraj";176;3084;49;3133;NA;343484;225;2020-11-20;10829
2020-11-19;"Košický kraj";206;1736;48;1784;NA;343484;254;2020-11-19;10604
2020-11-18;"Košický kraj";122;532;17;549;NA;343484;139;2020-11-18;10350
2020-11-17;"Košický kraj";152;82;9;91;NA;343484;161;2020-11-17;10211
2020-11-16;"Košický kraj";114;596;27;623;NA;343484;141;2020-11-16;10050
2020-11-15;"Košický kraj";15;338;7;345;NA;343484;22;2020-11-15;9909
2020-11-14;"Košický kraj";234;520;12;532;NA;343484;246;2020-11-14;9887
2020-11-13;"Košický kraj";207;664;29;693;NA;343484;236;2020-11-13;9641
2020-11-12;"Košický kraj";192;736;13;749;NA;343484;205;2020-11-12;9405
2020-11-11;"Košický kraj";301;593;7;600;NA;343484;308;2020-11-11;9200
2020-11-10;"Košický kraj";190;541;11;552;NA;343484;201;2020-11-10;8892
2020-11-09;"Košický kraj";129;380;17;397;NA;343484;146;2020-11-09;8691
2020-11-08;"Košický kraj";78;1306;8;1314;NA;343484;86;2020-11-08;8545
2020-11-07;"Košický kraj";192;3909;22;3931;NA;343484;214;2020-11-07;8459
2020-11-06;"Košický kraj";195;5310;34;5344;NA;343484;229;2020-11-06;8245
2020-11-05;"Košický kraj";342;330;31;361;NA;343484;373;2020-11-05;8016
2020-11-04;"Košický kraj";101;154;6;160;NA;343484;107;2020-11-04;7643
2020-11-03;"Košický kraj";358;1122;13;1135;NA;343484;371;2020-11-03;7536
2020-11-02;"Košický kraj";111;6125;56;6181;NA;343484;167;2020-11-02;7165
2020-11-01;"Košický kraj";346;6522;34;6556;NA;343484;380;2020-11-01;6998
2020-10-31;"Košický kraj";82;14035;106;14141;NA;343484;188;2020-10-31;6618
2020-10-30;"Košický kraj";379;2835;27;2862;NA;343484;406;2020-10-30;6430
2020-10-29;"Košický kraj";333;983;13;996;NA;343484;346;2020-10-29;6024
2020-10-28;"Košický kraj";224;305;13;318;NA;343484;237;2020-10-28;5678
2020-10-27;"Košický kraj";386;439;21;460;NA;343484;407;2020-10-27;5441
2020-10-26;"Košický kraj";56;212;12;224;NA;343484;68;2020-10-26;5034
2020-10-25;"Košický kraj";154;79;2;81;NA;343484;156;2020-10-25;4966
2020-10-24;"Košický kraj";313;118;16;134;NA;343484;329;2020-10-24;4810
2020-10-23;"Košický kraj";315;331;8;339;NA;343484;323;2020-10-23;4481
2020-10-22;"Košický kraj";349;530;16;546;NA;343484;365;2020-10-22;4158
2020-10-21;"Košický kraj";129;84;2;86;NA;343484;131;2020-10-21;3793
2020-10-20;"Košický kraj";181;14;1;15;NA;343484;182;2020-10-20;3662
2020-10-19;"Košický kraj";64;38;1;39;NA;343484;65;2020-10-19;3480
2020-10-18;"Košický kraj";158;0;0;0;NA;343484;158;2020-10-18;3415
2020-10-17;"Košický kraj";142;0;0;0;NA;343484;142;2020-10-17;3257
2020-10-16;"Košický kraj";206;19;0;19;NA;343484;206;2020-10-16;3115
2020-10-15;"Košický kraj";177;19;5;24;NA;343484;182;2020-10-15;2909
2020-10-14;"Košický kraj";211;8;0;8;NA;343484;211;2020-10-14;2727
2020-10-13;"Košický kraj";179;80;3;83;NA;343484;182;2020-10-13;2516
2020-10-12;"Košický kraj";74;0;0;0;NA;343484;74;2020-10-12;2334
2020-10-11;"Košický kraj";121;0;0;0;NA;343484;121;2020-10-11;2260
2020-10-10;"Košický kraj";70;0;0;0;NA;343484;70;2020-10-10;2139
2020-10-09;"Košický kraj";188;0;0;0;NA;343484;188;2020-10-09;2069
2020-10-08;"Košický kraj";102;0;0;0;NA;343484;102;2020-10-08;1881
2020-10-07;"Košický kraj";158;0;0;0;NA;343484;158;2020-10-07;1779
2020-10-06;"Košický kraj";70;0;0;0;NA;343484;70;2020-10-06;1621
2020-10-05;"Košický kraj";39;0;0;0;NA;343484;39;2020-10-05;1551
2020-10-04;"Košický kraj";45;0;0;0;NA;343484;45;2020-10-04;1512
2020-10-03;"Košický kraj";105;0;0;0;NA;343484;105;2020-10-03;1467
2020-10-02;"Košický kraj";57;0;0;0;NA;343484;57;2020-10-02;1362
2020-10-01;"Košický kraj";69;0;0;0;NA;343484;69;2020-10-01;1305
2020-09-30;"Košický kraj";95;0;0;0;NA;343484;95;2020-09-30;1236
2020-09-29;"Košický kraj";75;0;0;0;NA;343484;75;2020-09-29;1141
2020-09-28;"Košický kraj";19;0;0;0;NA;343484;19;2020-09-28;1066
2020-09-27;"Košický kraj";21;0;0;0;NA;343484;21;2020-09-27;1047
2020-09-26;"Košický kraj";53;0;0;0;NA;343484;53;2020-09-26;1026
2020-09-25;"Košický kraj";72;0;0;0;NA;343484;72;2020-09-25;973
2020-09-24;"Košický kraj";35;0;0;0;NA;343484;35;2020-09-24;901
2020-09-23;"Košický kraj";23;0;0;0;NA;343484;23;2020-09-23;866
2020-09-22;"Košický kraj";39;0;0;0;NA;343484;39;2020-09-22;843
2020-09-21;"Košický kraj";5;0;0;0;NA;343484;5;2020-09-21;804
2020-09-20;"Košický kraj";3;0;0;0;NA;343484;3;2020-09-20;799
2020-09-19;"Košický kraj";13;0;0;0;NA;343484;13;2020-09-19;796
2020-09-18;"Košický kraj";20;0;0;0;NA;343484;20;2020-09-18;783
2020-09-17;"Košický kraj";22;0;0;0;NA;343484;22;2020-09-17;763
2020-09-16;"Košický kraj";12;0;0;0;NA;343484;12;2020-09-16;741
2020-09-15;"Košický kraj";10;0;0;0;NA;343484;10;2020-09-15;729
2020-09-14;"Košický kraj";6;0;0;0;NA;343484;6;2020-09-14;719
2020-09-13;"Košický kraj";3;0;0;0;NA;343484;3;2020-09-13;713
2020-09-12;"Košický kraj";16;0;0;0;NA;343484;16;2020-09-12;710
2020-09-11;"Košický kraj";20;0;0;0;NA;343484;20;2020-09-11;694
2020-09-10;"Košický kraj";11;0;0;0;NA;343484;11;2020-09-10;674
2020-09-09;"Košický kraj";37;0;0;0;NA;343484;37;2020-09-09;663
2020-09-08;"Košický kraj";10;0;0;0;NA;343484;10;2020-09-08;626
2020-09-07;"Košický kraj";4;0;0;0;NA;343484;4;2020-09-07;616
2020-09-06;"Košický kraj";2;0;0;0;NA;343484;2;2020-09-06;612
2020-09-05;"Košický kraj";10;0;0;0;NA;343484;10;2020-09-05;610
2020-09-04;"Košický kraj";14;0;0;0;NA;343484;14;2020-09-04;600
2020-09-03;"Košický kraj";22;0;0;0;NA;343484;22;2020-09-03;586
2020-09-02;"Košický kraj";13;0;0;0;NA;343484;13;2020-09-02;564
2020-09-01;"Košický kraj";21;0;0;0;NA;343484;21;2020-09-01;551
2020-08-31;"Košický kraj";9;0;0;0;NA;343484;9;2020-08-31;530
2020-08-30;"Košický kraj";21;0;0;0;NA;343484;21;2020-08-30;521
2020-08-29;"Košický kraj";1;0;0;0;NA;343484;1;2020-08-29;500
2020-08-28;"Košický kraj";19;0;0;0;NA;343484;19;2020-08-28;499
2020-08-27;"Košický kraj";15;0;0;0;NA;343484;15;2020-08-27;480
2020-08-26;"Košický kraj";8;0;0;0;NA;343484;8;2020-08-26;465
2020-08-25;"Košický kraj";23;0;0;0;NA;343484;23;2020-08-25;457
2020-08-24;"Košický kraj";6;0;0;0;NA;343484;6;2020-08-24;434
2020-08-23;"Košický kraj";8;0;0;0;NA;343484;8;2020-08-23;428
2020-08-22;"Košický kraj";13;0;0;0;NA;343484;13;2020-08-22;420
2020-08-21;"Košický kraj";10;0;0;0;NA;343484;10;2020-08-21;407
2020-08-20;"Košický kraj";10;0;0;0;NA;343484;10;2020-08-20;397
2020-08-19;"Košický kraj";3;0;0;0;NA;343484;3;2020-08-19;387
2020-08-18;"Košický kraj";7;0;0;0;NA;343484;7;2020-08-18;384
2020-08-17;"Košický kraj";2;0;0;0;NA;343484;2;2020-08-17;377
2020-08-16;"Košický kraj";2;0;0;0;NA;343484;2;2020-08-16;375
2020-08-15;"Košický kraj";3;0;0;0;NA;343484;3;2020-08-15;373
2020-08-14;"Košický kraj";1;0;0;0;NA;343484;1;2020-08-14;370
2020-08-13;"Košický kraj";3;0;0;0;NA;343484;3;2020-08-13;369
2020-08-12;"Košický kraj";12;0;0;0;NA;343484;12;2020-08-12;366
2020-08-11;"Košický kraj";5;0;0;0;NA;343484;5;2020-08-11;354
2020-08-10;"Košický kraj";1;0;0;0;NA;343484;1;2020-08-10;349
2020-08-09;"Košický kraj";0;0;0;0;NA;343484;0;2020-08-09;348
2020-08-08;"Košický kraj";5;0;0;0;NA;343484;5;2020-08-08;348
2020-08-07;"Košický kraj";7;0;0;0;NA;343484;7;2020-08-07;343
2020-08-06;"Košický kraj";3;0;0;0;NA;343484;3;2020-08-06;336
2020-08-05;"Košický kraj";4;0;0;0;NA;343484;4;2020-08-05;333
2020-08-04;"Košický kraj";1;0;0;0;NA;343484;1;2020-08-04;329
2020-08-03;"Košický kraj";1;0;0;0;NA;343484;1;2020-08-03;328
2020-08-02;"Košický kraj";0;0;0;0;NA;343484;0;2020-08-02;327
2020-08-01;"Košický kraj";0;0;0;0;NA;343484;0;2020-08-01;327
2020-07-31;"Košický kraj";0;0;0;0;NA;343484;0;2020-07-31;327
2020-07-30;"Košický kraj";2;0;0;0;NA;343484;2;2020-07-30;327
2020-07-29;"Košický kraj";1;0;0;0;NA;343484;1;2020-07-29;325
2020-07-28;"Košický kraj";9;0;0;0;NA;343484;9;2020-07-28;324
2020-07-27;"Košický kraj";4;0;0;0;NA;343484;4;2020-07-27;315
2020-07-26;"Košický kraj";0;0;0;0;NA;343484;0;2020-07-26;311
2020-07-25;"Košický kraj";2;0;0;0;NA;343484;2;2020-07-25;311
2020-07-24;"Košický kraj";2;0;0;0;NA;343484;2;2020-07-24;309
2020-07-23;"Košický kraj";1;0;0;0;NA;343484;1;2020-07-23;307
2020-07-22;"Košický kraj";1;0;0;0;NA;343484;1;2020-07-22;306
2020-07-21;"Košický kraj";0;0;0;0;NA;343484;0;2020-07-21;305
2020-07-20;"Košický kraj";0;0;0;0;NA;343484;0;2020-07-20;305
2020-07-19;"Košický kraj";0;0;0;0;NA;343484;0;2020-07-19;305
2020-07-18;"Košický kraj";1;0;0;0;NA;343484;1;2020-07-18;305
2020-07-17;"Košický kraj";1;0;0;0;NA;343484;1;2020-07-17;304
2020-07-16;"Košický kraj";0;0;0;0;NA;343484;0;2020-07-16;303
2020-07-15;"Košický kraj";2;0;0;0;NA;343484;2;2020-07-15;303
2020-07-14;"Košický kraj";1;0;0;0;NA;343484;1;2020-07-14;301
2020-07-13;"Košický kraj";1;0;0;0;NA;343484;1;2020-07-13;300
2020-07-12;"Košický kraj";0;0;0;0;NA;343484;0;2020-07-12;299
2020-07-11;"Košický kraj";0;0;0;0;NA;343484;0;2020-07-11;299
2020-07-10;"Košický kraj";1;0;0;0;NA;343484;1;2020-07-10;299
2020-07-09;"Košický kraj";1;0;0;0;NA;343484;1;2020-07-09;298
2020-07-08;"Košický kraj";12;0;0;0;NA;343484;12;2020-07-08;297
2020-07-07;"Košický kraj";0;0;0;0;NA;343484;0;2020-07-07;285
2020-07-06;"Košický kraj";0;0;0;0;NA;343484;0;2020-07-06;285
2020-07-05;"Košický kraj";0;0;0;0;NA;343484;0;2020-07-05;285
2020-07-04;"Košický kraj";0;0;0;0;NA;343484;0;2020-07-04;285
2020-07-03;"Košický kraj";1;0;0;0;NA;343484;1;2020-07-03;285
2020-07-02;"Košický kraj";0;0;0;0;NA;343484;0;2020-07-02;284
2020-07-01;"Košický kraj";1;0;0;0;NA;343484;1;2020-07-01;284
2020-06-30;"Košický kraj";0;0;0;0;NA;343484;0;2020-06-30;283
2020-06-29;"Košický kraj";0;0;0;0;NA;343484;0;2020-06-29;283
2020-06-28;"Košický kraj";0;0;0;0;NA;343484;0;2020-06-28;283
2020-06-27;"Košický kraj";0;0;0;0;NA;343484;0;2020-06-27;283
2020-06-26;"Košický kraj";0;0;0;0;NA;343484;0;2020-06-26;283
2020-06-25;"Košický kraj";3;0;0;0;NA;343484;3;2020-06-25;283
2020-06-24;"Košický kraj";3;0;0;0;NA;343484;3;2020-06-24;280
2020-06-23;"Košický kraj";3;0;0;0;NA;343484;3;2020-06-23;277
2020-06-22;"Košický kraj";0;0;0;0;NA;343484;0;2020-06-22;274
2020-06-21;"Košický kraj";0;0;0;0;NA;343484;0;2020-06-21;274
2020-06-20;"Košický kraj";0;0;0;0;NA;343484;0;2020-06-20;274
2020-06-19;"Košický kraj";0;0;0;0;NA;343484;0;2020-06-19;274
2020-06-18;"Košický kraj";1;0;0;0;NA;343484;1;2020-06-18;274
2020-06-17;"Košický kraj";0;0;0;0;NA;343484;0;2020-06-17;273
2020-06-16;"Košický kraj";2;0;0;0;NA;343484;2;2020-06-16;273
2020-06-14;"Košický kraj";0;0;0;0;NA;343484;0;2020-06-14;271
2020-06-13;"Košický kraj";0;0;0;0;NA;343484;0;2020-06-13;271
2020-06-12;"Košický kraj";0;0;0;0;NA;343484;0;2020-06-12;271
2020-06-11;"Košický kraj";0;0;0;0;NA;343484;0;2020-06-11;271
2020-06-10;"Košický kraj";6;0;0;0;NA;343484;6;2020-06-10;271
2020-06-09;"Košický kraj";0;0;0;0;NA;343484;0;2020-06-09;265
2020-06-08;"Košický kraj";0;0;0;0;NA;343484;0;2020-06-08;265
2020-06-07;"Košický kraj";2;0;0;0;NA;343484;2;2020-06-07;265
2020-06-05;"Košický kraj";0;0;0;0;NA;343484;0;2020-06-05;263
2020-06-03;"Košický kraj";0;0;0;0;NA;343484;0;2020-06-03;263
2020-06-02;"Košický kraj";1;0;0;0;NA;343484;1;2020-06-02;263
2020-05-31;"Košický kraj";0;0;0;0;NA;343484;0;2020-05-31;262
2020-05-29;"Košický kraj";1;0;0;0;NA;343484;1;2020-05-29;262
2020-05-27;"Košický kraj";0;0;0;0;NA;343484;0;2020-05-27;261
2020-05-26;"Košický kraj";1;0;0;0;NA;343484;1;2020-05-26;261
2020-05-25;"Košický kraj";1;0;0;0;NA;343484;1;2020-05-25;260
2020-05-24;"Košický kraj";0;0;0;0;NA;343484;0;2020-05-24;259
2020-05-23;"Košický kraj";0;0;0;0;NA;343484;0;2020-05-23;259
2020-05-22;"Košický kraj";0;0;0;0;NA;343484;0;2020-05-22;259
2020-05-21;"Košický kraj";0;0;0;0;NA;343484;0;2020-05-21;259
2020-05-20;"Košický kraj";3;0;0;0;NA;343484;3;2020-05-20;259
2020-05-19;"Košický kraj";0;0;0;0;NA;343484;0;2020-05-19;256
2020-05-17;"Košický kraj";1;0;0;0;NA;343484;1;2020-05-17;256
2020-05-16;"Košický kraj";1;0;0;0;NA;343484;1;2020-05-16;255
2020-05-15;"Košický kraj";10;0;0;0;NA;343484;10;2020-05-15;254
2020-05-14;"Košický kraj";1;0;0;0;NA;343484;1;2020-05-14;244
2020-05-13;"Košický kraj";6;0;0;0;NA;343484;6;2020-05-13;243
2020-05-12;"Košický kraj";0;0;0;0;NA;343484;0;2020-05-12;237
2020-05-11;"Košický kraj";0;0;0;0;NA;343484;0;2020-05-11;237
2020-05-09;"Košický kraj";0;0;0;0;NA;343484;0;2020-05-09;237
2020-05-07;"Košický kraj";0;0;0;0;NA;343484;0;2020-05-07;237
2020-05-06;"Košický kraj";1;0;0;0;NA;343484;1;2020-05-06;237
2020-05-05;"Košický kraj";0;0;0;0;NA;343484;0;2020-05-05;236
2020-05-04;"Košický kraj";0;0;0;0;NA;343484;0;2020-05-04;236
2020-05-03;"Košický kraj";0;0;0;0;NA;343484;0;2020-05-03;236
2020-05-02;"Košický kraj";1;0;0;0;NA;343484;1;2020-05-02;236
2020-05-01;"Košický kraj";0;0;0;0;NA;343484;0;2020-05-01;235
2020-04-30;"Košický kraj";1;0;0;0;NA;343484;1;2020-04-30;235
2020-04-29;"Košický kraj";1;0;0;0;NA;343484;1;2020-04-29;234
2020-04-28;"Košický kraj";1;0;0;0;NA;343484;1;2020-04-28;233
2020-04-27;"Košický kraj";1;0;0;0;NA;343484;1;2020-04-27;232
2020-04-26;"Košický kraj";0;0;0;0;NA;343484;0;2020-04-26;231
2020-04-25;"Košický kraj";0;0;0;0;NA;343484;0;2020-04-25;231
2020-04-24;"Košický kraj";3;0;0;0;NA;343484;3;2020-04-24;231
2020-04-23;"Košický kraj";4;0;0;0;NA;343484;4;2020-04-23;228
2020-04-22;"Košický kraj";21;0;0;0;NA;343484;21;2020-04-22;224
2020-04-21;"Košický kraj";4;0;0;0;NA;343484;4;2020-04-21;203
2020-04-20;"Košický kraj";0;0;0;0;NA;343484;0;2020-04-20;199
2020-04-19;"Košický kraj";1;0;0;0;NA;343484;1;2020-04-19;199
2020-04-18;"Košický kraj";2;0;0;0;NA;343484;2;2020-04-18;198
2020-04-17;"Košický kraj";7;0;0;0;NA;343484;7;2020-04-17;196
2020-04-16;"Košický kraj";29;0;0;0;NA;343484;29;2020-04-16;189
2020-04-15;"Košický kraj";50;0;0;0;NA;343484;50;2020-04-15;160
2020-04-14;"Košický kraj";4;0;0;0;NA;343484;4;2020-04-14;110
2020-04-13;"Košický kraj";5;0;0;0;NA;343484;5;2020-04-13;106
2020-04-12;"Košický kraj";4;0;0;0;NA;343484;4;2020-04-12;101
2020-04-11;"Košický kraj";2;0;0;0;NA;343484;2;2020-04-11;97
2020-04-10;"Košický kraj";1;0;0;0;NA;343484;1;2020-04-10;95
2020-04-09;"Košický kraj";4;0;0;0;NA;343484;4;2020-04-09;94
2020-04-08;"Košický kraj";5;0;0;0;NA;343484;5;2020-04-08;90
2020-04-07;"Košický kraj";34;0;0;0;NA;343484;34;2020-04-07;85
2020-04-06;"Košický kraj";6;0;0;0;NA;343484;6;2020-04-06;51
2020-04-05;"Košický kraj";4;0;0;0;NA;343484;4;2020-04-05;45
2020-04-04;"Košický kraj";5;0;0;0;NA;343484;5;2020-04-04;41
2020-04-03;"Košický kraj";4;0;0;0;NA;343484;4;2020-04-03;36
2020-04-02;"Košický kraj";3;0;0;0;NA;343484;3;2020-04-02;32
2020-04-01;"Košický kraj";3;0;0;0;NA;343484;3;2020-04-01;29
2020-03-31;"Košický kraj";1;0;0;0;NA;343484;1;2020-03-31;26
2020-03-30;"Košický kraj";5;0;0;0;NA;343484;5;2020-03-30;25
2020-03-29;"Košický kraj";0;0;0;0;NA;343484;0;2020-03-29;20
2020-03-28;"Košický kraj";1;0;0;0;NA;343484;1;2020-03-28;20
2020-03-27;"Košický kraj";1;0;0;0;NA;343484;1;2020-03-27;19
2020-03-26;"Košický kraj";3;0;0;0;NA;343484;3;2020-03-26;18
2020-03-25;"Košický kraj";2;0;0;0;NA;343484;2;2020-03-25;15
2020-03-24;"Košický kraj";0;0;0;0;NA;343484;0;2020-03-24;13
2020-03-23;"Košický kraj";2;0;0;0;NA;343484;2;2020-03-23;13
2020-03-22;"Košický kraj";0;0;0;0;NA;343484;0;2020-03-22;11
2020-03-21;"Košický kraj";3;0;0;0;NA;343484;3;2020-03-21;11
2020-03-20;"Košický kraj";1;0;0;0;NA;343484;1;2020-03-20;8
2020-03-19;"Košický kraj";0;0;0;0;NA;343484;0;2020-03-19;7
2020-03-18;"Košický kraj";0;0;0;0;NA;343484;0;2020-03-18;7
2020-03-17;"Košický kraj";0;0;0;0;NA;343484;0;2020-03-17;7
2020-03-16;"Košický kraj";3;0;0;0;NA;343484;3;2020-03-16;7
2020-03-15;"Košický kraj";1;0;0;0;NA;343484;1;2020-03-15;4
2020-03-14;"Košický kraj";0;0;0;0;NA;343484;0;2020-03-14;3
2020-03-13;"Košický kraj";2;0;0;0;NA;343484;2;2020-03-13;3
2020-03-12;"Košický kraj";0;0;0;0;NA;343484;0;2020-03-12;1
2020-03-11;"Košický kraj";0;0;0;0;NA;343484;0;2020-03-11;1
2020-03-09;"Košický kraj";1;0;0;0;NA;343484;1;2020-03-09;1
2020-03-08;"Košický kraj";0;0;0;0;NA;343484;0;2020-03-08;0
2020-03-07;"Košický kraj";0;0;0;0;NA;343484;0;2020-03-07;0
2020-03-06;"Košický kraj";0;0;0;0;NA;343484;0;2020-03-06;0
2022-04-25;"Nitriansky kraj";136;0;0;0;184557;282915;136;2022-04-25;282915
2022-04-24;"Nitriansky kraj";48;62;9;71;NA;282915;57;2022-04-24;282779
2022-04-23;"Nitriansky kraj";79;234;5;239;NA;282915;84;2022-04-23;282722
2022-04-22;"Nitriansky kraj";101;625;26;651;NA;282915;127;2022-04-22;282638
2022-04-21;"Nitriansky kraj";219;803;15;818;NA;282915;234;2022-04-21;282511
2022-04-20;"Nitriansky kraj";194;1007;33;1040;NA;282915;227;2022-04-20;282277
2022-04-19;"Nitriansky kraj";234;2106;83;2189;NA;282915;317;2022-04-19;282050
2022-04-18;"Nitriansky kraj";111;516;14;530;NA;282915;125;2022-04-18;281733
2022-04-17;"Nitriansky kraj";136;258;8;266;NA;282915;144;2022-04-17;281608
2022-04-16;"Nitriansky kraj";87;362;24;386;NA;282915;111;2022-04-16;281464
2022-04-15;"Nitriansky kraj";105;325;10;335;NA;282915;115;2022-04-15;281353
2022-04-14;"Nitriansky kraj";255;721;32;753;NA;282915;287;2022-04-14;281238
2022-04-13;"Nitriansky kraj";223;906;60;966;NA;282915;283;2022-04-13;280951
2022-04-12;"Nitriansky kraj";291;1043;60;1103;NA;282915;351;2022-04-12;280668
2022-04-11;"Nitriansky kraj";278;1668;101;1769;NA;282915;379;2022-04-11;280317
2022-04-10;"Nitriansky kraj";154;512;43;555;NA;282915;197;2022-04-10;279938
2022-04-09;"Nitriansky kraj";176;391;29;420;NA;282915;205;2022-04-09;279741
2022-04-08;"Nitriansky kraj";363;1066;76;1142;NA;282915;439;2022-04-08;279536
2022-04-07;"Nitriansky kraj";427;1293;115;1408;NA;282915;542;2022-04-07;279097
2022-04-06;"Nitriansky kraj";406;1191;98;1289;NA;282915;504;2022-04-06;278555
2022-04-05;"Nitriansky kraj";783;1195;110;1305;NA;282915;893;2022-04-05;278051
2022-04-04;"Nitriansky kraj";572;1570;152;1722;NA;282915;724;2022-04-04;277158
2022-04-03;"Nitriansky kraj";199;918;98;1016;NA;282915;297;2022-04-03;276434
2022-04-02;"Nitriansky kraj";362;450;45;495;NA;282915;407;2022-04-02;276137
2022-04-01;"Nitriansky kraj";614;1283;129;1412;NA;282915;743;2022-04-01;275730
2022-03-31;"Nitriansky kraj";685;1558;159;1717;NA;282915;844;2022-03-31;274987
2022-03-30;"Nitriansky kraj";751;1233;132;1365;NA;282915;883;2022-03-30;274143
2022-03-29;"Nitriansky kraj";1187;1523;175;1698;NA;282915;1362;2022-03-29;273260
2022-03-28;"Nitriansky kraj";711;1954;288;2242;NA;282915;999;2022-03-28;271898
2022-03-27;"Nitriansky kraj";463;790;148;938;NA;282915;611;2022-03-27;270899
2022-03-26;"Nitriansky kraj";653;408;83;491;NA;282915;736;2022-03-26;270288
2022-03-25;"Nitriansky kraj";918;1128;220;1348;NA;282915;1138;2022-03-25;269552
2022-03-24;"Nitriansky kraj";1391;1262;194;1456;NA;282915;1585;2022-03-24;268414
2022-03-23;"Nitriansky kraj";1401;1456;232;1688;NA;282915;1633;2022-03-23;266829
2022-03-22;"Nitriansky kraj";1360;1553;199;1752;NA;282915;1559;2022-03-22;265196
2022-03-21;"Nitriansky kraj";1304;2135;351;2486;NA;282915;1655;2022-03-21;263637
2022-03-20;"Nitriansky kraj";552;933;226;1159;NA;282915;778;2022-03-20;261982
2022-03-19;"Nitriansky kraj";839;424;146;570;NA;282915;985;2022-03-19;261204
2022-03-18;"Nitriansky kraj";1205;1201;271;1472;NA;282915;1476;2022-03-18;260219
2022-03-17;"Nitriansky kraj";1734;1473;236;1709;NA;282915;1970;2022-03-17;258743
2022-03-16;"Nitriansky kraj";1214;1472;232;1704;NA;282915;1446;2022-03-16;256773
2022-03-15;"Nitriansky kraj";1590;1566;256;1822;NA;282915;1846;2022-03-15;255327
2022-03-14;"Nitriansky kraj";1325;2630;384;3014;NA;282915;1709;2022-03-14;253481
2022-03-13;"Nitriansky kraj";527;992;202;1194;NA;282915;729;2022-03-13;251772
2022-03-12;"Nitriansky kraj";711;739;169;908;NA;282915;880;2022-03-12;251043
2022-03-11;"Nitriansky kraj";1085;1890;365;2255;NA;282915;1450;2022-03-11;250163
2022-03-10;"Nitriansky kraj";1403;2015;313;2328;NA;282915;1716;2022-03-10;248713
2022-03-09;"Nitriansky kraj";1452;2118;323;2441;NA;282915;1775;2022-03-09;246997
2022-03-08;"Nitriansky kraj";1695;2542;350;2892;NA;282915;2045;2022-03-08;245222
2022-03-07;"Nitriansky kraj";1115;3386;521;3907;NA;282915;1636;2022-03-07;243177
2022-03-06;"Nitriansky kraj";566;1509;350;1859;NA;282915;916;2022-03-06;241541
2022-03-05;"Nitriansky kraj";614;1239;214;1453;NA;282915;828;2022-03-05;240625
2022-03-04;"Nitriansky kraj";1315;1597;323;1920;NA;282915;1638;2022-03-04;239797
2022-03-03;"Nitriansky kraj";1405;2944;379;3323;NA;282915;1784;2022-03-03;238159
2022-03-02;"Nitriansky kraj";1417;2717;422;3139;NA;282915;1839;2022-03-02;236375
2022-03-01;"Nitriansky kraj";1380;2422;412;2834;NA;282915;1792;2022-03-01;234536
2022-02-28;"Nitriansky kraj";1577;4819;599;5418;NA;282915;2176;2022-02-28;232744
2022-02-27;"Nitriansky kraj";797;1271;294;1565;NA;282915;1091;2022-02-27;230568
2022-02-26;"Nitriansky kraj";895;799;217;1016;NA;282915;1112;2022-02-26;229477
2022-02-25;"Nitriansky kraj";1400;2314;339;2653;NA;282915;1739;2022-02-25;228365
2022-02-24;"Nitriansky kraj";1592;3586;389;3975;NA;282915;1981;2022-02-24;226626
2022-02-23;"Nitriansky kraj";1885;3930;476;4406;NA;282915;2361;2022-02-23;224645
2022-02-22;"Nitriansky kraj";2323;3849;502;4351;NA;282915;2825;2022-02-22;222284
2022-02-21;"Nitriansky kraj";1593;6250;816;7066;NA;282915;2409;2022-02-21;219459
2022-02-20;"Nitriansky kraj";1049;1987;439;2426;NA;282915;1488;2022-02-20;217050
2022-02-19;"Nitriansky kraj";1084;1341;336;1677;NA;282915;1420;2022-02-19;215562
2022-02-18;"Nitriansky kraj";2021;3277;583;3860;NA;282915;2604;2022-02-18;214142
2022-02-17;"Nitriansky kraj";2134;3890;480;4370;NA;282915;2614;2022-02-17;211538
2022-02-16;"Nitriansky kraj";2152;3945;532;4477;NA;282915;2684;2022-02-16;208924
2022-02-15;"Nitriansky kraj";2093;4069;780;4849;NA;282915;2873;2022-02-15;206240
2022-02-14;"Nitriansky kraj";2094;6253;921;7174;NA;282915;3015;2022-02-14;203367
2022-02-13;"Nitriansky kraj";1146;2832;547;3379;NA;282915;1693;2022-02-13;200352
2022-02-12;"Nitriansky kraj";1301;1171;343;1514;NA;282915;1644;2022-02-12;198659
2022-02-11;"Nitriansky kraj";2042;2942;561;3503;NA;282915;2603;2022-02-11;197015
2022-02-10;"Nitriansky kraj";2374;3366;537;3903;NA;282915;2911;2022-02-10;194412
2022-02-09;"Nitriansky kraj";2133;4802;653;5455;NA;282915;2786;2022-02-09;191501
2022-02-08;"Nitriansky kraj";1801;4935;736;5671;NA;282915;2537;2022-02-08;188715
2022-02-07;"Nitriansky kraj";2240;6803;762;7565;NA;282915;3002;2022-02-07;186178
2022-02-06;"Nitriansky kraj";1309;2690;494;3184;NA;282915;1803;2022-02-06;183176
2022-02-05;"Nitriansky kraj";1609;1504;358;1862;NA;282915;1967;2022-02-05;181373
2022-02-04;"Nitriansky kraj";1848;4185;510;4695;NA;282915;2358;2022-02-04;179406
2022-02-03;"Nitriansky kraj";2425;4186;491;4677;NA;282915;2916;2022-02-03;177048
2022-02-02;"Nitriansky kraj";1903;5318;766;6084;NA;282915;2669;2022-02-02;174132
2022-02-01;"Nitriansky kraj";2288;4717;597;5314;NA;282915;2885;2022-02-01;171463
2022-01-31;"Nitriansky kraj";1329;8991;746;9737;NA;282915;2075;2022-01-31;168578
2022-01-30;"Nitriansky kraj";777;3498;471;3969;NA;282915;1248;2022-01-30;166503
2022-01-29;"Nitriansky kraj";1099;1670;298;1968;NA;282915;1397;2022-01-29;165255
2022-01-28;"Nitriansky kraj";1610;4217;374;4591;NA;282915;1984;2022-01-28;163858
2022-01-27;"Nitriansky kraj";1429;3796;289;4085;NA;282915;1718;2022-01-27;161874
2022-01-26;"Nitriansky kraj";1392;4444;306;4750;NA;282915;1698;2022-01-26;160156
2022-01-25;"Nitriansky kraj";1591;4624;426;5050;NA;282915;2017;2022-01-25;158458
2022-01-24;"Nitriansky kraj";770;7459;359;7818;NA;282915;1129;2022-01-24;156441
2022-01-23;"Nitriansky kraj";327;3109;205;3314;NA;282915;532;2022-01-23;155312
2022-01-22;"Nitriansky kraj";596;1974;153;2127;NA;282915;749;2022-01-22;154780
2022-01-21;"Nitriansky kraj";532;3472;141;3613;NA;282915;673;2022-01-21;154031
2022-01-20;"Nitriansky kraj";737;3537;129;3666;NA;282915;866;2022-01-20;153358
2022-01-19;"Nitriansky kraj";614;4581;121;4702;NA;282915;735;2022-01-19;152492
2022-01-18;"Nitriansky kraj";650;3329;125;3454;NA;282915;775;2022-01-18;151757
2022-01-17;"Nitriansky kraj";439;7781;152;7933;NA;282915;591;2022-01-17;150982
2022-01-16;"Nitriansky kraj";140;3191;71;3262;NA;282915;211;2022-01-16;150391
2022-01-15;"Nitriansky kraj";268;1651;50;1701;NA;282915;318;2022-01-15;150180
2022-01-14;"Nitriansky kraj";167;2900;68;2968;NA;282915;235;2022-01-14;149862
2022-01-13;"Nitriansky kraj";244;3297;53;3350;NA;282915;297;2022-01-13;149627
2022-01-12;"Nitriansky kraj";298;4325;66;4391;NA;282915;364;2022-01-12;149330
2022-01-11;"Nitriansky kraj";424;3990;50;4040;NA;282915;474;2022-01-11;148966
2022-01-10;"Nitriansky kraj";292;7648;71;7719;NA;282915;363;2022-01-10;148492
2022-01-09;"Nitriansky kraj";100;3419;48;3467;NA;282915;148;2022-01-09;148129
2022-01-08;"Nitriansky kraj";206;1352;47;1399;NA;282915;253;2022-01-08;147981
2022-01-07;"Nitriansky kraj";326;2970;74;3044;NA;282915;400;2022-01-07;147728
2022-01-06;"Nitriansky kraj";125;910;33;943;NA;282915;158;2022-01-06;147328
2022-01-05;"Nitriansky kraj";357;4227;66;4293;NA;282915;423;2022-01-05;147170
2022-01-04;"Nitriansky kraj";453;3697;85;3782;NA;282915;538;2022-01-04;146747
2022-01-03;"Nitriansky kraj";353;7361;117;7478;NA;282915;470;2022-01-03;146209
2022-01-02;"Nitriansky kraj";25;3035;95;3130;NA;282915;120;2022-01-02;145739
2022-01-01;"Nitriansky kraj";71;177;9;186;NA;282915;80;2022-01-01;145619
2021-12-31;"Nitriansky kraj";382;1506;69;1575;NA;282915;451;2021-12-31;145539
2021-12-30;"Nitriansky kraj";325;3330;89;3419;NA;282915;414;2021-12-30;145088
2021-12-29;"Nitriansky kraj";347;2371;61;2432;NA;282915;408;2021-12-29;144674
2021-12-28;"Nitriansky kraj";628;2501;88;2589;NA;282915;716;2021-12-28;144266
2021-12-27;"Nitriansky kraj";402;4253;169;4422;NA;282915;571;2021-12-27;143550
2021-12-26;"Nitriansky kraj";84;1039;53;1092;NA;282915;137;2021-12-26;142979
2021-12-25;"Nitriansky kraj";22;499;31;530;NA;282915;53;2021-12-25;142842
2021-12-24;"Nitriansky kraj";175;448;26;474;NA;282915;201;2021-12-24;142789
2021-12-23;"Nitriansky kraj";472;3420;110;3530;NA;282915;582;2021-12-23;142588
2021-12-22;"Nitriansky kraj";398;3517;95;3612;NA;282915;493;2021-12-22;142006
2021-12-21;"Nitriansky kraj";735;2913;93;3006;NA;282915;828;2021-12-21;141513
2021-12-20;"Nitriansky kraj";407;6754;169;6923;NA;282915;576;2021-12-20;140685
2021-12-19;"Nitriansky kraj";198;3587;98;3685;NA;282915;296;2021-12-19;140109
2021-12-18;"Nitriansky kraj";361;1456;96;1552;NA;282915;457;2021-12-18;139813
2021-12-17;"Nitriansky kraj";409;4934;153;5087;NA;282915;562;2021-12-17;139356
2021-12-16;"Nitriansky kraj";429;4230;144;4374;NA;282915;573;2021-12-16;138794
2021-12-15;"Nitriansky kraj";639;5682;143;5825;NA;282915;782;2021-12-15;138221
2021-12-14;"Nitriansky kraj";907;4720;200;4920;NA;282915;1107;2021-12-14;137439
2021-12-13;"Nitriansky kraj";524;7388;291;7679;NA;282915;815;2021-12-13;136332
2021-12-12;"Nitriansky kraj";289;3893;174;4067;NA;282915;463;2021-12-12;135517
2021-12-11;"Nitriansky kraj";458;1754;121;1875;NA;282915;579;2021-12-11;135054
2021-12-10;"Nitriansky kraj";591;4868;177;5045;NA;282915;768;2021-12-10;134475
2021-12-09;"Nitriansky kraj";741;3428;202;3630;NA;282915;943;2021-12-09;133707
2021-12-08;"Nitriansky kraj";954;5136;200;5336;NA;282915;1154;2021-12-08;132764
2021-12-07;"Nitriansky kraj";900;4045;197;4242;NA;282915;1097;2021-12-07;131610
2021-12-06;"Nitriansky kraj";699;8196;339;8535;NA;282915;1038;2021-12-06;130513
2021-12-05;"Nitriansky kraj";337;4314;192;4506;NA;282915;529;2021-12-05;129475
2021-12-04;"Nitriansky kraj";758;2045;180;2225;NA;282915;938;2021-12-04;128946
2021-12-03;"Nitriansky kraj";920;5783;237;6020;NA;282915;1157;2021-12-03;128008
2021-12-02;"Nitriansky kraj";1388;3898;267;4165;NA;282915;1655;2021-12-02;126851
2021-12-01;"Nitriansky kraj";982;4107;261;4368;NA;282915;1243;2021-12-01;125196
2021-11-30;"Nitriansky kraj";751;5575;241;5816;NA;282915;992;2021-11-30;123953
2021-11-29;"Nitriansky kraj";665;10167;500;10667;NA;282915;1165;2021-11-29;122961
2021-11-28;"Nitriansky kraj";357;6214;300;6514;NA;282915;657;2021-11-28;121796
2021-11-27;"Nitriansky kraj";560;2879;281;3160;NA;282915;841;2021-11-27;121139
2021-11-26;"Nitriansky kraj";824;5529;290;5819;NA;282915;1114;2021-11-26;120298
2021-11-25;"Nitriansky kraj";847;4154;342;4496;NA;282915;1189;2021-11-25;119184
2021-11-24;"Nitriansky kraj";875;4422;325;4747;NA;282915;1200;2021-11-24;117995
2021-11-23;"Nitriansky kraj";1103;5148;353;5501;NA;282915;1456;2021-11-23;116795
2021-11-22;"Nitriansky kraj";545;7126;465;7591;NA;282915;1010;2021-11-22;115339
2021-11-21;"Nitriansky kraj";345;3410;314;3724;NA;282915;659;2021-11-21;114329
2021-11-20;"Nitriansky kraj";579;1865;252;2117;NA;282915;831;2021-11-20;113670
2021-11-19;"Nitriansky kraj";571;4256;349;4605;NA;282915;920;2021-11-19;112839
2021-11-18;"Nitriansky kraj";677;4883;420;5303;NA;282915;1097;2021-11-18;111919
2021-11-17;"Nitriansky kraj";479;1622;207;1829;NA;282915;686;2021-11-17;110822
2021-11-16;"Nitriansky kraj";668;3882;266;4148;NA;282915;934;2021-11-16;110136
2021-11-15;"Nitriansky kraj";556;6033;440;6473;NA;282915;996;2021-11-15;109202
2021-11-14;"Nitriansky kraj";229;2796;259;3055;NA;282915;488;2021-11-14;108206
2021-11-13;"Nitriansky kraj";387;1473;201;1674;NA;282915;588;2021-11-13;107718
2021-11-12;"Nitriansky kraj";552;3096;270;3366;NA;282915;822;2021-11-12;107130
2021-11-11;"Nitriansky kraj";539;3545;238;3783;NA;282915;777;2021-11-11;106308
2021-11-10;"Nitriansky kraj";411;3494;234;3728;NA;282915;645;2021-11-10;105531
2021-11-09;"Nitriansky kraj";413;3313;210;3523;NA;282915;623;2021-11-09;104886
2021-11-08;"Nitriansky kraj";464;4936;331;5267;NA;282915;795;2021-11-08;104263
2021-11-07;"Nitriansky kraj";209;2074;161;2235;NA;282915;370;2021-11-07;103468
2021-11-06;"Nitriansky kraj";236;1407;114;1521;NA;282915;350;2021-11-06;103098
2021-11-05;"Nitriansky kraj";407;2583;185;2768;NA;282915;592;2021-11-05;102748
2021-11-04;"Nitriansky kraj";437;3083;168;3251;NA;282915;605;2021-11-04;102156
2021-11-03;"Nitriansky kraj";525;2891;157;3048;NA;282915;682;2021-11-03;101551
2021-11-02;"Nitriansky kraj";320;4279;239;4518;NA;282915;559;2021-11-02;100869
2021-11-01;"Nitriansky kraj";136;712;61;773;NA;282915;197;2021-11-01;100310
2021-10-31;"Nitriansky kraj";109;1234;114;1348;NA;282915;223;2021-10-31;100113
2021-10-30;"Nitriansky kraj";202;1218;82;1300;NA;282915;284;2021-10-30;99890
2021-10-29;"Nitriansky kraj";347;2481;120;2601;NA;282915;467;2021-10-29;99606
2021-10-28;"Nitriansky kraj";281;2603;95;2698;NA;282915;376;2021-10-28;99139
2021-10-27;"Nitriansky kraj";340;2923;112;3035;NA;282915;452;2021-10-27;98763
2021-10-26;"Nitriansky kraj";297;2926;117;3043;NA;282915;414;2021-10-26;98311
2021-10-25;"Nitriansky kraj";171;3599;124;3723;NA;282915;295;2021-10-25;97897
2021-10-24;"Nitriansky kraj";58;1914;74;1988;NA;282915;132;2021-10-24;97602
2021-10-23;"Nitriansky kraj";173;1815;77;1892;NA;282915;250;2021-10-23;97470
2021-10-22;"Nitriansky kraj";202;2216;68;2284;NA;282915;270;2021-10-22;97220
2021-10-21;"Nitriansky kraj";214;2793;65;2858;NA;282915;279;2021-10-21;96950
2021-10-20;"Nitriansky kraj";218;2328;74;2402;NA;282915;292;2021-10-20;96671
2021-10-19;"Nitriansky kraj";250;2929;65;2994;NA;282915;315;2021-10-19;96379
2021-10-18;"Nitriansky kraj";81;3259;90;3349;NA;282915;171;2021-10-18;96064
2021-10-17;"Nitriansky kraj";36;3010;92;3102;NA;282915;128;2021-10-17;95893
2021-10-16;"Nitriansky kraj";37;1477;38;1515;NA;282915;75;2021-10-16;95765
2021-10-15;"Nitriansky kraj";145;2653;34;2687;NA;282915;179;2021-10-15;95690
2021-10-14;"Nitriansky kraj";95;2389;30;2419;NA;282915;125;2021-10-14;95511
2021-10-13;"Nitriansky kraj";91;2248;36;2284;NA;282915;127;2021-10-13;95386
2021-10-12;"Nitriansky kraj";119;2905;34;2939;NA;282915;153;2021-10-12;95259
2021-10-11;"Nitriansky kraj";91;2703;42;2745;NA;282915;133;2021-10-11;95106
2021-10-10;"Nitriansky kraj";33;1527;22;1549;NA;282915;55;2021-10-10;94973
2021-10-09;"Nitriansky kraj";17;1395;17;1412;NA;282915;34;2021-10-09;94918
2021-10-08;"Nitriansky kraj";61;3004;37;3041;NA;282915;98;2021-10-08;94884
2021-10-07;"Nitriansky kraj";59;2829;30;2859;NA;282915;89;2021-10-07;94786
2021-10-06;"Nitriansky kraj";66;2657;28;2685;NA;282915;94;2021-10-06;94697
2021-10-05;"Nitriansky kraj";97;2536;32;2568;NA;282915;129;2021-10-05;94603
2021-10-04;"Nitriansky kraj";56;3263;49;3312;NA;282915;105;2021-10-04;94474
2021-10-03;"Nitriansky kraj";10;1591;24;1615;NA;282915;34;2021-10-03;94369
2021-10-02;"Nitriansky kraj";46;1567;20;1587;NA;282915;66;2021-10-02;94335
2021-10-01;"Nitriansky kraj";26;2860;34;2894;NA;282915;60;2021-10-01;94269
2021-09-30;"Nitriansky kraj";66;2468;15;2483;NA;282915;81;2021-09-30;94209
2021-09-29;"Nitriansky kraj";92;2266;16;2282;NA;282915;108;2021-09-29;94128
2021-09-28;"Nitriansky kraj";86;2893;27;2920;NA;282915;113;2021-09-28;94020
2021-09-27;"Nitriansky kraj";50;3633;41;3674;NA;282915;91;2021-09-27;93907
2021-09-26;"Nitriansky kraj";12;1635;20;1655;NA;282915;32;2021-09-26;93816
2021-09-25;"Nitriansky kraj";43;1456;20;1476;NA;282915;63;2021-09-25;93784
2021-09-24;"Nitriansky kraj";35;2783;15;2798;NA;282915;50;2021-09-24;93721
2021-09-23;"Nitriansky kraj";69;2503;20;2523;NA;282915;89;2021-09-23;93671
2021-09-22;"Nitriansky kraj";68;2380;17;2397;NA;282915;85;2021-09-22;93582
2021-09-21;"Nitriansky kraj";70;2684;30;2714;NA;282915;100;2021-09-21;93497
2021-09-20;"Nitriansky kraj";41;2497;21;2518;NA;282915;62;2021-09-20;93397
2021-09-19;"Nitriansky kraj";16;1553;20;1573;NA;282915;36;2021-09-19;93335
2021-09-18;"Nitriansky kraj";42;1421;19;1440;NA;282915;61;2021-09-18;93299
2021-09-17;"Nitriansky kraj";54;2757;30;2787;NA;282915;84;2021-09-17;93238
2021-09-16;"Nitriansky kraj";55;2499;44;2543;NA;282915;99;2021-09-16;93154
2021-09-15;"Nitriansky kraj";34;538;12;550;NA;282915;46;2021-09-15;93055
2021-09-14;"Nitriansky kraj";52;1821;20;1841;NA;282915;72;2021-09-14;93009
2021-09-13;"Nitriansky kraj";27;2373;27;2400;NA;282915;54;2021-09-13;92937
2021-09-12;"Nitriansky kraj";4;1182;17;1199;NA;282915;21;2021-09-12;92883
2021-09-11;"Nitriansky kraj";36;1181;8;1189;NA;282915;44;2021-09-11;92862
2021-09-10;"Nitriansky kraj";25;2133;12;2145;NA;282915;37;2021-09-10;92818
2021-09-09;"Nitriansky kraj";15;1611;20;1631;NA;282915;35;2021-09-09;92781
2021-09-08;"Nitriansky kraj";30;1463;22;1485;NA;282915;52;2021-09-08;92746
2021-09-07;"Nitriansky kraj";35;1460;9;1469;NA;282915;44;2021-09-07;92694
2021-09-06;"Nitriansky kraj";19;1668;27;1695;NA;282915;46;2021-09-06;92650
2021-09-05;"Nitriansky kraj";10;1007;8;1015;NA;282915;18;2021-09-05;92604
2021-09-04;"Nitriansky kraj";18;1119;10;1129;NA;282915;28;2021-09-04;92586
2021-09-03;"Nitriansky kraj";20;1743;17;1760;NA;282915;37;2021-09-03;92558
2021-09-02;"Nitriansky kraj";16;1389;14;1403;NA;282915;30;2021-09-02;92521
2021-09-01;"Nitriansky kraj";9;337;2;339;NA;282915;11;2021-09-01;92491
2021-08-31;"Nitriansky kraj";10;1360;6;1366;NA;282915;16;2021-08-31;92480
2021-08-30;"Nitriansky kraj";8;1381;10;1391;NA;282915;18;2021-08-30;92464
2021-08-29;"Nitriansky kraj";2;450;1;451;NA;282915;3;2021-08-29;92446
2021-08-28;"Nitriansky kraj";5;1071;3;1074;NA;282915;8;2021-08-28;92443
2021-08-27;"Nitriansky kraj";7;1804;4;1808;NA;282915;11;2021-08-27;92435
2021-08-26;"Nitriansky kraj";2;1255;6;1261;NA;282915;8;2021-08-26;92424
2021-08-25;"Nitriansky kraj";15;1087;3;1090;NA;282915;18;2021-08-25;92416
2021-08-24;"Nitriansky kraj";6;990;2;992;NA;282915;8;2021-08-24;92398
2021-08-23;"Nitriansky kraj";13;1271;4;1275;NA;282915;17;2021-08-23;92390
2021-08-22;"Nitriansky kraj";0;1167;3;1170;NA;282915;3;2021-08-22;92373
2021-08-21;"Nitriansky kraj";1;853;2;855;NA;282915;3;2021-08-21;92370
2021-08-20;"Nitriansky kraj";8;1580;5;1585;NA;282915;13;2021-08-20;92367
2021-08-19;"Nitriansky kraj";11;1167;4;1171;NA;282915;15;2021-08-19;92354
2021-08-18;"Nitriansky kraj";8;1180;7;1187;NA;282915;15;2021-08-18;92339
2021-08-17;"Nitriansky kraj";4;1035;3;1038;NA;282915;7;2021-08-17;92324
2021-08-16;"Nitriansky kraj";7;1129;4;1133;NA;282915;11;2021-08-16;92317
2021-08-15;"Nitriansky kraj";2;662;1;663;NA;282915;3;2021-08-15;92306
2021-08-14;"Nitriansky kraj";1;878;5;883;NA;282915;6;2021-08-14;92303
2021-08-13;"Nitriansky kraj";0;957;1;958;NA;282915;1;2021-08-13;92297
2021-08-12;"Nitriansky kraj";5;765;0;765;NA;282915;5;2021-08-12;92296
2021-08-11;"Nitriansky kraj";3;527;1;528;NA;282915;4;2021-08-11;92291
2021-08-10;"Nitriansky kraj";3;570;1;571;NA;282915;4;2021-08-10;92287
2021-08-09;"Nitriansky kraj";3;992;1;993;NA;282915;4;2021-08-09;92283
2021-08-08;"Nitriansky kraj";0;668;1;669;NA;282915;1;2021-08-08;92279
2021-08-07;"Nitriansky kraj";0;557;1;558;NA;282915;1;2021-08-07;92278
2021-08-06;"Nitriansky kraj";5;799;0;799;NA;282915;5;2021-08-06;92277
2021-08-05;"Nitriansky kraj";6;612;0;612;NA;282915;6;2021-08-05;92272
2021-08-04;"Nitriansky kraj";1;497;2;499;NA;282915;3;2021-08-04;92266
2021-08-03;"Nitriansky kraj";5;1455;0;1455;NA;282915;5;2021-08-03;92263
2021-08-02;"Nitriansky kraj";1;683;4;687;NA;282915;5;2021-08-02;92258
2021-08-01;"Nitriansky kraj";1;606;0;606;NA;282915;1;2021-08-01;92253
2021-07-31;"Nitriansky kraj";1;514;1;515;NA;282915;2;2021-07-31;92252
2021-07-30;"Nitriansky kraj";2;827;0;827;NA;282915;2;2021-07-30;92250
2021-07-29;"Nitriansky kraj";3;720;2;722;NA;282915;5;2021-07-29;92248
2021-07-28;"Nitriansky kraj";4;598;0;598;NA;282915;4;2021-07-28;92243
2021-07-27;"Nitriansky kraj";12;602;1;603;NA;282915;13;2021-07-27;92239
2021-07-26;"Nitriansky kraj";7;970;1;971;NA;282915;8;2021-07-26;92226
2021-07-25;"Nitriansky kraj";1;654;1;655;NA;282915;2;2021-07-25;92218
2021-07-24;"Nitriansky kraj";0;620;0;620;NA;282915;0;2021-07-24;92216
2021-07-23;"Nitriansky kraj";3;851;1;852;NA;282915;4;2021-07-23;92216
2021-07-22;"Nitriansky kraj";5;689;0;689;NA;282915;5;2021-07-22;92212
2021-07-21;"Nitriansky kraj";6;650;2;652;NA;282915;8;2021-07-21;92207
2021-07-20;"Nitriansky kraj";1;527;1;528;NA;282915;2;2021-07-20;92199
2021-07-19;"Nitriansky kraj";2;965;0;965;NA;282915;2;2021-07-19;92197
2021-07-18;"Nitriansky kraj";1;747;0;747;NA;282915;1;2021-07-18;92195
2021-07-17;"Nitriansky kraj";5;612;0;612;NA;282915;5;2021-07-17;92194
2021-07-16;"Nitriansky kraj";2;876;0;876;NA;282915;2;2021-07-16;92189
2021-07-15;"Nitriansky kraj";11;708;0;708;NA;282915;11;2021-07-15;92187
2021-07-14;"Nitriansky kraj";4;646;0;646;NA;282915;4;2021-07-14;92176
2021-07-13;"Nitriansky kraj";2;697;2;699;NA;282915;4;2021-07-13;92172
2021-07-12;"Nitriansky kraj";1;819;0;819;NA;282915;1;2021-07-12;92168
2021-07-11;"Nitriansky kraj";1;961;0;961;NA;282915;1;2021-07-11;92167
2021-07-10;"Nitriansky kraj";1;630;0;630;NA;282915;1;2021-07-10;92166
2021-07-09;"Nitriansky kraj";3;1000;0;1000;NA;282915;3;2021-07-09;92165
2021-07-08;"Nitriansky kraj";0;683;0;683;NA;282915;0;2021-07-08;92162
2021-07-07;"Nitriansky kraj";2;935;2;937;NA;282915;4;2021-07-07;92162
2021-07-06;"Nitriansky kraj";1;1269;1;1270;NA;282915;2;2021-07-06;92158
2021-07-05;"Nitriansky kraj";1;507;0;507;NA;282915;1;2021-07-05;92156
2021-07-04;"Nitriansky kraj";0;821;1;822;NA;282915;1;2021-07-04;92155
2021-07-03;"Nitriansky kraj";0;611;0;611;NA;282915;0;2021-07-03;92154
2021-07-02;"Nitriansky kraj";0;1259;0;1259;NA;282915;0;2021-07-02;92154
2021-07-01;"Nitriansky kraj";0;369;1;370;NA;282915;1;2021-07-01;92154
2021-06-30;"Nitriansky kraj";1;6777;2;6779;NA;282915;3;2021-06-30;92153
2021-06-29;"Nitriansky kraj";1;3536;0;3536;NA;282915;1;2021-06-29;92150
2021-06-28;"Nitriansky kraj";3;4393;0;4393;NA;282915;3;2021-06-28;92149
2021-06-27;"Nitriansky kraj";0;3263;0;3263;NA;282915;0;2021-06-27;92146
2021-06-26;"Nitriansky kraj";1;4979;3;4982;NA;282915;4;2021-06-26;92146
2021-06-25;"Nitriansky kraj";8;5182;1;5183;NA;282915;9;2021-06-25;92142
2021-06-24;"Nitriansky kraj";1;3354;0;3354;NA;282915;1;2021-06-24;92133
2021-06-23;"Nitriansky kraj";1;3033;0;3033;NA;282915;1;2021-06-23;92132
2021-06-22;"Nitriansky kraj";1;3240;3;3243;NA;282915;4;2021-06-22;92131
2021-06-21;"Nitriansky kraj";8;5362;8;5370;NA;282915;16;2021-06-21;92127
2021-06-20;"Nitriansky kraj";0;4437;6;4443;NA;282915;6;2021-06-20;92111
2021-06-19;"Nitriansky kraj";0;5983;4;5987;NA;282915;4;2021-06-19;92105
2021-06-18;"Nitriansky kraj";4;6453;3;6456;NA;282915;7;2021-06-18;92101
2021-06-17;"Nitriansky kraj";5;4152;1;4153;NA;282915;6;2021-06-17;92094
2021-06-16;"Nitriansky kraj";4;3694;3;3697;NA;282915;7;2021-06-16;92088
2021-06-15;"Nitriansky kraj";1;3995;0;3995;NA;282915;1;2021-06-15;92081
2021-06-14;"Nitriansky kraj";0;5875;3;5878;NA;282915;3;2021-06-14;92080
2021-06-13;"Nitriansky kraj";0;6073;3;6076;NA;282915;3;2021-06-13;92077
2021-06-12;"Nitriansky kraj";1;8293;1;8294;NA;282915;2;2021-06-12;92074
2021-06-11;"Nitriansky kraj";3;6891;4;6895;NA;282915;7;2021-06-11;92072
2021-06-10;"Nitriansky kraj";7;4539;1;4540;NA;282915;8;2021-06-10;92065
2021-06-09;"Nitriansky kraj";2;4706;2;4708;NA;282915;4;2021-06-09;92057
2021-06-08;"Nitriansky kraj";8;4239;3;4242;NA;282915;11;2021-06-08;92053
2021-06-07;"Nitriansky kraj";6;5841;8;5849;NA;282915;14;2021-06-07;92042
2021-06-06;"Nitriansky kraj";0;6981;4;6985;NA;282915;4;2021-06-06;92028
2021-06-05;"Nitriansky kraj";6;9089;9;9098;NA;282915;15;2021-06-05;92024
2021-06-04;"Nitriansky kraj";9;7639;5;7644;NA;282915;14;2021-06-04;92009
2021-06-03;"Nitriansky kraj";2;5064;6;5070;NA;282915;8;2021-06-03;91995
2021-06-02;"Nitriansky kraj";11;5119;11;5130;NA;282915;22;2021-06-02;91987
2021-06-01;"Nitriansky kraj";3;4862;2;4864;NA;282915;5;2021-06-01;91965
2021-05-31;"Nitriansky kraj";8;8933;8;8941;NA;282915;16;2021-05-31;91960
2021-05-30;"Nitriansky kraj";1;9067;8;9075;NA;282915;9;2021-05-30;91944
2021-05-29;"Nitriansky kraj";2;13610;7;13617;NA;282915;9;2021-05-29;91935
2021-05-28;"Nitriansky kraj";10;8872;6;8878;NA;282915;16;2021-05-28;91926
2021-05-27;"Nitriansky kraj";4;6164;5;6169;NA;282915;9;2021-05-27;91910
2021-05-26;"Nitriansky kraj";11;8509;10;8519;NA;282915;21;2021-05-26;91901
2021-05-25;"Nitriansky kraj";15;7350;8;7358;NA;282915;23;2021-05-25;91880
2021-05-24;"Nitriansky kraj";14;9816;17;9833;NA;282915;31;2021-05-24;91857
2021-05-23;"Nitriansky kraj";1;9456;13;9469;NA;282915;14;2021-05-23;91826
2021-05-22;"Nitriansky kraj";7;16939;11;16950;NA;282915;18;2021-05-22;91812
2021-05-21;"Nitriansky kraj";18;10632;15;10647;NA;282915;33;2021-05-21;91794
2021-05-20;"Nitriansky kraj";8;7185;7;7192;NA;282915;15;2021-05-20;91761
2021-05-19;"Nitriansky kraj";20;6787;14;6801;NA;282915;34;2021-05-19;91746
2021-05-18;"Nitriansky kraj";23;7797;18;7815;NA;282915;41;2021-05-18;91712
2021-05-17;"Nitriansky kraj";22;9774;20;9794;NA;282915;42;2021-05-17;91671
2021-05-16;"Nitriansky kraj";4;13830;15;13845;NA;282915;19;2021-05-16;91629
2021-05-15;"Nitriansky kraj";5;25389;23;25412;NA;282915;28;2021-05-15;91610
2021-05-14;"Nitriansky kraj";18;13385;23;13408;NA;282915;41;2021-05-14;91582
2021-05-13;"Nitriansky kraj";24;8289;19;8308;NA;282915;43;2021-05-13;91541
2021-05-12;"Nitriansky kraj";10;7682;26;7708;NA;282915;36;2021-05-12;91498
2021-05-11;"Nitriansky kraj";36;8169;13;8182;NA;282915;49;2021-05-11;91462
2021-05-10;"Nitriansky kraj";16;13800;42;13842;NA;282915;58;2021-05-10;91413
2021-05-09;"Nitriansky kraj";8;21879;35;21914;NA;282915;43;2021-05-09;91355
2021-05-08;"Nitriansky kraj";0;24318;29;24347;NA;282915;29;2021-05-08;91312
2021-05-07;"Nitriansky kraj";32;14915;20;14935;NA;282915;52;2021-05-07;91283
2021-05-06;"Nitriansky kraj";30;9463;20;9483;NA;282915;50;2021-05-06;91231
2021-05-05;"Nitriansky kraj";19;8527;23;8550;NA;282915;42;2021-05-05;91181
2021-05-04;"Nitriansky kraj";46;9385;27;9412;NA;282915;73;2021-05-04;91139
2021-05-03;"Nitriansky kraj";32;14490;44;14534;NA;282915;76;2021-05-03;91066
2021-05-02;"Nitriansky kraj";4;31751;46;31797;NA;282915;50;2021-05-02;90990
2021-05-01;"Nitriansky kraj";23;60451;43;60494;NA;282915;66;2021-05-01;90940
2021-04-30;"Nitriansky kraj";28;31803;53;31856;NA;282915;81;2021-04-30;90874
2021-04-29;"Nitriansky kraj";27;14265;34;14299;NA;282915;61;2021-04-29;90793
2021-04-28;"Nitriansky kraj";36;14716;45;14761;NA;282915;81;2021-04-28;90732
2021-04-27;"Nitriansky kraj";51;13154;35;13189;NA;282915;86;2021-04-27;90651
2021-04-26;"Nitriansky kraj";38;21029;44;21073;NA;282915;82;2021-04-26;90565
2021-04-25;"Nitriansky kraj";7;44312;46;44358;NA;282915;53;2021-04-25;90483
2021-04-24;"Nitriansky kraj";23;93455;72;93527;NA;282915;95;2021-04-24;90430
2021-04-23;"Nitriansky kraj";54;35145;51;35196;NA;282915;105;2021-04-23;90335
2021-04-22;"Nitriansky kraj";32;15435;44;15479;NA;282915;76;2021-04-22;90230
2021-04-21;"Nitriansky kraj";38;14228;45;14273;NA;282915;83;2021-04-21;90154
2021-04-20;"Nitriansky kraj";67;16058;51;16109;NA;282915;118;2021-04-20;90071
2021-04-19;"Nitriansky kraj";35;24819;59;24878;NA;282915;94;2021-04-19;89953
2021-04-18;"Nitriansky kraj";0;39569;27;39596;NA;282915;27;2021-04-18;89859
2021-04-17;"Nitriansky kraj";34;92102;82;92184;NA;282915;116;2021-04-17;89832
2021-04-16;"Nitriansky kraj";46;32348;37;32385;NA;282915;83;2021-04-16;89716
2021-04-15;"Nitriansky kraj";75;16215;52;16267;NA;282915;127;2021-04-15;89633
2021-04-14;"Nitriansky kraj";43;15303;42;15345;NA;282915;85;2021-04-14;89506
2021-04-13;"Nitriansky kraj";110;15104;44;15148;NA;282915;154;2021-04-13;89421
2021-04-12;"Nitriansky kraj";29;22817;50;22867;NA;282915;79;2021-04-12;89267
2021-04-11;"Nitriansky kraj";1;37537;31;37568;NA;282915;32;2021-04-11;89188
2021-04-10;"Nitriansky kraj";35;95851;115;95966;NA;282915;150;2021-04-10;89156
2021-04-09;"Nitriansky kraj";69;30669;58;30727;NA;282915;127;2021-04-09;89006
2021-04-08;"Nitriansky kraj";71;15361;36;15397;NA;282915;107;2021-04-08;88879
2021-04-07;"Nitriansky kraj";64;18541;47;18588;NA;282915;111;2021-04-07;88772
2021-04-06;"Nitriansky kraj";65;33218;112;33330;NA;282915;177;2021-04-06;88661
2021-04-05;"Nitriansky kraj";37;12673;48;12721;NA;282915;85;2021-04-05;88484
2021-04-04;"Nitriansky kraj";5;17887;35;17922;NA;282915;40;2021-04-04;88399
2021-04-03;"Nitriansky kraj";26;85465;153;85618;NA;282915;179;2021-04-03;88359
2021-04-02;"Nitriansky kraj";32;18743;46;18789;NA;282915;78;2021-04-02;88180
2021-04-01;"Nitriansky kraj";63;24640;83;24723;NA;282915;146;2021-04-01;88102
2021-03-31;"Nitriansky kraj";73;21752;94;21846;NA;282915;167;2021-03-31;87956
2021-03-30;"Nitriansky kraj";125;17122;83;17205;NA;282915;208;2021-03-30;87789
2021-03-29;"Nitriansky kraj";81;25139;100;25239;NA;282915;181;2021-03-29;87581
2021-03-28;"Nitriansky kraj";6;45581;106;45687;NA;282915;112;2021-03-28;87400
2021-03-27;"Nitriansky kraj";39;104104;174;104278;NA;282915;213;2021-03-27;87288
2021-03-26;"Nitriansky kraj";90;40444;115;40559;NA;282915;205;2021-03-26;87075
2021-03-25;"Nitriansky kraj";95;19219;94;19313;NA;282915;189;2021-03-25;86870
2021-03-24;"Nitriansky kraj";90;14787;91;14878;NA;282915;181;2021-03-24;86681
2021-03-23;"Nitriansky kraj";167;16753;66;16819;NA;282915;233;2021-03-23;86500
2021-03-22;"Nitriansky kraj";101;24886;125;25011;NA;282915;226;2021-03-22;86267
2021-03-21;"Nitriansky kraj";27;42773;99;42872;NA;282915;126;2021-03-21;86041
2021-03-20;"Nitriansky kraj";36;100640;207;100847;NA;282915;243;2021-03-20;85915
2021-03-19;"Nitriansky kraj";76;37312;102;37414;NA;282915;178;2021-03-19;85672
2021-03-18;"Nitriansky kraj";103;20051;113;20164;NA;282915;216;2021-03-18;85494
2021-03-17;"Nitriansky kraj";87;15839;127;15966;NA;282915;214;2021-03-17;85278
2021-03-16;"Nitriansky kraj";172;18085;121;18206;NA;282915;293;2021-03-16;85064
2021-03-15;"Nitriansky kraj";130;24481;165;24646;NA;282915;295;2021-03-15;84771
2021-03-14;"Nitriansky kraj";3;45770;107;45877;NA;282915;110;2021-03-14;84476
2021-03-13;"Nitriansky kraj";65;112573;242;112815;NA;282915;307;2021-03-13;84366
2021-03-12;"Nitriansky kraj";127;40777;159;40936;NA;282915;286;2021-03-12;84059
2021-03-11;"Nitriansky kraj";131;18686;130;18816;NA;282915;261;2021-03-11;83773
2021-03-10;"Nitriansky kraj";96;17422;143;17565;NA;282915;239;2021-03-10;83512
2021-03-09;"Nitriansky kraj";260;17635;149;17784;NA;282915;409;2021-03-09;83273
2021-03-08;"Nitriansky kraj";145;27214;172;27386;NA;282915;317;2021-03-08;82864
2021-03-07;"Nitriansky kraj";48;46867;185;47052;NA;282915;233;2021-03-07;82547
2021-03-06;"Nitriansky kraj";86;112027;327;112354;NA;282915;413;2021-03-06;82314
2021-03-05;"Nitriansky kraj";133;39068;200;39268;NA;282915;333;2021-03-05;81901
2021-03-04;"Nitriansky kraj";176;18340;173;18513;NA;282915;349;2021-03-04;81568
2021-03-03;"Nitriansky kraj";172;17210;177;17387;NA;282915;349;2021-03-03;81219
2021-03-02;"Nitriansky kraj";274;21003;366;21369;NA;282915;640;2021-03-02;80870
2021-03-01;"Nitriansky kraj";133;27881;279;28160;NA;282915;412;2021-03-01;80230
2021-02-28;"Nitriansky kraj";80;40866;218;41084;NA;282915;298;2021-02-28;79818
2021-02-27;"Nitriansky kraj";101;106352;496;106848;NA;282915;597;2021-02-27;79520
2021-02-26;"Nitriansky kraj";109;36788;308;37096;NA;282915;417;2021-02-26;78923
2021-02-25;"Nitriansky kraj";188;15243;212;15455;NA;282915;400;2021-02-25;78506
2021-02-24;"Nitriansky kraj";125;13833;260;14093;NA;282915;385;2021-02-24;78106
2021-02-23;"Nitriansky kraj";273;15402;273;15675;NA;282915;546;2021-02-23;77721
2021-02-22;"Nitriansky kraj";154;26478;330;26808;NA;282915;484;2021-02-22;77175
2021-02-21;"Nitriansky kraj";22;43664;320;43984;NA;282915;342;2021-02-21;76691
2021-02-20;"Nitriansky kraj";128;109038;586;109624;NA;282915;714;2021-02-20;76349
2021-02-19;"Nitriansky kraj";173;36849;328;37177;NA;282915;501;2021-02-19;75635
2021-02-18;"Nitriansky kraj";202;17045;275;17320;NA;282915;477;2021-02-18;75134
2021-02-17;"Nitriansky kraj";198;12080;310;12390;NA;282915;508;2021-02-17;74657
2021-02-16;"Nitriansky kraj";284;16066;288;16354;NA;282915;572;2021-02-16;74149
2021-02-15;"Nitriansky kraj";122;28636;474;29110;NA;282915;596;2021-02-15;73577
2021-02-14;"Nitriansky kraj";8;49392;315;49707;NA;282915;323;2021-02-14;72981
2021-02-13;"Nitriansky kraj";127;110294;690;110984;NA;282915;817;2021-02-13;72658
2021-02-12;"Nitriansky kraj";162;33405;407;33812;NA;282915;569;2021-02-12;71841
2021-02-11;"Nitriansky kraj";195;12406;270;12676;NA;282915;465;2021-02-11;71272
2021-02-10;"Nitriansky kraj";186;17770;644;18414;NA;282915;830;2021-02-10;70807
2021-02-09;"Nitriansky kraj";260;18530;385;18915;NA;282915;645;2021-02-09;69977
2021-02-08;"Nitriansky kraj";177;37530;569;38099;NA;282915;746;2021-02-08;69332
2021-02-07;"Nitriansky kraj";20;52307;513;52820;NA;282915;533;2021-02-07;68586
2021-02-06;"Nitriansky kraj";129;101439;764;102203;NA;282915;893;2021-02-06;68053
2021-02-05;"Nitriansky kraj";244;26137;491;26628;NA;282915;735;2021-02-05;67160
2021-02-04;"Nitriansky kraj";308;15681;512;16193;NA;282915;820;2021-02-04;66425
2021-02-03;"Nitriansky kraj";191;13459;382;13841;NA;282915;573;2021-02-03;65605
2021-02-02;"Nitriansky kraj";327;17880;382;18262;NA;282915;709;2021-02-02;65032
2021-02-01;"Nitriansky kraj";221;24002;460;24462;NA;282915;681;2021-02-01;64323
2021-01-31;"Nitriansky kraj";9;46215;507;46722;NA;282915;516;2021-01-31;63642
2021-01-30;"Nitriansky kraj";152;99241;1090;100331;NA;282915;1242;2021-01-30;63126
2021-01-29;"Nitriansky kraj";302;22461;477;22938;NA;282915;779;2021-01-29;61884
2021-01-28;"Nitriansky kraj";269;11370;398;11768;NA;282915;667;2021-01-28;61105
2021-01-27;"Nitriansky kraj";235;6758;299;7057;NA;282915;534;2021-01-27;60438
2021-01-26;"Nitriansky kraj";345;16015;454;16469;NA;282915;799;2021-01-26;59904
2021-01-25;"Nitriansky kraj";201;21909;434;22343;NA;282915;635;2021-01-25;59105
2021-01-24;"Nitriansky kraj";12;79041;897;79938;NA;282915;909;2021-01-24;58470
2021-01-23;"Nitriansky kraj";277;97845;1446;99291;NA;282915;1723;2021-01-23;57561
2021-01-22;"Nitriansky kraj";139;35924;619;36543;NA;282915;758;2021-01-22;55838
2021-01-21;"Nitriansky kraj";305;14649;412;15061;NA;282915;717;2021-01-21;55080
2021-01-20;"Nitriansky kraj";326;11991;625;12616;NA;282915;951;2021-01-20;54363
2021-01-19;"Nitriansky kraj";344;11015;633;11648;NA;282915;977;2021-01-19;53412
2021-01-18;"Nitriansky kraj";367;8901;519;9420;NA;282915;886;2021-01-18;52435
2021-01-17;"Nitriansky kraj";97;15061;275;15336;NA;282915;372;2021-01-17;51549
2021-01-16;"Nitriansky kraj";64;36838;679;37517;NA;282915;743;2021-01-16;51177
2021-01-15;"Nitriansky kraj";373;15940;474;16414;NA;282915;847;2021-01-15;50434
2021-01-14;"Nitriansky kraj";627;10577;452;11029;NA;282915;1079;2021-01-14;49587
2021-01-13;"Nitriansky kraj";663;9234;484;9718;NA;282915;1147;2021-01-13;48508
2021-01-12;"Nitriansky kraj";642;8805;545;9350;NA;282915;1187;2021-01-12;47361
2021-01-11;"Nitriansky kraj";422;8347;513;8860;NA;282915;935;2021-01-11;46174
2021-01-10;"Nitriansky kraj";44;19841;730;20571;NA;282915;774;2021-01-10;45239
2021-01-09;"Nitriansky kraj";532;36823;1071;37894;NA;282915;1603;2021-01-09;44465
2021-01-08;"Nitriansky kraj";817;14001;691;14692;NA;282915;1508;2021-01-08;42862
2021-01-07;"Nitriansky kraj";438;10121;795;10916;NA;282915;1233;2021-01-07;41354
2021-01-06;"Nitriansky kraj";259;3192;197;3389;NA;282915;456;2021-01-06;40121
2021-01-05;"Nitriansky kraj";732;8918;1208;10126;NA;282915;1940;2021-01-05;39665
2021-01-04;"Nitriansky kraj";362;8409;1287;9696;NA;282915;1649;2021-01-04;37725
2021-01-03;"Nitriansky kraj";42;84;20;104;NA;282915;62;2021-01-03;36076
2021-01-02;"Nitriansky kraj";249;1090;26;1116;NA;282915;275;2021-01-02;36014
2021-01-01;"Nitriansky kraj";119;781;95;876;NA;282915;214;2021-01-01;35739
2020-12-31;"Nitriansky kraj";786;7646;962;8608;NA;282915;1748;2020-12-31;35525
2020-12-30;"Nitriansky kraj";1094;9619;1165;10784;NA;282915;2259;2020-12-30;33777
2020-12-29;"Nitriansky kraj";607;8028;1245;9273;NA;282915;1852;2020-12-29;31518
2020-12-28;"Nitriansky kraj";83;6804;1220;8024;NA;282915;1303;2020-12-28;29666
2020-12-27;"Nitriansky kraj";22;60;8;68;NA;282915;30;2020-12-27;28363
2020-12-26;"Nitriansky kraj";54;297;56;353;NA;282915;110;2020-12-26;28333
2020-12-25;"Nitriansky kraj";35;60;11;71;NA;282915;46;2020-12-25;28223
2020-12-24;"Nitriansky kraj";514;1861;176;2037;NA;282915;690;2020-12-24;28177
2020-12-23;"Nitriansky kraj";349;14679;782;15461;NA;282915;1131;2020-12-23;27487
2020-12-22;"Nitriansky kraj";673;10623;949;11572;NA;282915;1622;2020-12-22;26356
2020-12-21;"Nitriansky kraj";128;7587;931;8518;NA;282915;1059;2020-12-21;24734
2020-12-20;"Nitriansky kraj";77;50;10;60;NA;282915;87;2020-12-20;23675
2020-12-19;"Nitriansky kraj";262;2259;159;2418;NA;282915;421;2020-12-19;23588
2020-12-18;"Nitriansky kraj";512;7946;518;8464;NA;282915;1030;2020-12-18;23167
2020-12-17;"Nitriansky kraj";586;6519;486;7005;NA;282915;1072;2020-12-17;22137
2020-12-16;"Nitriansky kraj";357;8097;500;8597;NA;282915;857;2020-12-16;21065
2020-12-15;"Nitriansky kraj";461;9084;750;9834;NA;282915;1211;2020-12-15;20208
2020-12-14;"Nitriansky kraj";217;7816;797;8613;NA;282915;1014;2020-12-14;18997
2020-12-13;"Nitriansky kraj";12;69;6;75;NA;282915;18;2020-12-13;17983
2020-12-12;"Nitriansky kraj";341;1832;125;1957;NA;282915;466;2020-12-12;17965
2020-12-11;"Nitriansky kraj";409;5117;384;5501;NA;282915;793;2020-12-11;17499
2020-12-10;"Nitriansky kraj";360;5239;345;5584;NA;282915;705;2020-12-10;16706
2020-12-09;"Nitriansky kraj";362;5494;529;6023;NA;282915;891;2020-12-09;16001
2020-12-08;"Nitriansky kraj";340;8168;548;8716;NA;282915;888;2020-12-08;15110
2020-12-07;"Nitriansky kraj";139;6243;573;6816;NA;282915;712;2020-12-07;14222
2020-12-06;"Nitriansky kraj";15;89;4;93;NA;282915;19;2020-12-06;13510
2020-12-05;"Nitriansky kraj";136;1388;19;1407;NA;282915;155;2020-12-05;13491
2020-12-04;"Nitriansky kraj";232;2884;74;2958;NA;282915;306;2020-12-04;13336
2020-12-03;"Nitriansky kraj";248;2471;110;2581;NA;282915;358;2020-12-03;13030
2020-12-02;"Nitriansky kraj";252;2580;151;2731;NA;282915;403;2020-12-02;12672
2020-12-01;"Nitriansky kraj";331;2891;131;3022;NA;282915;462;2020-12-01;12269
2020-11-30;"Nitriansky kraj";91;4228;188;4416;NA;282915;279;2020-11-30;11807
2020-11-29;"Nitriansky kraj";3;634;42;676;NA;282915;45;2020-11-29;11528
2020-11-28;"Nitriansky kraj";135;892;31;923;NA;282915;166;2020-11-28;11483
2020-11-27;"Nitriansky kraj";177;2069;73;2142;NA;282915;250;2020-11-27;11317
2020-11-26;"Nitriansky kraj";191;2813;80;2893;NA;282915;271;2020-11-26;11067
2020-11-25;"Nitriansky kraj";325;2478;91;2569;NA;282915;416;2020-11-25;10796
2020-11-24;"Nitriansky kraj";147;1641;64;1705;NA;282915;211;2020-11-24;10380
2020-11-23;"Nitriansky kraj";102;9891;212;10103;NA;282915;314;2020-11-23;10169
2020-11-22;"Nitriansky kraj";7;1176;25;1201;NA;282915;32;2020-11-22;9855
2020-11-21;"Nitriansky kraj";86;1083;38;1121;NA;282915;124;2020-11-21;9823
2020-11-20;"Nitriansky kraj";264;4180;103;4283;NA;282915;367;2020-11-20;9699
2020-11-19;"Nitriansky kraj";185;3065;134;3199;NA;282915;319;2020-11-19;9332
2020-11-18;"Nitriansky kraj";188;2214;79;2293;NA;282915;267;2020-11-18;9013
2020-11-17;"Nitriansky kraj";178;596;29;625;NA;282915;207;2020-11-17;8746
2020-11-16;"Nitriansky kraj";139;1877;75;1952;NA;282915;214;2020-11-16;8539
2020-11-15;"Nitriansky kraj";14;180;5;185;NA;282915;19;2020-11-15;8325
2020-11-14;"Nitriansky kraj";114;1131;32;1163;NA;282915;146;2020-11-14;8306
2020-11-13;"Nitriansky kraj";210;936;46;982;NA;282915;256;2020-11-13;8160
2020-11-12;"Nitriansky kraj";256;1195;35;1230;NA;282915;291;2020-11-12;7904
2020-11-11;"Nitriansky kraj";279;1247;22;1269;NA;282915;301;2020-11-11;7613
2020-11-10;"Nitriansky kraj";192;2623;39;2662;NA;282915;231;2020-11-10;7312
2020-11-09;"Nitriansky kraj";128;3136;43;3179;NA;282915;171;2020-11-09;7081
2020-11-08;"Nitriansky kraj";43;1462;32;1494;NA;282915;75;2020-11-08;6910
2020-11-07;"Nitriansky kraj";130;1046;4;1050;NA;282915;134;2020-11-07;6835
2020-11-06;"Nitriansky kraj";210;2264;32;2296;NA;282915;242;2020-11-06;6701
2020-11-05;"Nitriansky kraj";178;313;14;327;NA;282915;192;2020-11-05;6459
2020-11-04;"Nitriansky kraj";211;297;16;313;NA;282915;227;2020-11-04;6267
2020-11-03;"Nitriansky kraj";216;435;25;460;NA;282915;241;2020-11-03;6040
2020-11-02;"Nitriansky kraj";171;4208;46;4254;NA;282915;217;2020-11-02;5799
2020-11-01;"Nitriansky kraj";130;2546;27;2573;NA;282915;157;2020-11-01;5582
2020-10-31;"Nitriansky kraj";261;10466;134;10600;NA;282915;395;2020-10-31;5425
2020-10-30;"Nitriansky kraj";204;2593;42;2635;NA;282915;246;2020-10-30;5030
2020-10-29;"Nitriansky kraj";293;841;39;880;NA;282915;332;2020-10-29;4784
2020-10-28;"Nitriansky kraj";216;608;59;667;NA;282915;275;2020-10-28;4452
2020-10-27;"Nitriansky kraj";296;550;47;597;NA;282915;343;2020-10-27;4177
2020-10-26;"Nitriansky kraj";69;633;56;689;NA;282915;125;2020-10-26;3834
2020-10-25;"Nitriansky kraj";50;62;8;70;NA;282915;58;2020-10-25;3709
2020-10-24;"Nitriansky kraj";169;237;11;248;NA;282915;180;2020-10-24;3651
2020-10-23;"Nitriansky kraj";282;762;41;803;NA;282915;323;2020-10-23;3471
2020-10-22;"Nitriansky kraj";137;444;39;483;NA;282915;176;2020-10-22;3148
2020-10-21;"Nitriansky kraj";146;208;3;211;NA;282915;149;2020-10-21;2972
2020-10-20;"Nitriansky kraj";197;78;6;84;NA;282915;203;2020-10-20;2823
2020-10-19;"Nitriansky kraj";148;79;1;80;NA;282915;149;2020-10-19;2620
2020-10-18;"Nitriansky kraj";22;0;0;0;NA;282915;22;2020-10-18;2471
2020-10-17;"Nitriansky kraj";67;0;0;0;NA;282915;67;2020-10-17;2449
2020-10-16;"Nitriansky kraj";133;28;3;31;NA;282915;136;2020-10-16;2382
2020-10-15;"Nitriansky kraj";106;31;2;33;NA;282915;108;2020-10-15;2246
2020-10-14;"Nitriansky kraj";80;22;4;26;NA;282915;84;2020-10-14;2138
2020-10-13;"Nitriansky kraj";101;82;2;84;NA;282915;103;2020-10-13;2054
2020-10-12;"Nitriansky kraj";36;0;0;0;NA;282915;36;2020-10-12;1951
2020-10-11;"Nitriansky kraj";8;0;0;0;NA;282915;8;2020-10-11;1915
2020-10-10;"Nitriansky kraj";107;0;0;0;NA;282915;107;2020-10-10;1907
2020-10-09;"Nitriansky kraj";120;0;0;0;NA;282915;120;2020-10-09;1800
2020-10-08;"Nitriansky kraj";132;0;0;0;NA;282915;132;2020-10-08;1680
2020-10-07;"Nitriansky kraj";81;0;0;0;NA;282915;81;2020-10-07;1548
2020-10-06;"Nitriansky kraj";48;0;0;0;NA;282915;48;2020-10-06;1467
2020-10-05;"Nitriansky kraj";20;0;0;0;NA;282915;20;2020-10-05;1419
2020-10-04;"Nitriansky kraj";17;0;0;0;NA;282915;17;2020-10-04;1399
2020-10-03;"Nitriansky kraj";96;0;0;0;NA;282915;96;2020-10-03;1382
2020-10-02;"Nitriansky kraj";108;0;0;0;NA;282915;108;2020-10-02;1286
2020-10-01;"Nitriansky kraj";95;0;0;0;NA;282915;95;2020-10-01;1178
2020-09-30;"Nitriansky kraj";100;0;0;0;NA;282915;100;2020-09-30;1083
2020-09-29;"Nitriansky kraj";50;0;0;0;NA;282915;50;2020-09-29;983
2020-09-28;"Nitriansky kraj";22;0;0;0;NA;282915;22;2020-09-28;933
2020-09-27;"Nitriansky kraj";16;0;0;0;NA;282915;16;2020-09-27;911
2020-09-26;"Nitriansky kraj";64;0;0;0;NA;282915;64;2020-09-26;895
2020-09-25;"Nitriansky kraj";90;0;0;0;NA;282915;90;2020-09-25;831
2020-09-24;"Nitriansky kraj";51;0;0;0;NA;282915;51;2020-09-24;741
2020-09-23;"Nitriansky kraj";70;0;0;0;NA;282915;70;2020-09-23;690
2020-09-22;"Nitriansky kraj";18;0;0;0;NA;282915;18;2020-09-22;620
2020-09-21;"Nitriansky kraj";10;0;0;0;NA;282915;10;2020-09-21;602
2020-09-20;"Nitriansky kraj";4;0;0;0;NA;282915;4;2020-09-20;592
2020-09-19;"Nitriansky kraj";14;0;0;0;NA;282915;14;2020-09-19;588
2020-09-18;"Nitriansky kraj";19;0;0;0;NA;282915;19;2020-09-18;574
2020-09-17;"Nitriansky kraj";30;0;0;0;NA;282915;30;2020-09-17;555
2020-09-16;"Nitriansky kraj";6;0;0;0;NA;282915;6;2020-09-16;525
2020-09-15;"Nitriansky kraj";19;0;0;0;NA;282915;19;2020-09-15;519
2020-09-14;"Nitriansky kraj";28;0;0;0;NA;282915;28;2020-09-14;500
2020-09-13;"Nitriansky kraj";3;0;0;0;NA;282915;3;2020-09-13;472
2020-09-12;"Nitriansky kraj";12;0;0;0;NA;282915;12;2020-09-12;469
2020-09-11;"Nitriansky kraj";23;0;0;0;NA;282915;23;2020-09-11;457
2020-09-10;"Nitriansky kraj";29;0;0;0;NA;282915;29;2020-09-10;434
2020-09-09;"Nitriansky kraj";19;0;0;0;NA;282915;19;2020-09-09;405
2020-09-08;"Nitriansky kraj";17;0;0;0;NA;282915;17;2020-09-08;386
2020-09-07;"Nitriansky kraj";17;0;0;0;NA;282915;17;2020-09-07;369
2020-09-06;"Nitriansky kraj";0;0;0;0;NA;282915;0;2020-09-06;352
2020-09-05;"Nitriansky kraj";22;0;0;0;NA;282915;22;2020-09-05;352
2020-09-04;"Nitriansky kraj";34;0;0;0;NA;282915;34;2020-09-04;330
2020-09-03;"Nitriansky kraj";15;0;0;0;NA;282915;15;2020-09-03;296
2020-09-02;"Nitriansky kraj";15;0;0;0;NA;282915;15;2020-09-02;281
2020-09-01;"Nitriansky kraj";2;0;0;0;NA;282915;2;2020-09-01;266
2020-08-31;"Nitriansky kraj";12;0;0;0;NA;282915;12;2020-08-31;264
2020-08-30;"Nitriansky kraj";1;0;0;0;NA;282915;1;2020-08-30;252
2020-08-29;"Nitriansky kraj";7;46;0;46;NA;282915;7;2020-08-29;251
2020-08-28;"Nitriansky kraj";12;0;0;0;NA;282915;12;2020-08-28;244
2020-08-27;"Nitriansky kraj";12;0;0;0;NA;282915;12;2020-08-27;232
2020-08-26;"Nitriansky kraj";4;0;0;0;NA;282915;4;2020-08-26;220
2020-08-25;"Nitriansky kraj";8;0;0;0;NA;282915;8;2020-08-25;216
2020-08-24;"Nitriansky kraj";1;0;0;0;NA;282915;1;2020-08-24;208
2020-08-23;"Nitriansky kraj";1;0;0;0;NA;282915;1;2020-08-23;207
2020-08-22;"Nitriansky kraj";2;0;0;0;NA;282915;2;2020-08-22;206
2020-08-21;"Nitriansky kraj";0;0;0;0;NA;282915;0;2020-08-21;204
2020-08-20;"Nitriansky kraj";7;0;0;0;NA;282915;7;2020-08-20;204
2020-08-19;"Nitriansky kraj";1;0;0;0;NA;282915;1;2020-08-19;197
2020-08-18;"Nitriansky kraj";2;0;0;0;NA;282915;2;2020-08-18;196
2020-08-17;"Nitriansky kraj";1;0;0;0;NA;282915;1;2020-08-17;194
2020-08-16;"Nitriansky kraj";0;0;0;0;NA;282915;0;2020-08-16;193
2020-08-15;"Nitriansky kraj";2;0;0;0;NA;282915;2;2020-08-15;193
2020-08-14;"Nitriansky kraj";1;0;0;0;NA;282915;1;2020-08-14;191
2020-08-13;"Nitriansky kraj";4;0;0;0;NA;282915;4;2020-08-13;190
2020-08-12;"Nitriansky kraj";0;0;0;0;NA;282915;0;2020-08-12;186
2020-08-11;"Nitriansky kraj";1;0;0;0;NA;282915;1;2020-08-11;186
2020-08-10;"Nitriansky kraj";0;0;0;0;NA;282915;0;2020-08-10;185
2020-08-09;"Nitriansky kraj";0;0;0;0;NA;282915;0;2020-08-09;185
2020-08-08;"Nitriansky kraj";0;0;0;0;NA;282915;0;2020-08-08;185
2020-08-07;"Nitriansky kraj";4;0;0;0;NA;282915;4;2020-08-07;185
2020-08-06;"Nitriansky kraj";4;0;0;0;NA;282915;4;2020-08-06;181
2020-08-05;"Nitriansky kraj";0;0;0;0;NA;282915;0;2020-08-05;177
2020-08-04;"Nitriansky kraj";7;0;0;0;NA;282915;7;2020-08-04;177
2020-08-03;"Nitriansky kraj";0;0;0;0;NA;282915;0;2020-08-03;170
2020-08-02;"Nitriansky kraj";0;0;0;0;NA;282915;0;2020-08-02;170
2020-08-01;"Nitriansky kraj";0;0;0;0;NA;282915;0;2020-08-01;170
2020-07-31;"Nitriansky kraj";0;0;0;0;NA;282915;0;2020-07-31;170
2020-07-30;"Nitriansky kraj";0;0;0;0;NA;282915;0;2020-07-30;170
2020-07-29;"Nitriansky kraj";0;0;0;0;NA;282915;0;2020-07-29;170
2020-07-28;"Nitriansky kraj";0;0;0;0;NA;282915;0;2020-07-28;170
2020-07-27;"Nitriansky kraj";0;0;0;0;NA;282915;0;2020-07-27;170
2020-07-26;"Nitriansky kraj";0;0;0;0;NA;282915;0;2020-07-26;170
2020-07-25;"Nitriansky kraj";0;0;0;0;NA;282915;0;2020-07-25;170
2020-07-24;"Nitriansky kraj";1;0;0;0;NA;282915;1;2020-07-24;170
2020-07-23;"Nitriansky kraj";3;0;0;0;NA;282915;3;2020-07-23;169
2020-07-22;"Nitriansky kraj";2;0;0;0;NA;282915;2;2020-07-22;166
2020-07-21;"Nitriansky kraj";14;0;0;0;NA;282915;14;2020-07-21;164
2020-07-20;"Nitriansky kraj";11;0;0;0;NA;282915;11;2020-07-20;150
2020-07-19;"Nitriansky kraj";0;0;0;0;NA;282915;0;2020-07-19;139
2020-07-18;"Nitriansky kraj";0;0;0;0;NA;282915;0;2020-07-18;139
2020-07-17;"Nitriansky kraj";0;0;0;0;NA;282915;0;2020-07-17;139
2020-07-16;"Nitriansky kraj";4;0;0;0;NA;282915;4;2020-07-16;139
2020-07-15;"Nitriansky kraj";5;0;0;0;NA;282915;5;2020-07-15;135
2020-07-14;"Nitriansky kraj";0;0;0;0;NA;282915;0;2020-07-14;130
2020-07-13;"Nitriansky kraj";0;0;0;0;NA;282915;0;2020-07-13;130
2020-07-12;"Nitriansky kraj";0;0;0;0;NA;282915;0;2020-07-12;130
2020-07-11;"Nitriansky kraj";0;0;0;0;NA;282915;0;2020-07-11;130
2020-07-10;"Nitriansky kraj";0;0;0;0;NA;282915;0;2020-07-10;130
2020-07-09;"Nitriansky kraj";1;0;0;0;NA;282915;1;2020-07-09;130
2020-07-08;"Nitriansky kraj";2;0;0;0;NA;282915;2;2020-07-08;129
2020-07-07;"Nitriansky kraj";0;0;0;0;NA;282915;0;2020-07-07;127
2020-07-06;"Nitriansky kraj";0;0;0;0;NA;282915;0;2020-07-06;127
2020-07-05;"Nitriansky kraj";0;0;0;0;NA;282915;0;2020-07-05;127
2020-07-04;"Nitriansky kraj";0;0;0;0;NA;282915;0;2020-07-04;127
2020-07-03;"Nitriansky kraj";0;0;0;0;NA;282915;0;2020-07-03;127
2020-07-02;"Nitriansky kraj";0;0;0;0;NA;282915;0;2020-07-02;127
2020-07-01;"Nitriansky kraj";3;0;0;0;NA;282915;3;2020-07-01;127
2020-06-30;"Nitriansky kraj";0;0;0;0;NA;282915;0;2020-06-30;124
2020-06-29;"Nitriansky kraj";0;0;0;0;NA;282915;0;2020-06-29;124
2020-06-28;"Nitriansky kraj";0;0;0;0;NA;282915;0;2020-06-28;124
2020-06-27;"Nitriansky kraj";0;0;0;0;NA;282915;0;2020-06-27;124
2020-06-26;"Nitriansky kraj";0;0;0;0;NA;282915;0;2020-06-26;124
2020-06-25;"Nitriansky kraj";0;0;0;0;NA;282915;0;2020-06-25;124
2020-06-24;"Nitriansky kraj";1;0;0;0;NA;282915;1;2020-06-24;124
2020-06-23;"Nitriansky kraj";0;0;0;0;NA;282915;0;2020-06-23;123
2020-06-22;"Nitriansky kraj";0;0;0;0;NA;282915;0;2020-06-22;123
2020-06-21;"Nitriansky kraj";0;0;0;0;NA;282915;0;2020-06-21;123
2020-06-20;"Nitriansky kraj";0;0;0;0;NA;282915;0;2020-06-20;123
2020-06-19;"Nitriansky kraj";0;0;0;0;NA;282915;0;2020-06-19;123
2020-06-18;"Nitriansky kraj";0;0;0;0;NA;282915;0;2020-06-18;123
2020-06-17;"Nitriansky kraj";0;0;0;0;NA;282915;0;2020-06-17;123
2020-06-16;"Nitriansky kraj";0;0;0;0;NA;282915;0;2020-06-16;123
2020-06-14;"Nitriansky kraj";0;0;0;0;NA;282915;0;2020-06-14;123
2020-06-13;"Nitriansky kraj";0;0;0;0;NA;282915;0;2020-06-13;123
2020-06-12;"Nitriansky kraj";0;0;0;0;NA;282915;0;2020-06-12;123
2020-06-11;"Nitriansky kraj";0;0;0;0;NA;282915;0;2020-06-11;123
2020-06-10;"Nitriansky kraj";1;0;0;0;NA;282915;1;2020-06-10;123
2020-06-09;"Nitriansky kraj";1;0;0;0;NA;282915;1;2020-06-09;122
2020-06-08;"Nitriansky kraj";0;0;0;0;NA;282915;0;2020-06-08;121
2020-06-07;"Nitriansky kraj";0;0;0;0;NA;282915;0;2020-06-07;121
2020-06-05;"Nitriansky kraj";0;0;0;0;NA;282915;0;2020-06-05;121
2020-06-03;"Nitriansky kraj";0;0;0;0;NA;282915;0;2020-06-03;121
2020-06-02;"Nitriansky kraj";1;0;0;0;NA;282915;1;2020-06-02;121
2020-05-31;"Nitriansky kraj";0;0;0;0;NA;282915;0;2020-05-31;120
2020-05-29;"Nitriansky kraj";0;0;0;0;NA;282915;0;2020-05-29;120
2020-05-27;"Nitriansky kraj";0;0;0;0;NA;282915;0;2020-05-27;120
2020-05-26;"Nitriansky kraj";0;0;0;0;NA;282915;0;2020-05-26;120
2020-05-25;"Nitriansky kraj";0;0;0;0;NA;282915;0;2020-05-25;120
2020-05-24;"Nitriansky kraj";2;0;0;0;NA;282915;2;2020-05-24;120
2020-05-23;"Nitriansky kraj";0;0;0;0;NA;282915;0;2020-05-23;118
2020-05-22;"Nitriansky kraj";1;0;0;0;NA;282915;1;2020-05-22;118
2020-05-21;"Nitriansky kraj";0;0;0;0;NA;282915;0;2020-05-21;117
2020-05-20;"Nitriansky kraj";0;0;0;0;NA;282915;0;2020-05-20;117
2020-05-19;"Nitriansky kraj";0;0;0;0;NA;282915;0;2020-05-19;117
2020-05-17;"Nitriansky kraj";0;0;0;0;NA;282915;0;2020-05-17;117
2020-05-16;"Nitriansky kraj";0;0;0;0;NA;282915;0;2020-05-16;117
2020-05-15;"Nitriansky kraj";1;0;0;0;NA;282915;1;2020-05-15;117
2020-05-14;"Nitriansky kraj";0;0;0;0;NA;282915;0;2020-05-14;116
2020-05-13;"Nitriansky kraj";0;0;0;0;NA;282915;0;2020-05-13;116
2020-05-12;"Nitriansky kraj";0;0;0;0;NA;282915;0;2020-05-12;116
2020-05-11;"Nitriansky kraj";2;0;0;0;NA;282915;2;2020-05-11;116
2020-05-09;"Nitriansky kraj";0;0;0;0;NA;282915;0;2020-05-09;114
2020-05-07;"Nitriansky kraj";1;0;0;0;NA;282915;1;2020-05-07;114
2020-05-06;"Nitriansky kraj";9;0;0;0;NA;282915;9;2020-05-06;113
2020-05-05;"Nitriansky kraj";0;0;0;0;NA;282915;0;2020-05-05;104
2020-05-04;"Nitriansky kraj";5;0;0;0;NA;282915;5;2020-05-04;104
2020-05-03;"Nitriansky kraj";2;0;0;0;NA;282915;2;2020-05-03;99
2020-05-02;"Nitriansky kraj";0;0;0;0;NA;282915;0;2020-05-02;97
2020-05-01;"Nitriansky kraj";1;0;0;0;NA;282915;1;2020-05-01;97
2020-04-30;"Nitriansky kraj";0;0;0;0;NA;282915;0;2020-04-30;96
2020-04-29;"Nitriansky kraj";0;0;0;0;NA;282915;0;2020-04-29;96
2020-04-28;"Nitriansky kraj";1;0;0;0;NA;282915;1;2020-04-28;96
2020-04-27;"Nitriansky kraj";0;0;0;0;NA;282915;0;2020-04-27;95
2020-04-26;"Nitriansky kraj";0;0;0;0;NA;282915;0;2020-04-26;95
2020-04-25;"Nitriansky kraj";0;0;0;0;NA;282915;0;2020-04-25;95
2020-04-24;"Nitriansky kraj";0;0;0;0;NA;282915;0;2020-04-24;95
2020-04-23;"Nitriansky kraj";3;0;0;0;NA;282915;3;2020-04-23;95
2020-04-22;"Nitriansky kraj";16;0;0;0;NA;282915;16;2020-04-22;92
2020-04-21;"Nitriansky kraj";6;0;0;0;NA;282915;6;2020-04-21;76
2020-04-20;"Nitriansky kraj";5;0;0;0;NA;282915;5;2020-04-20;70
2020-04-19;"Nitriansky kraj";0;0;0;0;NA;282915;0;2020-04-19;65
2020-04-18;"Nitriansky kraj";0;0;0;0;NA;282915;0;2020-04-18;65
2020-04-17;"Nitriansky kraj";7;0;0;0;NA;282915;7;2020-04-17;65
2020-04-16;"Nitriansky kraj";0;0;0;0;NA;282915;0;2020-04-16;58
2020-04-15;"Nitriansky kraj";6;0;0;0;NA;282915;6;2020-04-15;58
2020-04-14;"Nitriansky kraj";2;0;0;0;NA;282915;2;2020-04-14;52
2020-04-13;"Nitriansky kraj";1;0;0;0;NA;282915;1;2020-04-13;50
2020-04-12;"Nitriansky kraj";3;0;0;0;NA;282915;3;2020-04-12;49
2020-04-11;"Nitriansky kraj";1;0;0;0;NA;282915;1;2020-04-11;46
2020-04-10;"Nitriansky kraj";1;0;0;0;NA;282915;1;2020-04-10;45
2020-04-09;"Nitriansky kraj";0;0;0;0;NA;282915;0;2020-04-09;44
2020-04-08;"Nitriansky kraj";2;0;0;0;NA;282915;2;2020-04-08;44
2020-04-07;"Nitriansky kraj";3;0;0;0;NA;282915;3;2020-04-07;42
2020-04-06;"Nitriansky kraj";4;0;0;0;NA;282915;4;2020-04-06;39
2020-04-05;"Nitriansky kraj";5;0;0;0;NA;282915;5;2020-04-05;35
2020-04-04;"Nitriansky kraj";0;0;0;0;NA;282915;0;2020-04-04;30
2020-04-03;"Nitriansky kraj";0;0;0;0;NA;282915;0;2020-04-03;30
2020-04-02;"Nitriansky kraj";1;0;0;0;NA;282915;1;2020-04-02;30
2020-04-01;"Nitriansky kraj";0;0;0;0;NA;282915;0;2020-04-01;29
2020-03-31;"Nitriansky kraj";3;0;0;0;NA;282915;3;2020-03-31;29
2020-03-30;"Nitriansky kraj";3;0;0;0;NA;282915;3;2020-03-30;26
2020-03-29;"Nitriansky kraj";3;0;0;0;NA;282915;3;2020-03-29;23
2020-03-28;"Nitriansky kraj";1;0;0;0;NA;282915;1;2020-03-28;20
2020-03-27;"Nitriansky kraj";1;0;0;0;NA;282915;1;2020-03-27;19
2020-03-26;"Nitriansky kraj";1;0;0;0;NA;282915;1;2020-03-26;18
2020-03-25;"Nitriansky kraj";1;0;0;0;NA;282915;1;2020-03-25;17
2020-03-24;"Nitriansky kraj";0;0;0;0;NA;282915;0;2020-03-24;16
2020-03-23;"Nitriansky kraj";2;0;0;0;NA;282915;2;2020-03-23;16
2020-03-22;"Nitriansky kraj";2;0;0;0;NA;282915;2;2020-03-22;14
2020-03-21;"Nitriansky kraj";2;0;0;0;NA;282915;2;2020-03-21;12
2020-03-20;"Nitriansky kraj";1;0;0;0;NA;282915;1;2020-03-20;10
2020-03-19;"Nitriansky kraj";1;0;0;0;NA;282915;1;2020-03-19;9
2020-03-18;"Nitriansky kraj";2;0;0;0;NA;282915;2;2020-03-18;8
2020-03-17;"Nitriansky kraj";1;0;0;0;NA;282915;1;2020-03-17;6
2020-03-16;"Nitriansky kraj";0;0;0;0;NA;282915;0;2020-03-16;5
2020-03-15;"Nitriansky kraj";4;0;0;0;NA;282915;4;2020-03-15;5
2020-03-14;"Nitriansky kraj";1;0;0;0;NA;282915;1;2020-03-14;1
2020-03-13;"Nitriansky kraj";0;0;0;0;NA;282915;0;2020-03-13;0
2020-03-12;"Nitriansky kraj";0;0;0;0;NA;282915;0;2020-03-12;0
2020-03-11;"Nitriansky kraj";0;0;0;0;NA;282915;0;2020-03-11;0
2020-03-09;"Nitriansky kraj";0;0;0;0;NA;282915;0;2020-03-09;0
2020-03-08;"Nitriansky kraj";0;0;0;0;NA;282915;0;2020-03-08;0
2020-03-07;"Nitriansky kraj";0;0;0;0;NA;282915;0;2020-03-07;0
2020-03-06;"Nitriansky kraj";0;0;0;0;NA;282915;0;2020-03-06;0
2022-04-25;"Prešovský kraj";229;14;0;14;261099;363182;229;2022-04-25;363182
2022-04-24;"Prešovský kraj";56;144;6;150;NA;363182;62;2022-04-24;362953
2022-04-23;"Prešovský kraj";121;225;4;229;NA;363182;125;2022-04-23;362891
2022-04-22;"Prešovský kraj";226;424;29;453;NA;363182;255;2022-04-22;362766
2022-04-21;"Prešovský kraj";193;1313;37;1350;NA;363182;230;2022-04-21;362511
2022-04-20;"Prešovský kraj";305;1200;38;1238;NA;363182;343;2022-04-20;362281
2022-04-19;"Prešovský kraj";332;1459;66;1525;NA;363182;398;2022-04-19;361938
2022-04-18;"Prešovský kraj";74;299;43;342;NA;363182;117;2022-04-18;361540
2022-04-17;"Prešovský kraj";117;172;10;182;NA;363182;127;2022-04-17;361423
2022-04-16;"Prešovský kraj";93;285;30;315;NA;363182;123;2022-04-16;361296
2022-04-15;"Prešovský kraj";125;207;1;208;NA;363182;126;2022-04-15;361173
2022-04-14;"Prešovský kraj";303;926;45;971;NA;363182;348;2022-04-14;361047
2022-04-13;"Prešovský kraj";352;1065;51;1116;NA;363182;403;2022-04-13;360699
2022-04-12;"Prešovský kraj";208;1207;58;1265;NA;363182;266;2022-04-12;360296
2022-04-11;"Prešovský kraj";437;1968;103;2071;NA;363182;540;2022-04-11;360030
2022-04-10;"Prešovský kraj";97;421;40;461;NA;363182;137;2022-04-10;359490
2022-04-09;"Prešovský kraj";234;346;42;388;NA;363182;276;2022-04-09;359353
2022-04-08;"Prešovský kraj";368;1277;86;1363;NA;363182;454;2022-04-08;359077
2022-04-07;"Prešovský kraj";442;1307;82;1389;NA;363182;524;2022-04-07;358623
2022-04-06;"Prešovský kraj";582;1267;94;1361;NA;363182;676;2022-04-06;358099
2022-04-05;"Prešovský kraj";596;1734;99;1833;NA;363182;695;2022-04-05;357423
2022-04-04;"Prešovský kraj";804;2062;169;2231;NA;363182;973;2022-04-04;356728
2022-04-03;"Prešovský kraj";159;579;76;655;NA;363182;235;2022-04-03;355755
2022-04-02;"Prešovský kraj";359;408;41;449;NA;363182;400;2022-04-02;355520
2022-04-01;"Prešovský kraj";621;1407;120;1527;NA;363182;741;2022-04-01;355120
2022-03-31;"Prešovský kraj";717;2187;132;2319;NA;363182;849;2022-03-31;354379
2022-03-30;"Prešovský kraj";973;2061;154;2215;NA;363182;1127;2022-03-30;353530
2022-03-29;"Prešovský kraj";645;2078;164;2242;NA;363182;809;2022-03-29;352403
2022-03-28;"Prešovský kraj";946;3199;256;3455;NA;363182;1202;2022-03-28;351594
2022-03-27;"Prešovský kraj";256;793;101;894;NA;363182;357;2022-03-27;350392
2022-03-26;"Prešovský kraj";719;663;80;743;NA;363182;799;2022-03-26;350035
2022-03-25;"Prešovský kraj";895;1956;227;2183;NA;363182;1122;2022-03-25;349236
2022-03-24;"Prešovský kraj";909;2153;200;2353;NA;363182;1109;2022-03-24;348114
2022-03-23;"Prešovský kraj";1291;2147;209;2356;NA;363182;1500;2022-03-23;347005
2022-03-22;"Prešovský kraj";1398;2251;192;2443;NA;363182;1590;2022-03-22;345505
2022-03-21;"Prešovský kraj";1234;3002;290;3292;NA;363182;1524;2022-03-21;343915
2022-03-20;"Prešovský kraj";262;813;130;943;NA;363182;392;2022-03-20;342391
2022-03-19;"Prešovský kraj";802;902;115;1017;NA;363182;917;2022-03-19;341999
2022-03-18;"Prešovský kraj";1217;2105;225;2330;NA;363182;1442;2022-03-18;341082
2022-03-17;"Prešovský kraj";1118;2446;182;2628;NA;363182;1300;2022-03-17;339640
2022-03-16;"Prešovský kraj";1585;2084;222;2306;NA;363182;1807;2022-03-16;338340
2022-03-15;"Prešovský kraj";1460;2329;217;2546;NA;363182;1677;2022-03-15;336533
2022-03-14;"Prešovský kraj";1438;3310;380;3690;NA;363182;1818;2022-03-14;334856
2022-03-13;"Prešovský kraj";432;1045;190;1235;NA;363182;622;2022-03-13;333038
2022-03-12;"Prešovský kraj";1150;857;117;974;NA;363182;1267;2022-03-12;332416
2022-03-11;"Prešovský kraj";1271;2551;287;2838;NA;363182;1558;2022-03-11;331149
2022-03-10;"Prešovský kraj";1114;2577;278;2855;NA;363182;1392;2022-03-10;329591
2022-03-09;"Prešovský kraj";1477;2813;345;3158;NA;363182;1822;2022-03-09;328199
2022-03-08;"Prešovský kraj";1716;2999;308;3307;NA;363182;2024;2022-03-08;326377
2022-03-07;"Prešovský kraj";1326;4197;509;4706;NA;363182;1835;2022-03-07;324353
2022-03-06;"Prešovský kraj";278;1650;232;1882;NA;363182;510;2022-03-06;322518
2022-03-05;"Prešovský kraj";785;1194;136;1330;NA;363182;921;2022-03-05;322008
2022-03-04;"Prešovský kraj";1263;2812;303;3115;NA;363182;1566;2022-03-04;321087
2022-03-03;"Prešovský kraj";1049;3016;373;3389;NA;363182;1422;2022-03-03;319521
2022-03-02;"Prešovský kraj";1526;2955;335;3290;NA;363182;1861;2022-03-02;318099
2022-03-01;"Prešovský kraj";1612;3302;338;3640;NA;363182;1950;2022-03-01;316238
2022-02-28;"Prešovský kraj";1234;4963;538;5501;NA;363182;1772;2022-02-28;314288
2022-02-27;"Prešovský kraj";523;1467;278;1745;NA;363182;801;2022-02-27;312516
2022-02-26;"Prešovský kraj";867;1317;167;1484;NA;363182;1034;2022-02-26;311715
2022-02-25;"Prešovský kraj";1740;2768;346;3114;NA;363182;2086;2022-02-25;310681
2022-02-24;"Prešovský kraj";1435;3301;399;3700;NA;363182;1834;2022-02-24;308595
2022-02-23;"Prešovský kraj";1837;3516;404;3920;NA;363182;2241;2022-02-23;306761
2022-02-22;"Prešovský kraj";2294;3893;407;4300;NA;363182;2701;2022-02-22;304520
2022-02-21;"Prešovský kraj";1609;5165;618;5783;NA;363182;2227;2022-02-21;301819
2022-02-20;"Prešovský kraj";759;1877;319;2196;NA;363182;1078;2022-02-20;299592
2022-02-19;"Prešovský kraj";1535;1556;247;1803;NA;363182;1782;2022-02-19;298514
2022-02-18;"Prešovský kraj";2332;3580;393;3973;NA;363182;2725;2022-02-18;296732
2022-02-17;"Prešovský kraj";2293;3740;457;4197;NA;363182;2750;2022-02-17;294007
2022-02-16;"Prešovský kraj";2494;4049;484;4533;NA;363182;2978;2022-02-16;291257
2022-02-15;"Prešovský kraj";2992;4583;551;5134;NA;363182;3543;2022-02-15;288279
2022-02-14;"Prešovský kraj";2122;6203;845;7048;NA;363182;2967;2022-02-14;284736
2022-02-13;"Prešovský kraj";1338;2452;434;2886;NA;363182;1772;2022-02-13;281769
2022-02-12;"Prešovský kraj";2333;1867;352;2219;NA;363182;2685;2022-02-12;279997
2022-02-11;"Prešovský kraj";2666;3930;520;4450;NA;363182;3186;2022-02-11;277312
2022-02-10;"Prešovský kraj";2977;4516;599;5115;NA;363182;3576;2022-02-10;274126
2022-02-09;"Prešovský kraj";2644;4502;634;5136;NA;363182;3278;2022-02-09;270550
2022-02-08;"Prešovský kraj";3387;4890;651;5541;NA;363182;4038;2022-02-08;267272
2022-02-07;"Prešovský kraj";2132;6919;941;7860;NA;363182;3073;2022-02-07;263234
2022-02-06;"Prešovský kraj";1360;2884;490;3374;NA;363182;1850;2022-02-06;260161
2022-02-05;"Prešovský kraj";2813;1993;334;2327;NA;363182;3147;2022-02-05;258311
2022-02-04;"Prešovský kraj";2944;4556;573;5129;NA;363182;3517;2022-02-04;255164
2022-02-03;"Prešovský kraj";3375;5205;487;5692;NA;363182;3862;2022-02-03;251647
2022-02-02;"Prešovský kraj";3150;5686;562;6248;NA;363182;3712;2022-02-02;247785
2022-02-01;"Prešovský kraj";2791;5693;631;6324;NA;363182;3422;2022-02-01;244073
2022-01-31;"Prešovský kraj";2444;9142;929;10071;NA;363182;3373;2022-01-31;240651
2022-01-30;"Prešovský kraj";1311;3437;495;3932;NA;363182;1806;2022-01-30;237278
2022-01-29;"Prešovský kraj";2291;1949;282;2231;NA;363182;2573;2022-01-29;235472
2022-01-28;"Prešovský kraj";2473;4784;486;5270;NA;363182;2959;2022-01-28;232899
2022-01-27;"Prešovský kraj";2353;4558;412;4970;NA;363182;2765;2022-01-27;229940
2022-01-26;"Prešovský kraj";2311;5628;405;6033;NA;363182;2716;2022-01-26;227175
2022-01-25;"Prešovský kraj";2127;5284;346;5630;NA;363182;2473;2022-01-25;224459
2022-01-24;"Prešovský kraj";1324;7619;410;8029;NA;363182;1734;2022-01-24;221986
2022-01-23;"Prešovský kraj";262;3584;218;3802;NA;363182;480;2022-01-23;220252
2022-01-22;"Prešovský kraj";1448;1764;157;1921;NA;363182;1605;2022-01-22;219772
2022-01-21;"Prešovský kraj";1128;4312;196;4508;NA;363182;1324;2022-01-21;218167
2022-01-20;"Prešovský kraj";1184;4012;156;4168;NA;363182;1340;2022-01-20;216843
2022-01-19;"Prešovský kraj";822;4781;173;4954;NA;363182;995;2022-01-19;215503
2022-01-18;"Prešovský kraj";1032;4918;163;5081;NA;363182;1195;2022-01-18;214508
2022-01-17;"Prešovský kraj";784;7143;150;7293;NA;363182;934;2022-01-17;213313
2022-01-16;"Prešovský kraj";113;3113;98;3211;NA;363182;211;2022-01-16;212379
2022-01-15;"Prešovský kraj";675;1546;64;1610;NA;363182;739;2022-01-15;212168
2022-01-14;"Prešovský kraj";202;3792;78;3870;NA;363182;280;2022-01-14;211429
2022-01-13;"Prešovský kraj";252;3550;89;3639;NA;363182;341;2022-01-13;211149
2022-01-12;"Prešovský kraj";431;4183;77;4260;NA;363182;508;2022-01-12;210808
2022-01-11;"Prešovský kraj";438;4812;80;4892;NA;363182;518;2022-01-11;210300
2022-01-10;"Prešovský kraj";469;7561;135;7696;NA;363182;604;2022-01-10;209782
2022-01-09;"Prešovský kraj";114;4129;78;4207;NA;363182;192;2022-01-09;209178
2022-01-08;"Prešovský kraj";291;2097;39;2136;NA;363182;330;2022-01-08;208986
2022-01-07;"Prešovský kraj";370;3882;106;3988;NA;363182;476;2022-01-07;208656
2022-01-06;"Prešovský kraj";104;1000;43;1043;NA;363182;147;2022-01-06;208180
2022-01-05;"Prešovský kraj";373;4752;100;4852;NA;363182;473;2022-01-05;208033
2022-01-04;"Prešovský kraj";428;4558;77;4635;NA;363182;505;2022-01-04;207560
2022-01-03;"Prešovský kraj";390;6868;105;6973;NA;363182;495;2022-01-03;207055
2022-01-02;"Prešovský kraj";158;3180;75;3255;NA;363182;233;2022-01-02;206560
2022-01-01;"Prešovský kraj";55;379;8;387;NA;363182;63;2022-01-01;206327
2021-12-31;"Prešovský kraj";220;2217;77;2294;NA;363182;297;2021-12-31;206264
2021-12-30;"Prešovský kraj";230;2985;81;3066;NA;363182;311;2021-12-30;205967
2021-12-29;"Prešovský kraj";298;3924;73;3997;NA;363182;371;2021-12-29;205656
2021-12-28;"Prešovský kraj";365;3625;60;3685;NA;363182;425;2021-12-28;205285
2021-12-27;"Prešovský kraj";593;5336;93;5429;NA;363182;686;2021-12-27;204860
2021-12-26;"Prešovský kraj";112;1584;62;1646;NA;363182;174;2021-12-26;204174
2021-12-25;"Prešovský kraj";12;600;29;629;NA;363182;41;2021-12-25;204000
2021-12-24;"Prešovský kraj";27;463;26;489;NA;363182;53;2021-12-24;203959
2021-12-23;"Prešovský kraj";623;3125;76;3201;NA;363182;699;2021-12-23;203906
2021-12-22;"Prešovský kraj";234;3600;86;3686;NA;363182;320;2021-12-22;203207
2021-12-21;"Prešovský kraj";520;4571;78;4649;NA;363182;598;2021-12-21;202887
2021-12-20;"Prešovský kraj";371;7190;107;7297;NA;363182;478;2021-12-20;202289
2021-12-19;"Prešovský kraj";110;3166;74;3240;NA;363182;184;2021-12-19;201811
2021-12-18;"Prešovský kraj";313;1562;61;1623;NA;363182;374;2021-12-18;201627
2021-12-17;"Prešovský kraj";429;4482;96;4578;NA;363182;525;2021-12-17;201253
2021-12-16;"Prešovský kraj";401;4557;95;4652;NA;363182;496;2021-12-16;200728
2021-12-15;"Prešovský kraj";473;4499;79;4578;NA;363182;552;2021-12-15;200232
2021-12-14;"Prešovský kraj";662;5468;125;5593;NA;363182;787;2021-12-14;199680
2021-12-13;"Prešovský kraj";588;8085;175;8260;NA;363182;763;2021-12-13;198893
2021-12-12;"Prešovský kraj";160;3852;106;3958;NA;363182;266;2021-12-12;198130
2021-12-11;"Prešovský kraj";483;2040;91;2131;NA;363182;574;2021-12-11;197864
2021-12-10;"Prešovský kraj";649;5018;140;5158;NA;363182;789;2021-12-10;197290
2021-12-09;"Prešovský kraj";669;4702;135;4837;NA;363182;804;2021-12-09;196501
2021-12-08;"Prešovský kraj";944;4794;167;4961;NA;363182;1111;2021-12-08;195697
2021-12-07;"Prešovský kraj";1217;5853;188;6041;NA;363182;1405;2021-12-07;194586
2021-12-06;"Prešovský kraj";784;8604;247;8851;NA;363182;1031;2021-12-06;193181
2021-12-05;"Prešovský kraj";145;4439;133;4572;NA;363182;278;2021-12-05;192150
2021-12-04;"Prešovský kraj";1025;2290;127;2417;NA;363182;1152;2021-12-04;191872
2021-12-03;"Prešovský kraj";1040;5268;231;5499;NA;363182;1271;2021-12-03;190720
2021-12-02;"Prešovský kraj";2255;5291;183;5474;NA;363182;2438;2021-12-02;189449
2021-12-01;"Prešovský kraj";826;5267;239;5506;NA;363182;1065;2021-12-01;187011
2021-11-30;"Prešovský kraj";1123;6651;265;6916;NA;363182;1388;2021-11-30;185946
2021-11-29;"Prešovský kraj";583;11478;473;11951;NA;363182;1056;2021-11-29;184558
2021-11-28;"Prešovský kraj";919;5898;234;6132;NA;363182;1153;2021-11-28;183502
2021-11-27;"Prešovský kraj";884;2977;219;3196;NA;363182;1103;2021-11-27;182349
2021-11-26;"Prešovský kraj";1311;5890;328;6218;NA;363182;1639;2021-11-26;181246
2021-11-25;"Prešovský kraj";1285;5051;307;5358;NA;363182;1592;2021-11-25;179607
2021-11-24;"Prešovský kraj";1209;6120;357;6477;NA;363182;1566;2021-11-24;178015
2021-11-23;"Prešovský kraj";1099;6631;314;6945;NA;363182;1413;2021-11-23;176449
2021-11-22;"Prešovský kraj";905;8209;529;8738;NA;363182;1434;2021-11-22;175036
2021-11-21;"Prešovský kraj";950;3766;316;4082;NA;363182;1266;2021-11-21;173602
2021-11-20;"Prešovský kraj";1372;2193;222;2415;NA;363182;1594;2021-11-20;172336
2021-11-19;"Prešovský kraj";1629;5864;452;6316;NA;363182;2081;2021-11-19;170742
2021-11-18;"Prešovský kraj";823;6696;518;7214;NA;363182;1341;2021-11-18;168661
2021-11-17;"Prešovský kraj";1648;1336;148;1484;NA;363182;1796;2021-11-17;167320
2021-11-16;"Prešovský kraj";1346;5511;398;5909;NA;363182;1744;2021-11-16;165524
2021-11-15;"Prešovský kraj";897;7804;577;8381;NA;363182;1474;2021-11-15;163780
2021-11-14;"Prešovský kraj";603;3168;311;3479;NA;363182;914;2021-11-14;162306
2021-11-13;"Prešovský kraj";1255;2068;262;2330;NA;363182;1517;2021-11-13;161392
2021-11-12;"Prešovský kraj";1358;5236;371;5607;NA;363182;1729;2021-11-12;159875
2021-11-11;"Prešovský kraj";1218;5087;438;5525;NA;363182;1656;2021-11-11;158146
2021-11-10;"Prešovský kraj";1278;4966;380;5346;NA;363182;1658;2021-11-10;156490
2021-11-09;"Prešovský kraj";1038;5431;407;5838;NA;363182;1445;2021-11-09;154832
2021-11-08;"Prešovský kraj";1068;6987;574;7561;NA;363182;1642;2021-11-08;153387
2021-11-07;"Prešovský kraj";421;2500;242;2742;NA;363182;663;2021-11-07;151745
2021-11-06;"Prešovský kraj";1389;1899;234;2133;NA;363182;1623;2021-11-06;151082
2021-11-05;"Prešovský kraj";1080;4974;367;5341;NA;363182;1447;2021-11-05;149459
2021-11-04;"Prešovský kraj";1743;5162;322;5484;NA;363182;2065;2021-11-04;148012
2021-11-03;"Prešovský kraj";1326;5337;387;5724;NA;363182;1713;2021-11-03;145947
2021-11-02;"Prešovský kraj";1002;7553;556;8109;NA;363182;1558;2021-11-02;144234
2021-11-01;"Prešovský kraj";347;1402;131;1533;NA;363182;478;2021-11-01;142676
2021-10-31;"Prešovský kraj";447;2045;210;2255;NA;363182;657;2021-10-31;142198
2021-10-30;"Prešovský kraj";1148;1928;183;2111;NA;363182;1331;2021-10-30;141541
2021-10-29;"Prešovský kraj";1360;4460;253;4713;NA;363182;1613;2021-10-29;140210
2021-10-28;"Prešovský kraj";960;4500;300;4800;NA;363182;1260;2021-10-28;138597
2021-10-27;"Prešovský kraj";1444;4325;221;4546;NA;363182;1665;2021-10-27;137337
2021-10-26;"Prešovský kraj";940;5125;217;5342;NA;363182;1157;2021-10-26;135672
2021-10-25;"Prešovský kraj";673;6077;348;6425;NA;363182;1021;2021-10-25;134515
2021-10-24;"Prešovský kraj";110;2180;149;2329;NA;363182;259;2021-10-24;133494
2021-10-23;"Prešovský kraj";1145;1928;141;2069;NA;363182;1286;2021-10-23;133235
2021-10-22;"Prešovský kraj";792;4876;177;5053;NA;363182;969;2021-10-22;131949
2021-10-21;"Prešovský kraj";901;4738;191;4929;NA;363182;1092;2021-10-21;130980
2021-10-20;"Prešovský kraj";833;4199;195;4394;NA;363182;1028;2021-10-20;129888
2021-10-19;"Prešovský kraj";830;4728;175;4903;NA;363182;1005;2021-10-19;128860
2021-10-18;"Prešovský kraj";454;5752;240;5992;NA;363182;694;2021-10-18;127855
2021-10-17;"Prešovský kraj";181;2430;131;2561;NA;363182;312;2021-10-17;127161
2021-10-16;"Prešovský kraj";561;1924;94;2018;NA;363182;655;2021-10-16;126849
2021-10-15;"Prešovský kraj";533;4735;107;4842;NA;363182;640;2021-10-15;126194
2021-10-14;"Prešovský kraj";506;3948;85;4033;NA;363182;591;2021-10-14;125554
2021-10-13;"Prešovský kraj";549;3794;98;3892;NA;363182;647;2021-10-13;124963
2021-10-12;"Prešovský kraj";520;3966;101;4067;NA;363182;621;2021-10-12;124316
2021-10-11;"Prešovský kraj";433;5421;131;5552;NA;363182;564;2021-10-11;123695
2021-10-10;"Prešovský kraj";78;2099;64;2163;NA;363182;142;2021-10-10;123131
2021-10-09;"Prešovský kraj";311;2077;47;2124;NA;363182;358;2021-10-09;122989
2021-10-08;"Prešovský kraj";636;4934;94;5028;NA;363182;730;2021-10-08;122631
2021-10-07;"Prešovský kraj";487;3919;101;4020;NA;363182;588;2021-10-07;121901
2021-10-06;"Prešovský kraj";296;3851;104;3955;NA;363182;400;2021-10-06;121313
2021-10-05;"Prešovský kraj";430;4151;90;4241;NA;363182;520;2021-10-05;120913
2021-10-04;"Prešovský kraj";353;5569;125;5694;NA;363182;478;2021-10-04;120393
2021-10-03;"Prešovský kraj";19;2324;47;2371;NA;363182;66;2021-10-03;119915
2021-10-02;"Prešovský kraj";269;2238;58;2296;NA;363182;327;2021-10-02;119849
2021-10-01;"Prešovský kraj";325;4997;63;5060;NA;363182;388;2021-10-01;119522
2021-09-30;"Prešovský kraj";265;4044;83;4127;NA;363182;348;2021-09-30;119134
2021-09-29;"Prešovský kraj";381;3825;55;3880;NA;363182;436;2021-09-29;118786
2021-09-28;"Prešovský kraj";312;4714;69;4783;NA;363182;381;2021-09-28;118350
2021-09-27;"Prešovský kraj";257;5062;104;5166;NA;363182;361;2021-09-27;117969
2021-09-26;"Prešovský kraj";8;2422;67;2489;NA;363182;75;2021-09-26;117608
2021-09-25;"Prešovský kraj";134;2540;46;2586;NA;363182;180;2021-09-25;117533
2021-09-24;"Prešovský kraj";297;4822;61;4883;NA;363182;358;2021-09-24;117353
2021-09-23;"Prešovský kraj";109;4105;45;4150;NA;363182;154;2021-09-23;116995
2021-09-22;"Prešovský kraj";177;3836;41;3877;NA;363182;218;2021-09-22;116841
2021-09-21;"Prešovský kraj";219;5059;66;5125;NA;363182;285;2021-09-21;116623
2021-09-20;"Prešovský kraj";180;5183;68;5251;NA;363182;248;2021-09-20;116338
2021-09-19;"Prešovský kraj";7;2726;30;2756;NA;363182;37;2021-09-19;116090
2021-09-18;"Prešovský kraj";169;2406;37;2443;NA;363182;206;2021-09-18;116053
2021-09-17;"Prešovský kraj";157;4402;52;4454;NA;363182;209;2021-09-17;115847
2021-09-16;"Prešovský kraj";146;4371;71;4442;NA;363182;217;2021-09-16;115638
2021-09-15;"Prešovský kraj";68;701;19;720;NA;363182;87;2021-09-15;115421
2021-09-14;"Prešovský kraj";133;3369;38;3407;NA;363182;171;2021-09-14;115334
2021-09-13;"Prešovský kraj";105;4225;37;4262;NA;363182;142;2021-09-13;115163
2021-09-12;"Prešovský kraj";4;1776;29;1805;NA;363182;33;2021-09-12;115021
2021-09-11;"Prešovský kraj";65;2012;24;2036;NA;363182;89;2021-09-11;114988
2021-09-10;"Prešovský kraj";105;3241;30;3271;NA;363182;135;2021-09-10;114899
2021-09-09;"Prešovský kraj";29;3090;27;3117;NA;363182;56;2021-09-09;114764
2021-09-08;"Prešovský kraj";73;2444;20;2464;NA;363182;93;2021-09-08;114708
2021-09-07;"Prešovský kraj";82;2449;24;2473;NA;363182;106;2021-09-07;114615
2021-09-06;"Prešovský kraj";61;3282;20;3302;NA;363182;81;2021-09-06;114509
2021-09-05;"Prešovský kraj";5;1338;11;1349;NA;363182;16;2021-09-05;114428
2021-09-04;"Prešovský kraj";27;1864;14;1878;NA;363182;41;2021-09-04;114412
2021-09-03;"Prešovský kraj";39;2976;15;2991;NA;363182;54;2021-09-03;114371
2021-09-02;"Prešovský kraj";39;2558;20;2578;NA;363182;59;2021-09-02;114317
2021-09-01;"Prešovský kraj";14;575;6;581;NA;363182;20;2021-09-01;114258
2021-08-31;"Prešovský kraj";47;2438;13;2451;NA;363182;60;2021-08-31;114238
2021-08-30;"Prešovský kraj";23;2827;19;2846;NA;363182;42;2021-08-30;114178
2021-08-29;"Prešovský kraj";3;781;1;782;NA;363182;4;2021-08-29;114136
2021-08-28;"Prešovský kraj";5;2101;8;2109;NA;363182;13;2021-08-28;114132
2021-08-27;"Prešovský kraj";32;3084;8;3092;NA;363182;40;2021-08-27;114119
2021-08-26;"Prešovský kraj";13;2094;8;2102;NA;363182;21;2021-08-26;114079
2021-08-25;"Prešovský kraj";18;1947;4;1951;NA;363182;22;2021-08-25;114058
2021-08-24;"Prešovský kraj";10;2138;5;2143;NA;363182;15;2021-08-24;114036
2021-08-23;"Prešovský kraj";16;2576;6;2582;NA;363182;22;2021-08-23;114021
2021-08-22;"Prešovský kraj";0;1440;6;1446;NA;363182;6;2021-08-22;113999
2021-08-21;"Prešovský kraj";28;2018;4;2022;NA;363182;32;2021-08-21;113993
2021-08-20;"Prešovský kraj";15;2906;7;2913;NA;363182;22;2021-08-20;113961
2021-08-19;"Prešovský kraj";22;2242;8;2250;NA;363182;30;2021-08-19;113939
2021-08-18;"Prešovský kraj";6;1752;11;1763;NA;363182;17;2021-08-18;113909
2021-08-17;"Prešovský kraj";29;1829;6;1835;NA;363182;35;2021-08-17;113892
2021-08-16;"Prešovský kraj";11;2524;7;2531;NA;363182;18;2021-08-16;113857
2021-08-15;"Prešovský kraj";0;896;2;898;NA;363182;2;2021-08-15;113839
2021-08-14;"Prešovský kraj";14;1662;1;1663;NA;363182;15;2021-08-14;113837
2021-08-13;"Prešovský kraj";24;1646;12;1658;NA;363182;36;2021-08-13;113822
2021-08-12;"Prešovský kraj";9;1752;3;1755;NA;363182;12;2021-08-12;113786
2021-08-11;"Prešovský kraj";15;1193;3;1196;NA;363182;18;2021-08-11;113774
2021-08-10;"Prešovský kraj";10;1102;4;1106;NA;363182;14;2021-08-10;113756
2021-08-09;"Prešovský kraj";13;2156;4;2160;NA;363182;17;2021-08-09;113742
2021-08-08;"Prešovský kraj";2;675;2;677;NA;363182;4;2021-08-08;113725
2021-08-07;"Prešovský kraj";5;1114;3;1117;NA;363182;8;2021-08-07;113721
2021-08-06;"Prešovský kraj";9;1459;4;1463;NA;363182;13;2021-08-06;113713
2021-08-05;"Prešovský kraj";9;1370;2;1372;NA;363182;11;2021-08-05;113700
2021-08-04;"Prešovský kraj";6;1007;1;1008;NA;363182;7;2021-08-04;113689
2021-08-03;"Prešovský kraj";8;976;1;977;NA;363182;9;2021-08-03;113682
2021-08-02;"Prešovský kraj";5;1477;6;1483;NA;363182;11;2021-08-02;113673
2021-08-01;"Prešovský kraj";0;738;2;740;NA;363182;2;2021-08-01;113662
2021-07-31;"Prešovský kraj";20;1080;0;1080;NA;363182;20;2021-07-31;113660
2021-07-30;"Prešovský kraj";2;1518;1;1519;NA;363182;3;2021-07-30;113640
2021-07-29;"Prešovský kraj";6;1302;1;1303;NA;363182;7;2021-07-29;113637
2021-07-28;"Prešovský kraj";6;1106;1;1107;NA;363182;7;2021-07-28;113630
2021-07-27;"Prešovský kraj";5;1140;2;1142;NA;363182;7;2021-07-27;113623
2021-07-26;"Prešovský kraj";12;1583;1;1584;NA;363182;13;2021-07-26;113616
2021-07-25;"Prešovský kraj";0;687;1;688;NA;363182;1;2021-07-25;113603
2021-07-24;"Prešovský kraj";8;1040;0;1040;NA;363182;8;2021-07-24;113602
2021-07-23;"Prešovský kraj";8;1608;1;1609;NA;363182;9;2021-07-23;113594
2021-07-22;"Prešovský kraj";13;1431;10;1441;NA;363182;23;2021-07-22;113585
2021-07-21;"Prešovský kraj";5;1076;1;1077;NA;363182;6;2021-07-21;113562
2021-07-20;"Prešovský kraj";4;1064;0;1064;NA;363182;4;2021-07-20;113556
2021-07-19;"Prešovský kraj";2;1644;4;1648;NA;363182;6;2021-07-19;113552
2021-07-18;"Prešovský kraj";1;647;0;647;NA;363182;1;2021-07-18;113546
2021-07-17;"Prešovský kraj";6;1245;1;1246;NA;363182;7;2021-07-17;113545
2021-07-16;"Prešovský kraj";4;1558;2;1560;NA;363182;6;2021-07-16;113538
2021-07-15;"Prešovský kraj";5;1310;4;1314;NA;363182;9;2021-07-15;113532
2021-07-14;"Prešovský kraj";1;1051;2;1053;NA;363182;3;2021-07-14;113523
2021-07-13;"Prešovský kraj";1;1071;2;1073;NA;363182;3;2021-07-13;113520
2021-07-12;"Prešovský kraj";1;1949;2;1951;NA;363182;3;2021-07-12;113517
2021-07-11;"Prešovský kraj";0;660;1;661;NA;363182;1;2021-07-11;113514
2021-07-10;"Prešovský kraj";4;1229;2;1231;NA;363182;6;2021-07-10;113513
2021-07-09;"Prešovský kraj";6;1957;1;1958;NA;363182;7;2021-07-09;113507
2021-07-08;"Prešovský kraj";5;1192;0;1192;NA;363182;5;2021-07-08;113500
2021-07-07;"Prešovský kraj";7;1468;3;1471;NA;363182;10;2021-07-07;113495
2021-07-06;"Prešovský kraj";5;1423;2;1425;NA;363182;7;2021-07-06;113485
2021-07-05;"Prešovský kraj";2;645;0;645;NA;363182;2;2021-07-05;113478
2021-07-04;"Prešovský kraj";0;788;0;788;NA;363182;0;2021-07-04;113476
2021-07-03;"Prešovský kraj";2;1391;0;1391;NA;363182;2;2021-07-03;113476
2021-07-02;"Prešovský kraj";4;1796;0;1796;NA;363182;4;2021-07-02;113474
2021-07-01;"Prešovský kraj";2;1590;1;1591;NA;363182;3;2021-07-01;113470
2021-06-30;"Prešovský kraj";3;8829;4;8833;NA;363182;7;2021-06-30;113467
2021-06-29;"Prešovský kraj";1;4935;3;4938;NA;363182;4;2021-06-29;113460
2021-06-28;"Prešovský kraj";5;6109;2;6111;NA;363182;7;2021-06-28;113456
2021-06-27;"Prešovský kraj";0;3852;1;3853;NA;363182;1;2021-06-27;113449
2021-06-26;"Prešovský kraj";4;5815;1;5816;NA;363182;5;2021-06-26;113448
2021-06-25;"Prešovský kraj";7;7321;4;7325;NA;363182;11;2021-06-25;113443
2021-06-24;"Prešovský kraj";10;5406;5;5411;NA;363182;15;2021-06-24;113432
2021-06-23;"Prešovský kraj";4;5124;2;5126;NA;363182;6;2021-06-23;113417
2021-06-22;"Prešovský kraj";5;5143;1;5144;NA;363182;6;2021-06-22;113411
2021-06-21;"Prešovský kraj";13;7033;6;7039;NA;363182;19;2021-06-21;113405
2021-06-20;"Prešovský kraj";0;5204;3;5207;NA;363182;3;2021-06-20;113386
2021-06-19;"Prešovský kraj";1;7349;5;7354;NA;363182;6;2021-06-19;113383
2021-06-18;"Prešovský kraj";9;8682;10;8692;NA;363182;19;2021-06-18;113377
2021-06-17;"Prešovský kraj";9;6548;5;6553;NA;363182;14;2021-06-17;113358
2021-06-16;"Prešovský kraj";6;6422;3;6425;NA;363182;9;2021-06-16;113344
2021-06-15;"Prešovský kraj";2;5709;4;5713;NA;363182;6;2021-06-15;113335
2021-06-14;"Prešovský kraj";5;8229;13;8242;NA;363182;18;2021-06-14;113329
2021-06-13;"Prešovský kraj";1;6455;7;6462;NA;363182;8;2021-06-13;113311
2021-06-12;"Prešovský kraj";3;8904;9;8913;NA;363182;12;2021-06-12;113303
2021-06-11;"Prešovský kraj";21;9877;9;9886;NA;363182;30;2021-06-11;113291
2021-06-10;"Prešovský kraj";11;6512;10;6522;NA;363182;21;2021-06-10;113261
2021-06-09;"Prešovský kraj";16;6375;3;6378;NA;363182;19;2021-06-09;113240
2021-06-08;"Prešovský kraj";31;6495;12;6507;NA;363182;43;2021-06-08;113221
2021-06-07;"Prešovský kraj";11;9111;15;9126;NA;363182;26;2021-06-07;113178
2021-06-06;"Prešovský kraj";0;8016;5;8021;NA;363182;5;2021-06-06;113152
2021-06-05;"Prešovský kraj";17;10248;15;10263;NA;363182;32;2021-06-05;113147
2021-06-04;"Prešovský kraj";26;10375;18;10393;NA;363182;44;2021-06-04;113115
2021-06-03;"Prešovský kraj";14;6820;16;6836;NA;363182;30;2021-06-03;113071
2021-06-02;"Prešovský kraj";47;7372;14;7386;NA;363182;61;2021-06-02;113041
2021-06-01;"Prešovský kraj";15;6926;14;6940;NA;363182;29;2021-06-01;112980
2021-05-31;"Prešovský kraj";27;9951;22;9973;NA;363182;49;2021-05-31;112951
2021-05-30;"Prešovský kraj";2;9717;14;9731;NA;363182;16;2021-05-30;112902
2021-05-29;"Prešovský kraj";23;12733;24;12757;NA;363182;47;2021-05-29;112886
2021-05-28;"Prešovský kraj";30;12468;19;12487;NA;363182;49;2021-05-28;112839
2021-05-27;"Prešovský kraj";16;7653;37;7690;NA;363182;53;2021-05-27;112790
2021-05-26;"Prešovský kraj";32;8140;23;8163;NA;363182;55;2021-05-26;112737
2021-05-25;"Prešovský kraj";38;8690;20;8710;NA;363182;58;2021-05-25;112682
2021-05-24;"Prešovský kraj";17;13298;37;13335;NA;363182;54;2021-05-24;112624
2021-05-23;"Prešovský kraj";3;11947;20;11967;NA;363182;23;2021-05-23;112570
2021-05-22;"Prešovský kraj";11;14422;44;14466;NA;363182;55;2021-05-22;112547
2021-05-21;"Prešovský kraj";44;13803;24;13827;NA;363182;68;2021-05-21;112492
2021-05-20;"Prešovský kraj";13;9437;29;9466;NA;363182;42;2021-05-20;112424
2021-05-19;"Prešovský kraj";60;10756;36;10792;NA;363182;96;2021-05-19;112382
2021-05-18;"Prešovský kraj";44;9062;27;9089;NA;363182;71;2021-05-18;112286
2021-05-17;"Prešovský kraj";60;12856;47;12903;NA;363182;107;2021-05-17;112215
2021-05-16;"Prešovský kraj";20;16302;66;16368;NA;363182;86;2021-05-16;112108
2021-05-15;"Prešovský kraj";20;24604;81;24685;NA;363182;101;2021-05-15;112022
2021-05-14;"Prešovský kraj";49;18671;68;18739;NA;363182;117;2021-05-14;111921
2021-05-13;"Prešovský kraj";54;11166;71;11237;NA;363182;125;2021-05-13;111804
2021-05-12;"Prešovský kraj";59;10822;39;10861;NA;363182;98;2021-05-12;111679
2021-05-11;"Prešovský kraj";61;10728;48;10776;NA;363182;109;2021-05-11;111581
2021-05-10;"Prešovský kraj";79;15726;67;15793;NA;363182;146;2021-05-10;111472
2021-05-09;"Prešovský kraj";54;21658;82;21740;NA;363182;136;2021-05-09;111326
2021-05-08;"Prešovský kraj";39;23050;52;23102;NA;363182;91;2021-05-08;111190
2021-05-07;"Prešovský kraj";81;23543;66;23609;NA;363182;147;2021-05-07;111099
2021-05-06;"Prešovský kraj";107;12924;66;12990;NA;363182;173;2021-05-06;110952
2021-05-05;"Prešovský kraj";60;12808;84;12892;NA;363182;144;2021-05-05;110779
2021-05-04;"Prešovský kraj";203;13470;67;13537;NA;363182;270;2021-05-04;110635
2021-05-03;"Prešovský kraj";68;18458;109;18567;NA;363182;177;2021-05-03;110365
2021-05-02;"Prešovský kraj";29;36676;102;36778;NA;363182;131;2021-05-02;110188
2021-05-01;"Prešovský kraj";70;57153;183;57336;NA;363182;253;2021-05-01;110057
2021-04-30;"Prešovský kraj";135;39333;118;39451;NA;363182;253;2021-04-30;109804
2021-04-29;"Prešovský kraj";110;16635;97;16732;NA;363182;207;2021-04-29;109551
2021-04-28;"Prešovský kraj";122;18671;89;18760;NA;363182;211;2021-04-28;109344
2021-04-27;"Prešovský kraj";154;19994;120;20114;NA;363182;274;2021-04-27;109133
2021-04-26;"Prešovský kraj";99;27241;123;27364;NA;363182;222;2021-04-26;108859
2021-04-25;"Prešovský kraj";9;52776;156;52932;NA;363182;165;2021-04-25;108637
2021-04-24;"Prešovský kraj";61;85698;243;85941;NA;363182;304;2021-04-24;108472
2021-04-23;"Prešovský kraj";171;40365;137;40502;NA;363182;308;2021-04-23;108168
2021-04-22;"Prešovský kraj";86;18104;125;18229;NA;363182;211;2021-04-22;107860
2021-04-21;"Prešovský kraj";144;21550;139;21689;NA;363182;283;2021-04-21;107649
2021-04-20;"Prešovský kraj";115;23346;128;23474;NA;363182;243;2021-04-20;107366
2021-04-19;"Prešovský kraj";106;29133;145;29278;NA;363182;251;2021-04-19;107123
2021-04-18;"Prešovský kraj";4;51824;129;51953;NA;363182;133;2021-04-18;106872
2021-04-17;"Prešovský kraj";119;97970;238;98208;NA;363182;357;2021-04-17;106739
2021-04-16;"Prešovský kraj";135;40989;146;41135;NA;363182;281;2021-04-16;106382
2021-04-15;"Prešovský kraj";112;20179;137;20316;NA;363182;249;2021-04-15;106101
2021-04-14;"Prešovský kraj";199;23332;130;23462;NA;363182;329;2021-04-14;105852
2021-04-13;"Prešovský kraj";180;23907;116;24023;NA;363182;296;2021-04-13;105523
2021-04-12;"Prešovský kraj";172;30152;175;30327;NA;363182;347;2021-04-12;105227
2021-04-11;"Prešovský kraj";11;49955;187;50142;NA;363182;198;2021-04-11;104880
2021-04-10;"Prešovský kraj";94;90181;297;90478;NA;363182;391;2021-04-10;104682
2021-04-09;"Prešovský kraj";255;37163;200;37363;NA;363182;455;2021-04-09;104291
2021-04-08;"Prešovský kraj";192;18893;157;19050;NA;363182;349;2021-04-08;103836
2021-04-07;"Prešovský kraj";314;27797;154;27951;NA;363182;468;2021-04-07;103487
2021-04-06;"Prešovský kraj";231;41711;268;41979;NA;363182;499;2021-04-06;103019
2021-04-05;"Prešovský kraj";54;18454;132;18586;NA;363182;186;2021-04-05;102520
2021-04-04;"Prešovský kraj";31;18569;91;18660;NA;363182;122;2021-04-04;102334
2021-04-03;"Prešovský kraj";104;90664;321;90985;NA;363182;425;2021-04-03;102212
2021-04-02;"Prešovský kraj";194;23381;134;23515;NA;363182;328;2021-04-02;101787
2021-04-01;"Prešovský kraj";256;42879;195;43074;NA;363182;451;2021-04-01;101459
2021-03-31;"Prešovský kraj";311;30176;227;30403;NA;363182;538;2021-03-31;101008
2021-03-30;"Prešovský kraj";374;20751;203;20954;NA;363182;577;2021-03-30;100470
2021-03-29;"Prešovský kraj";219;28188;229;28417;NA;363182;448;2021-03-29;99893
2021-03-28;"Prešovský kraj";26;46811;256;47067;NA;363182;282;2021-03-28;99445
2021-03-27;"Prešovský kraj";181;88673;372;89045;NA;363182;553;2021-03-27;99163
2021-03-26;"Prešovský kraj";310;47751;299;48050;NA;363182;609;2021-03-26;98610
2021-03-25;"Prešovský kraj";248;22281;213;22494;NA;363182;461;2021-03-25;98001
2021-03-24;"Prešovský kraj";381;19590;213;19803;NA;363182;594;2021-03-24;97540
2021-03-23;"Prešovský kraj";241;20351;255;20606;NA;363182;496;2021-03-23;96946
2021-03-22;"Prešovský kraj";299;28634;287;28921;NA;363182;586;2021-03-22;96450
2021-03-21;"Prešovský kraj";32;49439;266;49705;NA;363182;298;2021-03-21;95864
2021-03-20;"Prešovský kraj";180;92529;426;92955;NA;363182;606;2021-03-20;95566
2021-03-19;"Prešovský kraj";373;46582;326;46908;NA;363182;699;2021-03-19;94960
2021-03-18;"Prešovský kraj";251;21721;217;21938;NA;363182;468;2021-03-18;94261
2021-03-17;"Prešovský kraj";331;20887;231;21118;NA;363182;562;2021-03-17;93793
2021-03-16;"Prešovský kraj";461;21094;278;21372;NA;363182;739;2021-03-16;93231
2021-03-15;"Prešovský kraj";370;28813;324;29137;NA;363182;694;2021-03-15;92492
2021-03-14;"Prešovský kraj";52;50410;356;50766;NA;363182;408;2021-03-14;91798
2021-03-13;"Prešovský kraj";200;94768;531;95299;NA;363182;731;2021-03-13;91390
2021-03-12;"Prešovský kraj";425;47691;368;48059;NA;363182;793;2021-03-12;90659
2021-03-11;"Prešovský kraj";463;22059;253;22312;NA;363182;716;2021-03-11;89866
2021-03-10;"Prešovský kraj";325;20821;293;21114;NA;363182;618;2021-03-10;89150
2021-03-09;"Prešovský kraj";505;21496;288;21784;NA;363182;793;2021-03-09;88532
2021-03-08;"Prešovský kraj";314;28903;333;29236;NA;363182;647;2021-03-08;87739
2021-03-07;"Prešovský kraj";19;48328;388;48716;NA;363182;407;2021-03-07;87092
2021-03-06;"Prešovský kraj";193;97527;591;98118;NA;363182;784;2021-03-06;86685
2021-03-05;"Prešovský kraj";497;46054;397;46451;NA;363182;894;2021-03-05;85901
2021-03-04;"Prešovský kraj";372;22670;359;23029;NA;363182;731;2021-03-04;85007
2021-03-03;"Prešovský kraj";397;21623;333;21956;NA;363182;730;2021-03-03;84276
2021-03-02;"Prešovský kraj";421;22682;357;23039;NA;363182;778;2021-03-02;83546
2021-03-01;"Prešovský kraj";303;27716;406;28122;NA;363182;709;2021-03-01;82768
2021-02-28;"Prešovský kraj";75;45000;387;45387;NA;363182;462;2021-02-28;82059
2021-02-27;"Prešovský kraj";273;90231;734;90965;NA;363182;1007;2021-02-27;81597
2021-02-26;"Prešovský kraj";455;41340;438;41778;NA;363182;893;2021-02-26;80590
2021-02-25;"Prešovský kraj";270;19496;337;19833;NA;363182;607;2021-02-25;79697
2021-02-24;"Prešovský kraj";328;19026;377;19403;NA;363182;705;2021-02-24;79090
2021-02-23;"Prešovský kraj";430;21277;345;21622;NA;363182;775;2021-02-23;78385
2021-02-22;"Prešovský kraj";351;27180;356;27536;NA;363182;707;2021-02-22;77610
2021-02-21;"Prešovský kraj";66;31453;301;31754;NA;363182;367;2021-02-21;76903
2021-02-20;"Prešovský kraj";129;71413;517;71930;NA;363182;646;2021-02-20;76536
2021-02-19;"Prešovský kraj";381;38995;430;39425;NA;363182;811;2021-02-19;75890
2021-02-18;"Prešovský kraj";268;16960;322;17282;NA;363182;590;2021-02-18;75079
2021-02-17;"Prešovský kraj";293;17392;246;17638;NA;363182;539;2021-02-17;74489
2021-02-16;"Prešovský kraj";422;18862;265;19127;NA;363182;687;2021-02-16;73950
2021-02-15;"Prešovský kraj";211;31366;303;31669;NA;363182;514;2021-02-15;73263
2021-02-14;"Prešovský kraj";27;39387;321;39708;NA;363182;348;2021-02-14;72749
2021-02-13;"Prešovský kraj";157;74747;402;75149;NA;363182;559;2021-02-13;72401
2021-02-12;"Prešovský kraj";308;38758;365;39123;NA;363182;673;2021-02-12;71842
2021-02-11;"Prešovský kraj";218;16218;239;16457;NA;363182;457;2021-02-11;71169
2021-02-10;"Prešovský kraj";220;18542;282;18824;NA;363182;502;2021-02-10;70712
2021-02-09;"Prešovský kraj";323;21497;370;21867;NA;363182;693;2021-02-09;70210
2021-02-08;"Prešovský kraj";161;36924;261;37185;NA;363182;422;2021-02-08;69517
2021-02-07;"Prešovský kraj";21;34227;209;34436;NA;363182;230;2021-02-07;69095
2021-02-06;"Prešovský kraj";176;69164;360;69524;NA;363182;536;2021-02-06;68865
2021-02-05;"Prešovský kraj";177;31271;262;31533;NA;363182;439;2021-02-05;68329
2021-02-04;"Prešovský kraj";176;13080;237;13317;NA;363182;413;2021-02-04;67890
2021-02-03;"Prešovský kraj";251;8421;236;8657;NA;363182;487;2021-02-03;67477
2021-02-02;"Prešovský kraj";249;11769;264;12033;NA;363182;513;2021-02-02;66990
2021-02-01;"Prešovský kraj";220;16059;316;16375;NA;363182;536;2021-02-01;66477
2021-01-31;"Prešovský kraj";42;10587;107;10694;NA;363182;149;2021-01-31;65941
2021-01-30;"Prešovský kraj";142;23939;215;24154;NA;363182;357;2021-01-30;65792
2021-01-29;"Prešovský kraj";185;17924;326;18250;NA;363182;511;2021-01-29;65435
2021-01-28;"Prešovský kraj";311;7348;150;7498;NA;363182;461;2021-01-28;64924
2021-01-27;"Prešovský kraj";153;9730;147;9877;NA;363182;300;2021-01-27;64463
2021-01-26;"Prešovský kraj";252;16653;151;16804;NA;363182;403;2021-01-26;64163
2021-01-25;"Prešovský kraj";196;30092;253;30345;NA;363182;449;2021-01-25;63760
2021-01-24;"Prešovský kraj";12;45706;304;46010;NA;363182;316;2021-01-24;63311
2021-01-23;"Prešovský kraj";189;96883;487;97370;NA;363182;676;2021-01-23;62995
2021-01-22;"Prešovský kraj";187;35383;261;35644;NA;363182;448;2021-01-22;62319
2021-01-21;"Prešovský kraj";187;20434;212;20646;NA;363182;399;2021-01-21;61871
2021-01-20;"Prešovský kraj";253;14782;195;14977;NA;363182;448;2021-01-20;61472
2021-01-19;"Prešovský kraj";281;12329;305;12634;NA;363182;586;2021-01-19;61024
2021-01-18;"Prešovský kraj";203;10422;336;10758;NA;363182;539;2021-01-18;60438
2021-01-17;"Prešovský kraj";107;14391;1008;15399;NA;363182;1115;2021-01-17;59899
2021-01-16;"Prešovský kraj";72;1838;81;1919;NA;363182;153;2021-01-16;58784
2021-01-15;"Prešovský kraj";159;7033;257;7290;NA;363182;416;2021-01-15;58631
2021-01-14;"Prešovský kraj";268;5534;256;5790;NA;363182;524;2021-01-14;58215
2021-01-13;"Prešovský kraj";342;5649;226;5875;NA;363182;568;2021-01-13;57691
2021-01-12;"Prešovský kraj";455;8251;386;8637;NA;363182;841;2021-01-12;57123
2021-01-11;"Prešovský kraj";343;8149;471;8620;NA;363182;814;2021-01-11;56282
2021-01-10;"Prešovský kraj";63;476;23;499;NA;363182;86;2021-01-10;55468
2021-01-09;"Prešovský kraj";439;2248;125;2373;NA;363182;564;2021-01-09;55382
2021-01-08;"Prešovský kraj";430;10416;561;10977;NA;363182;991;2021-01-08;54818
2021-01-07;"Prešovský kraj";268;7432;622;8054;NA;363182;890;2021-01-07;53827
2021-01-06;"Prešovský kraj";315;1484;134;1618;NA;363182;449;2021-01-06;52937
2021-01-05;"Prešovský kraj";655;11275;976;12251;NA;363182;1631;2021-01-05;52488
2021-01-04;"Prešovský kraj";371;16845;1789;18634;NA;363182;2160;2021-01-04;50857
2021-01-03;"Prešovský kraj";89;459;41;500;NA;363182;130;2021-01-03;48697
2021-01-02;"Prešovský kraj";65;1556;160;1716;NA;363182;225;2021-01-02;48567
2021-01-01;"Prešovský kraj";174;956;71;1027;NA;363182;245;2021-01-01;48342
2020-12-31;"Prešovský kraj";640;11959;783;12742;NA;363182;1423;2020-12-31;48097
2020-12-30;"Prešovský kraj";729;8729;769;9498;NA;363182;1498;2020-12-30;46674
2020-12-29;"Prešovský kraj";435;9273;949;10222;NA;363182;1384;2020-12-29;45176
2020-12-28;"Prešovský kraj";393;9046;1079;10125;NA;363182;1472;2020-12-28;43792
2020-12-27;"Prešovský kraj";40;613;45;658;NA;363182;85;2020-12-27;42320
2020-12-26;"Prešovský kraj";64;176;12;188;NA;363182;76;2020-12-26;42235
2020-12-25;"Prešovský kraj";208;274;11;285;NA;363182;219;2020-12-25;42159
2020-12-24;"Prešovský kraj";452;1214;85;1299;NA;363182;537;2020-12-24;41940
2020-12-23;"Prešovský kraj";361;11006;618;11624;NA;363182;979;2020-12-23;41403
2020-12-22;"Prešovský kraj";439;9023;695;9718;NA;363182;1134;2020-12-22;40424
2020-12-21;"Prešovský kraj";432;9577;847;10424;NA;363182;1279;2020-12-21;39290
2020-12-20;"Prešovský kraj";184;396;20;416;NA;363182;204;2020-12-20;38011
2020-12-19;"Prešovský kraj";276;1658;151;1809;NA;363182;427;2020-12-19;37807
2020-12-18;"Prešovský kraj";396;8246;566;8812;NA;363182;962;2020-12-18;37380
2020-12-17;"Prešovský kraj";427;10505;866;11371;NA;363182;1293;2020-12-17;36418
2020-12-16;"Prešovský kraj";466;5613;473;6086;NA;363182;939;2020-12-16;35125
2020-12-15;"Prešovský kraj";411;5406;574;5980;NA;363182;985;2020-12-15;34186
2020-12-14;"Prešovský kraj";334;5538;477;6015;NA;363182;811;2020-12-14;33201
2020-12-13;"Prešovský kraj";89;29;8;37;NA;363182;97;2020-12-13;32390
2020-12-12;"Prešovský kraj";319;2474;166;2640;NA;363182;485;2020-12-12;32293
2020-12-11;"Prešovský kraj";560;5602;402;6004;NA;363182;962;2020-12-11;31808
2020-12-10;"Prešovský kraj";337;5019;423;5442;NA;363182;760;2020-12-10;30846
2020-12-09;"Prešovský kraj";358;4357;314;4671;NA;363182;672;2020-12-09;30086
2020-12-08;"Prešovský kraj";350;6629;651;7280;NA;363182;1001;2020-12-08;29414
2020-12-07;"Prešovský kraj";309;4345;327;4672;NA;363182;636;2020-12-07;28413
2020-12-06;"Prešovský kraj";59;655;26;681;NA;363182;85;2020-12-06;27777
2020-12-05;"Prešovský kraj";218;984;87;1071;NA;363182;305;2020-12-05;27692
2020-12-04;"Prešovský kraj";352;5070;293;5363;NA;363182;645;2020-12-04;27387
2020-12-03;"Prešovský kraj";284;2456;179;2635;NA;363182;463;2020-12-03;26742
2020-12-02;"Prešovský kraj";232;2830;225;3055;NA;363182;457;2020-12-02;26279
2020-12-01;"Prešovský kraj";281;1884;196;2080;NA;363182;477;2020-12-01;25822
2020-11-30;"Prešovský kraj";196;5333;97;5430;NA;363182;293;2020-11-30;25345
2020-11-29;"Prešovský kraj";27;379;42;421;NA;363182;69;2020-11-29;25052
2020-11-28;"Prešovský kraj";199;772;77;849;NA;363182;276;2020-11-28;24983
2020-11-27;"Prešovský kraj";232;2350;130;2480;NA;363182;362;2020-11-27;24707
2020-11-26;"Prešovský kraj";263;3014;329;3343;NA;363182;592;2020-11-26;24345
2020-11-25;"Prešovský kraj";302;2174;103;2277;NA;363182;405;2020-11-25;23753
2020-11-24;"Prešovský kraj";365;1777;156;1933;NA;363182;521;2020-11-24;23348
2020-11-23;"Prešovský kraj";164;1099;60;1159;NA;363182;224;2020-11-23;22827
2020-11-22;"Prešovský kraj";46;44;1;45;NA;363182;47;2020-11-22;22603
2020-11-21;"Prešovský kraj";205;754;62;816;NA;363182;267;2020-11-21;22556
2020-11-20;"Prešovský kraj";363;2258;102;2360;NA;363182;465;2020-11-20;22289
2020-11-19;"Prešovský kraj";359;2096;238;2334;NA;363182;597;2020-11-19;21824
2020-11-18;"Prešovský kraj";270;488;43;531;NA;363182;313;2020-11-18;21227
2020-11-17;"Prešovský kraj";347;205;23;228;NA;363182;370;2020-11-17;20914
2020-11-16;"Prešovský kraj";226;540;58;598;NA;363182;284;2020-11-16;20544
2020-11-15;"Prešovský kraj";186;39;4;43;NA;363182;190;2020-11-15;20260
2020-11-14;"Prešovský kraj";261;54;4;58;NA;363182;265;2020-11-14;20070
2020-11-13;"Prešovský kraj";395;166;8;174;NA;363182;403;2020-11-13;19805
2020-11-12;"Prešovský kraj";397;229;50;279;NA;363182;447;2020-11-12;19402
2020-11-11;"Prešovský kraj";516;161;15;176;NA;363182;531;2020-11-11;18955
2020-11-10;"Prešovský kraj";437;197;9;206;NA;363182;446;2020-11-10;18424
2020-11-09;"Prešovský kraj";190;4110;945;5055;NA;363182;1135;2020-11-09;17978
2020-11-08;"Prešovský kraj";97;2817;32;2849;NA;363182;129;2020-11-08;16843
2020-11-07;"Prešovský kraj";416;8578;81;8659;NA;363182;497;2020-11-07;16714
2020-11-06;"Prešovský kraj";520;4791;76;4867;NA;363182;596;2020-11-06;16217
2020-11-05;"Prešovský kraj";397;180;5;185;NA;363182;402;2020-11-05;15621
2020-11-04;"Prešovský kraj";350;807;8;815;NA;363182;358;2020-11-04;15219
2020-11-03;"Prešovský kraj";565;98;12;110;NA;363182;577;2020-11-03;14861
2020-11-02;"Prešovský kraj";203;4158;1004;5162;NA;363182;1207;2020-11-02;14284
2020-11-01;"Prešovský kraj";386;2906;53;2959;NA;363182;439;2020-11-01;13077
2020-10-31;"Prešovský kraj";315;10497;170;10667;NA;363182;485;2020-10-31;12638
2020-10-30;"Prešovský kraj";552;2949;65;3014;NA;363182;617;2020-10-30;12153
2020-10-29;"Prešovský kraj";594;301;38;339;NA;363182;632;2020-10-29;11536
2020-10-28;"Prešovský kraj";617;291;46;337;NA;363182;663;2020-10-28;10904
2020-10-27;"Prešovský kraj";656;268;34;302;NA;363182;690;2020-10-27;10241
2020-10-26;"Prešovský kraj";137;363;57;420;NA;363182;194;2020-10-26;9551
2020-10-25;"Prešovský kraj";237;346;11;357;NA;363182;248;2020-10-25;9357
2020-10-24;"Prešovský kraj";719;200;12;212;NA;363182;731;2020-10-24;9109
2020-10-23;"Prešovský kraj";750;218;8;226;NA;363182;758;2020-10-23;8378
2020-10-22;"Prešovský kraj";646;396;30;426;NA;363182;676;2020-10-22;7620
2020-10-21;"Prešovský kraj";383;58;8;66;NA;363182;391;2020-10-21;6944
2020-10-20;"Prešovský kraj";493;65;7;72;NA;363182;500;2020-10-20;6553
2020-10-19;"Prešovský kraj";140;235;15;250;NA;363182;155;2020-10-19;6053
2020-10-18;"Prešovský kraj";209;0;0;0;NA;363182;209;2020-10-18;5898
2020-10-17;"Prešovský kraj";342;0;0;0;NA;363182;342;2020-10-17;5689
2020-10-16;"Prešovský kraj";388;57;3;60;NA;363182;391;2020-10-16;5347
2020-10-15;"Prešovský kraj";435;85;18;103;NA;363182;453;2020-10-15;4956
2020-10-14;"Prešovský kraj";451;54;10;64;NA;363182;461;2020-10-14;4503
2020-10-13;"Prešovský kraj";264;50;6;56;NA;363182;270;2020-10-13;4042
2020-10-12;"Prešovský kraj";214;334;35;369;NA;363182;249;2020-10-12;3772
2020-10-11;"Prešovský kraj";127;0;0;0;NA;363182;127;2020-10-11;3523
2020-10-10;"Prešovský kraj";248;0;0;0;NA;363182;248;2020-10-10;3396
2020-10-09;"Prešovský kraj";406;0;0;0;NA;363182;406;2020-10-09;3148
2020-10-08;"Prešovský kraj";245;0;0;0;NA;363182;245;2020-10-08;2742
2020-10-07;"Prešovský kraj";244;0;0;0;NA;363182;244;2020-10-07;2497
2020-10-06;"Prešovský kraj";166;0;0;0;NA;363182;166;2020-10-06;2253
2020-10-05;"Prešovský kraj";84;0;0;0;NA;363182;84;2020-10-05;2087
2020-10-04;"Prešovský kraj";118;0;0;0;NA;363182;118;2020-10-04;2003
2020-10-03;"Prešovský kraj";204;0;0;0;NA;363182;204;2020-10-03;1885
2020-10-02;"Prešovský kraj";149;0;0;0;NA;363182;149;2020-10-02;1681
2020-10-01;"Prešovský kraj";136;0;0;0;NA;363182;136;2020-10-01;1532
2020-09-30;"Prešovský kraj";121;0;0;0;NA;363182;121;2020-09-30;1396
2020-09-29;"Prešovský kraj";156;0;0;0;NA;363182;156;2020-09-29;1275
2020-09-28;"Prešovský kraj";51;0;0;0;NA;363182;51;2020-09-28;1119
2020-09-27;"Prešovský kraj";10;0;0;0;NA;363182;10;2020-09-27;1068
2020-09-26;"Prešovský kraj";72;0;0;0;NA;363182;72;2020-09-26;1058
2020-09-25;"Prešovský kraj";91;0;0;0;NA;363182;91;2020-09-25;986
2020-09-24;"Prešovský kraj";52;0;0;0;NA;363182;52;2020-09-24;895
2020-09-23;"Prešovský kraj";55;0;0;0;NA;363182;55;2020-09-23;843
2020-09-22;"Prešovský kraj";29;0;0;0;NA;363182;29;2020-09-22;788
2020-09-21;"Prešovský kraj";14;0;0;0;NA;363182;14;2020-09-21;759
2020-09-20;"Prešovský kraj";5;0;0;0;NA;363182;5;2020-09-20;745
2020-09-19;"Prešovský kraj";12;0;0;0;NA;363182;12;2020-09-19;740
2020-09-18;"Prešovský kraj";29;0;0;0;NA;363182;29;2020-09-18;728
2020-09-17;"Prešovský kraj";25;0;0;0;NA;363182;25;2020-09-17;699
2020-09-16;"Prešovský kraj";8;0;0;0;NA;363182;8;2020-09-16;674
2020-09-15;"Prešovský kraj";10;0;0;0;NA;363182;10;2020-09-15;666
2020-09-14;"Prešovský kraj";47;0;0;0;NA;363182;47;2020-09-14;656
2020-09-13;"Prešovský kraj";3;0;0;0;NA;363182;3;2020-09-13;609
2020-09-12;"Prešovský kraj";4;0;0;0;NA;363182;4;2020-09-12;606
2020-09-11;"Prešovský kraj";15;0;0;0;NA;363182;15;2020-09-11;602
2020-09-10;"Prešovský kraj";10;0;0;0;NA;363182;10;2020-09-10;587
2020-09-09;"Prešovský kraj";21;0;0;0;NA;363182;21;2020-09-09;577
2020-09-08;"Prešovský kraj";23;0;0;0;NA;363182;23;2020-09-08;556
2020-09-07;"Prešovský kraj";5;0;0;0;NA;363182;5;2020-09-07;533
2020-09-06;"Prešovský kraj";3;0;0;0;NA;363182;3;2020-09-06;528
2020-09-05;"Prešovský kraj";7;0;0;0;NA;363182;7;2020-09-05;525
2020-09-04;"Prešovský kraj";24;0;0;0;NA;363182;24;2020-09-04;518
2020-09-03;"Prešovský kraj";8;0;0;0;NA;363182;8;2020-09-03;494
2020-09-02;"Prešovský kraj";9;0;0;0;NA;363182;9;2020-09-02;486
2020-09-01;"Prešovský kraj";6;0;0;0;NA;363182;6;2020-09-01;477
2020-08-31;"Prešovský kraj";3;0;0;0;NA;363182;3;2020-08-31;471
2020-08-30;"Prešovský kraj";6;0;0;0;NA;363182;6;2020-08-30;468
2020-08-29;"Prešovský kraj";4;0;0;0;NA;363182;4;2020-08-29;462
2020-08-28;"Prešovský kraj";6;0;0;0;NA;363182;6;2020-08-28;458
2020-08-27;"Prešovský kraj";7;0;0;0;NA;363182;7;2020-08-27;452
2020-08-26;"Prešovský kraj";22;0;0;0;NA;363182;22;2020-08-26;445
2020-08-25;"Prešovský kraj";1;0;0;0;NA;363182;1;2020-08-25;423
2020-08-24;"Prešovský kraj";5;0;0;0;NA;363182;5;2020-08-24;422
2020-08-23;"Prešovský kraj";3;0;0;0;NA;363182;3;2020-08-23;417
2020-08-22;"Prešovský kraj";3;0;0;0;NA;363182;3;2020-08-22;414
2020-08-21;"Prešovský kraj";11;0;0;0;NA;363182;11;2020-08-21;411
2020-08-20;"Prešovský kraj";8;0;0;0;NA;363182;8;2020-08-20;400
2020-08-19;"Prešovský kraj";8;0;0;0;NA;363182;8;2020-08-19;392
2020-08-18;"Prešovský kraj";6;0;0;0;NA;363182;6;2020-08-18;384
2020-08-17;"Prešovský kraj";1;0;0;0;NA;363182;1;2020-08-17;378
2020-08-16;"Prešovský kraj";0;0;0;0;NA;363182;0;2020-08-16;377
2020-08-15;"Prešovský kraj";8;0;0;0;NA;363182;8;2020-08-15;377
2020-08-14;"Prešovský kraj";6;0;0;0;NA;363182;6;2020-08-14;369
2020-08-13;"Prešovský kraj";8;0;0;0;NA;363182;8;2020-08-13;363
2020-08-12;"Prešovský kraj";19;0;0;0;NA;363182;19;2020-08-12;355
2020-08-11;"Prešovský kraj";3;0;0;0;NA;363182;3;2020-08-11;336
2020-08-10;"Prešovský kraj";0;0;0;0;NA;363182;0;2020-08-10;333
2020-08-09;"Prešovský kraj";0;0;0;0;NA;363182;0;2020-08-09;333
2020-08-08;"Prešovský kraj";2;0;0;0;NA;363182;2;2020-08-08;333
2020-08-07;"Prešovský kraj";6;0;0;0;NA;363182;6;2020-08-07;331
2020-08-06;"Prešovský kraj";2;0;0;0;NA;363182;2;2020-08-06;325
2020-08-05;"Prešovský kraj";8;0;0;0;NA;363182;8;2020-08-05;323
2020-08-04;"Prešovský kraj";5;0;0;0;NA;363182;5;2020-08-04;315
2020-08-03;"Prešovský kraj";4;0;0;0;NA;363182;4;2020-08-03;310
2020-08-02;"Prešovský kraj";6;0;0;0;NA;363182;6;2020-08-02;306
2020-08-01;"Prešovský kraj";0;0;0;0;NA;363182;0;2020-08-01;300
2020-07-31;"Prešovský kraj";2;0;0;0;NA;363182;2;2020-07-31;300
2020-07-30;"Prešovský kraj";6;0;0;0;NA;363182;6;2020-07-30;298
2020-07-29;"Prešovský kraj";5;0;0;0;NA;363182;5;2020-07-29;292
2020-07-28;"Prešovský kraj";0;0;0;0;NA;363182;0;2020-07-28;287
2020-07-27;"Prešovský kraj";1;0;0;0;NA;363182;1;2020-07-27;287
2020-07-26;"Prešovský kraj";1;0;0;0;NA;363182;1;2020-07-26;286
2020-07-25;"Prešovský kraj";21;0;0;0;NA;363182;21;2020-07-25;285
2020-07-24;"Prešovský kraj";1;0;0;0;NA;363182;1;2020-07-24;264
2020-07-23;"Prešovský kraj";5;0;0;0;NA;363182;5;2020-07-23;263
2020-07-22;"Prešovský kraj";1;0;0;0;NA;363182;1;2020-07-22;258
2020-07-21;"Prešovský kraj";2;0;0;0;NA;363182;2;2020-07-21;257
2020-07-20;"Prešovský kraj";1;0;0;0;NA;363182;1;2020-07-20;255
2020-07-19;"Prešovský kraj";0;0;0;0;NA;363182;0;2020-07-19;254
2020-07-18;"Prešovský kraj";0;0;0;0;NA;363182;0;2020-07-18;254
2020-07-17;"Prešovský kraj";3;0;0;0;NA;363182;3;2020-07-17;254
2020-07-16;"Prešovský kraj";1;0;0;0;NA;363182;1;2020-07-16;251
2020-07-15;"Prešovský kraj";5;0;0;0;NA;363182;5;2020-07-15;250
2020-07-14;"Prešovský kraj";5;0;0;0;NA;363182;5;2020-07-14;245
2020-07-13;"Prešovský kraj";1;0;0;0;NA;363182;1;2020-07-13;240
2020-07-12;"Prešovský kraj";1;0;0;0;NA;363182;1;2020-07-12;239
2020-07-11;"Prešovský kraj";6;0;0;0;NA;363182;6;2020-07-11;238
2020-07-10;"Prešovský kraj";5;0;0;0;NA;363182;5;2020-07-10;232
2020-07-09;"Prešovský kraj";2;0;0;0;NA;363182;2;2020-07-09;227
2020-07-08;"Prešovský kraj";14;0;0;0;NA;363182;14;2020-07-08;225
2020-07-07;"Prešovský kraj";2;0;0;0;NA;363182;2;2020-07-07;211
2020-07-06;"Prešovský kraj";0;0;0;0;NA;363182;0;2020-07-06;209
2020-07-05;"Prešovský kraj";0;0;0;0;NA;363182;0;2020-07-05;209
2020-07-04;"Prešovský kraj";1;0;0;0;NA;363182;1;2020-07-04;209
2020-07-03;"Prešovský kraj";3;0;0;0;NA;363182;3;2020-07-03;208
2020-07-02;"Prešovský kraj";0;0;0;0;NA;363182;0;2020-07-02;205
2020-07-01;"Prešovský kraj";0;0;0;0;NA;363182;0;2020-07-01;205
2020-06-30;"Prešovský kraj";7;0;0;0;NA;363182;7;2020-06-30;205
2020-06-29;"Prešovský kraj";0;0;0;0;NA;363182;0;2020-06-29;198
2020-06-28;"Prešovský kraj";0;0;0;0;NA;363182;0;2020-06-28;198
2020-06-27;"Prešovský kraj";3;0;0;0;NA;363182;3;2020-06-27;198
2020-06-26;"Prešovský kraj";3;0;0;0;NA;363182;3;2020-06-26;195
2020-06-25;"Prešovský kraj";0;0;0;0;NA;363182;0;2020-06-25;192
2020-06-24;"Prešovský kraj";4;0;0;0;NA;363182;4;2020-06-24;192
2020-06-23;"Prešovský kraj";0;0;0;0;NA;363182;0;2020-06-23;188
2020-06-22;"Prešovský kraj";0;0;0;0;NA;363182;0;2020-06-22;188
2020-06-21;"Prešovský kraj";0;0;0;0;NA;363182;0;2020-06-21;188
2020-06-20;"Prešovský kraj";0;0;0;0;NA;363182;0;2020-06-20;188
2020-06-19;"Prešovský kraj";1;0;0;0;NA;363182;1;2020-06-19;188
2020-06-18;"Prešovský kraj";0;0;0;0;NA;363182;0;2020-06-18;187
2020-06-17;"Prešovský kraj";0;0;0;0;NA;363182;0;2020-06-17;187
2020-06-16;"Prešovský kraj";6;0;0;0;NA;363182;6;2020-06-16;187
2020-06-14;"Prešovský kraj";0;0;0;0;NA;363182;0;2020-06-14;181
2020-06-13;"Prešovský kraj";0;0;0;0;NA;363182;0;2020-06-13;181
2020-06-12;"Prešovský kraj";1;0;0;0;NA;363182;1;2020-06-12;181
2020-06-11;"Prešovský kraj";0;0;0;0;NA;363182;0;2020-06-11;180
2020-06-10;"Prešovský kraj";0;0;0;0;NA;363182;0;2020-06-10;180
2020-06-09;"Prešovský kraj";0;0;0;0;NA;363182;0;2020-06-09;180
2020-06-08;"Prešovský kraj";0;0;0;0;NA;363182;0;2020-06-08;180
2020-06-07;"Prešovský kraj";0;0;0;0;NA;363182;0;2020-06-07;180
2020-06-05;"Prešovský kraj";0;0;0;0;NA;363182;0;2020-06-05;180
2020-06-03;"Prešovský kraj";0;0;0;0;NA;363182;0;2020-06-03;180
2020-06-02;"Prešovský kraj";1;0;0;0;NA;363182;1;2020-06-02;180
2020-05-31;"Prešovský kraj";1;0;0;0;NA;363182;1;2020-05-31;179
2020-05-29;"Prešovský kraj";0;0;0;0;NA;363182;0;2020-05-29;178
2020-05-27;"Prešovský kraj";0;0;0;0;NA;363182;0;2020-05-27;178
2020-05-26;"Prešovský kraj";0;0;0;0;NA;363182;0;2020-05-26;178
2020-05-25;"Prešovský kraj";0;0;0;0;NA;363182;0;2020-05-25;178
2020-05-24;"Prešovský kraj";0;0;0;0;NA;363182;0;2020-05-24;178
2020-05-23;"Prešovský kraj";0;0;0;0;NA;363182;0;2020-05-23;178
2020-05-22;"Prešovský kraj";0;0;0;0;NA;363182;0;2020-05-22;178
2020-05-21;"Prešovský kraj";1;0;0;0;NA;363182;1;2020-05-21;178
2020-05-20;"Prešovský kraj";0;0;0;0;NA;363182;0;2020-05-20;177
2020-05-19;"Prešovský kraj";0;0;0;0;NA;363182;0;2020-05-19;177
2020-05-17;"Prešovský kraj";0;0;0;0;NA;363182;0;2020-05-17;177
2020-05-16;"Prešovský kraj";0;0;0;0;NA;363182;0;2020-05-16;177
2020-05-15;"Prešovský kraj";0;0;0;0;NA;363182;0;2020-05-15;177
2020-05-14;"Prešovský kraj";0;0;0;0;NA;363182;0;2020-05-14;177
2020-05-13;"Prešovský kraj";1;0;0;0;NA;363182;1;2020-05-13;177
2020-05-12;"Prešovský kraj";0;0;0;0;NA;363182;0;2020-05-12;176
2020-05-11;"Prešovský kraj";1;0;0;0;NA;363182;1;2020-05-11;176
2020-05-09;"Prešovský kraj";0;0;0;0;NA;363182;0;2020-05-09;175
2020-05-07;"Prešovský kraj";0;0;0;0;NA;363182;0;2020-05-07;175
2020-05-06;"Prešovský kraj";0;0;0;0;NA;363182;0;2020-05-06;175
2020-05-05;"Prešovský kraj";1;0;0;0;NA;363182;1;2020-05-05;175
2020-05-04;"Prešovský kraj";0;0;0;0;NA;363182;0;2020-05-04;174
2020-05-03;"Prešovský kraj";0;0;0;0;NA;363182;0;2020-05-03;174
2020-05-02;"Prešovský kraj";0;0;0;0;NA;363182;0;2020-05-02;174
2020-05-01;"Prešovský kraj";2;0;0;0;NA;363182;2;2020-05-01;174
2020-04-30;"Prešovský kraj";0;0;0;0;NA;363182;0;2020-04-30;172
2020-04-29;"Prešovský kraj";1;0;0;0;NA;363182;1;2020-04-29;172
2020-04-28;"Prešovský kraj";1;0;0;0;NA;363182;1;2020-04-28;171
2020-04-27;"Prešovský kraj";2;0;0;0;NA;363182;2;2020-04-27;170
2020-04-26;"Prešovský kraj";0;0;0;0;NA;363182;0;2020-04-26;168
2020-04-25;"Prešovský kraj";0;0;0;0;NA;363182;0;2020-04-25;168
2020-04-24;"Prešovský kraj";0;0;0;0;NA;363182;0;2020-04-24;168
2020-04-23;"Prešovský kraj";2;0;0;0;NA;363182;2;2020-04-23;168
2020-04-22;"Prešovský kraj";11;0;0;0;NA;363182;11;2020-04-22;166
2020-04-21;"Prešovský kraj";12;0;0;0;NA;363182;12;2020-04-21;155
2020-04-20;"Prešovský kraj";2;0;0;0;NA;363182;2;2020-04-20;143
2020-04-19;"Prešovský kraj";4;0;0;0;NA;363182;4;2020-04-19;141
2020-04-18;"Prešovský kraj";1;0;0;0;NA;363182;1;2020-04-18;137
2020-04-17;"Prešovský kraj";4;0;0;0;NA;363182;4;2020-04-17;136
2020-04-16;"Prešovský kraj";9;0;0;0;NA;363182;9;2020-04-16;132
2020-04-15;"Prešovský kraj";21;0;0;0;NA;363182;21;2020-04-15;123
2020-04-14;"Prešovský kraj";1;0;0;0;NA;363182;1;2020-04-14;102
2020-04-13;"Prešovský kraj";2;0;0;0;NA;363182;2;2020-04-13;101
2020-04-12;"Prešovský kraj";6;0;0;0;NA;363182;6;2020-04-12;99
2020-04-11;"Prešovský kraj";4;0;0;0;NA;363182;4;2020-04-11;93
2020-04-10;"Prešovský kraj";0;0;0;0;NA;363182;0;2020-04-10;89
2020-04-09;"Prešovský kraj";1;0;0;0;NA;363182;1;2020-04-09;89
2020-04-08;"Prešovský kraj";0;0;0;0;NA;363182;0;2020-04-08;88
2020-04-07;"Prešovský kraj";7;0;0;0;NA;363182;7;2020-04-07;88
2020-04-06;"Prešovský kraj";10;0;0;0;NA;363182;10;2020-04-06;81
2020-04-05;"Prešovský kraj";13;0;0;0;NA;363182;13;2020-04-05;71
2020-04-04;"Prešovský kraj";1;0;0;0;NA;363182;1;2020-04-04;58
2020-04-03;"Prešovský kraj";4;0;0;0;NA;363182;4;2020-04-03;57
2020-04-02;"Prešovský kraj";6;0;0;0;NA;363182;6;2020-04-02;53
2020-04-01;"Prešovský kraj";6;0;0;0;NA;363182;6;2020-04-01;47
2020-03-31;"Prešovský kraj";6;0;0;0;NA;363182;6;2020-03-31;41
2020-03-30;"Prešovský kraj";2;0;0;0;NA;363182;2;2020-03-30;35
2020-03-29;"Prešovský kraj";2;0;0;0;NA;363182;2;2020-03-29;33
2020-03-28;"Prešovský kraj";2;0;0;0;NA;363182;2;2020-03-28;31
2020-03-27;"Prešovský kraj";1;0;0;0;NA;363182;1;2020-03-27;29
2020-03-26;"Prešovský kraj";8;0;0;0;NA;363182;8;2020-03-26;28
2020-03-25;"Prešovský kraj";1;0;0;0;NA;363182;1;2020-03-25;20
2020-03-24;"Prešovský kraj";4;0;0;0;NA;363182;4;2020-03-24;19
2020-03-23;"Prešovský kraj";0;0;0;0;NA;363182;0;2020-03-23;15
2020-03-22;"Prešovský kraj";1;0;0;0;NA;363182;1;2020-03-22;15
2020-03-21;"Prešovský kraj";2;0;0;0;NA;363182;2;2020-03-21;14
2020-03-20;"Prešovský kraj";3;0;0;0;NA;363182;3;2020-03-20;12
2020-03-19;"Prešovský kraj";2;0;0;0;NA;363182;2;2020-03-19;9
2020-03-18;"Prešovský kraj";1;0;0;0;NA;363182;1;2020-03-18;7
2020-03-17;"Prešovský kraj";1;0;0;0;NA;363182;1;2020-03-17;6
2020-03-16;"Prešovský kraj";4;0;0;0;NA;363182;4;2020-03-16;5
2020-03-15;"Prešovský kraj";0;0;0;0;NA;363182;0;2020-03-15;1
2020-03-14;"Prešovský kraj";1;0;0;0;NA;363182;1;2020-03-14;1
2020-03-13;"Prešovský kraj";0;0;0;0;NA;363182;0;2020-03-13;0
2020-03-12;"Prešovský kraj";0;0;0;0;NA;363182;0;2020-03-12;0
2020-03-11;"Prešovský kraj";0;0;0;0;NA;363182;0;2020-03-11;0
2020-03-09;"Prešovský kraj";0;0;0;0;NA;363182;0;2020-03-09;0
2020-03-08;"Prešovský kraj";0;0;0;0;NA;363182;0;2020-03-08;0
2020-03-07;"Prešovský kraj";0;0;0;0;NA;363182;0;2020-03-07;0
2020-03-06;"Prešovský kraj";0;0;0;0;NA;363182;0;2020-03-06;0
2022-04-25;"Trenčiansky kraj";106;0;0;0;211335;299128;106;2022-04-25;299128
2022-04-24;"Trenčiansky kraj";32;80;3;83;NA;299128;35;2022-04-24;299022
2022-04-23;"Trenčiansky kraj";104;84;5;89;NA;299128;109;2022-04-23;298987
2022-04-22;"Trenčiansky kraj";122;324;27;351;NA;299128;149;2022-04-22;298878
2022-04-21;"Trenčiansky kraj";191;516;18;534;NA;299128;209;2022-04-21;298729
2022-04-20;"Trenčiansky kraj";269;460;23;483;NA;299128;292;2022-04-20;298520
2022-04-19;"Trenčiansky kraj";180;802;39;841;NA;299128;219;2022-04-19;298228
2022-04-18;"Trenčiansky kraj";107;242;15;257;NA;299128;122;2022-04-18;298009
2022-04-17;"Trenčiansky kraj";154;314;14;328;NA;299128;168;2022-04-17;297887
2022-04-16;"Trenčiansky kraj";51;297;10;307;NA;299128;61;2022-04-16;297719
2022-04-15;"Trenčiansky kraj";71;313;12;325;NA;299128;83;2022-04-15;297658
2022-04-14;"Trenčiansky kraj";235;702;36;738;NA;299128;271;2022-04-14;297575
2022-04-13;"Trenčiansky kraj";288;512;39;551;NA;299128;327;2022-04-13;297304
2022-04-12;"Trenčiansky kraj";293;744;52;796;NA;299128;345;2022-04-12;296977
2022-04-11;"Trenčiansky kraj";349;634;61;695;NA;299128;410;2022-04-11;296632
2022-04-10;"Trenčiansky kraj";110;440;28;468;NA;299128;138;2022-04-10;296222
2022-04-09;"Trenčiansky kraj";234;269;24;293;NA;299128;258;2022-04-09;296084
2022-04-08;"Trenčiansky kraj";301;475;27;502;NA;299128;328;2022-04-08;295826
2022-04-07;"Trenčiansky kraj";381;592;68;660;NA;299128;449;2022-04-07;295498
2022-04-06;"Trenčiansky kraj";416;680;78;758;NA;299128;494;2022-04-06;295049
2022-04-05;"Trenčiansky kraj";499;614;65;679;NA;299128;564;2022-04-05;294555
2022-04-04;"Trenčiansky kraj";468;948;95;1043;NA;299128;563;2022-04-04;293991
2022-04-03;"Trenčiansky kraj";127;373;46;419;NA;299128;173;2022-04-03;293428
2022-04-02;"Trenčiansky kraj";368;404;59;463;NA;299128;427;2022-04-02;293255
2022-04-01;"Trenčiansky kraj";510;630;65;695;NA;299128;575;2022-04-01;292828
2022-03-31;"Trenčiansky kraj";520;892;95;987;NA;299128;615;2022-03-31;292253
2022-03-30;"Trenčiansky kraj";706;1361;85;1446;NA;299128;791;2022-03-30;291638
2022-03-29;"Trenčiansky kraj";682;933;93;1026;NA;299128;775;2022-03-29;290847
2022-03-28;"Trenčiansky kraj";673;1298;123;1421;NA;299128;796;2022-03-28;290072
2022-03-27;"Trenčiansky kraj";167;596;86;682;NA;299128;253;2022-03-27;289276
2022-03-26;"Trenčiansky kraj";513;395;43;438;NA;299128;556;2022-03-26;289023
2022-03-25;"Trenčiansky kraj";534;794;90;884;NA;299128;624;2022-03-25;288467
2022-03-24;"Trenčiansky kraj";712;1117;104;1221;NA;299128;816;2022-03-24;287843
2022-03-23;"Trenčiansky kraj";903;899;93;992;NA;299128;996;2022-03-23;287027
2022-03-22;"Trenčiansky kraj";918;934;114;1048;NA;299128;1032;2022-03-22;286031
2022-03-21;"Trenčiansky kraj";745;1317;198;1515;NA;299128;943;2022-03-21;284999
2022-03-20;"Trenčiansky kraj";334;826;89;915;NA;299128;423;2022-03-20;284056
2022-03-19;"Trenčiansky kraj";560;510;77;587;NA;299128;637;2022-03-19;283633
2022-03-18;"Trenčiansky kraj";884;827;128;955;NA;299128;1012;2022-03-18;282996
2022-03-17;"Trenčiansky kraj";863;991;127;1118;NA;299128;990;2022-03-17;281984
2022-03-16;"Trenčiansky kraj";1147;1128;125;1253;NA;299128;1272;2022-03-16;280994
2022-03-15;"Trenčiansky kraj";1054;1155;122;1277;NA;299128;1176;2022-03-15;279722
2022-03-14;"Trenčiansky kraj";934;2078;253;2331;NA;299128;1187;2022-03-14;278546
2022-03-13;"Trenčiansky kraj";373;698;97;795;NA;299128;470;2022-03-13;277359
2022-03-12;"Trenčiansky kraj";674;550;94;644;NA;299128;768;2022-03-12;276889
2022-03-11;"Trenčiansky kraj";1131;1191;215;1406;NA;299128;1346;2022-03-11;276121
2022-03-10;"Trenčiansky kraj";1087;1178;220;1398;NA;299128;1307;2022-03-10;274775
2022-03-09;"Trenčiansky kraj";1515;1346;236;1582;NA;299128;1751;2022-03-09;273468
2022-03-08;"Trenčiansky kraj";1059;1589;247;1836;NA;299128;1306;2022-03-08;271717
2022-03-07;"Trenčiansky kraj";1079;1920;342;2262;NA;299128;1421;2022-03-07;270411
2022-03-06;"Trenčiansky kraj";354;832;134;966;NA;299128;488;2022-03-06;268990
2022-03-05;"Trenčiansky kraj";583;700;138;838;NA;299128;721;2022-03-05;268502
2022-03-04;"Trenčiansky kraj";1125;1158;204;1362;NA;299128;1329;2022-03-04;267781
2022-03-03;"Trenčiansky kraj";1346;1521;216;1737;NA;299128;1562;2022-03-03;266452
2022-03-02;"Trenčiansky kraj";1345;1548;239;1787;NA;299128;1584;2022-03-02;264890
2022-03-01;"Trenčiansky kraj";1409;1609;299;1908;NA;299128;1708;2022-03-01;263306
2022-02-28;"Trenčiansky kraj";1390;2383;363;2746;NA;299128;1753;2022-02-28;261598
2022-02-27;"Trenčiansky kraj";573;1043;218;1261;NA;299128;791;2022-02-27;259845
2022-02-26;"Trenčiansky kraj";934;784;147;931;NA;299128;1081;2022-02-26;259054
2022-02-25;"Trenčiansky kraj";1460;1422;271;1693;NA;299128;1731;2022-02-25;257973
2022-02-24;"Trenčiansky kraj";1372;2288;274;2562;NA;299128;1646;2022-02-24;256242
2022-02-23;"Trenčiansky kraj";1677;1895;291;2186;NA;299128;1968;2022-02-23;254596
2022-02-22;"Trenčiansky kraj";2073;2075;418;2493;NA;299128;2491;2022-02-22;252628
2022-02-21;"Trenčiansky kraj";2172;3615;547;4162;NA;299128;2719;2022-02-21;250137
2022-02-20;"Trenčiansky kraj";1079;1436;322;1758;NA;299128;1401;2022-02-20;247418
2022-02-19;"Trenčiansky kraj";1168;1008;244;1252;NA;299128;1412;2022-02-19;246017
2022-02-18;"Trenčiansky kraj";2456;2175;440;2615;NA;299128;2896;2022-02-18;244605
2022-02-17;"Trenčiansky kraj";2090;2540;388;2928;NA;299128;2478;2022-02-17;241709
2022-02-16;"Trenčiansky kraj";2928;2286;469;2755;NA;299128;3397;2022-02-16;239231
2022-02-15;"Trenčiansky kraj";2372;2408;534;2942;NA;299128;2906;2022-02-15;235834
2022-02-14;"Trenčiansky kraj";2401;3916;686;4602;NA;299128;3087;2022-02-14;232928
2022-02-13;"Trenčiansky kraj";1357;1777;454;2231;NA;299128;1811;2022-02-13;229841
2022-02-12;"Trenčiansky kraj";1802;1448;277;1725;NA;299128;2079;2022-02-12;228030
2022-02-11;"Trenčiansky kraj";2863;2376;456;2832;NA;299128;3319;2022-02-11;225951
2022-02-10;"Trenčiansky kraj";2853;2529;462;2991;NA;299128;3315;2022-02-10;222632
2022-02-09;"Trenčiansky kraj";2788;4158;559;4717;NA;299128;3347;2022-02-09;219317
2022-02-08;"Trenčiansky kraj";2592;2987;621;3608;NA;299128;3213;2022-02-08;215970
2022-02-07;"Trenčiansky kraj";2787;4732;862;5594;NA;299128;3649;2022-02-07;212757
2022-02-06;"Trenčiansky kraj";1431;2181;472;2653;NA;299128;1903;2022-02-06;209108
2022-02-05;"Trenčiansky kraj";1458;1689;323;2012;NA;299128;1781;2022-02-05;207205
2022-02-04;"Trenčiansky kraj";2480;3036;483;3519;NA;299128;2963;2022-02-04;205424
2022-02-03;"Trenčiansky kraj";2391;3381;462;3843;NA;299128;2853;2022-02-03;202461
2022-02-02;"Trenčiansky kraj";2486;4411;563;4974;NA;299128;3049;2022-02-02;199608
2022-02-01;"Trenčiansky kraj";2359;3605;509;4114;NA;299128;2868;2022-02-01;196559
2022-01-31;"Trenčiansky kraj";1823;7070;627;7697;NA;299128;2450;2022-01-31;193691
2022-01-30;"Trenčiansky kraj";680;2463;319;2782;NA;299128;999;2022-01-30;191241
2022-01-29;"Trenčiansky kraj";1227;1772;227;1999;NA;299128;1454;2022-01-29;190242
2022-01-28;"Trenčiansky kraj";1709;3602;322;3924;NA;299128;2031;2022-01-28;188788
2022-01-27;"Trenčiansky kraj";1533;3414;322;3736;NA;299128;1855;2022-01-27;186757
2022-01-26;"Trenčiansky kraj";1415;4533;311;4844;NA;299128;1726;2022-01-26;184902
2022-01-25;"Trenčiansky kraj";1553;3168;258;3426;NA;299128;1811;2022-01-25;183176
2022-01-24;"Trenčiansky kraj";755;6691;290;6981;NA;299128;1045;2022-01-24;181365
2022-01-23;"Trenčiansky kraj";337;2409;179;2588;NA;299128;516;2022-01-23;180320
2022-01-22;"Trenčiansky kraj";683;1675;103;1778;NA;299128;786;2022-01-22;179804
2022-01-21;"Trenčiansky kraj";576;3394;139;3533;NA;299128;715;2022-01-21;179018
2022-01-20;"Trenčiansky kraj";710;2578;104;2682;NA;299128;814;2022-01-20;178303
2022-01-19;"Trenčiansky kraj";621;3627;111;3738;NA;299128;732;2022-01-19;177489
2022-01-18;"Trenčiansky kraj";579;3455;101;3556;NA;299128;680;2022-01-18;176757
2022-01-17;"Trenčiansky kraj";380;6158;122;6280;NA;299128;502;2022-01-17;176077
2022-01-16;"Trenčiansky kraj";89;2319;72;2391;NA;299128;161;2022-01-16;175575
2022-01-15;"Trenčiansky kraj";194;1345;40;1385;NA;299128;234;2022-01-15;175414
2022-01-14;"Trenčiansky kraj";189;2755;48;2803;NA;299128;237;2022-01-14;175180
2022-01-13;"Trenčiansky kraj";134;3201;62;3263;NA;299128;196;2022-01-13;174943
2022-01-12;"Trenčiansky kraj";346;2953;53;3006;NA;299128;399;2022-01-12;174747
2022-01-11;"Trenčiansky kraj";300;2896;50;2946;NA;299128;350;2022-01-11;174348
2022-01-10;"Trenčiansky kraj";218;6882;81;6963;NA;299128;299;2022-01-10;173998
2022-01-09;"Trenčiansky kraj";40;2808;52;2860;NA;299128;92;2022-01-09;173699
2022-01-08;"Trenčiansky kraj";267;1601;45;1646;NA;299128;312;2022-01-08;173607
2022-01-07;"Trenčiansky kraj";334;2717;64;2781;NA;299128;398;2022-01-07;173295
2022-01-06;"Trenčiansky kraj";75;1111;45;1156;NA;299128;120;2022-01-06;172897
2022-01-05;"Trenčiansky kraj";496;2875;64;2939;NA;299128;560;2022-01-05;172777
2022-01-04;"Trenčiansky kraj";521;3760;73;3833;NA;299128;594;2022-01-04;172217
2022-01-03;"Trenčiansky kraj";357;5680;117;5797;NA;299128;474;2022-01-03;171623
2022-01-02;"Trenčiansky kraj";179;2403;74;2477;NA;299128;253;2022-01-02;171149
2022-01-01;"Trenčiansky kraj";4;526;28;554;NA;299128;32;2022-01-01;170896
2021-12-31;"Trenčiansky kraj";443;1478;82;1560;NA;299128;525;2021-12-31;170864
2021-12-30;"Trenčiansky kraj";370;2400;129;2529;NA;299128;499;2021-12-30;170339
2021-12-29;"Trenčiansky kraj";429;2483;87;2570;NA;299128;516;2021-12-29;169840
2021-12-28;"Trenčiansky kraj";609;2741;111;2852;NA;299128;720;2021-12-28;169324
2021-12-27;"Trenčiansky kraj";546;3348;115;3463;NA;299128;661;2021-12-27;168604
2021-12-26;"Trenčiansky kraj";147;1098;78;1176;NA;299128;225;2021-12-26;167943
2021-12-25;"Trenčiansky kraj";52;503;27;530;NA;299128;79;2021-12-25;167718
2021-12-24;"Trenčiansky kraj";176;652;37;689;NA;299128;213;2021-12-24;167639
2021-12-23;"Trenčiansky kraj";532;2431;108;2539;NA;299128;640;2021-12-23;167426
2021-12-22;"Trenčiansky kraj";512;2595;119;2714;NA;299128;631;2021-12-22;166786
2021-12-21;"Trenčiansky kraj";694;3266;123;3389;NA;299128;817;2021-12-21;166155
2021-12-20;"Trenčiansky kraj";488;6754;210;6964;NA;299128;698;2021-12-20;165338
2021-12-19;"Trenčiansky kraj";202;2574;118;2692;NA;299128;320;2021-12-19;164640
2021-12-18;"Trenčiansky kraj";438;1752;108;1860;NA;299128;546;2021-12-18;164320
2021-12-17;"Trenčiansky kraj";427;4054;137;4191;NA;299128;564;2021-12-17;163774
2021-12-16;"Trenčiansky kraj";649;3214;180;3394;NA;299128;829;2021-12-16;163210
2021-12-15;"Trenčiansky kraj";791;4645;167;4812;NA;299128;958;2021-12-15;162381
2021-12-14;"Trenčiansky kraj";885;3640;142;3782;NA;299128;1027;2021-12-14;161423
2021-12-13;"Trenčiansky kraj";573;7458;256;7714;NA;299128;829;2021-12-13;160396
2021-12-12;"Trenčiansky kraj";306;3156;156;3312;NA;299128;462;2021-12-12;159567
2021-12-11;"Trenčiansky kraj";706;1876;138;2014;NA;299128;844;2021-12-11;159105
2021-12-10;"Trenčiansky kraj";789;3694;201;3895;NA;299128;990;2021-12-10;158261
2021-12-09;"Trenčiansky kraj";967;3897;203;4100;NA;299128;1170;2021-12-09;157271
2021-12-08;"Trenčiansky kraj";1020;4475;203;4678;NA;299128;1223;2021-12-08;156101
2021-12-07;"Trenčiansky kraj";1241;6281;217;6498;NA;299128;1458;2021-12-07;154878
2021-12-06;"Trenčiansky kraj";751;8923;430;9353;NA;299128;1181;2021-12-06;153420
2021-12-05;"Trenčiansky kraj";510;3610;210;3820;NA;299128;720;2021-12-05;152239
2021-12-04;"Trenčiansky kraj";1058;2043;156;2199;NA;299128;1214;2021-12-04;151519
2021-12-03;"Trenčiansky kraj";1272;4427;306;4733;NA;299128;1578;2021-12-03;150305
2021-12-02;"Trenčiansky kraj";2007;4132;265;4397;NA;299128;2272;2021-12-02;148727
2021-12-01;"Trenčiansky kraj";1000;4977;299;5276;NA;299128;1299;2021-12-01;146455
2021-11-30;"Trenčiansky kraj";1086;4743;332;5075;NA;299128;1418;2021-11-30;145156
2021-11-29;"Trenčiansky kraj";1165;10434;551;10985;NA;299128;1716;2021-11-29;143738
2021-11-28;"Trenčiansky kraj";664;5566;308;5874;NA;299128;972;2021-11-28;142022
2021-11-27;"Trenčiansky kraj";1080;2782;301;3083;NA;299128;1381;2021-11-27;141050
2021-11-26;"Trenčiansky kraj";1238;4529;350;4879;NA;299128;1588;2021-11-26;139669
2021-11-25;"Trenčiansky kraj";1018;3622;348;3970;NA;299128;1366;2021-11-25;138081
2021-11-24;"Trenčiansky kraj";1362;5596;472;6068;NA;299128;1834;2021-11-24;136715
2021-11-23;"Trenčiansky kraj";1140;3755;351;4106;NA;299128;1491;2021-11-23;134881
2021-11-22;"Trenčiansky kraj";920;6562;568;7130;NA;299128;1488;2021-11-22;133390
2021-11-21;"Trenčiansky kraj";413;3233;377;3610;NA;299128;790;2021-11-21;131902
2021-11-20;"Trenčiansky kraj";914;2379;341;2720;NA;299128;1255;2021-11-20;131112
2021-11-19;"Trenčiansky kraj";1261;3817;448;4265;NA;299128;1709;2021-11-19;129857
2021-11-18;"Trenčiansky kraj";810;5085;529;5614;NA;299128;1339;2021-11-18;128148
2021-11-17;"Trenčiansky kraj";796;1852;237;2089;NA;299128;1033;2021-11-17;126809
2021-11-16;"Trenčiansky kraj";859;4095;403;4498;NA;299128;1262;2021-11-16;125776
2021-11-15;"Trenčiansky kraj";720;5206;557;5763;NA;299128;1277;2021-11-15;124514
2021-11-14;"Trenčiansky kraj";447;2462;343;2805;NA;299128;790;2021-11-14;123237
2021-11-13;"Trenčiansky kraj";478;1879;254;2133;NA;299128;732;2021-11-13;122447
2021-11-12;"Trenčiansky kraj";784;3884;341;4225;NA;299128;1125;2021-11-12;121715
2021-11-11;"Trenčiansky kraj";805;3594;347;3941;NA;299128;1152;2021-11-11;120590
2021-11-10;"Trenčiansky kraj";647;3389;282;3671;NA;299128;929;2021-11-10;119438
2021-11-09;"Trenčiansky kraj";752;2915;306;3221;NA;299128;1058;2021-11-09;118509
2021-11-08;"Trenčiansky kraj";489;4724;355;5079;NA;299128;844;2021-11-08;117451
2021-11-07;"Trenčiansky kraj";405;2043;220;2263;NA;299128;625;2021-11-07;116607
2021-11-06;"Trenčiansky kraj";542;1755;176;1931;NA;299128;718;2021-11-06;115982
2021-11-05;"Trenčiansky kraj";677;3108;240;3348;NA;299128;917;2021-11-05;115264
2021-11-04;"Trenčiansky kraj";563;2741;232;2973;NA;299128;795;2021-11-04;114347
2021-11-03;"Trenčiansky kraj";619;2981;225;3206;NA;299128;844;2021-11-03;113552
2021-11-02;"Trenčiansky kraj";663;3884;313;4197;NA;299128;976;2021-11-02;112708
2021-11-01;"Trenčiansky kraj";219;1029;101;1130;NA;299128;320;2021-11-01;111732
2021-10-31;"Trenčiansky kraj";151;1462;152;1614;NA;299128;303;2021-10-31;111412
2021-10-30;"Trenčiansky kraj";345;1770;130;1900;NA;299128;475;2021-10-30;111109
2021-10-29;"Trenčiansky kraj";415;2885;130;3015;NA;299128;545;2021-10-29;110634
2021-10-28;"Trenčiansky kraj";429;2682;159;2841;NA;299128;588;2021-10-28;110089
2021-10-27;"Trenčiansky kraj";463;2640;94;2734;NA;299128;557;2021-10-27;109501
2021-10-26;"Trenčiansky kraj";419;2657;135;2792;NA;299128;554;2021-10-26;108944
2021-10-25;"Trenčiansky kraj";192;3431;134;3565;NA;299128;326;2021-10-25;108390
2021-10-24;"Trenčiansky kraj";121;1643;79;1722;NA;299128;200;2021-10-24;108064
2021-10-23;"Trenčiansky kraj";326;1737;64;1801;NA;299128;390;2021-10-23;107864
2021-10-22;"Trenčiansky kraj";358;2722;80;2802;NA;299128;438;2021-10-22;107474
2021-10-21;"Trenčiansky kraj";247;2369;76;2445;NA;299128;323;2021-10-21;107036
2021-10-20;"Trenčiansky kraj";302;2124;71;2195;NA;299128;373;2021-10-20;106713
2021-10-19;"Trenčiansky kraj";227;2866;61;2927;NA;299128;288;2021-10-19;106340
2021-10-18;"Trenčiansky kraj";143;2522;73;2595;NA;299128;216;2021-10-18;106052
2021-10-17;"Trenčiansky kraj";46;1457;31;1488;NA;299128;77;2021-10-17;105836
2021-10-16;"Trenčiansky kraj";76;1671;35;1706;NA;299128;111;2021-10-16;105759
2021-10-15;"Trenčiansky kraj";126;2970;52;3022;NA;299128;178;2021-10-15;105648
2021-10-14;"Trenčiansky kraj";103;1717;27;1744;NA;299128;130;2021-10-14;105470
2021-10-13;"Trenčiansky kraj";171;2672;28;2700;NA;299128;199;2021-10-13;105340
2021-10-12;"Trenčiansky kraj";114;2364;33;2397;NA;299128;147;2021-10-12;105141
2021-10-11;"Trenčiansky kraj";109;2571;50;2621;NA;299128;159;2021-10-11;104994
2021-10-10;"Trenčiansky kraj";17;1487;23;1510;NA;299128;40;2021-10-10;104835
2021-10-09;"Trenčiansky kraj";157;1809;16;1825;NA;299128;173;2021-10-09;104795
2021-10-08;"Trenčiansky kraj";82;3100;38;3138;NA;299128;120;2021-10-08;104622
2021-10-07;"Trenčiansky kraj";107;2054;32;2086;NA;299128;139;2021-10-07;104502
2021-10-06;"Trenčiansky kraj";193;2300;37;2337;NA;299128;230;2021-10-06;104363
2021-10-05;"Trenčiansky kraj";119;2236;42;2278;NA;299128;161;2021-10-05;104133
2021-10-04;"Trenčiansky kraj";105;2775;53;2828;NA;299128;158;2021-10-04;103972
2021-10-03;"Trenčiansky kraj";30;1558;27;1585;NA;299128;57;2021-10-03;103814
2021-10-02;"Trenčiansky kraj";107;1794;35;1829;NA;299128;142;2021-10-02;103757
2021-10-01;"Trenčiansky kraj";119;2692;37;2729;NA;299128;156;2021-10-01;103615
2021-09-30;"Trenčiansky kraj";74;2329;50;2379;NA;299128;124;2021-09-30;103459
2021-09-29;"Trenčiansky kraj";170;2151;30;2181;NA;299128;200;2021-09-29;103335
2021-09-28;"Trenčiansky kraj";95;2270;31;2301;NA;299128;126;2021-09-28;103135
2021-09-27;"Trenčiansky kraj";56;2819;57;2876;NA;299128;113;2021-09-27;103009
2021-09-26;"Trenčiansky kraj";20;1675;33;1708;NA;299128;53;2021-09-26;102896
2021-09-25;"Trenčiansky kraj";76;1674;21;1695;NA;299128;97;2021-09-25;102843
2021-09-24;"Trenčiansky kraj";104;3222;35;3257;NA;299128;139;2021-09-24;102746
2021-09-23;"Trenčiansky kraj";91;2252;27;2279;NA;299128;118;2021-09-23;102607
2021-09-22;"Trenčiansky kraj";90;2147;24;2171;NA;299128;114;2021-09-22;102489
2021-09-21;"Trenčiansky kraj";79;2309;29;2338;NA;299128;108;2021-09-21;102375
2021-09-20;"Trenčiansky kraj";78;2615;37;2652;NA;299128;115;2021-09-20;102267
2021-09-19;"Trenčiansky kraj";11;1571;20;1591;NA;299128;31;2021-09-19;102152
2021-09-18;"Trenčiansky kraj";53;2099;14;2113;NA;299128;67;2021-09-18;102121
2021-09-17;"Trenčiansky kraj";55;3144;26;3170;NA;299128;81;2021-09-17;102054
2021-09-16;"Trenčiansky kraj";52;2164;20;2184;NA;299128;72;2021-09-16;101973
2021-09-15;"Trenčiansky kraj";63;1043;7;1050;NA;299128;70;2021-09-15;101901
2021-09-14;"Trenčiansky kraj";67;2450;25;2475;NA;299128;92;2021-09-14;101831
2021-09-13;"Trenčiansky kraj";33;2276;35;2311;NA;299128;68;2021-09-13;101739
2021-09-12;"Trenčiansky kraj";3;1411;11;1422;NA;299128;14;2021-09-12;101671
2021-09-11;"Trenčiansky kraj";55;1729;6;1735;NA;299128;61;2021-09-11;101657
2021-09-10;"Trenčiansky kraj";49;2248;15;2263;NA;299128;64;2021-09-10;101596
2021-09-09;"Trenčiansky kraj";24;1685;30;1715;NA;299128;54;2021-09-09;101532
2021-09-08;"Trenčiansky kraj";54;1773;15;1788;NA;299128;69;2021-09-08;101478
2021-09-07;"Trenčiansky kraj";43;1395;18;1413;NA;299128;61;2021-09-07;101409
2021-09-06;"Trenčiansky kraj";47;1401;15;1416;NA;299128;62;2021-09-06;101348
2021-09-05;"Trenčiansky kraj";2;966;23;989;NA;299128;25;2021-09-05;101286
2021-09-04;"Trenčiansky kraj";41;925;4;929;NA;299128;45;2021-09-04;101261
2021-09-03;"Trenčiansky kraj";53;1422;15;1437;NA;299128;68;2021-09-03;101216
2021-09-02;"Trenčiansky kraj";7;1001;14;1015;NA;299128;21;2021-09-02;101148
2021-09-01;"Trenčiansky kraj";27;431;8;439;NA;299128;35;2021-09-01;101127
2021-08-31;"Trenčiansky kraj";21;1146;15;1161;NA;299128;36;2021-08-31;101092
2021-08-30;"Trenčiansky kraj";32;1168;10;1178;NA;299128;42;2021-08-30;101056
2021-08-29;"Trenčiansky kraj";1;482;11;493;NA;299128;12;2021-08-29;101014
2021-08-28;"Trenčiansky kraj";9;976;10;986;NA;299128;19;2021-08-28;101002
2021-08-27;"Trenčiansky kraj";21;1599;1;1600;NA;299128;22;2021-08-27;100983
2021-08-26;"Trenčiansky kraj";8;993;6;999;NA;299128;14;2021-08-26;100961
2021-08-25;"Trenčiansky kraj";40;875;7;882;NA;299128;47;2021-08-25;100947
2021-08-24;"Trenčiansky kraj";4;822;4;826;NA;299128;8;2021-08-24;100900
2021-08-23;"Trenčiansky kraj";6;1165;17;1182;NA;299128;23;2021-08-23;100892
2021-08-22;"Trenčiansky kraj";0;726;10;736;NA;299128;10;2021-08-22;100869
2021-08-21;"Trenčiansky kraj";5;964;7;971;NA;299128;12;2021-08-21;100859
2021-08-20;"Trenčiansky kraj";15;1538;2;1540;NA;299128;17;2021-08-20;100847
2021-08-19;"Trenčiansky kraj";2;986;2;988;NA;299128;4;2021-08-19;100830
2021-08-18;"Trenčiansky kraj";6;816;7;823;NA;299128;13;2021-08-18;100826
2021-08-17;"Trenčiansky kraj";9;634;1;635;NA;299128;10;2021-08-17;100813
2021-08-16;"Trenčiansky kraj";5;929;3;932;NA;299128;8;2021-08-16;100803
2021-08-15;"Trenčiansky kraj";0;558;1;559;NA;299128;1;2021-08-15;100795
2021-08-14;"Trenčiansky kraj";12;574;6;580;NA;299128;18;2021-08-14;100794
2021-08-13;"Trenčiansky kraj";2;934;0;934;NA;299128;2;2021-08-13;100776
2021-08-12;"Trenčiansky kraj";2;566;3;569;NA;299128;5;2021-08-12;100774
2021-08-11;"Trenčiansky kraj";1;683;0;683;NA;299128;1;2021-08-11;100769
2021-08-10;"Trenčiansky kraj";8;532;1;533;NA;299128;9;2021-08-10;100768
2021-08-09;"Trenčiansky kraj";8;698;1;699;NA;299128;9;2021-08-09;100759
2021-08-08;"Trenčiansky kraj";0;468;0;468;NA;299128;0;2021-08-08;100750
2021-08-07;"Trenčiansky kraj";3;464;0;464;NA;299128;3;2021-08-07;100750
2021-08-06;"Trenčiansky kraj";3;956;1;957;NA;299128;4;2021-08-06;100747
2021-08-05;"Trenčiansky kraj";3;582;1;583;NA;299128;4;2021-08-05;100743
2021-08-04;"Trenčiansky kraj";14;549;3;552;NA;299128;17;2021-08-04;100739
2021-08-03;"Trenčiansky kraj";9;510;5;515;NA;299128;14;2021-08-03;100722
2021-08-02;"Trenčiansky kraj";1;811;2;813;NA;299128;3;2021-08-02;100708
2021-08-01;"Trenčiansky kraj";0;514;1;515;NA;299128;1;2021-08-01;100705
2021-07-31;"Trenčiansky kraj";4;525;2;527;NA;299128;6;2021-07-31;100704
2021-07-30;"Trenčiansky kraj";2;1071;0;1071;NA;299128;2;2021-07-30;100698
2021-07-29;"Trenčiansky kraj";5;710;0;710;NA;299128;5;2021-07-29;100696
2021-07-28;"Trenčiansky kraj";3;521;2;523;NA;299128;5;2021-07-28;100691
2021-07-27;"Trenčiansky kraj";6;553;1;554;NA;299128;7;2021-07-27;100686
2021-07-26;"Trenčiansky kraj";7;781;1;782;NA;299128;8;2021-07-26;100679
2021-07-25;"Trenčiansky kraj";0;487;2;489;NA;299128;2;2021-07-25;100671
2021-07-24;"Trenčiansky kraj";3;643;1;644;NA;299128;4;2021-07-24;100669
2021-07-23;"Trenčiansky kraj";3;1154;0;1154;NA;299128;3;2021-07-23;100665
2021-07-22;"Trenčiansky kraj";2;849;2;851;NA;299128;4;2021-07-22;100662
2021-07-21;"Trenčiansky kraj";8;667;2;669;NA;299128;10;2021-07-21;100658
2021-07-20;"Trenčiansky kraj";4;530;1;531;NA;299128;5;2021-07-20;100648
2021-07-19;"Trenčiansky kraj";0;878;4;882;NA;299128;4;2021-07-19;100643
2021-07-18;"Trenčiansky kraj";0;526;0;526;NA;299128;0;2021-07-18;100639
2021-07-17;"Trenčiansky kraj";3;673;0;673;NA;299128;3;2021-07-17;100639
2021-07-16;"Trenčiansky kraj";4;1126;0;1126;NA;299128;4;2021-07-16;100636
2021-07-15;"Trenčiansky kraj";2;830;0;830;NA;299128;2;2021-07-15;100632
2021-07-14;"Trenčiansky kraj";8;665;1;666;NA;299128;9;2021-07-14;100630
2021-07-13;"Trenčiansky kraj";1;528;3;531;NA;299128;4;2021-07-13;100621
2021-07-12;"Trenčiansky kraj";9;827;3;830;NA;299128;12;2021-07-12;100617
2021-07-11;"Trenčiansky kraj";0;611;2;613;NA;299128;2;2021-07-11;100605
2021-07-10;"Trenčiansky kraj";2;535;0;535;NA;299128;2;2021-07-10;100603
2021-07-09;"Trenčiansky kraj";7;1387;2;1389;NA;299128;9;2021-07-09;100601
2021-07-08;"Trenčiansky kraj";2;824;1;825;NA;299128;3;2021-07-08;100592
2021-07-07;"Trenčiansky kraj";2;943;1;944;NA;299128;3;2021-07-07;100589
2021-07-06;"Trenčiansky kraj";4;1046;2;1048;NA;299128;6;2021-07-06;100586
2021-07-05;"Trenčiansky kraj";1;516;0;516;NA;299128;1;2021-07-05;100580
2021-07-04;"Trenčiansky kraj";0;612;1;613;NA;299128;1;2021-07-04;100579
2021-07-03;"Trenčiansky kraj";3;815;1;816;NA;299128;4;2021-07-03;100578
2021-07-02;"Trenčiansky kraj";5;1590;2;1592;NA;299128;7;2021-07-02;100574
2021-07-01;"Trenčiansky kraj";4;1173;1;1174;NA;299128;5;2021-07-01;100567
2021-06-30;"Trenčiansky kraj";2;7021;6;7027;NA;299128;8;2021-06-30;100562
2021-06-29;"Trenčiansky kraj";4;2773;5;2778;NA;299128;9;2021-06-29;100554
2021-06-28;"Trenčiansky kraj";5;3644;4;3648;NA;299128;9;2021-06-28;100545
2021-06-27;"Trenčiansky kraj";0;2861;1;2862;NA;299128;1;2021-06-27;100536
2021-06-26;"Trenčiansky kraj";1;3547;4;3551;NA;299128;5;2021-06-26;100535
2021-06-25;"Trenčiansky kraj";2;4626;1;4627;NA;299128;3;2021-06-25;100530
2021-06-24;"Trenčiansky kraj";3;3320;4;3324;NA;299128;7;2021-06-24;100527
2021-06-23;"Trenčiansky kraj";4;2808;2;2810;NA;299128;6;2021-06-23;100520
2021-06-22;"Trenčiansky kraj";7;3137;4;3141;NA;299128;11;2021-06-22;100514
2021-06-21;"Trenčiansky kraj";10;3891;4;3895;NA;299128;14;2021-06-21;100503
2021-06-20;"Trenčiansky kraj";0;3579;5;3584;NA;299128;5;2021-06-20;100489
2021-06-19;"Trenčiansky kraj";5;4528;1;4529;NA;299128;6;2021-06-19;100484
2021-06-18;"Trenčiansky kraj";7;6725;7;6732;NA;299128;14;2021-06-18;100478
2021-06-17;"Trenčiansky kraj";0;3469;6;3475;NA;299128;6;2021-06-17;100464
2021-06-16;"Trenčiansky kraj";4;3183;3;3186;NA;299128;7;2021-06-16;100458
2021-06-15;"Trenčiansky kraj";10;3697;2;3699;NA;299128;12;2021-06-15;100451
2021-06-14;"Trenčiansky kraj";10;4805;15;4820;NA;299128;25;2021-06-14;100439
2021-06-13;"Trenčiansky kraj";0;4643;4;4647;NA;299128;4;2021-06-13;100414
2021-06-12;"Trenčiansky kraj";4;5260;8;5268;NA;299128;12;2021-06-12;100410
2021-06-11;"Trenčiansky kraj";10;7365;11;7376;NA;299128;21;2021-06-11;100398
2021-06-10;"Trenčiansky kraj";5;4345;7;4352;NA;299128;12;2021-06-10;100377
2021-06-09;"Trenčiansky kraj";7;3693;7;3700;NA;299128;14;2021-06-09;100365
2021-06-08;"Trenčiansky kraj";21;3965;7;3972;NA;299128;28;2021-06-08;100351
2021-06-07;"Trenčiansky kraj";13;5560;10;5570;NA;299128;23;2021-06-07;100323
2021-06-06;"Trenčiansky kraj";0;5500;10;5510;NA;299128;10;2021-06-06;100300
2021-06-05;"Trenčiansky kraj";7;6511;5;6516;NA;299128;12;2021-06-05;100290
2021-06-04;"Trenčiansky kraj";16;7653;3;7656;NA;299128;19;2021-06-04;100278
2021-06-03;"Trenčiansky kraj";9;4485;10;4495;NA;299128;19;2021-06-03;100259
2021-06-02;"Trenčiansky kraj";28;4329;8;4337;NA;299128;36;2021-06-02;100240
2021-06-01;"Trenčiansky kraj";22;5396;18;5414;NA;299128;40;2021-06-01;100204
2021-05-31;"Trenčiansky kraj";30;6117;24;6141;NA;299128;54;2021-05-31;100164
2021-05-30;"Trenčiansky kraj";0;8258;16;8274;NA;299128;16;2021-05-30;100110
2021-05-29;"Trenčiansky kraj";13;7915;14;7929;NA;299128;27;2021-05-29;100094
2021-05-28;"Trenčiansky kraj";22;8995;25;9020;NA;299128;47;2021-05-28;100067
2021-05-27;"Trenčiansky kraj";6;5205;12;5217;NA;299128;18;2021-05-27;100020
2021-05-26;"Trenčiansky kraj";26;5069;15;5084;NA;299128;41;2021-05-26;100002
2021-05-25;"Trenčiansky kraj";18;6168;24;6192;NA;299128;42;2021-05-25;99961
2021-05-24;"Trenčiansky kraj";19;9292;37;9329;NA;299128;56;2021-05-24;99919
2021-05-23;"Trenčiansky kraj";0;9083;26;9109;NA;299128;26;2021-05-23;99863
2021-05-22;"Trenčiansky kraj";11;11314;21;11335;NA;299128;32;2021-05-22;99837
2021-05-21;"Trenčiansky kraj";23;11572;26;11598;NA;299128;49;2021-05-21;99805
2021-05-20;"Trenčiansky kraj";23;6320;25;6345;NA;299128;48;2021-05-20;99756
2021-05-19;"Trenčiansky kraj";16;5694;32;5726;NA;299128;48;2021-05-19;99708
2021-05-18;"Trenčiansky kraj";26;7779;28;7807;NA;299128;54;2021-05-18;99660
2021-05-17;"Trenčiansky kraj";37;7671;43;7714;NA;299128;80;2021-05-17;99606
2021-05-16;"Trenčiansky kraj";25;15615;41;15656;NA;299128;66;2021-05-16;99526
2021-05-15;"Trenčiansky kraj";3;21237;32;21269;NA;299128;35;2021-05-15;99460
2021-05-14;"Trenčiansky kraj";41;18676;42;18718;NA;299128;83;2021-05-14;99425
2021-05-13;"Trenčiansky kraj";41;8195;24;8219;NA;299128;65;2021-05-13;99342
2021-05-12;"Trenčiansky kraj";41;7409;31;7440;NA;299128;72;2021-05-12;99277
2021-05-11;"Trenčiansky kraj";66;10507;32;10539;NA;299128;98;2021-05-11;99205
2021-05-10;"Trenčiansky kraj";48;12989;55;13044;NA;299128;103;2021-05-10;99107
2021-05-09;"Trenčiansky kraj";52;17737;39;17776;NA;299128;91;2021-05-09;99004
2021-05-08;"Trenčiansky kraj";3;23822;33;23855;NA;299128;36;2021-05-08;98913
2021-05-07;"Trenčiansky kraj";45;23549;56;23605;NA;299128;101;2021-05-07;98877
2021-05-06;"Trenčiansky kraj";26;10771;44;10815;NA;299128;70;2021-05-06;98776
2021-05-05;"Trenčiansky kraj";73;9377;41;9418;NA;299128;114;2021-05-05;98706
2021-05-04;"Trenčiansky kraj";55;12733;53;12786;NA;299128;108;2021-05-04;98592
2021-05-03;"Trenčiansky kraj";60;15331;51;15382;NA;299128;111;2021-05-03;98484
2021-05-02;"Trenčiansky kraj";0;31152;65;31217;NA;299128;65;2021-05-02;98373
2021-05-01;"Trenčiansky kraj";71;56982;60;57042;NA;299128;131;2021-05-01;98308
2021-04-30;"Trenčiansky kraj";77;29427;61;29488;NA;299128;138;2021-04-30;98177
2021-04-29;"Trenčiansky kraj";49;13184;59;13243;NA;299128;108;2021-04-29;98039
2021-04-28;"Trenčiansky kraj";79;12537;52;12589;NA;299128;131;2021-04-28;97931
2021-04-27;"Trenčiansky kraj";107;15527;40;15567;NA;299128;147;2021-04-27;97800
2021-04-26;"Trenčiansky kraj";52;21070;63;21133;NA;299128;115;2021-04-26;97653
2021-04-25;"Trenčiansky kraj";0;34560;48;34608;NA;299128;48;2021-04-25;97538
2021-04-24;"Trenčiansky kraj";76;72398;100;72498;NA;299128;176;2021-04-24;97490
2021-04-23;"Trenčiansky kraj";143;29959;79;30038;NA;299128;222;2021-04-23;97314
2021-04-22;"Trenčiansky kraj";71;13847;64;13911;NA;299128;135;2021-04-22;97092
2021-04-21;"Trenčiansky kraj";79;13000;67;13067;NA;299128;146;2021-04-21;96957
2021-04-20;"Trenčiansky kraj";142;17740;80;17820;NA;299128;222;2021-04-20;96811
2021-04-19;"Trenčiansky kraj";102;22631;103;22734;NA;299128;205;2021-04-19;96589
2021-04-18;"Trenčiansky kraj";3;40879;97;40976;NA;299128;100;2021-04-18;96384
2021-04-17;"Trenčiansky kraj";77;81498;136;81634;NA;299128;213;2021-04-17;96284
2021-04-16;"Trenčiansky kraj";100;31961;90;32051;NA;299128;190;2021-04-16;96071
2021-04-15;"Trenčiansky kraj";71;14479;69;14548;NA;299128;140;2021-04-15;95881
2021-04-14;"Trenčiansky kraj";135;15563;72;15635;NA;299128;207;2021-04-14;95741
2021-04-13;"Trenčiansky kraj";189;18721;75;18796;NA;299128;264;2021-04-13;95534
2021-04-12;"Trenčiansky kraj";97;23743;91;23834;NA;299128;188;2021-04-12;95270
2021-04-11;"Trenčiansky kraj";1;34735;75;34810;NA;299128;76;2021-04-11;95082
2021-04-10;"Trenčiansky kraj";81;83093;145;83238;NA;299128;226;2021-04-10;95006
2021-04-09;"Trenčiansky kraj";120;28014;91;28105;NA;299128;211;2021-04-09;94780
2021-04-08;"Trenčiansky kraj";112;13283;85;13368;NA;299128;197;2021-04-08;94569
2021-04-07;"Trenčiansky kraj";204;17688;123;17811;NA;299128;327;2021-04-07;94372
2021-04-06;"Trenčiansky kraj";157;28567;178;28745;NA;299128;335;2021-04-06;94045
2021-04-05;"Trenčiansky kraj";15;9227;64;9291;NA;299128;79;2021-04-05;93710
2021-04-04;"Trenčiansky kraj";2;20291;85;20376;NA;299128;87;2021-04-04;93631
2021-04-03;"Trenčiansky kraj";86;80473;221;80694;NA;299128;307;2021-04-03;93544
2021-04-02;"Trenčiansky kraj";126;21620;81;21701;NA;299128;207;2021-04-02;93237
2021-04-01;"Trenčiansky kraj";159;32376;139;32515;NA;299128;298;2021-04-01;93030
2021-03-31;"Trenčiansky kraj";198;20100;130;20230;NA;299128;328;2021-03-31;92732
2021-03-30;"Trenčiansky kraj";272;17305;136;17441;NA;299128;408;2021-03-30;92404
2021-03-29;"Trenčiansky kraj";142;19479;170;19649;NA;299128;312;2021-03-29;91996
2021-03-28;"Trenčiansky kraj";3;34759;116;34875;NA;299128;119;2021-03-28;91684
2021-03-27;"Trenčiansky kraj";130;77314;293;77607;NA;299128;423;2021-03-27;91565
2021-03-26;"Trenčiansky kraj";211;35095;157;35252;NA;299128;368;2021-03-26;91142
2021-03-25;"Trenčiansky kraj";184;16580;176;16756;NA;299128;360;2021-03-25;90774
2021-03-24;"Trenčiansky kraj";259;13102;171;13273;NA;299128;430;2021-03-24;90414
2021-03-23;"Trenčiansky kraj";349;17589;174;17763;NA;299128;523;2021-03-23;89984
2021-03-22;"Trenčiansky kraj";141;21116;213;21329;NA;299128;354;2021-03-22;89461
2021-03-21;"Trenčiansky kraj";85;32711;164;32875;NA;299128;249;2021-03-21;89107
2021-03-20;"Trenčiansky kraj";128;80035;322;80357;NA;299128;450;2021-03-20;88858
2021-03-19;"Trenčiansky kraj";231;34783;232;35015;NA;299128;463;2021-03-19;88408
2021-03-18;"Trenčiansky kraj";262;16105;178;16283;NA;299128;440;2021-03-18;87945
2021-03-17;"Trenčiansky kraj";366;13435;164;13599;NA;299128;530;2021-03-17;87505
2021-03-16;"Trenčiansky kraj";450;15282;241;15523;NA;299128;691;2021-03-16;86975
2021-03-15;"Trenčiansky kraj";162;21235;261;21496;NA;299128;423;2021-03-15;86284
2021-03-14;"Trenčiansky kraj";42;34416;238;34654;NA;299128;280;2021-03-14;85861
2021-03-13;"Trenčiansky kraj";270;79186;453;79639;NA;299128;723;2021-03-13;85581
2021-03-12;"Trenčiansky kraj";366;34795;307;35102;NA;299128;673;2021-03-12;84858
2021-03-11;"Trenčiansky kraj";302;15558;213;15771;NA;299128;515;2021-03-11;84185
2021-03-10;"Trenčiansky kraj";402;13585;237;13822;NA;299128;639;2021-03-10;83670
2021-03-09;"Trenčiansky kraj";586;17982;285;18267;NA;299128;871;2021-03-09;83031
2021-03-08;"Trenčiansky kraj";174;21704;363;22067;NA;299128;537;2021-03-08;82160
2021-03-07;"Trenčiansky kraj";4;33660;313;33973;NA;299128;317;2021-03-07;81623
2021-03-06;"Trenčiansky kraj";260;79661;529;80190;NA;299128;789;2021-03-06;81306
2021-03-05;"Trenčiansky kraj";326;32969;415;33384;NA;299128;741;2021-03-05;80517
2021-03-04;"Trenčiansky kraj";323;16821;317;17138;NA;299128;640;2021-03-04;79776
2021-03-03;"Trenčiansky kraj";413;13960;347;14307;NA;299128;760;2021-03-03;79136
2021-03-02;"Trenčiansky kraj";612;17794;344;18138;NA;299128;956;2021-03-02;78376
2021-03-01;"Trenčiansky kraj";217;21104;445;21549;NA;299128;662;2021-03-01;77420
2021-02-28;"Trenčiansky kraj";45;30238;376;30614;NA;299128;421;2021-02-28;76758
2021-02-27;"Trenčiansky kraj";277;78735;686;79421;NA;299128;963;2021-02-27;76337
2021-02-26;"Trenčiansky kraj";420;32940;434;33374;NA;299128;854;2021-02-26;75374
2021-02-25;"Trenčiansky kraj";424;14029;328;14357;NA;299128;752;2021-02-25;74520
2021-02-24;"Trenčiansky kraj";427;12014;399;12413;NA;299128;826;2021-02-24;73768
2021-02-23;"Trenčiansky kraj";577;14904;390;15294;NA;299128;967;2021-02-23;72942
2021-02-22;"Trenčiansky kraj";160;19969;468;20437;NA;299128;628;2021-02-22;71975
2021-02-21;"Trenčiansky kraj";64;29478;392;29870;NA;299128;456;2021-02-21;71347
2021-02-20;"Trenčiansky kraj";274;77840;745;78585;NA;299128;1019;2021-02-20;70891
2021-02-19;"Trenčiansky kraj";272;30260;523;30783;NA;299128;795;2021-02-19;69872
2021-02-18;"Trenčiansky kraj";355;14094;403;14497;NA;299128;758;2021-02-18;69077
2021-02-17;"Trenčiansky kraj";363;11412;376;11788;NA;299128;739;2021-02-17;68319
2021-02-16;"Trenčiansky kraj";488;17761;406;18167;NA;299128;894;2021-02-16;67580
2021-02-15;"Trenčiansky kraj";151;21846;463;22309;NA;299128;614;2021-02-15;66686
2021-02-14;"Trenčiansky kraj";2;31255;324;31579;NA;299128;326;2021-02-14;66072
2021-02-13;"Trenčiansky kraj";274;63006;522;63528;NA;299128;796;2021-02-13;65746
2021-02-12;"Trenčiansky kraj";276;27979;412;28391;NA;299128;688;2021-02-12;64950
2021-02-11;"Trenčiansky kraj";291;11567;323;11890;NA;299128;614;2021-02-11;64262
2021-02-10;"Trenčiansky kraj";304;11408;317;11725;NA;299128;621;2021-02-10;63648
2021-02-09;"Trenčiansky kraj";514;18412;360;18772;NA;299128;874;2021-02-09;63027
2021-02-08;"Trenčiansky kraj";182;26832;430;27262;NA;299128;612;2021-02-08;62153
2021-02-07;"Trenčiansky kraj";31;36781;341;37122;NA;299128;372;2021-02-07;61541
2021-02-06;"Trenčiansky kraj";216;63931;560;64491;NA;299128;776;2021-02-06;61169
2021-02-05;"Trenčiansky kraj";202;18164;367;18531;NA;299128;569;2021-02-05;60393
2021-02-04;"Trenčiansky kraj";266;7253;311;7564;NA;299128;577;2021-02-04;59824
2021-02-03;"Trenčiansky kraj";162;6723;320;7043;NA;299128;482;2021-02-03;59247
2021-02-02;"Trenčiansky kraj";347;8074;381;8455;NA;299128;728;2021-02-02;58765
2021-02-01;"Trenčiansky kraj";167;8921;311;9232;NA;299128;478;2021-02-01;58037
2021-01-31;"Trenčiansky kraj";7;19103;159;19262;NA;299128;166;2021-01-31;57559
2021-01-30;"Trenčiansky kraj";228;38167;332;38499;NA;299128;560;2021-01-30;57393
2021-01-29;"Trenčiansky kraj";214;7590;235;7825;NA;299128;449;2021-01-29;56833
2021-01-28;"Trenčiansky kraj";307;5442;158;5600;NA;299128;465;2021-01-28;56384
2021-01-27;"Trenčiansky kraj";166;4842;181;5023;NA;299128;347;2021-01-27;55919
2021-01-26;"Trenčiansky kraj";303;14589;250;14839;NA;299128;553;2021-01-26;55572
2021-01-25;"Trenčiansky kraj";160;24310;207;24517;NA;299128;367;2021-01-25;55019
2021-01-24;"Trenčiansky kraj";51;38369;282;38651;NA;299128;333;2021-01-24;54652
2021-01-23;"Trenčiansky kraj";206;114125;749;114874;NA;299128;955;2021-01-23;54319
2021-01-22;"Trenčiansky kraj";148;21831;241;22072;NA;299128;389;2021-01-22;53364
2021-01-21;"Trenčiansky kraj";143;8586;166;8752;NA;299128;309;2021-01-21;52975
2021-01-20;"Trenčiansky kraj";181;8189;227;8416;NA;299128;408;2021-01-20;52666
2021-01-19;"Trenčiansky kraj";363;6600;262;6862;NA;299128;625;2021-01-19;52258
2021-01-18;"Trenčiansky kraj";72;4970;321;5291;NA;299128;393;2021-01-18;51633
2021-01-17;"Trenčiansky kraj";124;156;11;167;NA;299128;135;2021-01-17;51240
2021-01-16;"Trenčiansky kraj";39;1288;53;1341;NA;299128;92;2021-01-16;51105
2021-01-15;"Trenčiansky kraj";264;4031;214;4245;NA;299128;478;2021-01-15;51013
2021-01-14;"Trenčiansky kraj";275;3193;189;3382;NA;299128;464;2021-01-14;50535
2021-01-13;"Trenčiansky kraj";222;3893;215;4108;NA;299128;437;2021-01-13;50071
2021-01-12;"Trenčiansky kraj";508;4604;261;4865;NA;299128;769;2021-01-12;49634
2021-01-11;"Trenčiansky kraj";142;4367;354;4721;NA;299128;496;2021-01-11;48865
2021-01-10;"Trenčiansky kraj";89;4969;77;5046;NA;299128;166;2021-01-10;48369
2021-01-09;"Trenčiansky kraj";276;8280;128;8408;NA;299128;404;2021-01-09;48203
2021-01-08;"Trenčiansky kraj";489;6435;484;6919;NA;299128;973;2021-01-08;47799
2021-01-07;"Trenčiansky kraj";420;6138;577;6715;NA;299128;997;2021-01-07;46826
2021-01-06;"Trenčiansky kraj";221;1021;64;1085;NA;299128;285;2021-01-06;45829
2021-01-05;"Trenčiansky kraj";669;5753;706;6459;NA;299128;1375;2021-01-05;45544
2021-01-04;"Trenčiansky kraj";337;5248;782;6030;NA;299128;1119;2021-01-04;44169
2021-01-03;"Trenčiansky kraj";38;114;15;129;NA;299128;53;2021-01-03;43050
2021-01-02;"Trenčiansky kraj";129;196;23;219;NA;299128;152;2021-01-02;42997
2021-01-01;"Trenčiansky kraj";329;347;23;370;NA;299128;352;2021-01-01;42845
2020-12-31;"Trenčiansky kraj";597;4943;557;5500;NA;299128;1154;2020-12-31;42493
2020-12-30;"Trenčiansky kraj";836;7012;762;7774;NA;299128;1598;2020-12-30;41339
2020-12-29;"Trenčiansky kraj";459;6121;1009;7130;NA;299128;1468;2020-12-29;39741
2020-12-28;"Trenčiansky kraj";258;4195;777;4972;NA;299128;1035;2020-12-28;38273
2020-12-27;"Trenčiansky kraj";5;208;36;244;NA;299128;41;2020-12-27;37238
2020-12-26;"Trenčiansky kraj";174;74;10;84;NA;299128;184;2020-12-26;37197
2020-12-25;"Trenčiansky kraj";251;325;47;372;NA;299128;298;2020-12-25;37013
2020-12-24;"Trenčiansky kraj";552;2194;256;2450;NA;299128;808;2020-12-24;36715
2020-12-23;"Trenčiansky kraj";421;6552;661;7213;NA;299128;1082;2020-12-23;35907
2020-12-22;"Trenčiansky kraj";673;5760;694;6454;NA;299128;1367;2020-12-22;34825
2020-12-21;"Trenčiansky kraj";248;13395;979;14374;NA;299128;1227;2020-12-21;33458
2020-12-20;"Trenčiansky kraj";238;12504;292;12796;NA;299128;530;2020-12-20;32231
2020-12-19;"Trenčiansky kraj";341;1611;150;1761;NA;299128;491;2020-12-19;31701
2020-12-18;"Trenčiansky kraj";521;5199;615;5814;NA;299128;1136;2020-12-18;31210
2020-12-17;"Trenčiansky kraj";670;3843;524;4367;NA;299128;1194;2020-12-17;30074
2020-12-16;"Trenčiansky kraj";461;4474;648;5122;NA;299128;1109;2020-12-16;28880
2020-12-15;"Trenčiansky kraj";595;3805;670;4475;NA;299128;1265;2020-12-15;27771
2020-12-14;"Trenčiansky kraj";318;2907;552;3459;NA;299128;870;2020-12-14;26506
2020-12-13;"Trenčiansky kraj";77;49;6;55;NA;299128;83;2020-12-13;25636
2020-12-12;"Trenčiansky kraj";314;1191;136;1327;NA;299128;450;2020-12-12;25553
2020-12-11;"Trenčiansky kraj";751;3773;453;4226;NA;299128;1204;2020-12-11;25103
2020-12-10;"Trenčiansky kraj";271;3354;473;3827;NA;299128;744;2020-12-10;23899
2020-12-09;"Trenčiansky kraj";508;3788;466;4254;NA;299128;974;2020-12-09;23155
2020-12-08;"Trenčiansky kraj";546;3440;522;3962;NA;299128;1068;2020-12-08;22181
2020-12-07;"Trenčiansky kraj";258;3832;468;4300;NA;299128;726;2020-12-07;21113
2020-12-06;"Trenčiansky kraj";114;179;10;189;NA;299128;124;2020-12-06;20387
2020-12-05;"Trenčiansky kraj";223;610;56;666;NA;299128;279;2020-12-05;20263
2020-12-04;"Trenčiansky kraj";253;2943;273;3216;NA;299128;526;2020-12-04;19984
2020-12-03;"Trenčiansky kraj";503;1714;178;1892;NA;299128;681;2020-12-03;19458
2020-12-02;"Trenčiansky kraj";418;1844;232;2076;NA;299128;650;2020-12-02;18777
2020-12-01;"Trenčiansky kraj";321;5642;351;5993;NA;299128;672;2020-12-01;18127
2020-11-30;"Trenčiansky kraj";167;11514;520;12034;NA;299128;687;2020-11-30;17455
2020-11-29;"Trenčiansky kraj";29;30;5;35;NA;299128;34;2020-11-29;16768
2020-11-28;"Trenčiansky kraj";202;1051;93;1144;NA;299128;295;2020-11-28;16734
2020-11-27;"Trenčiansky kraj";330;1888;186;2074;NA;299128;516;2020-11-27;16439
2020-11-26;"Trenčiansky kraj";395;1252;122;1374;NA;299128;517;2020-11-26;15923
2020-11-25;"Trenčiansky kraj";322;1444;160;1604;NA;299128;482;2020-11-25;15406
2020-11-24;"Trenčiansky kraj";348;2553;308;2861;NA;299128;656;2020-11-24;14924
2020-11-23;"Trenčiansky kraj";159;1186;122;1308;NA;299128;281;2020-11-23;14268
2020-11-22;"Trenčiansky kraj";26;30;7;37;NA;299128;33;2020-11-22;13987
2020-11-21;"Trenčiansky kraj";255;1376;69;1445;NA;299128;324;2020-11-21;13954
2020-11-20;"Trenčiansky kraj";316;861;93;954;NA;299128;409;2020-11-20;13630
2020-11-19;"Trenčiansky kraj";316;740;113;853;NA;299128;429;2020-11-19;13221
2020-11-18;"Trenčiansky kraj";233;379;66;445;NA;299128;299;2020-11-18;12792
2020-11-17;"Trenčiansky kraj";222;106;15;121;NA;299128;237;2020-11-17;12493
2020-11-16;"Trenčiansky kraj";245;236;45;281;NA;299128;290;2020-11-16;12256
2020-11-15;"Trenčiansky kraj";109;29;6;35;NA;299128;115;2020-11-15;11966
2020-11-14;"Trenčiansky kraj";190;74;11;85;NA;299128;201;2020-11-14;11851
2020-11-13;"Trenčiansky kraj";308;131;13;144;NA;299128;321;2020-11-13;11650
2020-11-12;"Trenčiansky kraj";324;124;5;129;NA;299128;329;2020-11-12;11329
2020-11-11;"Trenčiansky kraj";366;113;10;123;NA;299128;376;2020-11-11;11000
2020-11-10;"Trenčiansky kraj";277;106;6;112;NA;299128;283;2020-11-10;10624
2020-11-09;"Trenčiansky kraj";115;1407;48;1455;NA;299128;163;2020-11-09;10341
2020-11-08;"Trenčiansky kraj";81;1271;8;1279;NA;299128;89;2020-11-08;10178
2020-11-07;"Trenčiansky kraj";319;3662;59;3721;NA;299128;378;2020-11-07;10089
2020-11-06;"Trenčiansky kraj";383;6893;84;6977;NA;299128;467;2020-11-06;9711
2020-11-05;"Trenčiansky kraj";399;98;15;113;NA;299128;414;2020-11-05;9244
2020-11-04;"Trenčiansky kraj";370;91;9;100;NA;299128;379;2020-11-04;8830
2020-11-03;"Trenčiansky kraj";575;97;8;105;NA;299128;583;2020-11-03;8451
2020-11-02;"Trenčiansky kraj";197;1833;68;1901;NA;299128;265;2020-11-02;7868
2020-11-01;"Trenčiansky kraj";257;808;24;832;NA;299128;281;2020-11-01;7603
2020-10-31;"Trenčiansky kraj";332;4719;82;4801;NA;299128;414;2020-10-31;7322
2020-10-30;"Trenčiansky kraj";299;5283;102;5385;NA;299128;401;2020-10-30;6908
2020-10-29;"Trenčiansky kraj";496;764;68;832;NA;299128;564;2020-10-29;6507
2020-10-28;"Trenčiansky kraj";269;192;33;225;NA;299128;302;2020-10-28;5943
2020-10-27;"Trenčiansky kraj";473;127;27;154;NA;299128;500;2020-10-27;5641
2020-10-26;"Trenčiansky kraj";177;107;36;143;NA;299128;213;2020-10-26;5141
2020-10-25;"Trenčiansky kraj";138;9;5;14;NA;299128;143;2020-10-25;4928
2020-10-24;"Trenčiansky kraj";395;128;6;134;NA;299128;401;2020-10-24;4785
2020-10-23;"Trenčiansky kraj";301;154;8;162;NA;299128;309;2020-10-23;4384
2020-10-22;"Trenčiansky kraj";273;82;12;94;NA;299128;285;2020-10-22;4075
2020-10-21;"Trenčiansky kraj";183;53;9;62;NA;299128;192;2020-10-21;3790
2020-10-20;"Trenčiansky kraj";212;47;6;53;NA;299128;218;2020-10-20;3598
2020-10-19;"Trenčiansky kraj";41;83;25;108;NA;299128;66;2020-10-19;3380
2020-10-18;"Trenčiansky kraj";104;0;0;0;NA;299128;104;2020-10-18;3314
2020-10-17;"Trenčiansky kraj";157;0;0;0;NA;299128;157;2020-10-17;3210
2020-10-16;"Trenčiansky kraj";225;42;6;48;NA;299128;231;2020-10-16;3053
2020-10-15;"Trenčiansky kraj";255;39;4;43;NA;299128;259;2020-10-15;2822
2020-10-14;"Trenčiansky kraj";162;42;7;49;NA;299128;169;2020-10-14;2563
2020-10-13;"Trenčiansky kraj";124;105;12;117;NA;299128;136;2020-10-13;2394
2020-10-12;"Trenčiansky kraj";55;0;0;0;NA;299128;55;2020-10-12;2258
2020-10-11;"Trenčiansky kraj";73;0;0;0;NA;299128;73;2020-10-11;2203
2020-10-10;"Trenčiansky kraj";180;0;0;0;NA;299128;180;2020-10-10;2130
2020-10-09;"Trenčiansky kraj";198;0;0;0;NA;299128;198;2020-10-09;1950
2020-10-08;"Trenčiansky kraj";115;0;0;0;NA;299128;115;2020-10-08;1752
2020-10-07;"Trenčiansky kraj";75;0;0;0;NA;299128;75;2020-10-07;1637
2020-10-06;"Trenčiansky kraj";72;0;0;0;NA;299128;72;2020-10-06;1562
2020-10-05;"Trenčiansky kraj";32;0;0;0;NA;299128;32;2020-10-05;1490
2020-10-04;"Trenčiansky kraj";37;0;0;0;NA;299128;37;2020-10-04;1458
2020-10-03;"Trenčiansky kraj";79;0;0;0;NA;299128;79;2020-10-03;1421
2020-10-02;"Trenčiansky kraj";69;0;0;0;NA;299128;69;2020-10-02;1342
2020-10-01;"Trenčiansky kraj";58;0;0;0;NA;299128;58;2020-10-01;1273
2020-09-30;"Trenčiansky kraj";76;0;0;0;NA;299128;76;2020-09-30;1215
2020-09-29;"Trenčiansky kraj";43;0;0;0;NA;299128;43;2020-09-29;1139
2020-09-28;"Trenčiansky kraj";7;0;0;0;NA;299128;7;2020-09-28;1096
2020-09-27;"Trenčiansky kraj";12;0;0;0;NA;299128;12;2020-09-27;1089
2020-09-26;"Trenčiansky kraj";37;0;0;0;NA;299128;37;2020-09-26;1077
2020-09-25;"Trenčiansky kraj";72;0;0;0;NA;299128;72;2020-09-25;1040
2020-09-24;"Trenčiansky kraj";41;0;0;0;NA;299128;41;2020-09-24;968
2020-09-23;"Trenčiansky kraj";32;0;0;0;NA;299128;32;2020-09-23;927
2020-09-22;"Trenčiansky kraj";26;0;0;0;NA;299128;26;2020-09-22;895
2020-09-21;"Trenčiansky kraj";23;0;0;0;NA;299128;23;2020-09-21;869
2020-09-20;"Trenčiansky kraj";21;0;0;0;NA;299128;21;2020-09-20;846
2020-09-19;"Trenčiansky kraj";20;0;0;0;NA;299128;20;2020-09-19;825
2020-09-18;"Trenčiansky kraj";41;0;0;0;NA;299128;41;2020-09-18;805
2020-09-17;"Trenčiansky kraj";20;0;0;0;NA;299128;20;2020-09-17;764
2020-09-16;"Trenčiansky kraj";14;0;0;0;NA;299128;14;2020-09-16;744
2020-09-15;"Trenčiansky kraj";8;0;0;0;NA;299128;8;2020-09-15;730
2020-09-14;"Trenčiansky kraj";5;0;0;0;NA;299128;5;2020-09-14;722
2020-09-13;"Trenčiansky kraj";12;0;0;0;NA;299128;12;2020-09-13;717
2020-09-12;"Trenčiansky kraj";2;0;0;0;NA;299128;2;2020-09-12;705
2020-09-11;"Trenčiansky kraj";27;0;0;0;NA;299128;27;2020-09-11;703
2020-09-10;"Trenčiansky kraj";15;0;0;0;NA;299128;15;2020-09-10;676
2020-09-09;"Trenčiansky kraj";11;0;0;0;NA;299128;11;2020-09-09;661
2020-09-08;"Trenčiansky kraj";12;0;0;0;NA;299128;12;2020-09-08;650
2020-09-07;"Trenčiansky kraj";6;0;0;0;NA;299128;6;2020-09-07;638
2020-09-06;"Trenčiansky kraj";1;0;0;0;NA;299128;1;2020-09-06;632
2020-09-05;"Trenčiansky kraj";3;0;0;0;NA;299128;3;2020-09-05;631
2020-09-04;"Trenčiansky kraj";9;0;0;0;NA;299128;9;2020-09-04;628
2020-09-03;"Trenčiansky kraj";10;0;0;0;NA;299128;10;2020-09-03;619
2020-09-02;"Trenčiansky kraj";5;0;0;0;NA;299128;5;2020-09-02;609
2020-09-01;"Trenčiansky kraj";1;0;0;0;NA;299128;1;2020-09-01;604
2020-08-31;"Trenčiansky kraj";12;0;0;0;NA;299128;12;2020-08-31;603
2020-08-30;"Trenčiansky kraj";0;0;0;0;NA;299128;0;2020-08-30;591
2020-08-29;"Trenčiansky kraj";1;0;0;0;NA;299128;1;2020-08-29;591
2020-08-28;"Trenčiansky kraj";12;0;0;0;NA;299128;12;2020-08-28;590
2020-08-27;"Trenčiansky kraj";10;0;0;0;NA;299128;10;2020-08-27;578
2020-08-26;"Trenčiansky kraj";15;0;0;0;NA;299128;15;2020-08-26;568
2020-08-25;"Trenčiansky kraj";12;0;0;0;NA;299128;12;2020-08-25;553
2020-08-24;"Trenčiansky kraj";4;0;0;0;NA;299128;4;2020-08-24;541
2020-08-23;"Trenčiansky kraj";5;0;0;0;NA;299128;5;2020-08-23;537
2020-08-22;"Trenčiansky kraj";6;0;0;0;NA;299128;6;2020-08-22;532
2020-08-21;"Trenčiansky kraj";6;0;0;0;NA;299128;6;2020-08-21;526
2020-08-20;"Trenčiansky kraj";20;0;0;0;NA;299128;20;2020-08-20;520
2020-08-19;"Trenčiansky kraj";17;0;0;0;NA;299128;17;2020-08-19;500
2020-08-18;"Trenčiansky kraj";9;0;0;0;NA;299128;9;2020-08-18;483
2020-08-17;"Trenčiansky kraj";4;0;0;0;NA;299128;4;2020-08-17;474
2020-08-16;"Trenčiansky kraj";0;0;0;0;NA;299128;0;2020-08-16;470
2020-08-15;"Trenčiansky kraj";9;0;0;0;NA;299128;9;2020-08-15;470
2020-08-14;"Trenčiansky kraj";15;0;0;0;NA;299128;15;2020-08-14;461
2020-08-13;"Trenčiansky kraj";23;0;0;0;NA;299128;23;2020-08-13;446
2020-08-12;"Trenčiansky kraj";6;0;0;0;NA;299128;6;2020-08-12;423
2020-08-11;"Trenčiansky kraj";7;0;0;0;NA;299128;7;2020-08-11;417
2020-08-10;"Trenčiansky kraj";9;0;0;0;NA;299128;9;2020-08-10;410
2020-08-09;"Trenčiansky kraj";1;0;0;0;NA;299128;1;2020-08-09;401
2020-08-08;"Trenčiansky kraj";4;0;0;0;NA;299128;4;2020-08-08;400
2020-08-07;"Trenčiansky kraj";4;0;0;0;NA;299128;4;2020-08-07;396
2020-08-06;"Trenčiansky kraj";13;0;0;0;NA;299128;13;2020-08-06;392
2020-08-05;"Trenčiansky kraj";39;0;0;0;NA;299128;39;2020-08-05;379
2020-08-04;"Trenčiansky kraj";9;0;0;0;NA;299128;9;2020-08-04;340
2020-08-03;"Trenčiansky kraj";0;0;0;0;NA;299128;0;2020-08-03;331
2020-08-02;"Trenčiansky kraj";2;0;0;0;NA;299128;2;2020-08-02;331
2020-08-01;"Trenčiansky kraj";6;0;0;0;NA;299128;6;2020-08-01;329
2020-07-31;"Trenčiansky kraj";16;0;0;0;NA;299128;16;2020-07-31;323
2020-07-30;"Trenčiansky kraj";4;0;0;0;NA;299128;4;2020-07-30;307
2020-07-29;"Trenčiansky kraj";5;0;0;0;NA;299128;5;2020-07-29;303
2020-07-28;"Trenčiansky kraj";11;0;0;0;NA;299128;11;2020-07-28;298
2020-07-27;"Trenčiansky kraj";4;0;0;0;NA;299128;4;2020-07-27;287
2020-07-26;"Trenčiansky kraj";1;0;0;0;NA;299128;1;2020-07-26;283
2020-07-25;"Trenčiansky kraj";7;0;0;0;NA;299128;7;2020-07-25;282
2020-07-24;"Trenčiansky kraj";5;0;0;0;NA;299128;5;2020-07-24;275
2020-07-23;"Trenčiansky kraj";10;0;0;0;NA;299128;10;2020-07-23;270
2020-07-22;"Trenčiansky kraj";11;0;0;0;NA;299128;11;2020-07-22;260
2020-07-21;"Trenčiansky kraj";6;0;0;0;NA;299128;6;2020-07-21;249
2020-07-20;"Trenčiansky kraj";13;0;0;0;NA;299128;13;2020-07-20;243
2020-07-19;"Trenčiansky kraj";0;0;0;0;NA;299128;0;2020-07-19;230
2020-07-18;"Trenčiansky kraj";0;0;0;0;NA;299128;0;2020-07-18;230
2020-07-17;"Trenčiansky kraj";1;0;0;0;NA;299128;1;2020-07-17;230
2020-07-16;"Trenčiansky kraj";0;0;0;0;NA;299128;0;2020-07-16;229
2020-07-15;"Trenčiansky kraj";2;0;0;0;NA;299128;2;2020-07-15;229
2020-07-14;"Trenčiansky kraj";8;0;0;0;NA;299128;8;2020-07-14;227
2020-07-13;"Trenčiansky kraj";1;0;0;0;NA;299128;1;2020-07-13;219
2020-07-12;"Trenčiansky kraj";0;0;0;0;NA;299128;0;2020-07-12;218
2020-07-11;"Trenčiansky kraj";0;0;0;0;NA;299128;0;2020-07-11;218
2020-07-10;"Trenčiansky kraj";3;0;0;0;NA;299128;3;2020-07-10;218
2020-07-09;"Trenčiansky kraj";2;0;0;0;NA;299128;2;2020-07-09;215
2020-07-08;"Trenčiansky kraj";1;0;0;0;NA;299128;1;2020-07-08;213
2020-07-07;"Trenčiansky kraj";9;0;0;0;NA;299128;9;2020-07-07;212
2020-07-06;"Trenčiansky kraj";1;0;0;0;NA;299128;1;2020-07-06;203
2020-07-05;"Trenčiansky kraj";1;0;0;0;NA;299128;1;2020-07-05;202
2020-07-04;"Trenčiansky kraj";0;0;0;0;NA;299128;0;2020-07-04;201
2020-07-03;"Trenčiansky kraj";2;0;0;0;NA;299128;2;2020-07-03;201
2020-07-02;"Trenčiansky kraj";10;0;0;0;NA;299128;10;2020-07-02;199
2020-07-01;"Trenčiansky kraj";1;0;0;0;NA;299128;1;2020-07-01;189
2020-06-30;"Trenčiansky kraj";6;0;0;0;NA;299128;6;2020-06-30;188
2020-06-29;"Trenčiansky kraj";1;0;0;0;NA;299128;1;2020-06-29;182
2020-06-28;"Trenčiansky kraj";0;0;0;0;NA;299128;0;2020-06-28;181
2020-06-27;"Trenčiansky kraj";0;0;0;0;NA;299128;0;2020-06-27;181
2020-06-26;"Trenčiansky kraj";0;0;0;0;NA;299128;0;2020-06-26;181
2020-06-25;"Trenčiansky kraj";2;0;0;0;NA;299128;2;2020-06-25;181
2020-06-24;"Trenčiansky kraj";1;0;0;0;NA;299128;1;2020-06-24;179
2020-06-23;"Trenčiansky kraj";0;0;0;0;NA;299128;0;2020-06-23;178
2020-06-22;"Trenčiansky kraj";0;0;0;0;NA;299128;0;2020-06-22;178
2020-06-21;"Trenčiansky kraj";0;0;0;0;NA;299128;0;2020-06-21;178
2020-06-20;"Trenčiansky kraj";0;0;0;0;NA;299128;0;2020-06-20;178
2020-06-19;"Trenčiansky kraj";0;0;0;0;NA;299128;0;2020-06-19;178
2020-06-18;"Trenčiansky kraj";0;0;0;0;NA;299128;0;2020-06-18;178
2020-06-17;"Trenčiansky kraj";0;0;0;0;NA;299128;0;2020-06-17;178
2020-06-16;"Trenčiansky kraj";0;0;0;0;NA;299128;0;2020-06-16;178
2020-06-14;"Trenčiansky kraj";0;0;0;0;NA;299128;0;2020-06-14;178
2020-06-13;"Trenčiansky kraj";0;0;0;0;NA;299128;0;2020-06-13;178
2020-06-12;"Trenčiansky kraj";0;0;0;0;NA;299128;0;2020-06-12;178
2020-06-11;"Trenčiansky kraj";0;0;0;0;NA;299128;0;2020-06-11;178
2020-06-10;"Trenčiansky kraj";1;0;0;0;NA;299128;1;2020-06-10;178
2020-06-09;"Trenčiansky kraj";0;0;0;0;NA;299128;0;2020-06-09;177
2020-06-08;"Trenčiansky kraj";0;0;0;0;NA;299128;0;2020-06-08;177
2020-06-07;"Trenčiansky kraj";0;0;0;0;NA;299128;0;2020-06-07;177
2020-06-05;"Trenčiansky kraj";0;0;0;0;NA;299128;0;2020-06-05;177
2020-06-03;"Trenčiansky kraj";0;0;0;0;NA;299128;0;2020-06-03;177
2020-06-02;"Trenčiansky kraj";0;0;0;0;NA;299128;0;2020-06-02;177
2020-05-31;"Trenčiansky kraj";0;0;0;0;NA;299128;0;2020-05-31;177
2020-05-29;"Trenčiansky kraj";0;0;0;0;NA;299128;0;2020-05-29;177
2020-05-27;"Trenčiansky kraj";2;0;0;0;NA;299128;2;2020-05-27;177
2020-05-26;"Trenčiansky kraj";0;0;0;0;NA;299128;0;2020-05-26;175
2020-05-25;"Trenčiansky kraj";0;0;0;0;NA;299128;0;2020-05-25;175
2020-05-24;"Trenčiansky kraj";0;0;0;0;NA;299128;0;2020-05-24;175
2020-05-23;"Trenčiansky kraj";0;0;0;0;NA;299128;0;2020-05-23;175
2020-05-22;"Trenčiansky kraj";0;0;0;0;NA;299128;0;2020-05-22;175
2020-05-21;"Trenčiansky kraj";0;0;0;0;NA;299128;0;2020-05-21;175
2020-05-20;"Trenčiansky kraj";0;0;0;0;NA;299128;0;2020-05-20;175
2020-05-19;"Trenčiansky kraj";0;0;0;0;NA;299128;0;2020-05-19;175
2020-05-17;"Trenčiansky kraj";0;0;0;0;NA;299128;0;2020-05-17;175
2020-05-16;"Trenčiansky kraj";0;0;0;0;NA;299128;0;2020-05-16;175
2020-05-15;"Trenčiansky kraj";1;0;0;0;NA;299128;1;2020-05-15;175
2020-05-14;"Trenčiansky kraj";2;0;0;0;NA;299128;2;2020-05-14;174
2020-05-13;"Trenčiansky kraj";1;0;0;0;NA;299128;1;2020-05-13;172
2020-05-12;"Trenčiansky kraj";1;0;0;0;NA;299128;1;2020-05-12;171
2020-05-11;"Trenčiansky kraj";3;0;0;0;NA;299128;3;2020-05-11;170
2020-05-09;"Trenčiansky kraj";2;0;0;0;NA;299128;2;2020-05-09;167
2020-05-07;"Trenčiansky kraj";6;0;0;0;NA;299128;6;2020-05-07;165
2020-05-06;"Trenčiansky kraj";0;0;0;0;NA;299128;0;2020-05-06;159
2020-05-05;"Trenčiansky kraj";2;0;0;0;NA;299128;2;2020-05-05;159
2020-05-04;"Trenčiansky kraj";0;0;0;0;NA;299128;0;2020-05-04;157
2020-05-03;"Trenčiansky kraj";0;0;0;0;NA;299128;0;2020-05-03;157
2020-05-02;"Trenčiansky kraj";0;0;0;0;NA;299128;0;2020-05-02;157
2020-05-01;"Trenčiansky kraj";0;0;0;0;NA;299128;0;2020-05-01;157
2020-04-30;"Trenčiansky kraj";0;0;0;0;NA;299128;0;2020-04-30;157
2020-04-29;"Trenčiansky kraj";2;0;0;0;NA;299128;2;2020-04-29;157
2020-04-28;"Trenčiansky kraj";1;0;0;0;NA;299128;1;2020-04-28;155
2020-04-27;"Trenčiansky kraj";0;0;0;0;NA;299128;0;2020-04-27;154
2020-04-26;"Trenčiansky kraj";1;0;0;0;NA;299128;1;2020-04-26;154
2020-04-25;"Trenčiansky kraj";0;0;0;0;NA;299128;0;2020-04-25;153
2020-04-24;"Trenčiansky kraj";0;0;0;0;NA;299128;0;2020-04-24;153
2020-04-23;"Trenčiansky kraj";11;0;0;0;NA;299128;11;2020-04-23;153
2020-04-22;"Trenčiansky kraj";1;0;0;0;NA;299128;1;2020-04-22;142
2020-04-21;"Trenčiansky kraj";11;0;0;0;NA;299128;11;2020-04-21;141
2020-04-20;"Trenčiansky kraj";15;0;0;0;NA;299128;15;2020-04-20;130
2020-04-19;"Trenčiansky kraj";2;0;0;0;NA;299128;2;2020-04-19;115
2020-04-18;"Trenčiansky kraj";3;0;0;0;NA;299128;3;2020-04-18;113
2020-04-17;"Trenčiansky kraj";4;0;0;0;NA;299128;4;2020-04-17;110
2020-04-16;"Trenčiansky kraj";10;0;0;0;NA;299128;10;2020-04-16;106
2020-04-15;"Trenčiansky kraj";4;0;0;0;NA;299128;4;2020-04-15;96
2020-04-14;"Trenčiansky kraj";0;0;0;0;NA;299128;0;2020-04-14;92
2020-04-13;"Trenčiansky kraj";1;0;0;0;NA;299128;1;2020-04-13;92
2020-04-12;"Trenčiansky kraj";2;0;0;0;NA;299128;2;2020-04-12;91
2020-04-11;"Trenčiansky kraj";3;0;0;0;NA;299128;3;2020-04-11;89
2020-04-10;"Trenčiansky kraj";0;0;0;0;NA;299128;0;2020-04-10;86
2020-04-09;"Trenčiansky kraj";0;0;0;0;NA;299128;0;2020-04-09;86
2020-04-08;"Trenčiansky kraj";2;0;0;0;NA;299128;2;2020-04-08;86
2020-04-07;"Trenčiansky kraj";18;0;0;0;NA;299128;18;2020-04-07;84
2020-04-06;"Trenčiansky kraj";0;0;0;0;NA;299128;0;2020-04-06;66
2020-04-05;"Trenčiansky kraj";3;0;0;0;NA;299128;3;2020-04-05;66
2020-04-04;"Trenčiansky kraj";5;0;0;0;NA;299128;5;2020-04-04;63
2020-04-03;"Trenčiansky kraj";4;0;0;0;NA;299128;4;2020-04-03;58
2020-04-02;"Trenčiansky kraj";1;0;0;0;NA;299128;1;2020-04-02;54
2020-04-01;"Trenčiansky kraj";3;0;0;0;NA;299128;3;2020-04-01;53
2020-03-31;"Trenčiansky kraj";1;0;0;0;NA;299128;1;2020-03-31;50
2020-03-30;"Trenčiansky kraj";3;0;0;0;NA;299128;3;2020-03-30;49
2020-03-29;"Trenčiansky kraj";6;0;0;0;NA;299128;6;2020-03-29;46
2020-03-28;"Trenčiansky kraj";9;0;0;0;NA;299128;9;2020-03-28;40
2020-03-27;"Trenčiansky kraj";2;0;0;0;NA;299128;2;2020-03-27;31
2020-03-26;"Trenčiansky kraj";6;0;0;0;NA;299128;6;2020-03-26;29
2020-03-25;"Trenčiansky kraj";3;0;0;0;NA;299128;3;2020-03-25;23
2020-03-24;"Trenčiansky kraj";1;0;0;0;NA;299128;1;2020-03-24;20
2020-03-23;"Trenčiansky kraj";0;0;0;0;NA;299128;0;2020-03-23;19
2020-03-22;"Trenčiansky kraj";0;0;0;0;NA;299128;0;2020-03-22;19
2020-03-21;"Trenčiansky kraj";2;0;0;0;NA;299128;2;2020-03-21;19
2020-03-20;"Trenčiansky kraj";2;0;0;0;NA;299128;2;2020-03-20;17
2020-03-19;"Trenčiansky kraj";8;0;0;0;NA;299128;8;2020-03-19;15
2020-03-18;"Trenčiansky kraj";0;0;0;0;NA;299128;0;2020-03-18;7
2020-03-17;"Trenčiansky kraj";0;0;0;0;NA;299128;0;2020-03-17;7
2020-03-16;"Trenčiansky kraj";1;0;0;0;NA;299128;1;2020-03-16;7
2020-03-15;"Trenčiansky kraj";5;0;0;0;NA;299128;5;2020-03-15;6
2020-03-14;"Trenčiansky kraj";0;0;0;0;NA;299128;0;2020-03-14;1
2020-03-13;"Trenčiansky kraj";0;0;0;0;NA;299128;0;2020-03-13;1
2020-03-12;"Trenčiansky kraj";1;0;0;0;NA;299128;1;2020-03-12;1
2020-03-11;"Trenčiansky kraj";0;0;0;0;NA;299128;0;2020-03-11;0
2020-03-09;"Trenčiansky kraj";0;0;0;0;NA;299128;0;2020-03-09;0
2020-03-08;"Trenčiansky kraj";0;0;0;0;NA;299128;0;2020-03-08;0
2020-03-07;"Trenčiansky kraj";0;0;0;0;NA;299128;0;2020-03-07;0
2020-03-06;"Trenčiansky kraj";0;0;0;0;NA;299128;0;2020-03-06;0
2022-04-25;"Trnavský kraj";154;0;0;0;202189;271360;154;2022-04-25;271360
2022-04-24;"Trnavský kraj";41;20;3;23;NA;271360;44;2022-04-24;271206
2022-04-23;"Trnavský kraj";130;110;8;118;NA;271360;138;2022-04-23;271162
2022-04-22;"Trnavský kraj";157;410;24;434;NA;271360;181;2022-04-22;271024
2022-04-21;"Trnavský kraj";238;506;16;522;NA;271360;254;2022-04-21;270843
2022-04-20;"Trnavský kraj";164;332;22;354;NA;271360;186;2022-04-20;270589
2022-04-19;"Trnavský kraj";223;483;30;513;NA;271360;253;2022-04-19;270403
2022-04-18;"Trnavský kraj";66;63;9;72;NA;271360;75;2022-04-18;270150
2022-04-17;"Trnavský kraj";116;65;4;69;NA;271360;120;2022-04-17;270075
2022-04-16;"Trnavský kraj";99;103;9;112;NA;271360;108;2022-04-16;269955
2022-04-15;"Trnavský kraj";193;113;2;115;NA;271360;195;2022-04-15;269847
2022-04-14;"Trnavský kraj";237;596;42;638;NA;271360;279;2022-04-14;269652
2022-04-13;"Trnavský kraj";298;385;26;411;NA;271360;324;2022-04-13;269373
2022-04-12;"Trnavský kraj";358;492;39;531;NA;271360;397;2022-04-12;269049
2022-04-11;"Trnavský kraj";265;601;37;638;NA;271360;302;2022-04-11;268652
2022-04-10;"Trnavský kraj";124;128;19;147;NA;271360;143;2022-04-10;268350
2022-04-09;"Trnavský kraj";324;66;5;71;NA;271360;329;2022-04-09;268207
2022-04-08;"Trnavský kraj";380;388;43;431;NA;271360;423;2022-04-08;267878
2022-04-07;"Trnavský kraj";405;363;33;396;NA;271360;438;2022-04-07;267455
2022-04-06;"Trnavský kraj";485;380;35;415;NA;271360;520;2022-04-06;267017
2022-04-05;"Trnavský kraj";549;401;49;450;NA;271360;598;2022-04-05;266497
2022-04-04;"Trnavský kraj";621;707;90;797;NA;271360;711;2022-04-04;265899
2022-04-03;"Trnavský kraj";35;126;22;148;NA;271360;57;2022-04-03;265188
2022-04-02;"Trnavský kraj";478;113;14;127;NA;271360;492;2022-04-02;265131
2022-04-01;"Trnavský kraj";630;643;65;708;NA;271360;695;2022-04-01;264639
2022-03-31;"Trnavský kraj";709;483;69;552;NA;271360;778;2022-03-31;263944
2022-03-30;"Trnavský kraj";885;483;74;557;NA;271360;959;2022-03-30;263166
2022-03-29;"Trnavský kraj";845;667;75;742;NA;271360;920;2022-03-29;262207
2022-03-28;"Trnavský kraj";623;795;117;912;NA;271360;740;2022-03-28;261287
2022-03-27;"Trnavský kraj";340;185;39;224;NA;271360;379;2022-03-27;260547
2022-03-26;"Trnavský kraj";762;214;36;250;NA;271360;798;2022-03-26;260168
2022-03-25;"Trnavský kraj";859;664;69;733;NA;271360;928;2022-03-25;259370
2022-03-24;"Trnavský kraj";920;638;73;711;NA;271360;993;2022-03-24;258442
2022-03-23;"Trnavský kraj";1112;794;96;890;NA;271360;1208;2022-03-23;257449
2022-03-22;"Trnavský kraj";1096;767;70;837;NA;271360;1166;2022-03-22;256241
2022-03-21;"Trnavský kraj";1096;1025;113;1138;NA;271360;1209;2022-03-21;255075
2022-03-20;"Trnavský kraj";229;262;46;308;NA;271360;275;2022-03-20;253866
2022-03-19;"Trnavský kraj";1000;237;57;294;NA;271360;1057;2022-03-19;253591
2022-03-18;"Trnavský kraj";1038;897;107;1004;NA;271360;1145;2022-03-18;252534
2022-03-17;"Trnavský kraj";1148;721;93;814;NA;271360;1241;2022-03-17;251389
2022-03-16;"Trnavský kraj";1344;602;87;689;NA;271360;1431;2022-03-16;250148
2022-03-15;"Trnavský kraj";1179;1037;122;1159;NA;271360;1301;2022-03-15;248717
2022-03-14;"Trnavský kraj";890;1545;177;1722;NA;271360;1067;2022-03-14;247416
2022-03-13;"Trnavský kraj";290;422;57;479;NA;271360;347;2022-03-13;246349
2022-03-12;"Trnavský kraj";958;589;113;702;NA;271360;1071;2022-03-12;246002
2022-03-11;"Trnavský kraj";961;1038;126;1164;NA;271360;1087;2022-03-11;244931
2022-03-10;"Trnavský kraj";1049;1247;150;1397;NA;271360;1199;2022-03-10;243844
2022-03-09;"Trnavský kraj";1271;1159;161;1320;NA;271360;1432;2022-03-09;242645
2022-03-08;"Trnavský kraj";1393;1361;179;1540;NA;271360;1572;2022-03-08;241213
2022-03-07;"Trnavský kraj";1005;2051;263;2314;NA;271360;1268;2022-03-07;239641
2022-03-06;"Trnavský kraj";395;565;118;683;NA;271360;513;2022-03-06;238373
2022-03-05;"Trnavský kraj";806;475;90;565;NA;271360;896;2022-03-05;237860
2022-03-04;"Trnavský kraj";1028;1053;126;1179;NA;271360;1154;2022-03-04;236964
2022-03-03;"Trnavský kraj";1513;1135;168;1303;NA;271360;1681;2022-03-03;235810
2022-03-02;"Trnavský kraj";1330;1513;194;1707;NA;271360;1524;2022-03-02;234129
2022-03-01;"Trnavský kraj";1527;1351;201;1552;NA;271360;1728;2022-03-01;232605
2022-02-28;"Trnavský kraj";1318;2105;264;2369;NA;271360;1582;2022-02-28;230877
2022-02-27;"Trnavský kraj";386;640;106;746;NA;271360;492;2022-02-27;229295
2022-02-26;"Trnavský kraj";1268;526;112;638;NA;271360;1380;2022-02-26;228803
2022-02-25;"Trnavský kraj";1439;1491;211;1702;NA;271360;1650;2022-02-25;227423
2022-02-24;"Trnavský kraj";1397;1421;183;1604;NA;271360;1580;2022-02-24;225773
2022-02-23;"Trnavský kraj";2032;1668;240;1908;NA;271360;2272;2022-02-23;224193
2022-02-22;"Trnavský kraj";2171;1891;271;2162;NA;271360;2442;2022-02-22;221921
2022-02-21;"Trnavský kraj";1983;2849;438;3287;NA;271360;2421;2022-02-21;219479
2022-02-20;"Trnavský kraj";888;830;187;1017;NA;271360;1075;2022-02-20;217058
2022-02-19;"Trnavský kraj";1838;712;149;861;NA;271360;1987;2022-02-19;215983
2022-02-18;"Trnavský kraj";2132;1733;269;2002;NA;271360;2401;2022-02-18;213996
2022-02-17;"Trnavský kraj";1987;1764;269;2033;NA;271360;2256;2022-02-17;211595
2022-02-16;"Trnavský kraj";2047;1809;317;2126;NA;271360;2364;2022-02-16;209339
2022-02-15;"Trnavský kraj";2228;2412;400;2812;NA;271360;2628;2022-02-15;206975
2022-02-14;"Trnavský kraj";2216;3425;492;3917;NA;271360;2708;2022-02-14;204347
2022-02-13;"Trnavský kraj";805;1129;247;1376;NA;271360;1052;2022-02-13;201639
2022-02-12;"Trnavský kraj";2081;966;175;1141;NA;271360;2256;2022-02-12;200587
2022-02-11;"Trnavský kraj";1665;2158;266;2424;NA;271360;1931;2022-02-11;198331
2022-02-10;"Trnavský kraj";2491;1942;256;2198;NA;271360;2747;2022-02-10;196400
2022-02-09;"Trnavský kraj";2205;2474;365;2839;NA;271360;2570;2022-02-09;193653
2022-02-08;"Trnavský kraj";1758;2352;353;2705;NA;271360;2111;2022-02-08;191083
2022-02-07;"Trnavský kraj";2581;3356;459;3815;NA;271360;3040;2022-02-07;188972
2022-02-06;"Trnavský kraj";1194;1309;276;1585;NA;271360;1470;2022-02-06;185932
2022-02-05;"Trnavský kraj";2165;1102;187;1289;NA;271360;2352;2022-02-05;184462
2022-02-04;"Trnavský kraj";2191;2179;253;2432;NA;271360;2444;2022-02-04;182110
2022-02-03;"Trnavský kraj";2124;3295;347;3642;NA;271360;2471;2022-02-03;179666
2022-02-02;"Trnavský kraj";1812;2684;281;2965;NA;271360;2093;2022-02-02;177195
2022-02-01;"Trnavský kraj";2344;2656;318;2974;NA;271360;2662;2022-02-01;175102
2022-01-31;"Trnavský kraj";1931;5001;489;5490;NA;271360;2420;2022-01-31;172440
2022-01-30;"Trnavský kraj";709;1672;176;1848;NA;271360;885;2022-01-30;170020
2022-01-29;"Trnavský kraj";2136;1174;159;1333;NA;271360;2295;2022-01-29;169135
2022-01-28;"Trnavský kraj";1734;2340;216;2556;NA;271360;1950;2022-01-28;166840
2022-01-27;"Trnavský kraj";1989;2333;246;2579;NA;271360;2235;2022-01-27;164890
2022-01-26;"Trnavský kraj";1906;2730;217;2947;NA;271360;2123;2022-01-26;162655
2022-01-25;"Trnavský kraj";1631;2422;195;2617;NA;271360;1826;2022-01-25;160532
2022-01-24;"Trnavský kraj";999;4194;236;4430;NA;271360;1235;2022-01-24;158706
2022-01-23;"Trnavský kraj";299;1897;105;2002;NA;271360;404;2022-01-23;157471
2022-01-22;"Trnavský kraj";1169;1197;81;1278;NA;271360;1250;2022-01-22;157067
2022-01-21;"Trnavský kraj";830;2134;104;2238;NA;271360;934;2022-01-21;155817
2022-01-20;"Trnavský kraj";917;2511;100;2611;NA;271360;1017;2022-01-20;154883
2022-01-19;"Trnavský kraj";832;2122;84;2206;NA;271360;916;2022-01-19;153866
2022-01-18;"Trnavský kraj";704;2051;74;2125;NA;271360;778;2022-01-18;152950
2022-01-17;"Trnavský kraj";366;3885;87;3972;NA;271360;453;2022-01-17;152172
2022-01-16;"Trnavský kraj";84;1696;44;1740;NA;271360;128;2022-01-16;151719
2022-01-15;"Trnavský kraj";421;1015;33;1048;NA;271360;454;2022-01-15;151591
2022-01-14;"Trnavský kraj";349;2040;50;2090;NA;271360;399;2022-01-14;151137
2022-01-13;"Trnavský kraj";234;2057;52;2109;NA;271360;286;2022-01-13;150738
2022-01-12;"Trnavský kraj";400;1927;35;1962;NA;271360;435;2022-01-12;150452
2022-01-11;"Trnavský kraj";384;2261;33;2294;NA;271360;417;2022-01-11;150017
2022-01-10;"Trnavský kraj";258;4357;71;4428;NA;271360;329;2022-01-10;149600
2022-01-09;"Trnavský kraj";35;1921;22;1943;NA;271360;57;2022-01-09;149271
2022-01-08;"Trnavský kraj";364;1005;29;1034;NA;271360;393;2022-01-08;149214
2022-01-07;"Trnavský kraj";332;1984;47;2031;NA;271360;379;2022-01-07;148821
2022-01-06;"Trnavský kraj";234;830;20;850;NA;271360;254;2022-01-06;148442
2022-01-05;"Trnavský kraj";416;1925;37;1962;NA;271360;453;2022-01-05;148188
2022-01-04;"Trnavský kraj";538;2337;37;2374;NA;271360;575;2022-01-04;147735
2022-01-03;"Trnavský kraj";441;3897;65;3962;NA;271360;506;2022-01-03;147160
2022-01-02;"Trnavský kraj";79;1561;21;1582;NA;271360;100;2022-01-02;146654
2022-01-01;"Trnavský kraj";4;190;7;197;NA;271360;11;2022-01-01;146554
2021-12-31;"Trnavský kraj";485;1246;60;1306;NA;271360;545;2021-12-31;146543
2021-12-30;"Trnavský kraj";401;1927;58;1985;NA;271360;459;2021-12-30;145998
2021-12-29;"Trnavský kraj";401;1756;70;1826;NA;271360;471;2021-12-29;145539
2021-12-28;"Trnavský kraj";633;1742;73;1815;NA;271360;706;2021-12-28;145068
2021-12-27;"Trnavský kraj";463;2814;134;2948;NA;271360;597;2021-12-27;144362
2021-12-26;"Trnavský kraj";253;1019;30;1049;NA;271360;283;2021-12-26;143765
2021-12-25;"Trnavský kraj";104;341;41;382;NA;271360;145;2021-12-25;143482
2021-12-24;"Trnavský kraj";216;369;27;396;NA;271360;243;2021-12-24;143337
2021-12-23;"Trnavský kraj";570;1825;102;1927;NA;271360;672;2021-12-23;143094
2021-12-22;"Trnavský kraj";545;1732;81;1813;NA;271360;626;2021-12-22;142422
2021-12-21;"Trnavský kraj";699;2577;89;2666;NA;271360;788;2021-12-21;141796
2021-12-20;"Trnavský kraj";438;3941;103;4044;NA;271360;541;2021-12-20;141008
2021-12-19;"Trnavský kraj";155;1762;63;1825;NA;271360;218;2021-12-19;140467
2021-12-18;"Trnavský kraj";627;1302;77;1379;NA;271360;704;2021-12-18;140249
2021-12-17;"Trnavský kraj";576;2276;109;2385;NA;271360;685;2021-12-17;139545
2021-12-16;"Trnavský kraj";653;2530;123;2653;NA;271360;776;2021-12-16;138860
2021-12-15;"Trnavský kraj";746;2198;120;2318;NA;271360;866;2021-12-15;138084
2021-12-14;"Trnavský kraj";976;2718;134;2852;NA;271360;1110;2021-12-14;137218
2021-12-13;"Trnavský kraj";521;4857;175;5032;NA;271360;696;2021-12-13;136108
2021-12-12;"Trnavský kraj";337;2117;87;2204;NA;271360;424;2021-12-12;135412
2021-12-11;"Trnavský kraj";720;1324;83;1407;NA;271360;803;2021-12-11;134988
2021-12-10;"Trnavský kraj";702;2909;136;3045;NA;271360;838;2021-12-10;134185
2021-12-09;"Trnavský kraj";926;2313;96;2409;NA;271360;1022;2021-12-09;133347
2021-12-08;"Trnavský kraj";1233;2547;137;2684;NA;271360;1370;2021-12-08;132325
2021-12-07;"Trnavský kraj";1159;3637;174;3811;NA;271360;1333;2021-12-07;130955
2021-12-06;"Trnavský kraj";911;3649;208;3857;NA;271360;1119;2021-12-06;129622
2021-12-05;"Trnavský kraj";269;2303;106;2409;NA;271360;375;2021-12-05;128503
2021-12-04;"Trnavský kraj";1225;1623;115;1738;NA;271360;1340;2021-12-04;128128
2021-12-03;"Trnavský kraj";1246;2998;201;3199;NA;271360;1447;2021-12-03;126788
2021-12-02;"Trnavský kraj";1809;2379;188;2567;NA;271360;1997;2021-12-02;125341
2021-12-01;"Trnavský kraj";738;3011;179;3190;NA;271360;917;2021-12-01;123344
2021-11-30;"Trnavský kraj";1166;4217;202;4419;NA;271360;1368;2021-11-30;122427
2021-11-29;"Trnavský kraj";814;5360;299;5659;NA;271360;1113;2021-11-29;121059
2021-11-28;"Trnavský kraj";482;3087;146;3233;NA;271360;628;2021-11-28;119946
2021-11-27;"Trnavský kraj";1186;2240;206;2446;NA;271360;1392;2021-11-27;119318
2021-11-26;"Trnavský kraj";880;2895;202;3097;NA;271360;1082;2021-11-26;117926
2021-11-25;"Trnavský kraj";1002;2680;158;2838;NA;271360;1160;2021-11-25;116844
2021-11-24;"Trnavský kraj";1060;3442;250;3692;NA;271360;1310;2021-11-24;115684
2021-11-23;"Trnavský kraj";1078;3714;273;3987;NA;271360;1351;2021-11-23;114374
2021-11-22;"Trnavský kraj";696;4028;295;4323;NA;271360;991;2021-11-22;113023
2021-11-21;"Trnavský kraj";298;2270;212;2482;NA;271360;510;2021-11-21;112032
2021-11-20;"Trnavský kraj";826;1529;196;1725;NA;271360;1022;2021-11-20;111522
2021-11-19;"Trnavský kraj";901;3369;315;3684;NA;271360;1216;2021-11-19;110500
2021-11-18;"Trnavský kraj";796;2872;240;3112;NA;271360;1036;2021-11-18;109284
2021-11-17;"Trnavský kraj";769;1201;139;1340;NA;271360;908;2021-11-17;108248
2021-11-16;"Trnavský kraj";591;2755;206;2961;NA;271360;797;2021-11-16;107340
2021-11-15;"Trnavský kraj";606;3350;239;3589;NA;271360;845;2021-11-15;106543
2021-11-14;"Trnavský kraj";236;1579;141;1720;NA;271360;377;2021-11-14;105698
2021-11-13;"Trnavský kraj";815;1314;132;1446;NA;271360;947;2021-11-13;105321
2021-11-12;"Trnavský kraj";563;2585;157;2742;NA;271360;720;2021-11-12;104374
2021-11-11;"Trnavský kraj";512;2426;161;2587;NA;271360;673;2021-11-11;103654
2021-11-10;"Trnavský kraj";590;2315;173;2488;NA;271360;763;2021-11-10;102981
2021-11-09;"Trnavský kraj";585;2538;187;2725;NA;271360;772;2021-11-09;102218
2021-11-08;"Trnavský kraj";357;2715;163;2878;NA;271360;520;2021-11-08;101446
2021-11-07;"Trnavský kraj";162;1349;111;1460;NA;271360;273;2021-11-07;100926
2021-11-06;"Trnavský kraj";391;1287;82;1369;NA;271360;473;2021-11-06;100653
2021-11-05;"Trnavský kraj";447;2202;102;2304;NA;271360;549;2021-11-05;100180
2021-11-04;"Trnavský kraj";432;2289;112;2401;NA;271360;544;2021-11-04;99631
2021-11-03;"Trnavský kraj";420;2091;97;2188;NA;271360;517;2021-11-03;99087
2021-11-02;"Trnavský kraj";365;2777;124;2901;NA;271360;489;2021-11-02;98570
2021-11-01;"Trnavský kraj";220;583;27;610;NA;271360;247;2021-11-01;98081
2021-10-31;"Trnavský kraj";61;887;62;949;NA;271360;123;2021-10-31;97834
2021-10-30;"Trnavský kraj";251;1099;50;1149;NA;271360;301;2021-10-30;97711
2021-10-29;"Trnavský kraj";312;2123;53;2176;NA;271360;365;2021-10-29;97410
2021-10-28;"Trnavský kraj";339;2034;65;2099;NA;271360;404;2021-10-28;97045
2021-10-27;"Trnavský kraj";232;1884;58;1942;NA;271360;290;2021-10-27;96641
2021-10-26;"Trnavský kraj";366;1964;54;2018;NA;271360;420;2021-10-26;96351
2021-10-25;"Trnavský kraj";142;2786;72;2858;NA;271360;214;2021-10-25;95931
2021-10-24;"Trnavský kraj";11;990;30;1020;NA;271360;41;2021-10-24;95717
2021-10-23;"Trnavský kraj";228;1126;27;1153;NA;271360;255;2021-10-23;95676
2021-10-22;"Trnavský kraj";204;2269;51;2320;NA;271360;255;2021-10-22;95421
2021-10-21;"Trnavský kraj";188;1671;46;1717;NA;271360;234;2021-10-21;95166
2021-10-20;"Trnavský kraj";212;1634;47;1681;NA;271360;259;2021-10-20;94932
2021-10-19;"Trnavský kraj";240;1848;30;1878;NA;271360;270;2021-10-19;94673
2021-10-18;"Trnavský kraj";95;2316;72;2388;NA;271360;167;2021-10-18;94403
2021-10-17;"Trnavský kraj";5;1218;17;1235;NA;271360;22;2021-10-17;94236
2021-10-16;"Trnavský kraj";129;1233;17;1250;NA;271360;146;2021-10-16;94214
2021-10-15;"Trnavský kraj";122;2121;24;2145;NA;271360;146;2021-10-15;94068
2021-10-14;"Trnavský kraj";131;1663;24;1687;NA;271360;155;2021-10-14;93922
2021-10-13;"Trnavský kraj";128;2072;23;2095;NA;271360;151;2021-10-13;93767
2021-10-12;"Trnavský kraj";189;2788;38;2826;NA;271360;227;2021-10-12;93616
2021-10-11;"Trnavský kraj";115;2621;35;2656;NA;271360;150;2021-10-11;93389
2021-10-10;"Trnavský kraj";2;993;15;1008;NA;271360;17;2021-10-10;93239
2021-10-09;"Trnavský kraj";151;1099;10;1109;NA;271360;161;2021-10-09;93222
2021-10-08;"Trnavský kraj";106;2326;34;2360;NA;271360;140;2021-10-08;93061
2021-10-07;"Trnavský kraj";151;1744;25;1769;NA;271360;176;2021-10-07;92921
2021-10-06;"Trnavský kraj";122;1929;27;1956;NA;271360;149;2021-10-06;92745
2021-10-05;"Trnavský kraj";220;3726;34;3760;NA;271360;254;2021-10-05;92596
2021-10-04;"Trnavský kraj";54;1963;47;2010;NA;271360;101;2021-10-04;92342
2021-10-03;"Trnavský kraj";1;1106;17;1123;NA;271360;18;2021-10-03;92241
2021-10-02;"Trnavský kraj";52;1055;12;1067;NA;271360;64;2021-10-02;92223
2021-10-01;"Trnavský kraj";113;2243;17;2260;NA;271360;130;2021-10-01;92159
2021-09-30;"Trnavský kraj";109;1872;18;1890;NA;271360;127;2021-09-30;92029
2021-09-29;"Trnavský kraj";83;1331;11;1342;NA;271360;94;2021-09-29;91902
2021-09-28;"Trnavský kraj";135;1934;31;1965;NA;271360;166;2021-09-28;91808
2021-09-27;"Trnavský kraj";80;2084;25;2109;NA;271360;105;2021-09-27;91642
2021-09-26;"Trnavský kraj";2;1048;12;1060;NA;271360;14;2021-09-26;91537
2021-09-25;"Trnavský kraj";61;1105;9;1114;NA;271360;70;2021-09-25;91523
2021-09-24;"Trnavský kraj";41;2229;15;2244;NA;271360;56;2021-09-24;91453
2021-09-23;"Trnavský kraj";89;1691;16;1707;NA;271360;105;2021-09-23;91397
2021-09-22;"Trnavský kraj";119;1706;28;1734;NA;271360;147;2021-09-22;91292
2021-09-21;"Trnavský kraj";108;1505;17;1522;NA;271360;125;2021-09-21;91145
2021-09-20;"Trnavský kraj";50;1652;20;1672;NA;271360;70;2021-09-20;91020
2021-09-19;"Trnavský kraj";2;924;8;932;NA;271360;10;2021-09-19;90950
2021-09-18;"Trnavský kraj";100;982;6;988;NA;271360;106;2021-09-18;90940
2021-09-17;"Trnavský kraj";77;1709;20;1729;NA;271360;97;2021-09-17;90834
2021-09-16;"Trnavský kraj";105;1279;32;1311;NA;271360;137;2021-09-16;90737
2021-09-15;"Trnavský kraj";59;841;5;846;NA;271360;64;2021-09-15;90600
2021-09-14;"Trnavský kraj";38;1583;12;1595;NA;271360;50;2021-09-14;90536
2021-09-13;"Trnavský kraj";56;1410;16;1426;NA;271360;72;2021-09-13;90486
2021-09-12;"Trnavský kraj";0;653;1;654;NA;271360;1;2021-09-12;90414
2021-09-11;"Trnavský kraj";37;971;10;981;NA;271360;47;2021-09-11;90413
2021-09-10;"Trnavský kraj";43;1441;9;1450;NA;271360;52;2021-09-10;90366
2021-09-09;"Trnavský kraj";42;954;13;967;NA;271360;55;2021-09-09;90314
2021-09-08;"Trnavský kraj";65;802;15;817;NA;271360;80;2021-09-08;90259
2021-09-07;"Trnavský kraj";29;844;5;849;NA;271360;34;2021-09-07;90179
2021-09-06;"Trnavský kraj";18;1234;14;1248;NA;271360;32;2021-09-06;90145
2021-09-05;"Trnavský kraj";2;580;4;584;NA;271360;6;2021-09-05;90113
2021-09-04;"Trnavský kraj";17;868;6;874;NA;271360;23;2021-09-04;90107
2021-09-03;"Trnavský kraj";14;1060;5;1065;NA;271360;19;2021-09-03;90084
2021-09-02;"Trnavský kraj";30;830;10;840;NA;271360;40;2021-09-02;90065
2021-09-01;"Trnavský kraj";6;409;4;413;NA;271360;10;2021-09-01;90025
2021-08-31;"Trnavský kraj";13;884;3;887;NA;271360;16;2021-08-31;90015
2021-08-30;"Trnavský kraj";7;904;1;905;NA;271360;8;2021-08-30;89999
2021-08-29;"Trnavský kraj";8;427;1;428;NA;271360;9;2021-08-29;89991
2021-08-28;"Trnavský kraj";17;694;2;696;NA;271360;19;2021-08-28;89982
2021-08-27;"Trnavský kraj";1;1186;4;1190;NA;271360;5;2021-08-27;89963
2021-08-26;"Trnavský kraj";8;713;3;716;NA;271360;11;2021-08-26;89958
2021-08-25;"Trnavský kraj";11;683;6;689;NA;271360;17;2021-08-25;89947
2021-08-24;"Trnavský kraj";7;801;1;802;NA;271360;8;2021-08-24;89930
2021-08-23;"Trnavský kraj";4;844;1;845;NA;271360;5;2021-08-23;89922
2021-08-22;"Trnavský kraj";0;474;0;474;NA;271360;0;2021-08-22;89917
2021-08-21;"Trnavský kraj";8;703;0;703;NA;271360;8;2021-08-21;89917
2021-08-20;"Trnavský kraj";4;1095;4;1099;NA;271360;8;2021-08-20;89909
2021-08-19;"Trnavský kraj";10;881;3;884;NA;271360;13;2021-08-19;89901
2021-08-18;"Trnavský kraj";6;789;2;791;NA;271360;8;2021-08-18;89888
2021-08-17;"Trnavský kraj";7;524;4;528;NA;271360;11;2021-08-17;89880
2021-08-16;"Trnavský kraj";9;966;3;969;NA;271360;12;2021-08-16;89869
2021-08-15;"Trnavský kraj";0;556;1;557;NA;271360;1;2021-08-15;89857
2021-08-14;"Trnavský kraj";10;801;3;804;NA;271360;13;2021-08-14;89856
2021-08-13;"Trnavský kraj";5;1077;6;1083;NA;271360;11;2021-08-13;89843
2021-08-12;"Trnavský kraj";3;666;3;669;NA;271360;6;2021-08-12;89832
2021-08-11;"Trnavský kraj";7;576;2;578;NA;271360;9;2021-08-11;89826
2021-08-10;"Trnavský kraj";3;757;3;760;NA;271360;6;2021-08-10;89817
2021-08-09;"Trnavský kraj";12;808;0;808;NA;271360;12;2021-08-09;89811
2021-08-08;"Trnavský kraj";1;545;0;545;NA;271360;1;2021-08-08;89799
2021-08-07;"Trnavský kraj";9;724;0;724;NA;271360;9;2021-08-07;89798
2021-08-06;"Trnavský kraj";3;988;0;988;NA;271360;3;2021-08-06;89789
2021-08-05;"Trnavský kraj";2;662;1;663;NA;271360;3;2021-08-05;89786
2021-08-04;"Trnavský kraj";1;891;1;892;NA;271360;2;2021-08-04;89783
2021-08-03;"Trnavský kraj";13;645;0;645;NA;271360;13;2021-08-03;89781
2021-08-02;"Trnavský kraj";2;725;1;726;NA;271360;3;2021-08-02;89768
2021-08-01;"Trnavský kraj";0;565;2;567;NA;271360;2;2021-08-01;89765
2021-07-31;"Trnavský kraj";3;886;0;886;NA;271360;3;2021-07-31;89763
2021-07-30;"Trnavský kraj";3;1084;3;1087;NA;271360;6;2021-07-30;89760
2021-07-29;"Trnavský kraj";1;775;0;775;NA;271360;1;2021-07-29;89754
2021-07-28;"Trnavský kraj";5;794;1;795;NA;271360;6;2021-07-28;89753
2021-07-27;"Trnavský kraj";7;623;2;625;NA;271360;9;2021-07-27;89747
2021-07-26;"Trnavský kraj";2;857;2;859;NA;271360;4;2021-07-26;89738
2021-07-25;"Trnavský kraj";0;707;0;707;NA;271360;0;2021-07-25;89734
2021-07-24;"Trnavský kraj";4;828;2;830;NA;271360;6;2021-07-24;89734
2021-07-23;"Trnavský kraj";3;1057;0;1057;NA;271360;3;2021-07-23;89728
2021-07-22;"Trnavský kraj";0;671;2;673;NA;271360;2;2021-07-22;89725
2021-07-21;"Trnavský kraj";2;660;2;662;NA;271360;4;2021-07-21;89723
2021-07-20;"Trnavský kraj";2;593;0;593;NA;271360;2;2021-07-20;89719
2021-07-19;"Trnavský kraj";9;886;0;886;NA;271360;9;2021-07-19;89717
2021-07-18;"Trnavský kraj";0;600;2;602;NA;271360;2;2021-07-18;89708
2021-07-17;"Trnavský kraj";8;796;0;796;NA;271360;8;2021-07-17;89706
2021-07-16;"Trnavský kraj";11;963;0;963;NA;271360;11;2021-07-16;89698
2021-07-15;"Trnavský kraj";4;832;1;833;NA;271360;5;2021-07-15;89687
2021-07-14;"Trnavský kraj";1;699;1;700;NA;271360;2;2021-07-14;89682
2021-07-13;"Trnavský kraj";1;693;1;694;NA;271360;2;2021-07-13;89680
2021-07-12;"Trnavský kraj";4;959;0;959;NA;271360;4;2021-07-12;89678
2021-07-11;"Trnavský kraj";0;692;0;692;NA;271360;0;2021-07-11;89674
2021-07-10;"Trnavský kraj";1;803;0;803;NA;271360;1;2021-07-10;89674
2021-07-09;"Trnavský kraj";3;1262;3;1265;NA;271360;6;2021-07-09;89673
2021-07-08;"Trnavský kraj";4;755;0;755;NA;271360;4;2021-07-08;89667
2021-07-07;"Trnavský kraj";9;924;2;926;NA;271360;11;2021-07-07;89663
2021-07-06;"Trnavský kraj";2;1401;1;1402;NA;271360;3;2021-07-06;89652
2021-07-05;"Trnavský kraj";1;503;2;505;NA;271360;3;2021-07-05;89649
2021-07-04;"Trnavský kraj";0;1129;3;1132;NA;271360;3;2021-07-04;89646
2021-07-03;"Trnavský kraj";4;815;0;815;NA;271360;4;2021-07-03;89643
2021-07-02;"Trnavský kraj";2;1137;2;1139;NA;271360;4;2021-07-02;89639
2021-07-01;"Trnavský kraj";4;487;0;487;NA;271360;4;2021-07-01;89635
2021-06-30;"Trnavský kraj";0;5135;1;5136;NA;271360;1;2021-06-30;89631
2021-06-29;"Trnavský kraj";4;2563;1;2564;NA;271360;5;2021-06-29;89630
2021-06-28;"Trnavský kraj";2;2600;1;2601;NA;271360;3;2021-06-28;89625
2021-06-27;"Trnavský kraj";0;3213;0;3213;NA;271360;0;2021-06-27;89622
2021-06-26;"Trnavský kraj";3;3871;1;3872;NA;271360;4;2021-06-26;89622
2021-06-25;"Trnavský kraj";2;4374;3;4377;NA;271360;5;2021-06-25;89618
2021-06-24;"Trnavský kraj";4;2520;3;2523;NA;271360;7;2021-06-24;89613
2021-06-23;"Trnavský kraj";4;2842;2;2844;NA;271360;6;2021-06-23;89606
2021-06-22;"Trnavský kraj";2;2996;1;2997;NA;271360;3;2021-06-22;89600
2021-06-21;"Trnavský kraj";6;3114;5;3119;NA;271360;11;2021-06-21;89597
2021-06-20;"Trnavský kraj";0;3952;1;3953;NA;271360;1;2021-06-20;89586
2021-06-19;"Trnavský kraj";3;4735;2;4737;NA;271360;5;2021-06-19;89585
2021-06-18;"Trnavský kraj";5;6125;4;6129;NA;271360;9;2021-06-18;89580
2021-06-17;"Trnavský kraj";3;3340;0;3340;NA;271360;3;2021-06-17;89571
2021-06-16;"Trnavský kraj";6;2926;3;2929;NA;271360;9;2021-06-16;89568
2021-06-15;"Trnavský kraj";8;3234;3;3237;NA;271360;11;2021-06-15;89559
2021-06-14;"Trnavský kraj";2;3829;1;3830;NA;271360;3;2021-06-14;89548
2021-06-13;"Trnavský kraj";0;5001;8;5009;NA;271360;8;2021-06-13;89545
2021-06-12;"Trnavský kraj";11;5807;2;5809;NA;271360;13;2021-06-12;89537
2021-06-11;"Trnavský kraj";17;5850;4;5854;NA;271360;21;2021-06-11;89524
2021-06-10;"Trnavský kraj";14;3476;1;3477;NA;271360;15;2021-06-10;89503
2021-06-09;"Trnavský kraj";10;3685;1;3686;NA;271360;11;2021-06-09;89488
2021-06-08;"Trnavský kraj";8;3344;4;3348;NA;271360;12;2021-06-08;89477
2021-06-07;"Trnavský kraj";12;4498;8;4506;NA;271360;20;2021-06-07;89465
2021-06-06;"Trnavský kraj";0;5517;2;5519;NA;271360;2;2021-06-06;89445
2021-06-05;"Trnavský kraj";20;6905;8;6913;NA;271360;28;2021-06-05;89443
2021-06-04;"Trnavský kraj";9;6735;10;6745;NA;271360;19;2021-06-04;89415
2021-06-03;"Trnavský kraj";14;4361;11;4372;NA;271360;25;2021-06-03;89396
2021-06-02;"Trnavský kraj";4;4148;11;4159;NA;271360;15;2021-06-02;89371
2021-06-01;"Trnavský kraj";18;3662;5;3667;NA;271360;23;2021-06-01;89356
2021-05-31;"Trnavský kraj";14;5515;16;5531;NA;271360;30;2021-05-31;89333
2021-05-30;"Trnavský kraj";0;6473;7;6480;NA;271360;7;2021-05-30;89303
2021-05-29;"Trnavský kraj";11;8964;4;8968;NA;271360;15;2021-05-29;89296
2021-05-28;"Trnavský kraj";14;7160;11;7171;NA;271360;25;2021-05-28;89281
2021-05-27;"Trnavský kraj";22;4753;8;4761;NA;271360;30;2021-05-27;89256
2021-05-26;"Trnavský kraj";6;4870;8;4878;NA;271360;14;2021-05-26;89226
2021-05-25;"Trnavský kraj";19;5026;27;5053;NA;271360;46;2021-05-25;89212
2021-05-24;"Trnavský kraj";15;6520;22;6542;NA;271360;37;2021-05-24;89166
2021-05-23;"Trnavský kraj";0;7920;8;7928;NA;271360;8;2021-05-23;89129
2021-05-22;"Trnavský kraj";13;13381;21;13402;NA;271360;34;2021-05-22;89121
2021-05-21;"Trnavský kraj";16;8525;19;8544;NA;271360;35;2021-05-21;89087
2021-05-20;"Trnavský kraj";15;5511;11;5522;NA;271360;26;2021-05-20;89052
2021-05-19;"Trnavský kraj";18;5431;13;5444;NA;271360;31;2021-05-19;89026
2021-05-18;"Trnavský kraj";26;5768;15;5783;NA;271360;41;2021-05-18;88995
2021-05-17;"Trnavský kraj";17;6262;24;6286;NA;271360;41;2021-05-17;88954
2021-05-16;"Trnavský kraj";10;9984;8;9992;NA;271360;18;2021-05-16;88913
2021-05-15;"Trnavský kraj";11;18525;14;18539;NA;271360;25;2021-05-15;88895
2021-05-14;"Trnavský kraj";34;10279;21;10300;NA;271360;55;2021-05-14;88870
2021-05-13;"Trnavský kraj";26;6913;12;6925;NA;271360;38;2021-05-13;88815
2021-05-12;"Trnavský kraj";34;6621;26;6647;NA;271360;60;2021-05-12;88777
2021-05-11;"Trnavský kraj";32;6393;13;6406;NA;271360;45;2021-05-11;88717
2021-05-10;"Trnavský kraj";58;9139;24;9163;NA;271360;82;2021-05-10;88672
2021-05-09;"Trnavský kraj";21;12570;12;12582;NA;271360;33;2021-05-09;88590
2021-05-08;"Trnavský kraj";4;23028;22;23050;NA;271360;26;2021-05-08;88557
2021-05-07;"Trnavský kraj";26;15465;30;15495;NA;271360;56;2021-05-07;88531
2021-05-06;"Trnavský kraj";22;8407;22;8429;NA;271360;44;2021-05-06;88475
2021-05-05;"Trnavský kraj";34;6273;22;6295;NA;271360;56;2021-05-05;88431
2021-05-04;"Trnavský kraj";51;8538;17;8555;NA;271360;68;2021-05-04;88375
2021-05-03;"Trnavský kraj";20;8957;22;8979;NA;271360;42;2021-05-03;88307
2021-05-02;"Trnavský kraj";0;25657;29;25686;NA;271360;29;2021-05-02;88265
2021-05-01;"Trnavský kraj";30;81353;64;81417;NA;271360;94;2021-05-01;88236
2021-04-30;"Trnavský kraj";45;26846;35;26881;NA;271360;80;2021-04-30;88142
2021-04-29;"Trnavský kraj";25;20323;28;20351;NA;271360;53;2021-04-29;88062
2021-04-28;"Trnavský kraj";46;8896;28;8924;NA;271360;74;2021-04-28;88009
2021-04-27;"Trnavský kraj";54;8756;37;8793;NA;271360;91;2021-04-27;87935
2021-04-26;"Trnavský kraj";53;16116;42;16158;NA;271360;95;2021-04-26;87844
2021-04-25;"Trnavský kraj";0;30183;24;30207;NA;271360;24;2021-04-25;87749
2021-04-24;"Trnavský kraj";46;126077;84;126161;NA;271360;130;2021-04-24;87725
2021-04-23;"Trnavský kraj";71;25741;53;25794;NA;271360;124;2021-04-23;87595
2021-04-22;"Trnavský kraj";40;10904;25;10929;NA;271360;65;2021-04-22;87471
2021-04-21;"Trnavský kraj";60;10748;45;10793;NA;271360;105;2021-04-21;87406
2021-04-20;"Trnavský kraj";57;13504;28;13532;NA;271360;85;2021-04-20;87301
2021-04-19;"Trnavský kraj";46;14603;18;14621;NA;271360;64;2021-04-19;87216
2021-04-18;"Trnavský kraj";7;40843;43;40886;NA;271360;50;2021-04-18;87152
2021-04-17;"Trnavský kraj";58;118102;89;118191;NA;271360;147;2021-04-17;87102
2021-04-16;"Trnavský kraj";67;25962;48;26010;NA;271360;115;2021-04-16;86955
2021-04-15;"Trnavský kraj";65;11373;36;11409;NA;271360;101;2021-04-15;86840
2021-04-14;"Trnavský kraj";78;18442;53;18495;NA;271360;131;2021-04-14;86739
2021-04-13;"Trnavský kraj";126;9871;44;9915;NA;271360;170;2021-04-13;86608
2021-04-12;"Trnavský kraj";40;15577;40;15617;NA;271360;80;2021-04-12;86438
2021-04-11;"Trnavský kraj";3;44420;44;44464;NA;271360;47;2021-04-11;86358
2021-04-10;"Trnavský kraj";60;123822;107;123929;NA;271360;167;2021-04-10;86311
2021-04-09;"Trnavský kraj";95;26191;34;26225;NA;271360;129;2021-04-09;86144
2021-04-08;"Trnavský kraj";85;10913;54;10967;NA;271360;139;2021-04-08;86015
2021-04-07;"Trnavský kraj";131;15979;81;16060;NA;271360;212;2021-04-07;85876
2021-04-06;"Trnavský kraj";92;20586;90;20676;NA;271360;182;2021-04-06;85664
2021-04-05;"Trnavský kraj";91;7542;17;7559;NA;271360;108;2021-04-05;85482
2021-04-04;"Trnavský kraj";9;28831;49;28880;NA;271360;58;2021-04-04;85374
2021-04-03;"Trnavský kraj";29;144452;186;144638;NA;271360;215;2021-04-03;85316
2021-04-02;"Trnavský kraj";91;17538;33;17571;NA;271360;124;2021-04-02;85101
2021-04-01;"Trnavský kraj";118;22279;71;22350;NA;271360;189;2021-04-01;84977
2021-03-31;"Trnavský kraj";140;15828;82;15910;NA;271360;222;2021-03-31;84788
2021-03-30;"Trnavský kraj";182;10482;79;10561;NA;271360;261;2021-03-30;84566
2021-03-29;"Trnavský kraj";126;19255;122;19377;NA;271360;248;2021-03-29;84305
2021-03-28;"Trnavský kraj";26;50664;134;50798;NA;271360;160;2021-03-28;84057
2021-03-27;"Trnavský kraj";64;130217;246;130463;NA;271360;310;2021-03-27;83897
2021-03-26;"Trnavský kraj";139;30217;130;30347;NA;271360;269;2021-03-26;83587
2021-03-25;"Trnavský kraj";135;14212;80;14292;NA;271360;215;2021-03-25;83318
2021-03-24;"Trnavský kraj";159;10521;89;10610;NA;271360;248;2021-03-24;83103
2021-03-23;"Trnavský kraj";221;12735;104;12839;NA;271360;325;2021-03-23;82855
2021-03-22;"Trnavský kraj";103;17118;110;17228;NA;271360;213;2021-03-22;82530
2021-03-21;"Trnavský kraj";31;49119;150;49269;NA;271360;181;2021-03-21;82317
2021-03-20;"Trnavský kraj";112;136963;317;137280;NA;271360;429;2021-03-20;82136
2021-03-19;"Trnavský kraj";174;29071;137;29208;NA;271360;311;2021-03-19;81707
2021-03-18;"Trnavský kraj";158;12217;136;12353;NA;271360;294;2021-03-18;81396
2021-03-17;"Trnavský kraj";245;10434;103;10537;NA;271360;348;2021-03-17;81102
2021-03-16;"Trnavský kraj";311;12811;135;12946;NA;271360;446;2021-03-16;80754
2021-03-15;"Trnavský kraj";127;18271;146;18417;NA;271360;273;2021-03-15;80308
2021-03-14;"Trnavský kraj";14;47608;164;47772;NA;271360;178;2021-03-14;80035
2021-03-13;"Trnavský kraj";155;139224;409;139633;NA;271360;564;2021-03-13;79857
2021-03-12;"Trnavský kraj";201;28566;181;28747;NA;271360;382;2021-03-12;79293
2021-03-11;"Trnavský kraj";204;13301;140;13441;NA;271360;344;2021-03-11;78911
2021-03-10;"Trnavský kraj";242;10583;135;10718;NA;271360;377;2021-03-10;78567
2021-03-09;"Trnavský kraj";442;12824;155;12979;NA;271360;597;2021-03-09;78190
2021-03-08;"Trnavský kraj";182;21812;166;21978;NA;271360;348;2021-03-08;77593
2021-03-07;"Trnavský kraj";30;45463;227;45690;NA;271360;257;2021-03-07;77245
2021-03-06;"Trnavský kraj";154;135784;531;136315;NA;271360;685;2021-03-06;76988
2021-03-05;"Trnavský kraj";299;27959;239;28198;NA;271360;538;2021-03-05;76303
2021-03-04;"Trnavský kraj";238;14505;176;14681;NA;271360;414;2021-03-04;75765
2021-03-03;"Trnavský kraj";413;11583;246;11829;NA;271360;659;2021-03-03;75351
2021-03-02;"Trnavský kraj";477;12367;191;12558;NA;271360;668;2021-03-02;74692
2021-03-01;"Trnavský kraj";189;18586;234;18820;NA;271360;423;2021-03-01;74024
2021-02-28;"Trnavský kraj";87;47709;321;48030;NA;271360;408;2021-02-28;73601
2021-02-27;"Trnavský kraj";264;140224;800;141024;NA;271360;1064;2021-02-27;73193
2021-02-26;"Trnavský kraj";362;26637;284;26921;NA;271360;646;2021-02-26;72129
2021-02-25;"Trnavský kraj";433;10490;227;10717;NA;271360;660;2021-02-25;71483
2021-02-24;"Trnavský kraj";407;9113;290;9403;NA;271360;697;2021-02-24;70823
2021-02-23;"Trnavský kraj";469;11322;284;11606;NA;271360;753;2021-02-23;70126
2021-02-22;"Trnavský kraj";206;19901;330;20231;NA;271360;536;2021-02-22;69373
2021-02-21;"Trnavský kraj";38;48221;329;48550;NA;271360;367;2021-02-21;68837
2021-02-20;"Trnavský kraj";273;135835;859;136694;NA;271360;1132;2021-02-20;68470
2021-02-19;"Trnavský kraj";335;26382;366;26748;NA;271360;701;2021-02-19;67338
2021-02-18;"Trnavský kraj";344;11264;348;11612;NA;271360;692;2021-02-18;66637
2021-02-17;"Trnavský kraj";431;8783;416;9199;NA;271360;847;2021-02-17;65945
2021-02-16;"Trnavský kraj";426;11236;294;11530;NA;271360;720;2021-02-16;65098
2021-02-15;"Trnavský kraj";146;18276;326;18602;NA;271360;472;2021-02-15;64378
2021-02-14;"Trnavský kraj";51;57642;495;58137;NA;271360;546;2021-02-14;63906
2021-02-13;"Trnavský kraj";218;137051;994;138045;NA;271360;1212;2021-02-13;63360
2021-02-12;"Trnavský kraj";300;24090;352;24442;NA;271360;652;2021-02-12;62148
2021-02-11;"Trnavský kraj";422;9831;349;10180;NA;271360;771;2021-02-11;61496
2021-02-10;"Trnavský kraj";511;9194;342;9536;NA;271360;853;2021-02-10;60725
2021-02-09;"Trnavský kraj";544;12755;369;13124;NA;271360;913;2021-02-09;59872
2021-02-08;"Trnavský kraj";220;33414;497;33911;NA;271360;717;2021-02-08;58959
2021-02-07;"Trnavský kraj";140;69694;628;70322;NA;271360;768;2021-02-07;58242
2021-02-06;"Trnavský kraj";348;112687;1482;114169;NA;271360;1830;2021-02-06;57474
2021-02-05;"Trnavský kraj";377;16063;373;16436;NA;271360;750;2021-02-05;55644
2021-02-04;"Trnavský kraj";456;7317;456;7773;NA;271360;912;2021-02-04;54894
2021-02-03;"Trnavský kraj";472;6583;434;7017;NA;271360;906;2021-02-03;53982
2021-02-02;"Trnavský kraj";446;14243;424;14667;NA;271360;870;2021-02-02;53076
2021-02-01;"Trnavský kraj";198;38882;679;39561;NA;271360;877;2021-02-01;52206
2021-01-31;"Trnavský kraj";19;64707;822;65529;NA;271360;841;2021-01-31;51329
2021-01-30;"Trnavský kraj";323;111483;1288;112771;NA;271360;1611;2021-01-30;50488
2021-01-29;"Trnavský kraj";421;9689;290;9979;NA;271360;711;2021-01-29;48877
2021-01-28;"Trnavský kraj";389;5817;289;6106;NA;271360;678;2021-01-28;48166
2021-01-27;"Trnavský kraj";433;5554;225;5779;NA;271360;658;2021-01-27;47488
2021-01-26;"Trnavský kraj";565;25411;636;26047;NA;271360;1201;2021-01-26;46830
2021-01-25;"Trnavský kraj";210;41805;620;42425;NA;271360;830;2021-01-25;45629
2021-01-24;"Trnavský kraj";91;66399;779;67178;NA;271360;870;2021-01-24;44799
2021-01-23;"Trnavský kraj";372;113375;1319;114694;NA;271360;1691;2021-01-23;43929
2021-01-22;"Trnavský kraj";217;32755;505;33260;NA;271360;722;2021-01-22;42238
2021-01-21;"Trnavský kraj";311;13913;377;14290;NA;271360;688;2021-01-21;41516
2021-01-20;"Trnavský kraj";503;8685;283;8968;NA;271360;786;2021-01-20;40828
2021-01-19;"Trnavský kraj";415;7013;347;7360;NA;271360;762;2021-01-19;40042
2021-01-18;"Trnavský kraj";247;6690;513;7203;NA;271360;760;2021-01-18;39280
2021-01-17;"Trnavský kraj";128;854;215;1069;NA;271360;343;2021-01-17;38520
2021-01-16;"Trnavský kraj";103;898;24;922;NA;271360;127;2021-01-16;38177
2021-01-15;"Trnavský kraj";278;5467;336;5803;NA;271360;614;2021-01-15;38050
2021-01-14;"Trnavský kraj";452;4001;338;4339;NA;271360;790;2021-01-14;37436
2021-01-13;"Trnavský kraj";457;4751;378;5129;NA;271360;835;2021-01-13;36646
2021-01-12;"Trnavský kraj";469;6860;470;7330;NA;271360;939;2021-01-12;35811
2021-01-11;"Trnavský kraj";370;4587;360;4947;NA;271360;730;2021-01-11;34872
2021-01-10;"Trnavský kraj";71;13;0;13;NA;271360;71;2021-01-10;34142
2021-01-09;"Trnavský kraj";417;1775;100;1875;NA;271360;517;2021-01-09;34071
2021-01-08;"Trnavský kraj";381;6016;506;6522;NA;271360;887;2021-01-08;33554
2021-01-07;"Trnavský kraj";501;3545;329;3874;NA;271360;830;2021-01-07;32667
2021-01-06;"Trnavský kraj";179;758;132;890;NA;271360;311;2021-01-06;31837
2021-01-05;"Trnavský kraj";611;5165;561;5726;NA;271360;1172;2021-01-05;31526
2021-01-04;"Trnavský kraj";302;5556;709;6265;NA;271360;1011;2021-01-04;30354
2021-01-03;"Trnavský kraj";60;53;7;60;NA;271360;67;2021-01-03;29343
2021-01-02;"Trnavský kraj";282;417;32;449;NA;271360;314;2021-01-02;29276
2021-01-01;"Trnavský kraj";143;455;76;531;NA;271360;219;2021-01-01;28962
2020-12-31;"Trnavský kraj";498;8325;820;9145;NA;271360;1318;2020-12-31;28743
2020-12-30;"Trnavský kraj";785;5318;612;5930;NA;271360;1397;2020-12-30;27425
2020-12-29;"Trnavský kraj";322;4913;565;5478;NA;271360;887;2020-12-29;26028
2020-12-28;"Trnavský kraj";213;4900;552;5452;NA;271360;765;2020-12-28;25141
2020-12-27;"Trnavský kraj";27;20;4;24;NA;271360;31;2020-12-27;24376
2020-12-26;"Trnavský kraj";148;44;1;45;NA;271360;149;2020-12-26;24345
2020-12-25;"Trnavský kraj";65;49;5;54;NA;271360;70;2020-12-25;24196
2020-12-24;"Trnavský kraj";333;1359;117;1476;NA;271360;450;2020-12-24;24126
2020-12-23;"Trnavský kraj";210;6672;414;7086;NA;271360;624;2020-12-23;23676
2020-12-22;"Trnavský kraj";311;5427;455;5882;NA;271360;766;2020-12-22;23052
2020-12-21;"Trnavský kraj";328;4092;350;4442;NA;271360;678;2020-12-21;22286
2020-12-20;"Trnavský kraj";134;133;12;145;NA;271360;146;2020-12-20;21608
2020-12-19;"Trnavský kraj";201;1407;103;1510;NA;271360;304;2020-12-19;21462
2020-12-18;"Trnavský kraj";341;4432;334;4766;NA;271360;675;2020-12-18;21158
2020-12-17;"Trnavský kraj";375;4880;414;5294;NA;271360;789;2020-12-17;20483
2020-12-16;"Trnavský kraj";312;4945;383;5328;NA;271360;695;2020-12-16;19694
2020-12-15;"Trnavský kraj";492;6240;598;6838;NA;271360;1090;2020-12-15;18999
2020-12-14;"Trnavský kraj";161;3505;292;3797;NA;271360;453;2020-12-14;17909
2020-12-13;"Trnavský kraj";7;7;0;7;NA;271360;7;2020-12-13;17456
2020-12-12;"Trnavský kraj";254;1456;114;1570;NA;271360;368;2020-12-12;17449
2020-12-11;"Trnavský kraj";384;4289;241;4530;NA;271360;625;2020-12-11;17081
2020-12-10;"Trnavský kraj";183;5197;320;5517;NA;271360;503;2020-12-10;16456
2020-12-09;"Trnavský kraj";521;4199;317;4516;NA;271360;838;2020-12-09;15953
2020-12-08;"Trnavský kraj";281;4090;304;4394;NA;271360;585;2020-12-08;15115
2020-12-07;"Trnavský kraj";178;2895;199;3094;NA;271360;377;2020-12-07;14530
2020-12-06;"Trnavský kraj";46;0;0;0;NA;271360;46;2020-12-06;14153
2020-12-05;"Trnavský kraj";129;2218;41;2259;NA;271360;170;2020-12-05;14107
2020-12-04;"Trnavský kraj";242;3948;158;4106;NA;271360;400;2020-12-04;13937
2020-12-03;"Trnavský kraj";248;2770;190;2960;NA;271360;438;2020-12-03;13537
2020-12-02;"Trnavský kraj";284;4516;176;4692;NA;271360;460;2020-12-02;13099
2020-12-01;"Trnavský kraj";253;3190;205;3395;NA;271360;458;2020-12-01;12639
2020-11-30;"Trnavský kraj";200;7360;186;7546;NA;271360;386;2020-11-30;12181
2020-11-29;"Trnavský kraj";17;738;36;774;NA;271360;53;2020-11-29;11795
2020-11-28;"Trnavský kraj";83;1453;77;1530;NA;271360;160;2020-11-28;11742
2020-11-27;"Trnavský kraj";148;1779;85;1864;NA;271360;233;2020-11-27;11582
2020-11-26;"Trnavský kraj";234;1123;68;1191;NA;271360;302;2020-11-26;11349
2020-11-25;"Trnavský kraj";232;1168;74;1242;NA;271360;306;2020-11-25;11047
2020-11-24;"Trnavský kraj";295;1909;96;2005;NA;271360;391;2020-11-24;10741
2020-11-23;"Trnavský kraj";242;7393;129;7522;NA;271360;371;2020-11-23;10350
2020-11-22;"Trnavský kraj";10;82;9;91;NA;271360;19;2020-11-22;9979
2020-11-21;"Trnavský kraj";129;1354;36;1390;NA;271360;165;2020-11-21;9960
2020-11-20;"Trnavský kraj";246;1154;64;1218;NA;271360;310;2020-11-20;9795
2020-11-19;"Trnavský kraj";157;823;64;887;NA;271360;221;2020-11-19;9485
2020-11-18;"Trnavský kraj";235;822;82;904;NA;271360;317;2020-11-18;9264
2020-11-17;"Trnavský kraj";129;705;74;779;NA;271360;203;2020-11-17;8947
2020-11-16;"Trnavský kraj";187;732;32;764;NA;271360;219;2020-11-16;8744
2020-11-15;"Trnavský kraj";23;73;4;77;NA;271360;27;2020-11-15;8525
2020-11-14;"Trnavský kraj";86;397;12;409;NA;271360;98;2020-11-14;8498
2020-11-13;"Trnavský kraj";219;1312;21;1333;NA;271360;240;2020-11-13;8400
2020-11-12;"Trnavský kraj";162;420;18;438;NA;271360;180;2020-11-12;8160
2020-11-11;"Trnavský kraj";257;392;15;407;NA;271360;272;2020-11-11;7980
2020-11-10;"Trnavský kraj";189;889;30;919;NA;271360;219;2020-11-10;7708
2020-11-09;"Trnavský kraj";196;369;23;392;NA;271360;219;2020-11-09;7489
2020-11-08;"Trnavský kraj";55;400;4;404;NA;271360;59;2020-11-08;7270
2020-11-07;"Trnavský kraj";207;6070;74;6144;NA;271360;281;2020-11-07;7211
2020-11-06;"Trnavský kraj";260;1531;19;1550;NA;271360;279;2020-11-06;6930
2020-11-05;"Trnavský kraj";150;220;27;247;NA;271360;177;2020-11-05;6651
2020-11-04;"Trnavský kraj";188;212;10;222;NA;271360;198;2020-11-04;6474
2020-11-03;"Trnavský kraj";317;127;8;135;NA;271360;325;2020-11-03;6276
2020-11-02;"Trnavský kraj";281;1728;31;1759;NA;271360;312;2020-11-02;5951
2020-11-01;"Trnavský kraj";87;494;27;521;NA;271360;114;2020-11-01;5639
2020-10-31;"Trnavský kraj";259;5024;41;5065;NA;271360;300;2020-10-31;5525
2020-10-30;"Trnavský kraj";198;3784;27;3811;NA;271360;225;2020-10-30;5225
2020-10-29;"Trnavský kraj";273;1461;16;1477;NA;271360;289;2020-10-29;5000
2020-10-28;"Trnavský kraj";319;117;16;133;NA;271360;335;2020-10-28;4711
2020-10-27;"Trnavský kraj";199;461;36;497;NA;271360;235;2020-10-27;4376
2020-10-26;"Trnavský kraj";153;29;2;31;NA;271360;155;2020-10-26;4141
2020-10-25;"Trnavský kraj";95;19;1;20;NA;271360;96;2020-10-25;3986
2020-10-24;"Trnavský kraj";158;109;2;111;NA;271360;160;2020-10-24;3890
2020-10-23;"Trnavský kraj";201;89;4;93;NA;271360;205;2020-10-23;3730
2020-10-22;"Trnavský kraj";195;55;2;57;NA;271360;197;2020-10-22;3525
2020-10-21;"Trnavský kraj";134;73;3;76;NA;271360;137;2020-10-21;3328
2020-10-20;"Trnavský kraj";202;82;3;85;NA;271360;205;2020-10-20;3191
2020-10-19;"Trnavský kraj";67;55;0;55;NA;271360;67;2020-10-19;2986
2020-10-18;"Trnavský kraj";84;0;0;0;NA;271360;84;2020-10-18;2919
2020-10-17;"Trnavský kraj";123;0;0;0;NA;271360;123;2020-10-17;2835
2020-10-16;"Trnavský kraj";86;45;2;47;NA;271360;88;2020-10-16;2712
2020-10-15;"Trnavský kraj";155;66;2;68;NA;271360;157;2020-10-15;2624
2020-10-14;"Trnavský kraj";236;468;3;471;NA;271360;239;2020-10-14;2467
2020-10-13;"Trnavský kraj";138;16;2;18;NA;271360;140;2020-10-13;2228
2020-10-12;"Trnavský kraj";33;41;1;42;NA;271360;34;2020-10-12;2088
2020-10-11;"Trnavský kraj";31;0;0;0;NA;271360;31;2020-10-11;2054
2020-10-10;"Trnavský kraj";128;0;0;0;NA;271360;128;2020-10-10;2023
2020-10-09;"Trnavský kraj";156;0;0;0;NA;271360;156;2020-10-09;1895
2020-10-08;"Trnavský kraj";153;0;0;0;NA;271360;153;2020-10-08;1739
2020-10-07;"Trnavský kraj";80;0;0;0;NA;271360;80;2020-10-07;1586
2020-10-06;"Trnavský kraj";112;0;0;0;NA;271360;112;2020-10-06;1506
2020-10-05;"Trnavský kraj";33;0;0;0;NA;271360;33;2020-10-05;1394
2020-10-04;"Trnavský kraj";44;0;0;0;NA;271360;44;2020-10-04;1361
2020-10-03;"Trnavský kraj";60;0;0;0;NA;271360;60;2020-10-03;1317
2020-10-02;"Trnavský kraj";41;0;0;0;NA;271360;41;2020-10-02;1257
2020-10-01;"Trnavský kraj";53;0;0;0;NA;271360;53;2020-10-01;1216
2020-09-30;"Trnavský kraj";91;0;0;0;NA;271360;91;2020-09-30;1163
2020-09-29;"Trnavský kraj";40;0;0;0;NA;271360;40;2020-09-29;1072
2020-09-28;"Trnavský kraj";69;0;0;0;NA;271360;69;2020-09-28;1032
2020-09-27;"Trnavský kraj";30;0;0;0;NA;271360;30;2020-09-27;963
2020-09-26;"Trnavský kraj";46;0;0;0;NA;271360;46;2020-09-26;933
2020-09-25;"Trnavský kraj";32;0;0;0;NA;271360;32;2020-09-25;887
2020-09-24;"Trnavský kraj";42;0;0;0;NA;271360;42;2020-09-24;855
2020-09-23;"Trnavský kraj";43;0;0;0;NA;271360;43;2020-09-23;813
2020-09-22;"Trnavský kraj";55;0;0;0;NA;271360;55;2020-09-22;770
2020-09-21;"Trnavský kraj";41;0;0;0;NA;271360;41;2020-09-21;715
2020-09-20;"Trnavský kraj";17;0;0;0;NA;271360;17;2020-09-20;674
2020-09-19;"Trnavský kraj";4;0;0;0;NA;271360;4;2020-09-19;657
2020-09-18;"Trnavský kraj";33;0;0;0;NA;271360;33;2020-09-18;653
2020-09-17;"Trnavský kraj";42;0;0;0;NA;271360;42;2020-09-17;620
2020-09-16;"Trnavský kraj";49;0;0;0;NA;271360;49;2020-09-16;578
2020-09-15;"Trnavský kraj";5;0;0;0;NA;271360;5;2020-09-15;529
2020-09-14;"Trnavský kraj";26;0;0;0;NA;271360;26;2020-09-14;524
2020-09-13;"Trnavský kraj";9;0;0;0;NA;271360;9;2020-09-13;498
2020-09-12;"Trnavský kraj";12;0;0;0;NA;271360;12;2020-09-12;489
2020-09-11;"Trnavský kraj";16;0;0;0;NA;271360;16;2020-09-11;477
2020-09-10;"Trnavský kraj";32;0;0;0;NA;271360;32;2020-09-10;461
2020-09-09;"Trnavský kraj";14;0;0;0;NA;271360;14;2020-09-09;429
2020-09-08;"Trnavský kraj";11;0;0;0;NA;271360;11;2020-09-08;415
2020-09-07;"Trnavský kraj";7;0;0;0;NA;271360;7;2020-09-07;404
2020-09-06;"Trnavský kraj";5;0;0;0;NA;271360;5;2020-09-06;397
2020-09-05;"Trnavský kraj";7;0;0;0;NA;271360;7;2020-09-05;392
2020-09-04;"Trnavský kraj";16;0;0;0;NA;271360;16;2020-09-04;385
2020-09-03;"Trnavský kraj";8;0;0;0;NA;271360;8;2020-09-03;369
2020-09-02;"Trnavský kraj";7;0;0;0;NA;271360;7;2020-09-02;361
2020-09-01;"Trnavský kraj";1;0;0;0;NA;271360;1;2020-09-01;354
2020-08-31;"Trnavský kraj";6;0;0;0;NA;271360;6;2020-08-31;353
2020-08-30;"Trnavský kraj";1;0;0;0;NA;271360;1;2020-08-30;347
2020-08-29;"Trnavský kraj";3;0;0;0;NA;271360;3;2020-08-29;346
2020-08-28;"Trnavský kraj";14;0;0;0;NA;271360;14;2020-08-28;343
2020-08-27;"Trnavský kraj";6;0;0;0;NA;271360;6;2020-08-27;329
2020-08-26;"Trnavský kraj";4;0;0;0;NA;271360;4;2020-08-26;323
2020-08-25;"Trnavský kraj";7;0;0;0;NA;271360;7;2020-08-25;319
2020-08-24;"Trnavský kraj";1;0;0;0;NA;271360;1;2020-08-24;312
2020-08-23;"Trnavský kraj";6;0;0;0;NA;271360;6;2020-08-23;311
2020-08-22;"Trnavský kraj";3;0;0;0;NA;271360;3;2020-08-22;305
2020-08-21;"Trnavský kraj";4;0;0;0;NA;271360;4;2020-08-21;302
2020-08-20;"Trnavský kraj";23;0;0;0;NA;271360;23;2020-08-20;298
2020-08-19;"Trnavský kraj";13;0;0;0;NA;271360;13;2020-08-19;275
2020-08-18;"Trnavský kraj";20;0;0;0;NA;271360;20;2020-08-18;262
2020-08-17;"Trnavský kraj";3;0;0;0;NA;271360;3;2020-08-17;242
2020-08-16;"Trnavský kraj";0;0;0;0;NA;271360;0;2020-08-16;239
2020-08-15;"Trnavský kraj";7;0;0;0;NA;271360;7;2020-08-15;239
2020-08-14;"Trnavský kraj";6;0;0;0;NA;271360;6;2020-08-14;232
2020-08-13;"Trnavský kraj";10;0;0;0;NA;271360;10;2020-08-13;226
2020-08-12;"Trnavský kraj";2;0;0;0;NA;271360;2;2020-08-12;216
2020-08-11;"Trnavský kraj";30;0;0;0;NA;271360;30;2020-08-11;214
2020-08-10;"Trnavský kraj";0;0;0;0;NA;271360;0;2020-08-10;184
2020-08-09;"Trnavský kraj";0;0;0;0;NA;271360;0;2020-08-09;184
2020-08-08;"Trnavský kraj";13;0;0;0;NA;271360;13;2020-08-08;184
2020-08-07;"Trnavský kraj";4;0;0;0;NA;271360;4;2020-08-07;171
2020-08-06;"Trnavský kraj";4;0;0;0;NA;271360;4;2020-08-06;167
2020-08-05;"Trnavský kraj";0;0;0;0;NA;271360;0;2020-08-05;163
2020-08-04;"Trnavský kraj";1;0;0;0;NA;271360;1;2020-08-04;163
2020-08-03;"Trnavský kraj";2;0;0;0;NA;271360;2;2020-08-03;162
2020-08-02;"Trnavský kraj";1;0;0;0;NA;271360;1;2020-08-02;160
2020-08-01;"Trnavský kraj";0;0;0;0;NA;271360;0;2020-08-01;159
2020-07-31;"Trnavský kraj";7;0;0;0;NA;271360;7;2020-07-31;159
2020-07-30;"Trnavský kraj";6;0;0;0;NA;271360;6;2020-07-30;152
2020-07-29;"Trnavský kraj";0;0;0;0;NA;271360;0;2020-07-29;146
2020-07-28;"Trnavský kraj";1;0;0;0;NA;271360;1;2020-07-28;146
2020-07-27;"Trnavský kraj";2;0;0;0;NA;271360;2;2020-07-27;145
2020-07-26;"Trnavský kraj";0;0;0;0;NA;271360;0;2020-07-26;143
2020-07-25;"Trnavský kraj";0;0;0;0;NA;271360;0;2020-07-25;143
2020-07-24;"Trnavský kraj";1;0;0;0;NA;271360;1;2020-07-24;143
2020-07-23;"Trnavský kraj";2;0;0;0;NA;271360;2;2020-07-23;142
2020-07-22;"Trnavský kraj";1;0;0;0;NA;271360;1;2020-07-22;140
2020-07-21;"Trnavský kraj";2;0;0;0;NA;271360;2;2020-07-21;139
2020-07-20;"Trnavský kraj";0;0;0;0;NA;271360;0;2020-07-20;137
2020-07-19;"Trnavský kraj";0;0;0;0;NA;271360;0;2020-07-19;137
2020-07-18;"Trnavský kraj";0;0;0;0;NA;271360;0;2020-07-18;137
2020-07-17;"Trnavský kraj";0;0;0;0;NA;271360;0;2020-07-17;137
2020-07-16;"Trnavský kraj";0;0;0;0;NA;271360;0;2020-07-16;137
2020-07-15;"Trnavský kraj";1;0;0;0;NA;271360;1;2020-07-15;137
2020-07-14;"Trnavský kraj";0;0;0;0;NA;271360;0;2020-07-14;136
2020-07-13;"Trnavský kraj";0;0;0;0;NA;271360;0;2020-07-13;136
2020-07-12;"Trnavský kraj";0;0;0;0;NA;271360;0;2020-07-12;136
2020-07-11;"Trnavský kraj";0;0;0;0;NA;271360;0;2020-07-11;136
2020-07-10;"Trnavský kraj";0;0;0;0;NA;271360;0;2020-07-10;136
2020-07-09;"Trnavský kraj";0;0;0;0;NA;271360;0;2020-07-09;136
2020-07-08;"Trnavský kraj";3;0;0;0;NA;271360;3;2020-07-08;136
2020-07-07;"Trnavský kraj";4;0;0;0;NA;271360;4;2020-07-07;133
2020-07-06;"Trnavský kraj";0;0;0;0;NA;271360;0;2020-07-06;129
2020-07-05;"Trnavský kraj";0;0;0;0;NA;271360;0;2020-07-05;129
2020-07-04;"Trnavský kraj";0;0;0;0;NA;271360;0;2020-07-04;129
2020-07-03;"Trnavský kraj";0;0;0;0;NA;271360;0;2020-07-03;129
2020-07-02;"Trnavský kraj";3;0;0;0;NA;271360;3;2020-07-02;129
2020-07-01;"Trnavský kraj";0;0;0;0;NA;271360;0;2020-07-01;126
2020-06-30;"Trnavský kraj";0;0;0;0;NA;271360;0;2020-06-30;126
2020-06-29;"Trnavský kraj";0;0;0;0;NA;271360;0;2020-06-29;126
2020-06-28;"Trnavský kraj";0;0;0;0;NA;271360;0;2020-06-28;126
2020-06-27;"Trnavský kraj";0;0;0;0;NA;271360;0;2020-06-27;126
2020-06-26;"Trnavský kraj";0;0;0;0;NA;271360;0;2020-06-26;126
2020-06-25;"Trnavský kraj";0;0;0;0;NA;271360;0;2020-06-25;126
2020-06-24;"Trnavský kraj";0;0;0;0;NA;271360;0;2020-06-24;126
2020-06-23;"Trnavský kraj";0;0;0;0;NA;271360;0;2020-06-23;126
2020-06-22;"Trnavský kraj";0;0;0;0;NA;271360;0;2020-06-22;126
2020-06-21;"Trnavský kraj";0;0;0;0;NA;271360;0;2020-06-21;126
2020-06-20;"Trnavský kraj";0;0;0;0;NA;271360;0;2020-06-20;126
2020-06-19;"Trnavský kraj";0;0;0;0;NA;271360;0;2020-06-19;126
2020-06-18;"Trnavský kraj";2;0;0;0;NA;271360;2;2020-06-18;126
2020-06-17;"Trnavský kraj";0;0;0;0;NA;271360;0;2020-06-17;124
2020-06-16;"Trnavský kraj";0;0;0;0;NA;271360;0;2020-06-16;124
2020-06-14;"Trnavský kraj";0;0;0;0;NA;271360;0;2020-06-14;124
2020-06-13;"Trnavský kraj";0;0;0;0;NA;271360;0;2020-06-13;124
2020-06-12;"Trnavský kraj";0;0;0;0;NA;271360;0;2020-06-12;124
2020-06-11;"Trnavský kraj";0;0;0;0;NA;271360;0;2020-06-11;124
2020-06-10;"Trnavský kraj";0;0;0;0;NA;271360;0;2020-06-10;124
2020-06-09;"Trnavský kraj";0;0;0;0;NA;271360;0;2020-06-09;124
2020-06-08;"Trnavský kraj";0;0;0;0;NA;271360;0;2020-06-08;124
2020-06-07;"Trnavský kraj";0;0;0;0;NA;271360;0;2020-06-07;124
2020-06-05;"Trnavský kraj";0;0;0;0;NA;271360;0;2020-06-05;124
2020-06-03;"Trnavský kraj";0;0;0;0;NA;271360;0;2020-06-03;124
2020-06-02;"Trnavský kraj";0;0;0;0;NA;271360;0;2020-06-02;124
2020-05-31;"Trnavský kraj";0;0;0;0;NA;271360;0;2020-05-31;124
2020-05-29;"Trnavský kraj";0;0;0;0;NA;271360;0;2020-05-29;124
2020-05-27;"Trnavský kraj";0;0;0;0;NA;271360;0;2020-05-27;124
2020-05-26;"Trnavský kraj";0;0;0;0;NA;271360;0;2020-05-26;124
2020-05-25;"Trnavský kraj";1;0;0;0;NA;271360;1;2020-05-25;124
2020-05-24;"Trnavský kraj";0;0;0;0;NA;271360;0;2020-05-24;123
2020-05-23;"Trnavský kraj";2;0;0;0;NA;271360;2;2020-05-23;123
2020-05-22;"Trnavský kraj";0;0;0;0;NA;271360;0;2020-05-22;121
2020-05-21;"Trnavský kraj";0;0;0;0;NA;271360;0;2020-05-21;121
2020-05-20;"Trnavský kraj";2;0;0;0;NA;271360;2;2020-05-20;121
2020-05-19;"Trnavský kraj";0;0;0;0;NA;271360;0;2020-05-19;119
2020-05-17;"Trnavský kraj";0;0;0;0;NA;271360;0;2020-05-17;119
2020-05-16;"Trnavský kraj";0;0;0;0;NA;271360;0;2020-05-16;119
2020-05-15;"Trnavský kraj";1;0;0;0;NA;271360;1;2020-05-15;119
2020-05-14;"Trnavský kraj";0;0;0;0;NA;271360;0;2020-05-14;118
2020-05-13;"Trnavský kraj";0;0;0;0;NA;271360;0;2020-05-13;118
2020-05-12;"Trnavský kraj";0;0;0;0;NA;271360;0;2020-05-12;118
2020-05-11;"Trnavský kraj";2;0;0;0;NA;271360;2;2020-05-11;118
2020-05-09;"Trnavský kraj";0;0;0;0;NA;271360;0;2020-05-09;116
2020-05-07;"Trnavský kraj";0;0;0;0;NA;271360;0;2020-05-07;116
2020-05-06;"Trnavský kraj";0;0;0;0;NA;271360;0;2020-05-06;116
2020-05-05;"Trnavský kraj";0;0;0;0;NA;271360;0;2020-05-05;116
2020-05-04;"Trnavský kraj";0;0;0;0;NA;271360;0;2020-05-04;116
2020-05-03;"Trnavský kraj";0;0;0;0;NA;271360;0;2020-05-03;116
2020-05-02;"Trnavský kraj";0;0;0;0;NA;271360;0;2020-05-02;116
2020-05-01;"Trnavský kraj";0;0;0;0;NA;271360;0;2020-05-01;116
2020-04-30;"Trnavský kraj";0;0;0;0;NA;271360;0;2020-04-30;116
2020-04-29;"Trnavský kraj";0;0;0;0;NA;271360;0;2020-04-29;116
2020-04-28;"Trnavský kraj";1;0;0;0;NA;271360;1;2020-04-28;116
2020-04-27;"Trnavský kraj";0;0;0;0;NA;271360;0;2020-04-27;115
2020-04-26;"Trnavský kraj";0;0;0;0;NA;271360;0;2020-04-26;115
2020-04-25;"Trnavský kraj";2;0;0;0;NA;271360;2;2020-04-25;115
2020-04-24;"Trnavský kraj";4;0;0;0;NA;271360;4;2020-04-24;113
2020-04-23;"Trnavský kraj";5;0;0;0;NA;271360;5;2020-04-23;109
2020-04-22;"Trnavský kraj";10;0;0;0;NA;271360;10;2020-04-22;104
2020-04-21;"Trnavský kraj";5;0;0;0;NA;271360;5;2020-04-21;94
2020-04-20;"Trnavský kraj";0;0;0;0;NA;271360;0;2020-04-20;89
2020-04-19;"Trnavský kraj";1;0;0;0;NA;271360;1;2020-04-19;89
2020-04-18;"Trnavský kraj";4;0;0;0;NA;271360;4;2020-04-18;88
2020-04-17;"Trnavský kraj";7;0;0;0;NA;271360;7;2020-04-17;84
2020-04-16;"Trnavský kraj";5;0;0;0;NA;271360;5;2020-04-16;77
2020-04-15;"Trnavský kraj";5;0;0;0;NA;271360;5;2020-04-15;72
2020-04-14;"Trnavský kraj";1;0;0;0;NA;271360;1;2020-04-14;67
2020-04-13;"Trnavský kraj";0;0;0;0;NA;271360;0;2020-04-13;66
2020-04-12;"Trnavský kraj";0;0;0;0;NA;271360;0;2020-04-12;66
2020-04-11;"Trnavský kraj";0;0;0;0;NA;271360;0;2020-04-11;66
2020-04-10;"Trnavský kraj";2;0;0;0;NA;271360;2;2020-04-10;66
2020-04-09;"Trnavský kraj";3;0;0;0;NA;271360;3;2020-04-09;64
2020-04-08;"Trnavský kraj";4;0;0;0;NA;271360;4;2020-04-08;61
2020-04-07;"Trnavský kraj";6;0;0;0;NA;271360;6;2020-04-07;57
2020-04-06;"Trnavský kraj";6;0;0;0;NA;271360;6;2020-04-06;51
2020-04-05;"Trnavský kraj";1;0;0;0;NA;271360;1;2020-04-05;45
2020-04-04;"Trnavský kraj";1;0;0;0;NA;271360;1;2020-04-04;44
2020-04-03;"Trnavský kraj";3;0;0;0;NA;271360;3;2020-04-03;43
2020-04-02;"Trnavský kraj";4;0;0;0;NA;271360;4;2020-04-02;40
2020-04-01;"Trnavský kraj";0;0;0;0;NA;271360;0;2020-04-01;36
2020-03-31;"Trnavský kraj";3;0;0;0;NA;271360;3;2020-03-31;36
2020-03-30;"Trnavský kraj";4;0;0;0;NA;271360;4;2020-03-30;33
2020-03-29;"Trnavský kraj";1;0;0;0;NA;271360;1;2020-03-29;29
2020-03-28;"Trnavský kraj";3;0;0;0;NA;271360;3;2020-03-28;28
2020-03-27;"Trnavský kraj";5;0;0;0;NA;271360;5;2020-03-27;25
2020-03-26;"Trnavský kraj";5;0;0;0;NA;271360;5;2020-03-26;20
2020-03-25;"Trnavský kraj";1;0;0;0;NA;271360;1;2020-03-25;15
2020-03-24;"Trnavský kraj";0;0;0;0;NA;271360;0;2020-03-24;14
2020-03-23;"Trnavský kraj";2;0;0;0;NA;271360;2;2020-03-23;14
2020-03-22;"Trnavský kraj";1;0;0;0;NA;271360;1;2020-03-22;12
2020-03-21;"Trnavský kraj";5;0;0;0;NA;271360;5;2020-03-21;11
2020-03-20;"Trnavský kraj";0;0;0;0;NA;271360;0;2020-03-20;6
2020-03-19;"Trnavský kraj";0;0;0;0;NA;271360;0;2020-03-19;6
2020-03-18;"Trnavský kraj";0;0;0;0;NA;271360;0;2020-03-18;6
2020-03-17;"Trnavský kraj";3;0;0;0;NA;271360;3;2020-03-17;6
2020-03-16;"Trnavský kraj";1;0;0;0;NA;271360;1;2020-03-16;3
2020-03-15;"Trnavský kraj";0;0;0;0;NA;271360;0;2020-03-15;2
2020-03-14;"Trnavský kraj";0;0;0;0;NA;271360;0;2020-03-14;2
2020-03-13;"Trnavský kraj";1;0;0;0;NA;271360;1;2020-03-13;2
2020-03-12;"Trnavský kraj";1;0;0;0;NA;271360;1;2020-03-12;1
2020-03-11;"Trnavský kraj";0;0;0;0;NA;271360;0;2020-03-11;0
2020-03-09;"Trnavský kraj";0;0;0;0;NA;271360;0;2020-03-09;0
2020-03-08;"Trnavský kraj";0;0;0;0;NA;271360;0;2020-03-08;0
2020-03-07;"Trnavský kraj";0;0;0;0;NA;271360;0;2020-03-07;0
2020-03-06;"Trnavský kraj";0;0;0;0;NA;271360;0;2020-03-06;0
2022-04-25;"Žilinský kraj";218;5;0;5;252397;347991;218;2022-04-25;347991
2022-04-24;"Žilinský kraj";8;143;14;157;NA;347991;22;2022-04-24;347773
2022-04-23;"Žilinský kraj";212;323;31;354;NA;347991;243;2022-04-23;347751
2022-04-22;"Žilinský kraj";126;540;35;575;NA;347991;161;2022-04-22;347508
2022-04-21;"Žilinský kraj";218;781;63;844;NA;347991;281;2022-04-21;347347
2022-04-20;"Žilinský kraj";366;914;52;966;NA;347991;418;2022-04-20;347066
2022-04-19;"Žilinský kraj";346;1850;79;1929;NA;347991;425;2022-04-19;346648
2022-04-18;"Žilinský kraj";84;368;27;395;NA;347991;111;2022-04-18;346223
2022-04-17;"Žilinský kraj";157;175;13;188;NA;347991;170;2022-04-17;346112
2022-04-16;"Žilinský kraj";111;282;54;336;NA;347991;165;2022-04-16;345942
2022-04-15;"Žilinský kraj";43;223;11;234;NA;347991;54;2022-04-15;345777
2022-04-14;"Žilinský kraj";315;1195;53;1248;NA;347991;368;2022-04-14;345723
2022-04-13;"Žilinský kraj";331;1101;39;1140;NA;347991;370;2022-04-13;345355
2022-04-12;"Žilinský kraj";280;1079;42;1121;NA;347991;322;2022-04-12;344985
2022-04-11;"Žilinský kraj";453;1335;87;1422;NA;347991;540;2022-04-11;344663
2022-04-10;"Žilinský kraj";20;313;26;339;NA;347991;46;2022-04-10;344123
2022-04-09;"Žilinský kraj";233;261;38;299;NA;347991;271;2022-04-09;344077
2022-04-08;"Žilinský kraj";368;762;50;812;NA;347991;418;2022-04-08;343806
2022-04-07;"Žilinský kraj";359;797;54;851;NA;347991;413;2022-04-07;343388
2022-04-06;"Žilinský kraj";541;1030;69;1099;NA;347991;610;2022-04-06;342975
2022-04-05;"Žilinský kraj";699;1038;78;1116;NA;347991;777;2022-04-05;342365
2022-04-04;"Žilinský kraj";605;1340;110;1450;NA;347991;715;2022-04-04;341588
2022-04-03;"Žilinský kraj";82;268;34;302;NA;347991;116;2022-04-03;340873
2022-04-02;"Žilinský kraj";289;224;33;257;NA;347991;322;2022-04-02;340757
2022-04-01;"Žilinský kraj";592;943;60;1003;NA;347991;652;2022-04-01;340435
2022-03-31;"Žilinský kraj";557;863;92;955;NA;347991;649;2022-03-31;339783
2022-03-30;"Žilinský kraj";688;1644;102;1746;NA;347991;790;2022-03-30;339134
2022-03-29;"Žilinský kraj";755;917;103;1020;NA;347991;858;2022-03-29;338344
2022-03-28;"Žilinský kraj";825;1744;141;1885;NA;347991;966;2022-03-28;337486
2022-03-27;"Žilinský kraj";88;414;91;505;NA;347991;179;2022-03-27;336520
2022-03-26;"Žilinský kraj";586;224;53;277;NA;347991;639;2022-03-26;336341
2022-03-25;"Žilinský kraj";601;866;100;966;NA;347991;701;2022-03-25;335702
2022-03-24;"Žilinský kraj";697;1433;100;1533;NA;347991;797;2022-03-24;335001
2022-03-23;"Žilinský kraj";883;940;103;1043;NA;347991;986;2022-03-23;334204
2022-03-22;"Žilinský kraj";1102;2516;136;2652;NA;347991;1238;2022-03-22;333218
2022-03-21;"Žilinský kraj";969;1921;163;2084;NA;347991;1132;2022-03-21;331980
2022-03-20;"Žilinský kraj";157;438;88;526;NA;347991;245;2022-03-20;330848
2022-03-19;"Žilinský kraj";479;340;69;409;NA;347991;548;2022-03-19;330603
2022-03-18;"Žilinský kraj";864;773;119;892;NA;347991;983;2022-03-18;330055
2022-03-17;"Žilinský kraj";733;1120;154;1274;NA;347991;887;2022-03-17;329072
2022-03-16;"Žilinský kraj";995;1371;165;1536;NA;347991;1160;2022-03-16;328185
2022-03-15;"Žilinský kraj";1252;2522;215;2737;NA;347991;1467;2022-03-15;327025
2022-03-14;"Žilinský kraj";1138;1546;209;1755;NA;347991;1347;2022-03-14;325558
2022-03-13;"Žilinský kraj";226;522;112;634;NA;347991;338;2022-03-13;324211
2022-03-12;"Žilinský kraj";650;346;94;440;NA;347991;744;2022-03-12;323873
2022-03-11;"Žilinský kraj";824;1755;197;1952;NA;347991;1021;2022-03-11;323129
2022-03-10;"Žilinský kraj";1249;1519;169;1688;NA;347991;1418;2022-03-10;322108
2022-03-09;"Žilinský kraj";1713;1457;206;1663;NA;347991;1919;2022-03-09;320690
2022-03-08;"Žilinský kraj";699;2333;311;2644;NA;347991;1010;2022-03-08;318771
2022-03-07;"Žilinský kraj";1448;2225;300;2525;NA;347991;1748;2022-03-07;317761
2022-03-06;"Žilinský kraj";323;797;211;1008;NA;347991;534;2022-03-06;316013
2022-03-05;"Žilinský kraj";576;572;129;701;NA;347991;705;2022-03-05;315479
2022-03-04;"Žilinský kraj";1194;1884;264;2148;NA;347991;1458;2022-03-04;314774
2022-03-03;"Žilinský kraj";1240;1852;247;2099;NA;347991;1487;2022-03-03;313316
2022-03-02;"Žilinský kraj";1194;1798;250;2048;NA;347991;1444;2022-03-02;311829
2022-03-01;"Žilinský kraj";1710;2974;347;3321;NA;347991;2057;2022-03-01;310385
2022-02-28;"Žilinský kraj";1700;2980;355;3335;NA;347991;2055;2022-02-28;308328
2022-02-27;"Žilinský kraj";224;940;221;1161;NA;347991;445;2022-02-27;306273
2022-02-26;"Žilinský kraj";1184;816;171;987;NA;347991;1355;2022-02-26;305828
2022-02-25;"Žilinský kraj";1371;2421;320;2741;NA;347991;1691;2022-02-25;304473
2022-02-24;"Žilinský kraj";1504;2589;314;2903;NA;347991;1818;2022-02-24;302782
2022-02-23;"Žilinský kraj";1766;3298;333;3631;NA;347991;2099;2022-02-23;300964
2022-02-22;"Žilinský kraj";2419;3369;406;3775;NA;347991;2825;2022-02-22;298865
2022-02-21;"Žilinský kraj";2227;4181;573;4754;NA;347991;2800;2022-02-21;296040
2022-02-20;"Žilinský kraj";541;1473;304;1777;NA;347991;845;2022-02-20;293240
2022-02-19;"Žilinský kraj";1656;944;273;1217;NA;347991;1929;2022-02-19;292395
2022-02-18;"Žilinský kraj";1994;3335;439;3774;NA;347991;2433;2022-02-18;290466
2022-02-17;"Žilinský kraj";2274;3013;424;3437;NA;347991;2698;2022-02-17;288033
2022-02-16;"Žilinský kraj";2676;3573;496;4069;NA;347991;3172;2022-02-16;285335
2022-02-15;"Žilinský kraj";2939;4226;604;4830;NA;347991;3543;2022-02-15;282163
2022-02-14;"Žilinský kraj";2955;4182;777;4959;NA;347991;3732;2022-02-14;278620
2022-02-13;"Žilinský kraj";751;1842;464;2306;NA;347991;1215;2022-02-13;274888
2022-02-12;"Žilinský kraj";1771;1431;319;1750;NA;347991;2090;2022-02-12;273673
2022-02-11;"Žilinský kraj";2856;3332;570;3902;NA;347991;3426;2022-02-11;271583
2022-02-10;"Žilinský kraj";2861;3472;583;4055;NA;347991;3444;2022-02-10;268157
2022-02-09;"Žilinský kraj";3365;3863;618;4481;NA;347991;3983;2022-02-09;264713
2022-02-08;"Žilinský kraj";3367;4866;780;5646;NA;347991;4147;2022-02-08;260730
2022-02-07;"Žilinský kraj";3242;5569;913;6482;NA;347991;4155;2022-02-07;256583
2022-02-06;"Žilinský kraj";1389;2587;529;3116;NA;347991;1918;2022-02-06;252428
2022-02-05;"Žilinský kraj";2107;1846;425;2271;NA;347991;2532;2022-02-05;250510
2022-02-04;"Žilinský kraj";3099;4389;631;5020;NA;347991;3730;2022-02-04;247978
2022-02-03;"Žilinský kraj";3201;4122;613;4735;NA;347991;3814;2022-02-03;244248
2022-02-02;"Žilinský kraj";3168;4616;666;5282;NA;347991;3834;2022-02-02;240434
2022-02-01;"Žilinský kraj";3593;5240;694;5934;NA;347991;4287;2022-02-01;236600
2022-01-31;"Žilinský kraj";2145;7492;931;8423;NA;347991;3076;2022-01-31;232313
2022-01-30;"Žilinský kraj";1487;2898;431;3329;NA;347991;1918;2022-01-30;229237
2022-01-29;"Žilinský kraj";2055;2033;365;2398;NA;347991;2420;2022-01-29;227319
2022-01-28;"Žilinský kraj";2572;4800;546;5346;NA;347991;3118;2022-01-28;224899
2022-01-27;"Žilinský kraj";2406;4038;537;4575;NA;347991;2943;2022-01-27;221781
2022-01-26;"Žilinský kraj";2693;5009;516;5525;NA;347991;3209;2022-01-26;218838
2022-01-25;"Žilinský kraj";2595;5626;416;6042;NA;347991;3011;2022-01-25;215629
2022-01-24;"Žilinský kraj";1401;7098;522;7620;NA;347991;1923;2022-01-24;212618
2022-01-23;"Žilinský kraj";654;2923;276;3199;NA;347991;930;2022-01-23;210695
2022-01-22;"Žilinský kraj";1256;1706;206;1912;NA;347991;1462;2022-01-22;209765
2022-01-21;"Žilinský kraj";1188;4187;265;4452;NA;347991;1453;2022-01-21;208303
2022-01-20;"Žilinský kraj";1288;3654;205;3859;NA;347991;1493;2022-01-20;206850
2022-01-19;"Žilinský kraj";1215;4086;206;4292;NA;347991;1421;2022-01-19;205357
2022-01-18;"Žilinský kraj";1191;4213;168;4381;NA;347991;1359;2022-01-18;203936
2022-01-17;"Žilinský kraj";675;6886;256;7142;NA;347991;931;2022-01-17;202577
2022-01-16;"Žilinský kraj";175;2418;106;2524;NA;347991;281;2022-01-16;201646
2022-01-15;"Žilinský kraj";398;1410;70;1480;NA;347991;468;2022-01-15;201365
2022-01-14;"Žilinský kraj";446;3716;106;3822;NA;347991;552;2022-01-14;200897
2022-01-13;"Žilinský kraj";295;2912;78;2990;NA;347991;373;2022-01-13;200345
2022-01-12;"Žilinský kraj";422;3168;72;3240;NA;347991;494;2022-01-12;199972
2022-01-11;"Žilinský kraj";622;4216;57;4273;NA;347991;679;2022-01-11;199478
2022-01-10;"Žilinský kraj";436;6344;102;6446;NA;347991;538;2022-01-10;198799
2022-01-09;"Žilinský kraj";95;2934;54;2988;NA;347991;149;2022-01-09;198261
2022-01-08;"Žilinský kraj";345;1650;45;1695;NA;347991;390;2022-01-08;198112
2022-01-07;"Žilinský kraj";525;4566;75;4641;NA;347991;600;2022-01-07;197722
2022-01-06;"Žilinský kraj";167;1214;40;1254;NA;347991;207;2022-01-06;197122
2022-01-05;"Žilinský kraj";471;3492;75;3567;NA;347991;546;2022-01-05;196915
2022-01-04;"Žilinský kraj";606;3762;87;3849;NA;347991;693;2022-01-04;196369
2022-01-03;"Žilinský kraj";601;6083;116;6199;NA;347991;717;2022-01-03;195676
2022-01-02;"Žilinský kraj";288;2596;85;2681;NA;347991;373;2022-01-02;194959
2022-01-01;"Žilinský kraj";14;439;15;454;NA;347991;29;2022-01-01;194586
2021-12-31;"Žilinský kraj";323;1608;70;1678;NA;347991;393;2021-12-31;194557
2021-12-30;"Žilinský kraj";492;2213;95;2308;NA;347991;587;2021-12-30;194164
2021-12-29;"Žilinský kraj";543;6864;83;6947;NA;347991;626;2021-12-29;193577
2021-12-28;"Žilinský kraj";641;3408;106;3514;NA;347991;747;2021-12-28;192951
2021-12-27;"Žilinský kraj";691;3961;145;4106;NA;347991;836;2021-12-27;192204
2021-12-26;"Žilinský kraj";242;1167;58;1225;NA;347991;300;2021-12-26;191368
2021-12-25;"Žilinský kraj";22;442;45;487;NA;347991;67;2021-12-25;191068
2021-12-24;"Žilinský kraj";98;518;21;539;NA;347991;119;2021-12-24;191001
2021-12-23;"Žilinský kraj";731;2678;105;2783;NA;347991;836;2021-12-23;190882
2021-12-22;"Žilinský kraj";510;2428;77;2505;NA;347991;587;2021-12-22;190046
2021-12-21;"Žilinský kraj";755;3641;102;3743;NA;347991;857;2021-12-21;189459
2021-12-20;"Žilinský kraj";563;4545;125;4670;NA;347991;688;2021-12-20;188602
2021-12-19;"Žilinský kraj";133;2215;90;2305;NA;347991;223;2021-12-19;187914
2021-12-18;"Žilinský kraj";417;1321;70;1391;NA;347991;487;2021-12-18;187691
2021-12-17;"Žilinský kraj";604;3895;127;4022;NA;347991;731;2021-12-17;187204
2021-12-16;"Žilinský kraj";660;3931;109;4040;NA;347991;769;2021-12-16;186473
2021-12-15;"Žilinský kraj";802;3491;122;3613;NA;347991;924;2021-12-15;185704
2021-12-14;"Žilinský kraj";798;4587;129;4716;NA;347991;927;2021-12-14;184780
2021-12-13;"Žilinský kraj";759;7755;212;7967;NA;347991;971;2021-12-13;183853
2021-12-12;"Žilinský kraj";340;2836;114;2950;NA;347991;454;2021-12-12;182882
2021-12-11;"Žilinský kraj";761;1849;112;1961;NA;347991;873;2021-12-11;182428
2021-12-10;"Žilinský kraj";638;4041;136;4177;NA;347991;774;2021-12-10;181555
2021-12-09;"Žilinský kraj";870;5842;161;6003;NA;347991;1031;2021-12-09;180781
2021-12-08;"Žilinský kraj";1018;3215;158;3373;NA;347991;1176;2021-12-08;179750
2021-12-07;"Žilinský kraj";1356;5148;160;5308;NA;347991;1516;2021-12-07;178574
2021-12-06;"Žilinský kraj";919;7441;226;7667;NA;347991;1145;2021-12-06;177058
2021-12-05;"Žilinský kraj";505;3306;134;3440;NA;347991;639;2021-12-05;175913
2021-12-04;"Žilinský kraj";704;1892;153;2045;NA;347991;857;2021-12-04;175274
2021-12-03;"Žilinský kraj";1204;4864;215;5079;NA;347991;1419;2021-12-03;174417
2021-12-02;"Žilinský kraj";1847;4131;199;4330;NA;347991;2046;2021-12-02;172998
2021-12-01;"Žilinský kraj";1183;4073;195;4268;NA;347991;1378;2021-12-01;170952
2021-11-30;"Žilinský kraj";1575;5467;252;5719;NA;347991;1827;2021-11-30;169574
2021-11-29;"Žilinský kraj";1395;9069;358;9427;NA;347991;1753;2021-11-29;167747
2021-11-28;"Žilinský kraj";625;4581;235;4816;NA;347991;860;2021-11-28;165994
2021-11-27;"Žilinský kraj";909;2557;192;2749;NA;347991;1101;2021-11-27;165134
2021-11-26;"Žilinský kraj";1195;6599;344;6943;NA;347991;1539;2021-11-26;164033
2021-11-25;"Žilinský kraj";1281;4701;331;5032;NA;347991;1612;2021-11-25;162494
2021-11-24;"Žilinský kraj";1792;4660;324;4984;NA;347991;2116;2021-11-24;160882
2021-11-23;"Žilinský kraj";1630;4654;353;5007;NA;347991;1983;2021-11-23;158766
2021-11-22;"Žilinský kraj";1126;6699;452;7151;NA;347991;1578;2021-11-22;156783
2021-11-21;"Žilinský kraj";443;2865;260;3125;NA;347991;703;2021-11-21;155205
2021-11-20;"Žilinský kraj";963;2104;241;2345;NA;347991;1204;2021-11-20;154502
2021-11-19;"Žilinský kraj";1281;4622;434;5056;NA;347991;1715;2021-11-19;153298
2021-11-18;"Žilinský kraj";1220;4432;376;4808;NA;347991;1596;2021-11-18;151583
2021-11-17;"Žilinský kraj";1001;1434;149;1583;NA;347991;1150;2021-11-17;149987
2021-11-16;"Žilinský kraj";1197;4058;323;4381;NA;347991;1520;2021-11-16;148837
2021-11-15;"Žilinský kraj";977;5050;476;5526;NA;347991;1453;2021-11-15;147317
2021-11-14;"Žilinský kraj";356;2287;262;2549;NA;347991;618;2021-11-14;145864
2021-11-13;"Žilinský kraj";652;1882;220;2102;NA;347991;872;2021-11-13;145246
2021-11-12;"Žilinský kraj";1027;4291;340;4631;NA;347991;1367;2021-11-12;144374
2021-11-11;"Žilinský kraj";924;4192;272;4464;NA;347991;1196;2021-11-11;143007
2021-11-10;"Žilinský kraj";897;4509;305;4814;NA;347991;1202;2021-11-10;141811
2021-11-09;"Žilinský kraj";1440;4619;256;4875;NA;347991;1696;2021-11-09;140609
2021-11-08;"Žilinský kraj";781;4438;425;4863;NA;347991;1206;2021-11-08;138913
2021-11-07;"Žilinský kraj";304;2130;231;2361;NA;347991;535;2021-11-07;137707
2021-11-06;"Žilinský kraj";741;2150;201;2351;NA;347991;942;2021-11-06;137172
2021-11-05;"Žilinský kraj";1064;4067;235;4302;NA;347991;1299;2021-11-05;136230
2021-11-04;"Žilinský kraj";776;3709;232;3941;NA;347991;1008;2021-11-04;134931
2021-11-03;"Žilinský kraj";1106;5550;338;5888;NA;347991;1444;2021-11-03;133923
2021-11-02;"Žilinský kraj";1136;4451;333;4784;NA;347991;1469;2021-11-02;132479
2021-11-01;"Žilinský kraj";399;1456;137;1593;NA;347991;536;2021-11-01;131010
2021-10-31;"Žilinský kraj";344;1387;145;1532;NA;347991;489;2021-10-31;130474
2021-10-30;"Žilinský kraj";571;1944;161;2105;NA;347991;732;2021-10-30;129985
2021-10-29;"Žilinský kraj";733;3339;194;3533;NA;347991;927;2021-10-29;129253
2021-10-28;"Žilinský kraj";639;4953;247;5200;NA;347991;886;2021-10-28;128326
2021-10-27;"Žilinský kraj";739;3446;173;3619;NA;347991;912;2021-10-27;127440
2021-10-26;"Žilinský kraj";945;4748;216;4964;NA;347991;1161;2021-10-26;126528
2021-10-25;"Žilinský kraj";649;5736;271;6007;NA;347991;920;2021-10-25;125367
2021-10-24;"Žilinský kraj";248;1679;107;1786;NA;347991;355;2021-10-24;124447
2021-10-23;"Žilinský kraj";399;2415;149;2564;NA;347991;548;2021-10-23;124092
2021-10-22;"Žilinský kraj";587;3898;151;4049;NA;347991;738;2021-10-22;123544
2021-10-21;"Žilinský kraj";591;3367;162;3529;NA;347991;753;2021-10-21;122806
2021-10-20;"Žilinský kraj";479;3864;154;4018;NA;347991;633;2021-10-20;122053
2021-10-19;"Žilinský kraj";675;3763;161;3924;NA;347991;836;2021-10-19;121420
2021-10-18;"Žilinský kraj";432;5160;271;5431;NA;347991;703;2021-10-18;120584
2021-10-17;"Žilinský kraj";135;1769;101;1870;NA;347991;236;2021-10-17;119881
2021-10-16;"Žilinský kraj";273;2341;100;2441;NA;347991;373;2021-10-16;119645
2021-10-15;"Žilinský kraj";347;3859;146;4005;NA;347991;493;2021-10-15;119272
2021-10-14;"Žilinský kraj";419;3035;110;3145;NA;347991;529;2021-10-14;118779
2021-10-13;"Žilinský kraj";404;3427;112;3539;NA;347991;516;2021-10-13;118250
2021-10-12;"Žilinský kraj";589;4000;141;4141;NA;347991;730;2021-10-12;117734
2021-10-11;"Žilinský kraj";323;4501;154;4655;NA;347991;477;2021-10-11;117004
2021-10-10;"Žilinský kraj";113;1577;77;1654;NA;347991;190;2021-10-10;116527
2021-10-09;"Žilinský kraj";201;1565;57;1622;NA;347991;258;2021-10-09;116337
2021-10-08;"Žilinský kraj";265;4227;99;4326;NA;347991;364;2021-10-08;116079
2021-10-07;"Žilinský kraj";338;3384;113;3497;NA;347991;451;2021-10-07;115715
2021-10-06;"Žilinský kraj";313;3901;89;3990;NA;347991;402;2021-10-06;115264
2021-10-05;"Žilinský kraj";387;4031;122;4153;NA;347991;509;2021-10-05;114862
2021-10-04;"Žilinský kraj";297;4449;121;4570;NA;347991;418;2021-10-04;114353
2021-10-03;"Žilinský kraj";22;1596;63;1659;NA;347991;85;2021-10-03;113935
2021-10-02;"Žilinský kraj";209;1990;45;2035;NA;347991;254;2021-10-02;113850
2021-10-01;"Žilinský kraj";263;4047;104;4151;NA;347991;367;2021-10-01;113596
2021-09-30;"Žilinský kraj";248;3531;71;3602;NA;347991;319;2021-09-30;113229
2021-09-29;"Žilinský kraj";285;3577;82;3659;NA;347991;367;2021-09-29;112910
2021-09-28;"Žilinský kraj";272;3656;73;3729;NA;347991;345;2021-09-28;112543
2021-09-27;"Žilinský kraj";239;4418;152;4570;NA;347991;391;2021-09-27;112198
2021-09-26;"Žilinský kraj";17;1665;42;1707;NA;347991;59;2021-09-26;111807
2021-09-25;"Žilinský kraj";111;1711;50;1761;NA;347991;161;2021-09-25;111748
2021-09-24;"Žilinský kraj";199;6127;98;6225;NA;347991;297;2021-09-24;111587
2021-09-23;"Žilinský kraj";176;2629;74;2703;NA;347991;250;2021-09-23;111290
2021-09-22;"Žilinský kraj";185;2728;77;2805;NA;347991;262;2021-09-22;111040
2021-09-21;"Žilinský kraj";250;3123;78;3201;NA;347991;328;2021-09-21;110778
2021-09-20;"Žilinský kraj";244;3231;95;3326;NA;347991;339;2021-09-20;110450
2021-09-19;"Žilinský kraj";26;1579;37;1616;NA;347991;63;2021-09-19;110111
2021-09-18;"Žilinský kraj";87;1441;45;1486;NA;347991;132;2021-09-18;110048
2021-09-17;"Žilinský kraj";192;3351;56;3407;NA;347991;248;2021-09-17;109916
2021-09-16;"Žilinský kraj";164;2744;87;2831;NA;347991;251;2021-09-16;109668
2021-09-15;"Žilinský kraj";31;555;11;566;NA;347991;42;2021-09-15;109417
2021-09-14;"Žilinský kraj";155;3268;61;3329;NA;347991;216;2021-09-14;109375
2021-09-13;"Žilinský kraj";81;3250;75;3325;NA;347991;156;2021-09-13;109159
2021-09-12;"Žilinský kraj";9;1138;24;1162;NA;347991;33;2021-09-12;109003
2021-09-11;"Žilinský kraj";47;1322;21;1343;NA;347991;68;2021-09-11;108970
2021-09-10;"Žilinský kraj";66;2439;34;2473;NA;347991;100;2021-09-10;108902
2021-09-09;"Žilinský kraj";56;2352;18;2370;NA;347991;74;2021-09-09;108802
2021-09-08;"Žilinský kraj";68;1560;24;1584;NA;347991;92;2021-09-08;108728
2021-09-07;"Žilinský kraj";72;1806;27;1833;NA;347991;99;2021-09-07;108636
2021-09-06;"Žilinský kraj";31;2381;45;2426;NA;347991;76;2021-09-06;108537
2021-09-05;"Žilinský kraj";11;785;8;793;NA;347991;19;2021-09-05;108461
2021-09-04;"Žilinský kraj";24;1080;5;1085;NA;347991;29;2021-09-04;108442
2021-09-03;"Žilinský kraj";52;2047;28;2075;NA;347991;80;2021-09-03;108413
2021-09-02;"Žilinský kraj";30;1432;22;1454;NA;347991;52;2021-09-02;108333
2021-09-01;"Žilinský kraj";5;461;6;467;NA;347991;11;2021-09-01;108281
2021-08-31;"Žilinský kraj";32;1710;15;1725;NA;347991;47;2021-08-31;108270
2021-08-30;"Žilinský kraj";7;1801;4;1805;NA;347991;11;2021-08-30;108223
2021-08-29;"Žilinský kraj";8;631;5;636;NA;347991;13;2021-08-29;108212
2021-08-28;"Žilinský kraj";2;1005;1;1006;NA;347991;3;2021-08-28;108199
2021-08-27;"Žilinský kraj";13;1765;12;1777;NA;347991;25;2021-08-27;108196
2021-08-26;"Žilinský kraj";17;1636;7;1643;NA;347991;24;2021-08-26;108171
2021-08-25;"Žilinský kraj";9;1203;11;1214;NA;347991;20;2021-08-25;108147
2021-08-24;"Žilinský kraj";6;1395;9;1404;NA;347991;15;2021-08-24;108127
2021-08-23;"Žilinský kraj";11;1877;7;1884;NA;347991;18;2021-08-23;108112
2021-08-22;"Žilinský kraj";2;733;3;736;NA;347991;5;2021-08-22;108094
2021-08-21;"Žilinský kraj";6;1183;2;1185;NA;347991;8;2021-08-21;108089
2021-08-20;"Žilinský kraj";7;2284;5;2289;NA;347991;12;2021-08-20;108081
2021-08-19;"Žilinský kraj";6;1281;3;1284;NA;347991;9;2021-08-19;108069
2021-08-18;"Žilinský kraj";4;1331;7;1338;NA;347991;11;2021-08-18;108060
2021-08-17;"Žilinský kraj";9;1219;3;1222;NA;347991;12;2021-08-17;108049
2021-08-16;"Žilinský kraj";14;1696;5;1701;NA;347991;19;2021-08-16;108037
2021-08-15;"Žilinský kraj";1;880;2;882;NA;347991;3;2021-08-15;108018
2021-08-14;"Žilinský kraj";5;1197;0;1197;NA;347991;5;2021-08-14;108015
2021-08-13;"Žilinský kraj";6;1685;0;1685;NA;347991;6;2021-08-13;108010
2021-08-12;"Žilinský kraj";4;1105;1;1106;NA;347991;5;2021-08-12;108004
2021-08-11;"Žilinský kraj";13;1250;3;1253;NA;347991;16;2021-08-11;107999
2021-08-10;"Žilinský kraj";12;1292;3;1295;NA;347991;15;2021-08-10;107983
2021-08-09;"Žilinský kraj";9;1142;1;1143;NA;347991;10;2021-08-09;107968
2021-08-08;"Žilinský kraj";1;748;5;753;NA;347991;6;2021-08-08;107958
2021-08-07;"Žilinský kraj";7;1192;1;1193;NA;347991;8;2021-08-07;107952
2021-08-06;"Žilinský kraj";1;1347;0;1347;NA;347991;1;2021-08-06;107944
2021-08-05;"Žilinský kraj";7;1148;3;1151;NA;347991;10;2021-08-05;107943
2021-08-04;"Žilinský kraj";12;895;0;895;NA;347991;12;2021-08-04;107933
2021-08-03;"Žilinský kraj";11;918;0;918;NA;347991;11;2021-08-03;107921
2021-08-02;"Žilinský kraj";5;1513;1;1514;NA;347991;6;2021-08-02;107910
2021-08-01;"Žilinský kraj";0;679;2;681;NA;347991;2;2021-08-01;107904
2021-07-31;"Žilinský kraj";4;1114;0;1114;NA;347991;4;2021-07-31;107902
2021-07-30;"Žilinský kraj";3;1671;0;1671;NA;347991;3;2021-07-30;107898
2021-07-29;"Žilinský kraj";1;1299;0;1299;NA;347991;1;2021-07-29;107895
2021-07-28;"Žilinský kraj";4;901;0;901;NA;347991;4;2021-07-28;107894
2021-07-27;"Žilinský kraj";11;1378;0;1378;NA;347991;11;2021-07-27;107890
2021-07-26;"Žilinský kraj";1;1301;1;1302;NA;347991;2;2021-07-26;107879
2021-07-25;"Žilinský kraj";2;828;2;830;NA;347991;4;2021-07-25;107877
2021-07-24;"Žilinský kraj";2;1338;2;1340;NA;347991;4;2021-07-24;107873
2021-07-23;"Žilinský kraj";4;1750;0;1750;NA;347991;4;2021-07-23;107869
2021-07-22;"Žilinský kraj";2;1207;0;1207;NA;347991;2;2021-07-22;107865
2021-07-21;"Žilinský kraj";2;1021;0;1021;NA;347991;2;2021-07-21;107863
2021-07-20;"Žilinský kraj";4;1439;0;1439;NA;347991;4;2021-07-20;107861
2021-07-19;"Žilinský kraj";4;1763;1;1764;NA;347991;5;2021-07-19;107857
2021-07-18;"Žilinský kraj";0;854;1;855;NA;347991;1;2021-07-18;107852
2021-07-17;"Žilinský kraj";0;1350;0;1350;NA;347991;0;2021-07-17;107851
2021-07-16;"Žilinský kraj";2;1767;0;1767;NA;347991;2;2021-07-16;107851
2021-07-15;"Žilinský kraj";2;1577;0;1577;NA;347991;2;2021-07-15;107849
2021-07-14;"Žilinský kraj";5;1042;1;1043;NA;347991;6;2021-07-14;107847
2021-07-13;"Žilinský kraj";3;1709;1;1710;NA;347991;4;2021-07-13;107841
2021-07-12;"Žilinský kraj";3;1325;1;1326;NA;347991;4;2021-07-12;107837
2021-07-11;"Žilinský kraj";2;989;0;989;NA;347991;2;2021-07-11;107833
2021-07-10;"Žilinský kraj";1;1511;4;1515;NA;347991;5;2021-07-10;107831
2021-07-09;"Žilinský kraj";1;2208;1;2209;NA;347991;2;2021-07-09;107826
2021-07-08;"Žilinský kraj";6;1776;3;1779;NA;347991;9;2021-07-08;107824
2021-07-07;"Žilinský kraj";1;1585;3;1588;NA;347991;4;2021-07-07;107815
2021-07-06;"Žilinský kraj";4;1956;0;1956;NA;347991;4;2021-07-06;107811
2021-07-05;"Žilinský kraj";2;1031;1;1032;NA;347991;3;2021-07-05;107807
2021-07-04;"Žilinský kraj";0;1003;0;1003;NA;347991;0;2021-07-04;107804
2021-07-03;"Žilinský kraj";1;1696;2;1698;NA;347991;3;2021-07-03;107804
2021-07-02;"Žilinský kraj";0;3356;2;3358;NA;347991;2;2021-07-02;107801
2021-07-01;"Žilinský kraj";1;1118;0;1118;NA;347991;1;2021-07-01;107799
2021-06-30;"Žilinský kraj";1;10464;6;10470;NA;347991;7;2021-06-30;107798
2021-06-29;"Žilinský kraj";10;5946;0;5946;NA;347991;10;2021-06-29;107791
2021-06-28;"Žilinský kraj";4;6245;2;6247;NA;347991;6;2021-06-28;107781
2021-06-27;"Žilinský kraj";3;4702;1;4703;NA;347991;4;2021-06-27;107775
2021-06-26;"Žilinský kraj";4;5919;0;5919;NA;347991;4;2021-06-26;107771
2021-06-25;"Žilinský kraj";8;9756;5;9761;NA;347991;13;2021-06-25;107767
2021-06-24;"Žilinský kraj";6;5657;3;5660;NA;347991;9;2021-06-24;107754
2021-06-23;"Žilinský kraj";7;5955;10;5965;NA;347991;17;2021-06-23;107745
2021-06-22;"Žilinský kraj";6;5214;8;5222;NA;347991;14;2021-06-22;107728
2021-06-21;"Žilinský kraj";6;6287;8;6295;NA;347991;14;2021-06-21;107714
2021-06-20;"Žilinský kraj";1;5531;8;5539;NA;347991;9;2021-06-20;107700
2021-06-19;"Žilinský kraj";9;8353;2;8355;NA;347991;11;2021-06-19;107691
2021-06-18;"Žilinský kraj";11;10624;12;10636;NA;347991;23;2021-06-18;107680
2021-06-17;"Žilinský kraj";10;6092;12;6104;NA;347991;22;2021-06-17;107657
2021-06-16;"Žilinský kraj";17;5786;11;5797;NA;347991;28;2021-06-16;107635
2021-06-15;"Žilinský kraj";13;5996;13;6009;NA;347991;26;2021-06-15;107607
2021-06-14;"Žilinský kraj";10;7596;21;7617;NA;347991;31;2021-06-14;107581
2021-06-13;"Žilinský kraj";2;6682;9;6691;NA;347991;11;2021-06-13;107550
2021-06-12;"Žilinský kraj";9;8634;11;8645;NA;347991;20;2021-06-12;107539
2021-06-11;"Žilinský kraj";11;11566;14;11580;NA;347991;25;2021-06-11;107519
2021-06-10;"Žilinský kraj";14;6788;14;6802;NA;347991;28;2021-06-10;107494
2021-06-09;"Žilinský kraj";23;5925;14;5939;NA;347991;37;2021-06-09;107466
2021-06-08;"Žilinský kraj";18;6615;16;6631;NA;347991;34;2021-06-08;107429
2021-06-07;"Žilinský kraj";25;8534;21;8555;NA;347991;46;2021-06-07;107395
2021-06-06;"Žilinský kraj";10;8056;27;8083;NA;347991;37;2021-06-06;107349
2021-06-05;"Žilinský kraj";8;9175;10;9185;NA;347991;18;2021-06-05;107312
2021-06-04;"Žilinský kraj";19;12260;34;12294;NA;347991;53;2021-06-04;107294
2021-06-03;"Žilinský kraj";12;7033;33;7066;NA;347991;45;2021-06-03;107241
2021-06-02;"Žilinský kraj";17;7103;28;7131;NA;347991;45;2021-06-02;107196
2021-06-01;"Žilinský kraj";38;8285;46;8331;NA;347991;84;2021-06-01;107151
2021-05-31;"Žilinský kraj";31;9616;59;9675;NA;347991;90;2021-05-31;107067
2021-05-30;"Žilinský kraj";21;9025;35;9060;NA;347991;56;2021-05-30;106977
2021-05-29;"Žilinský kraj";13;11195;23;11218;NA;347991;36;2021-05-29;106921
2021-05-28;"Žilinský kraj";28;13277;30;13307;NA;347991;58;2021-05-28;106885
2021-05-27;"Žilinský kraj";17;8267;39;8306;NA;347991;56;2021-05-27;106827
2021-05-26;"Žilinský kraj";20;8329;25;8354;NA;347991;45;2021-05-26;106771
2021-05-25;"Žilinský kraj";21;9624;38;9662;NA;347991;59;2021-05-25;106726
2021-05-24;"Žilinský kraj";36;11487;57;11544;NA;347991;93;2021-05-24;106667
2021-05-23;"Žilinský kraj";4;10923;56;10979;NA;347991;60;2021-05-23;106574
2021-05-22;"Žilinský kraj";21;11893;28;11921;NA;347991;49;2021-05-22;106514
2021-05-21;"Žilinský kraj";28;15654;50;15704;NA;347991;78;2021-05-21;106465
2021-05-20;"Žilinský kraj";30;9616;30;9646;NA;347991;60;2021-05-20;106387
2021-05-19;"Žilinský kraj";46;8693;41;8734;NA;347991;87;2021-05-19;106327
2021-05-18;"Žilinský kraj";52;10609;44;10653;NA;347991;96;2021-05-18;106240
2021-05-17;"Žilinský kraj";51;12676;84;12760;NA;347991;135;2021-05-17;106144
2021-05-16;"Žilinský kraj";13;14114;42;14156;NA;347991;55;2021-05-16;106009
2021-05-15;"Žilinský kraj";30;18404;35;18439;NA;347991;65;2021-05-15;105954
2021-05-14;"Žilinský kraj";34;21205;82;21287;NA;347991;116;2021-05-14;105889
2021-05-13;"Žilinský kraj";64;11865;51;11916;NA;347991;115;2021-05-13;105773
2021-05-12;"Žilinský kraj";57;10337;51;10388;NA;347991;108;2021-05-12;105658
2021-05-11;"Žilinský kraj";70;12174;51;12225;NA;347991;121;2021-05-11;105550
2021-05-10;"Žilinský kraj";69;16182;72;16254;NA;347991;141;2021-05-10;105429
2021-05-09;"Žilinský kraj";58;20385;77;20462;NA;347991;135;2021-05-09;105288
2021-05-08;"Žilinský kraj";0;24133;63;24196;NA;347991;63;2021-05-08;105153
2021-05-07;"Žilinský kraj";65;26522;87;26609;NA;347991;152;2021-05-07;105090
2021-05-06;"Žilinský kraj";67;16615;72;16687;NA;347991;139;2021-05-06;104938
2021-05-05;"Žilinský kraj";71;13096;73;13169;NA;347991;144;2021-05-05;104799
2021-05-04;"Žilinský kraj";81;16749;80;16829;NA;347991;161;2021-05-04;104655
2021-05-03;"Žilinský kraj";97;20391;111;20502;NA;347991;208;2021-05-03;104494
2021-05-02;"Žilinský kraj";8;28886;64;28950;NA;347991;72;2021-05-02;104286
2021-05-01;"Žilinský kraj";65;55053;105;55158;NA;347991;170;2021-05-01;104214
2021-04-30;"Žilinský kraj";84;44000;117;44117;NA;347991;201;2021-04-30;104044
2021-04-29;"Žilinský kraj";77;24566;101;24667;NA;347991;178;2021-04-29;103843
2021-04-28;"Žilinský kraj";76;19214;91;19305;NA;347991;167;2021-04-28;103665
2021-04-27;"Žilinský kraj";97;21805;110;21915;NA;347991;207;2021-04-27;103498
2021-04-26;"Žilinský kraj";114;27412;136;27548;NA;347991;250;2021-04-26;103291
2021-04-25;"Žilinský kraj";38;35750;82;35832;NA;347991;120;2021-04-25;103041
2021-04-24;"Žilinský kraj";93;78854;157;79011;NA;347991;250;2021-04-24;102921
2021-04-23;"Žilinský kraj";144;49440;153;49593;NA;347991;297;2021-04-23;102671
2021-04-22;"Žilinský kraj";110;25247;132;25379;NA;347991;242;2021-04-22;102374
2021-04-21;"Žilinský kraj";118;20616;145;20761;NA;347991;263;2021-04-21;102132
2021-04-20;"Žilinský kraj";128;23873;136;24009;NA;347991;264;2021-04-20;101869
2021-04-19;"Žilinský kraj";164;32773;210;32983;NA;347991;374;2021-04-19;101605
2021-04-18;"Žilinský kraj";18;36767;91;36858;NA;347991;109;2021-04-18;101231
2021-04-17;"Žilinský kraj";108;89377;156;89533;NA;347991;264;2021-04-17;101122
2021-04-16;"Žilinský kraj";185;47847;208;48055;NA;347991;393;2021-04-16;100858
2021-04-15;"Žilinský kraj";108;24830;130;24960;NA;347991;238;2021-04-15;100465
2021-04-14;"Žilinský kraj";135;23145;145;23290;NA;347991;280;2021-04-14;100227
2021-04-13;"Žilinský kraj";171;25050;135;25185;NA;347991;306;2021-04-13;99947
2021-04-12;"Žilinský kraj";266;30794;189;30983;NA;347991;455;2021-04-12;99641
2021-04-11;"Žilinský kraj";19;37126;107;37233;NA;347991;126;2021-04-11;99186
2021-04-10;"Žilinský kraj";111;86284;237;86521;NA;347991;348;2021-04-10;99060
2021-04-09;"Žilinský kraj";195;41973;206;42179;NA;347991;401;2021-04-09;98712
2021-04-08;"Žilinský kraj";179;24434;141;24575;NA;347991;320;2021-04-08;98311
2021-04-07;"Žilinský kraj";309;28651;174;28825;NA;347991;483;2021-04-07;97991
2021-04-06;"Žilinský kraj";308;40107;301;40408;NA;347991;609;2021-04-06;97508
2021-04-05;"Žilinský kraj";17;14747;140;14887;NA;347991;157;2021-04-05;96899
2021-04-04;"Žilinský kraj";17;16284;69;16353;NA;347991;86;2021-04-04;96742
2021-04-03;"Žilinský kraj";180;100699;403;101102;NA;347991;583;2021-04-03;96656
2021-04-02;"Žilinský kraj";73;22411;83;22494;NA;347991;156;2021-04-02;96073
2021-04-01;"Žilinský kraj";334;43264;240;43504;NA;347991;574;2021-04-01;95917
2021-03-31;"Žilinský kraj";170;31635;247;31882;NA;347991;417;2021-03-31;95343
2021-03-30;"Žilinský kraj";406;26323;243;26566;NA;347991;649;2021-03-30;94926
2021-03-29;"Žilinský kraj";297;28029;268;28297;NA;347991;565;2021-03-29;94277
2021-03-28;"Žilinský kraj";21;36206;239;36445;NA;347991;260;2021-03-28;93712
2021-03-27;"Žilinský kraj";151;89107;353;89460;NA;347991;504;2021-03-27;93452
2021-03-26;"Žilinský kraj";312;51757;330;52087;NA;347991;642;2021-03-26;92948
2021-03-25;"Žilinský kraj";281;27619;214;27833;NA;347991;495;2021-03-25;92306
2021-03-24;"Žilinský kraj";280;21268;260;21528;NA;347991;540;2021-03-24;91811
2021-03-23;"Žilinský kraj";418;23193;278;23471;NA;347991;696;2021-03-23;91271
2021-03-22;"Žilinský kraj";293;29289;314;29603;NA;347991;607;2021-03-22;90575
2021-03-21;"Žilinský kraj";32;33705;227;33932;NA;347991;259;2021-03-21;89968
2021-03-20;"Žilinský kraj";165;93015;497;93512;NA;347991;662;2021-03-20;89709
2021-03-19;"Žilinský kraj";357;51988;414;52402;NA;347991;771;2021-03-19;89047
2021-03-18;"Žilinský kraj";329;28459;294;28753;NA;347991;623;2021-03-18;88276
2021-03-17;"Žilinský kraj";395;21919;269;22188;NA;347991;664;2021-03-17;87653
2021-03-16;"Žilinský kraj";514;24341;317;24658;NA;347991;831;2021-03-16;86989
2021-03-15;"Žilinský kraj";341;29613;419;30032;NA;347991;760;2021-03-15;86158
2021-03-14;"Žilinský kraj";87;34121;267;34388;NA;347991;354;2021-03-14;85398
2021-03-13;"Žilinský kraj";113;93386;581;93967;NA;347991;694;2021-03-13;85044
2021-03-12;"Žilinský kraj";520;52329;411;52740;NA;347991;931;2021-03-12;84350
2021-03-11;"Žilinský kraj";399;28189;302;28491;NA;347991;701;2021-03-11;83419
2021-03-10;"Žilinský kraj";368;22414;378;22792;NA;347991;746;2021-03-10;82718
2021-03-09;"Žilinský kraj";537;24857;316;25173;NA;347991;853;2021-03-09;81972
2021-03-08;"Žilinský kraj";387;30873;458;31331;NA;347991;845;2021-03-08;81119
2021-03-07;"Žilinský kraj";48;33469;290;33759;NA;347991;338;2021-03-07;80274
2021-03-06;"Žilinský kraj";173;92410;589;92999;NA;347991;762;2021-03-06;79936
2021-03-05;"Žilinský kraj";369;51987;484;52471;NA;347991;853;2021-03-05;79174
2021-03-04;"Žilinský kraj";467;30037;377;30414;NA;347991;844;2021-03-04;78321
2021-03-03;"Žilinský kraj";448;26261;394;26655;NA;347991;842;2021-03-03;77477
2021-03-02;"Žilinský kraj";551;25913;378;26291;NA;347991;929;2021-03-02;76635
2021-03-01;"Žilinský kraj";375;30498;441;30939;NA;347991;816;2021-03-01;75706
2021-02-28;"Žilinský kraj";61;34802;327;35129;NA;347991;388;2021-02-28;74890
2021-02-27;"Žilinský kraj";159;83781;639;84420;NA;347991;798;2021-02-27;74502
2021-02-26;"Žilinský kraj";459;47500;508;48008;NA;347991;967;2021-02-26;73704
2021-02-25;"Žilinský kraj";347;30879;393;31272;NA;347991;740;2021-02-25;72737
2021-02-24;"Žilinský kraj";339;18760;395;19155;NA;347991;734;2021-02-24;71997
2021-02-23;"Žilinský kraj";437;22172;418;22590;NA;347991;855;2021-02-23;71263
2021-02-22;"Žilinský kraj";345;29270;438;29708;NA;347991;783;2021-02-22;70408
2021-02-21;"Žilinský kraj";36;28686;322;29008;NA;347991;358;2021-02-21;69625
2021-02-20;"Žilinský kraj";152;89944;671;90615;NA;347991;823;2021-02-20;69267
2021-02-19;"Žilinský kraj";337;45541;417;45958;NA;347991;754;2021-02-19;68444
2021-02-18;"Žilinský kraj";263;24662;337;24999;NA;347991;600;2021-02-18;67690
2021-02-17;"Žilinský kraj";269;17932;355;18287;NA;347991;624;2021-02-17;67090
2021-02-16;"Žilinský kraj";321;24298;325;24623;NA;347991;646;2021-02-16;66466
2021-02-15;"Žilinský kraj";230;30420;311;30731;NA;347991;541;2021-02-15;65820
2021-02-14;"Žilinský kraj";30;28723;231;28954;NA;347991;261;2021-02-14;65279
2021-02-13;"Žilinský kraj";91;69638;453;70091;NA;347991;544;2021-02-13;65018
2021-02-12;"Žilinský kraj";242;43338;336;43674;NA;347991;578;2021-02-12;64474
2021-02-11;"Žilinský kraj";228;23521;300;23821;NA;347991;528;2021-02-11;63896
2021-02-10;"Žilinský kraj";259;17894;267;18161;NA;347991;526;2021-02-10;63368
2021-02-09;"Žilinský kraj";377;24784;274;25058;NA;347991;651;2021-02-09;62842
2021-02-08;"Žilinský kraj";160;41375;390;41765;NA;347991;550;2021-02-08;62191
2021-02-07;"Žilinský kraj";24;46446;252;46698;NA;347991;276;2021-02-07;61641
2021-02-06;"Žilinský kraj";71;72880;367;73247;NA;347991;438;2021-02-06;61365
2021-02-05;"Žilinský kraj";248;31869;323;32192;NA;347991;571;2021-02-05;60927
2021-02-04;"Žilinský kraj";238;13240;258;13498;NA;347991;496;2021-02-04;60356
2021-02-03;"Žilinský kraj";194;9186;255;9441;NA;347991;449;2021-02-03;59860
2021-02-02;"Žilinský kraj";216;9280;272;9552;NA;347991;488;2021-02-02;59411
2021-02-01;"Žilinský kraj";220;19690;370;20060;NA;347991;590;2021-02-01;58923
2021-01-31;"Žilinský kraj";11;2652;27;2679;NA;347991;38;2021-01-31;58333
2021-01-30;"Žilinský kraj";85;18447;187;18634;NA;347991;272;2021-01-30;58295
2021-01-29;"Žilinský kraj";209;22891;304;23195;NA;347991;513;2021-01-29;58023
2021-01-28;"Žilinský kraj";240;5533;172;5705;NA;347991;412;2021-01-28;57510
2021-01-27;"Žilinský kraj";256;6725;119;6844;NA;347991;375;2021-01-27;57098
2021-01-26;"Žilinský kraj";245;49781;348;50129;NA;347991;593;2021-01-26;56723
2021-01-25;"Žilinský kraj";159;21245;150;21395;NA;347991;309;2021-01-25;56130
2021-01-24;"Žilinský kraj";22;55835;268;56103;NA;347991;290;2021-01-24;55821
2021-01-23;"Žilinský kraj";91;101730;444;102174;NA;347991;535;2021-01-23;55531
2021-01-22;"Žilinský kraj";163;32160;237;32397;NA;347991;400;2021-01-22;54996
2021-01-21;"Žilinský kraj";116;19828;181;20009;NA;347991;297;2021-01-21;54596
2021-01-20;"Žilinský kraj";236;17126;159;17285;NA;347991;395;2021-01-20;54299
2021-01-19;"Žilinský kraj";245;15730;285;16015;NA;347991;530;2021-01-19;53904
2021-01-18;"Žilinský kraj";236;12685;326;13011;NA;347991;562;2021-01-18;53374
2021-01-17;"Žilinský kraj";95;147;8;155;NA;347991;103;2021-01-17;52812
2021-01-16;"Žilinský kraj";14;516;31;547;NA;347991;45;2021-01-16;52709
2021-01-15;"Žilinský kraj";248;7486;209;7695;NA;347991;457;2021-01-15;52664
2021-01-14;"Žilinský kraj";166;5319;239;5558;NA;347991;405;2021-01-14;52207
2021-01-13;"Žilinský kraj";247;11263;557;11820;NA;347991;804;2021-01-13;51802
2021-01-12;"Žilinský kraj";376;8410;385;8795;NA;347991;761;2021-01-12;50998
2021-01-11;"Žilinský kraj";351;10058;465;10523;NA;347991;816;2021-01-11;50237
2021-01-10;"Žilinský kraj";38;229;6;235;NA;347991;44;2021-01-10;49421
2021-01-09;"Žilinský kraj";192;1282;60;1342;NA;347991;252;2021-01-09;49377
2021-01-08;"Žilinský kraj";413;8721;462;9183;NA;347991;875;2021-01-08;49125
2021-01-07;"Žilinský kraj";438;23407;1872;25279;NA;347991;2310;2021-01-07;48250
2021-01-06;"Žilinský kraj";145;1076;67;1143;NA;347991;212;2021-01-06;45940
2021-01-05;"Žilinský kraj";717;10227;796;11023;NA;347991;1513;2021-01-05;45728
2021-01-04;"Žilinský kraj";479;9313;893;10206;NA;347991;1372;2021-01-04;44215
2021-01-03;"Žilinský kraj";13;1006;107;1113;NA;347991;120;2021-01-03;42843
2021-01-02;"Žilinský kraj";98;789;91;880;NA;347991;189;2021-01-02;42723
2021-01-01;"Žilinský kraj";118;241;13;254;NA;347991;131;2021-01-01;42534
2020-12-31;"Žilinský kraj";395;9626;784;10410;NA;347991;1179;2020-12-31;42403
2020-12-30;"Žilinský kraj";1038;11781;823;12604;NA;347991;1861;2020-12-30;41224
2020-12-29;"Žilinský kraj";256;10159;979;11138;NA;347991;1235;2020-12-29;39363
2020-12-28;"Žilinský kraj";406;10704;976;11680;NA;347991;1382;2020-12-28;38128
2020-12-27;"Žilinský kraj";40;684;94;778;NA;347991;134;2020-12-27;36746
2020-12-26;"Žilinský kraj";135;593;48;641;NA;347991;183;2020-12-26;36612
2020-12-25;"Žilinský kraj";66;83;9;92;NA;347991;75;2020-12-25;36429
2020-12-24;"Žilinský kraj";643;667;55;722;NA;347991;698;2020-12-24;36354
2020-12-23;"Žilinský kraj";228;16229;975;17204;NA;347991;1203;2020-12-23;35656
2020-12-22;"Žilinský kraj";519;13483;988;14471;NA;347991;1507;2020-12-22;34453
2020-12-21;"Žilinský kraj";444;12429;1078;13507;NA;347991;1522;2020-12-21;32946
2020-12-20;"Žilinský kraj";36;598;80;678;NA;347991;116;2020-12-20;31424
2020-12-19;"Žilinský kraj";208;1678;127;1805;NA;347991;335;2020-12-19;31308
2020-12-18;"Žilinský kraj";333;6553;370;6923;NA;347991;703;2020-12-18;30973
2020-12-17;"Žilinský kraj";500;3922;262;4184;NA;347991;762;2020-12-17;30270
2020-12-16;"Žilinský kraj";333;3815;267;4082;NA;347991;600;2020-12-16;29508
2020-12-15;"Žilinský kraj";528;3729;340;4069;NA;347991;868;2020-12-15;28908
2020-12-14;"Žilinský kraj";321;3884;309;4193;NA;347991;630;2020-12-14;28040
2020-12-13;"Žilinský kraj";26;494;66;560;NA;347991;92;2020-12-13;27410
2020-12-12;"Žilinský kraj";95;767;46;813;NA;347991;141;2020-12-12;27318
2020-12-11;"Žilinský kraj";455;3938;227;4165;NA;347991;682;2020-12-11;27177
2020-12-10;"Žilinský kraj";166;9129;838;9967;NA;347991;1004;2020-12-10;26495
2020-12-09;"Žilinský kraj";392;2169;132;2301;NA;347991;524;2020-12-09;25491
2020-12-08;"Žilinský kraj";331;3127;101;3228;NA;347991;432;2020-12-08;24967
2020-12-07;"Žilinský kraj";348;2746;162;2908;NA;347991;510;2020-12-07;24535
2020-12-06;"Žilinský kraj";15;128;6;134;NA;347991;21;2020-12-06;24025
2020-12-05;"Žilinský kraj";98;781;41;822;NA;347991;139;2020-12-05;24004
2020-12-04;"Žilinský kraj";228;3091;107;3198;NA;347991;335;2020-12-04;23865
2020-12-03;"Žilinský kraj";237;1609;115;1724;NA;347991;352;2020-12-03;23530
2020-12-02;"Žilinský kraj";181;1710;94;1804;NA;347991;275;2020-12-02;23178
2020-12-01;"Žilinský kraj";209;6239;284;6523;NA;347991;493;2020-12-01;22903
2020-11-30;"Žilinský kraj";203;5326;305;5631;NA;347991;508;2020-11-30;22410
2020-11-29;"Žilinský kraj";18;81;7;88;NA;347991;25;2020-11-29;21902
2020-11-28;"Žilinský kraj";99;349;15;364;NA;347991;114;2020-11-28;21877
2020-11-27;"Žilinský kraj";218;904;46;950;NA;347991;264;2020-11-27;21763
2020-11-26;"Žilinský kraj";190;1041;54;1095;NA;347991;244;2020-11-26;21499
2020-11-25;"Žilinský kraj";225;1217;49;1266;NA;347991;274;2020-11-25;21255
2020-11-24;"Žilinský kraj";213;2139;67;2206;NA;347991;280;2020-11-24;20981
2020-11-23;"Žilinský kraj";170;759;44;803;NA;347991;214;2020-11-23;20701
2020-11-22;"Žilinský kraj";11;67;2;69;NA;347991;13;2020-11-22;20487
2020-11-21;"Žilinský kraj";61;505;20;525;NA;347991;81;2020-11-21;20474
2020-11-20;"Žilinský kraj";251;1074;45;1119;NA;347991;296;2020-11-20;20393
2020-11-19;"Žilinský kraj";252;752;61;813;NA;347991;313;2020-11-19;20097
2020-11-18;"Žilinský kraj";346;348;15;363;NA;347991;361;2020-11-18;19784
2020-11-17;"Žilinský kraj";123;490;15;505;NA;347991;138;2020-11-17;19423
2020-11-16;"Žilinský kraj";227;247;15;262;NA;347991;242;2020-11-16;19285
2020-11-15;"Žilinský kraj";63;13;0;13;NA;347991;63;2020-11-15;19043
2020-11-14;"Žilinský kraj";189;1038;11;1049;NA;347991;200;2020-11-14;18980
2020-11-13;"Žilinský kraj";181;125;9;134;NA;347991;190;2020-11-13;18780
2020-11-12;"Žilinský kraj";334;79;2;81;NA;347991;336;2020-11-12;18590
2020-11-11;"Žilinský kraj";489;147;10;157;NA;347991;499;2020-11-11;18254
2020-11-10;"Žilinský kraj";374;519;9;528;NA;347991;383;2020-11-10;17755
2020-11-09;"Žilinský kraj";143;2335;30;2365;NA;347991;173;2020-11-09;17372
2020-11-08;"Žilinský kraj";59;2538;37;2575;NA;347991;96;2020-11-08;17199
2020-11-07;"Žilinský kraj";312;8175;88;8263;NA;347991;400;2020-11-07;17103
2020-11-06;"Žilinský kraj";503;4090;38;4128;NA;347991;541;2020-11-06;16703
2020-11-05;"Žilinský kraj";473;64;4;68;NA;347991;477;2020-11-05;16162
2020-11-04;"Žilinský kraj";423;178;10;188;NA;347991;433;2020-11-04;15685
2020-11-03;"Žilinský kraj";688;889;16;905;NA;347991;704;2020-11-03;15252
2020-11-02;"Žilinský kraj";472;1043;39;1082;NA;347991;511;2020-11-02;14548
2020-11-01;"Žilinský kraj";349;5096;130;5226;NA;347991;479;2020-11-01;14037
2020-10-31;"Žilinský kraj";661;7963;203;8166;NA;347991;864;2020-10-31;13558
2020-10-30;"Žilinský kraj";529;2575;61;2636;NA;347991;590;2020-10-30;12694
2020-10-29;"Žilinský kraj";740;503;17;520;NA;347991;757;2020-10-29;12104
2020-10-28;"Žilinský kraj";635;105;11;116;NA;347991;646;2020-10-28;11347
2020-10-27;"Žilinský kraj";355;154;24;178;NA;347991;379;2020-10-27;10701
2020-10-26;"Žilinský kraj";148;117;28;145;NA;347991;176;2020-10-26;10322
2020-10-25;"Žilinský kraj";436;0;0;0;NA;347991;436;2020-10-25;10146
2020-10-24;"Žilinský kraj";803;0;0;0;NA;347991;803;2020-10-24;9710
2020-10-23;"Žilinský kraj";659;102;13;115;NA;347991;672;2020-10-23;8907
2020-10-22;"Žilinský kraj";525;33;3;36;NA;347991;528;2020-10-22;8235
2020-10-21;"Žilinský kraj";478;74;14;88;NA;347991;492;2020-10-21;7707
2020-10-20;"Žilinský kraj";524;127;8;135;NA;347991;532;2020-10-20;7215
2020-10-19;"Žilinský kraj";70;80;12;92;NA;347991;82;2020-10-19;6683
2020-10-18;"Žilinský kraj";159;0;0;0;NA;347991;159;2020-10-18;6601
2020-10-17;"Žilinský kraj";509;0;0;0;NA;347991;509;2020-10-17;6442
2020-10-16;"Žilinský kraj";603;51;9;60;NA;347991;612;2020-10-16;5933
2020-10-15;"Žilinský kraj";679;61;3;64;NA;347991;682;2020-10-15;5321
2020-10-14;"Žilinský kraj";523;269;6;275;NA;347991;529;2020-10-14;4639
2020-10-13;"Žilinský kraj";367;458;40;498;NA;347991;407;2020-10-13;4110
2020-10-12;"Žilinský kraj";62;0;0;0;NA;347991;62;2020-10-12;3703
2020-10-11;"Žilinský kraj";50;0;0;0;NA;347991;50;2020-10-11;3641
2020-10-10;"Žilinský kraj";213;0;0;0;NA;347991;213;2020-10-10;3591
2020-10-09;"Žilinský kraj";543;0;0;0;NA;347991;543;2020-10-09;3378
2020-10-08;"Žilinský kraj";238;0;0;0;NA;347991;238;2020-10-08;2835
2020-10-07;"Žilinský kraj";168;0;0;0;NA;347991;168;2020-10-07;2597
2020-10-06;"Žilinský kraj";233;0;0;0;NA;347991;233;2020-10-06;2429
2020-10-05;"Žilinský kraj";33;0;0;0;NA;347991;33;2020-10-05;2196
2020-10-04;"Žilinský kraj";35;0;0;0;NA;347991;35;2020-10-04;2163
2020-10-03;"Žilinský kraj";155;0;0;0;NA;347991;155;2020-10-03;2128
2020-10-02;"Žilinský kraj";105;0;0;0;NA;347991;105;2020-10-02;1973
2020-10-01;"Žilinský kraj";147;0;0;0;NA;347991;147;2020-10-01;1868
2020-09-30;"Žilinský kraj";163;0;0;0;NA;347991;163;2020-09-30;1721
2020-09-29;"Žilinský kraj";105;0;0;0;NA;347991;105;2020-09-29;1558
2020-09-28;"Žilinský kraj";34;0;0;0;NA;347991;34;2020-09-28;1453
2020-09-27;"Žilinský kraj";108;0;0;0;NA;347991;108;2020-09-27;1419
2020-09-26;"Žilinský kraj";96;0;0;0;NA;347991;96;2020-09-26;1311
2020-09-25;"Žilinský kraj";69;0;0;0;NA;347991;69;2020-09-25;1215
2020-09-24;"Žilinský kraj";100;0;0;0;NA;347991;100;2020-09-24;1146
2020-09-23;"Žilinský kraj";65;0;0;0;NA;347991;65;2020-09-23;1046
2020-09-22;"Žilinský kraj";65;0;0;0;NA;347991;65;2020-09-22;981
2020-09-21;"Žilinský kraj";47;0;0;0;NA;347991;47;2020-09-21;916
2020-09-20;"Žilinský kraj";4;0;0;0;NA;347991;4;2020-09-20;869
2020-09-19;"Žilinský kraj";6;0;0;0;NA;347991;6;2020-09-19;865
2020-09-18;"Žilinský kraj";82;0;0;0;NA;347991;82;2020-09-18;859
2020-09-17;"Žilinský kraj";30;0;0;0;NA;347991;30;2020-09-17;777
2020-09-16;"Žilinský kraj";34;0;0;0;NA;347991;34;2020-09-16;747
2020-09-15;"Žilinský kraj";12;0;0;0;NA;347991;12;2020-09-15;713
2020-09-14;"Žilinský kraj";39;0;0;0;NA;347991;39;2020-09-14;701
2020-09-13;"Žilinský kraj";6;0;0;0;NA;347991;6;2020-09-13;662
2020-09-12;"Žilinský kraj";4;0;0;0;NA;347991;4;2020-09-12;656
2020-09-11;"Žilinský kraj";31;0;0;0;NA;347991;31;2020-09-11;652
2020-09-10;"Žilinský kraj";31;12;0;12;NA;347991;31;2020-09-10;621
2020-09-09;"Žilinský kraj";23;0;0;0;NA;347991;23;2020-09-09;590
2020-09-08;"Žilinský kraj";25;0;0;0;NA;347991;25;2020-09-08;567
2020-09-07;"Žilinský kraj";11;0;0;0;NA;347991;11;2020-09-07;542
2020-09-06;"Žilinský kraj";0;0;0;0;NA;347991;0;2020-09-06;531
2020-09-05;"Žilinský kraj";2;0;0;0;NA;347991;2;2020-09-05;531
2020-09-04;"Žilinský kraj";33;0;0;0;NA;347991;33;2020-09-04;529
2020-09-03;"Žilinský kraj";18;0;0;0;NA;347991;18;2020-09-03;496
2020-09-02;"Žilinský kraj";16;0;0;0;NA;347991;16;2020-09-02;478
2020-09-01;"Žilinský kraj";4;0;0;0;NA;347991;4;2020-09-01;462
2020-08-31;"Žilinský kraj";5;0;0;0;NA;347991;5;2020-08-31;458
2020-08-30;"Žilinský kraj";3;0;0;0;NA;347991;3;2020-08-30;453
2020-08-29;"Žilinský kraj";5;0;0;0;NA;347991;5;2020-08-29;450
2020-08-28;"Žilinský kraj";13;0;0;0;NA;347991;13;2020-08-28;445
2020-08-27;"Žilinský kraj";18;0;0;0;NA;347991;18;2020-08-27;432
2020-08-26;"Žilinský kraj";8;0;0;0;NA;347991;8;2020-08-26;414
2020-08-25;"Žilinský kraj";2;0;0;0;NA;347991;2;2020-08-25;406
2020-08-24;"Žilinský kraj";5;0;0;0;NA;347991;5;2020-08-24;404
2020-08-23;"Žilinský kraj";0;0;0;0;NA;347991;0;2020-08-23;399
2020-08-22;"Žilinský kraj";0;0;0;0;NA;347991;0;2020-08-22;399
2020-08-21;"Žilinský kraj";10;0;0;0;NA;347991;10;2020-08-21;399
2020-08-20;"Žilinský kraj";13;0;0;0;NA;347991;13;2020-08-20;389
2020-08-19;"Žilinský kraj";7;0;0;0;NA;347991;7;2020-08-19;376
2020-08-18;"Žilinský kraj";9;0;0;0;NA;347991;9;2020-08-18;369
2020-08-17;"Žilinský kraj";1;0;0;0;NA;347991;1;2020-08-17;360
2020-08-16;"Žilinský kraj";0;0;0;0;NA;347991;0;2020-08-16;359
2020-08-15;"Žilinský kraj";0;0;0;0;NA;347991;0;2020-08-15;359
2020-08-14;"Žilinský kraj";4;0;0;0;NA;347991;4;2020-08-14;359
2020-08-13;"Žilinský kraj";2;0;0;0;NA;347991;2;2020-08-13;355
2020-08-12;"Žilinský kraj";0;0;0;0;NA;347991;0;2020-08-12;353
2020-08-11;"Žilinský kraj";4;0;0;0;NA;347991;4;2020-08-11;353
2020-08-10;"Žilinský kraj";1;0;0;0;NA;347991;1;2020-08-10;349
2020-08-09;"Žilinský kraj";0;0;0;0;NA;347991;0;2020-08-09;348
2020-08-08;"Žilinský kraj";3;0;0;0;NA;347991;3;2020-08-08;348
2020-08-07;"Žilinský kraj";8;0;0;0;NA;347991;8;2020-08-07;345
2020-08-06;"Žilinský kraj";1;0;0;0;NA;347991;1;2020-08-06;337
2020-08-05;"Žilinský kraj";1;0;0;0;NA;347991;1;2020-08-05;336
2020-08-04;"Žilinský kraj";2;0;0;0;NA;347991;2;2020-08-04;335
2020-08-03;"Žilinský kraj";0;0;0;0;NA;347991;0;2020-08-03;333
2020-08-02;"Žilinský kraj";1;0;0;0;NA;347991;1;2020-08-02;333
2020-08-01;"Žilinský kraj";0;0;0;0;NA;347991;0;2020-08-01;332
2020-07-31;"Žilinský kraj";4;0;0;0;NA;347991;4;2020-07-31;332
2020-07-30;"Žilinský kraj";2;0;0;0;NA;347991;2;2020-07-30;328
2020-07-29;"Žilinský kraj";2;0;0;0;NA;347991;2;2020-07-29;326
2020-07-28;"Žilinský kraj";4;0;0;0;NA;347991;4;2020-07-28;324
2020-07-27;"Žilinský kraj";6;0;0;0;NA;347991;6;2020-07-27;320
2020-07-26;"Žilinský kraj";0;0;0;0;NA;347991;0;2020-07-26;314
2020-07-25;"Žilinský kraj";0;0;0;0;NA;347991;0;2020-07-25;314
2020-07-24;"Žilinský kraj";2;0;0;0;NA;347991;2;2020-07-24;314
2020-07-23;"Žilinský kraj";0;0;0;0;NA;347991;0;2020-07-23;312
2020-07-22;"Žilinský kraj";1;0;0;0;NA;347991;1;2020-07-22;312
2020-07-21;"Žilinský kraj";2;0;0;0;NA;347991;2;2020-07-21;311
2020-07-20;"Žilinský kraj";3;0;0;0;NA;347991;3;2020-07-20;309
2020-07-19;"Žilinský kraj";0;0;0;0;NA;347991;0;2020-07-19;306
2020-07-18;"Žilinský kraj";0;0;0;0;NA;347991;0;2020-07-18;306
2020-07-17;"Žilinský kraj";2;0;0;0;NA;347991;2;2020-07-17;306
2020-07-16;"Žilinský kraj";2;0;0;0;NA;347991;2;2020-07-16;304
2020-07-15;"Žilinský kraj";2;0;0;0;NA;347991;2;2020-07-15;302
2020-07-14;"Žilinský kraj";1;0;0;0;NA;347991;1;2020-07-14;300
2020-07-13;"Žilinský kraj";0;0;0;0;NA;347991;0;2020-07-13;299
2020-07-12;"Žilinský kraj";0;0;0;0;NA;347991;0;2020-07-12;299
2020-07-11;"Žilinský kraj";2;0;0;0;NA;347991;2;2020-07-11;299
2020-07-10;"Žilinský kraj";3;0;0;0;NA;347991;3;2020-07-10;297
2020-07-09;"Žilinský kraj";2;0;0;0;NA;347991;2;2020-07-09;294
2020-07-08;"Žilinský kraj";10;0;0;0;NA;347991;10;2020-07-08;292
2020-07-07;"Žilinský kraj";7;0;0;0;NA;347991;7;2020-07-07;282
2020-07-06;"Žilinský kraj";0;0;0;0;NA;347991;0;2020-07-06;275
2020-07-05;"Žilinský kraj";0;0;0;0;NA;347991;0;2020-07-05;275
2020-07-04;"Žilinský kraj";10;0;0;0;NA;347991;10;2020-07-04;275
2020-07-03;"Žilinský kraj";18;0;0;0;NA;347991;18;2020-07-03;265
2020-07-02;"Žilinský kraj";7;0;0;0;NA;347991;7;2020-07-02;247
2020-07-01;"Žilinský kraj";0;0;0;0;NA;347991;0;2020-07-01;240
2020-06-30;"Žilinský kraj";4;0;0;0;NA;347991;4;2020-06-30;240
2020-06-29;"Žilinský kraj";0;0;0;0;NA;347991;0;2020-06-29;236
2020-06-28;"Žilinský kraj";1;0;0;0;NA;347991;1;2020-06-28;236
2020-06-27;"Žilinský kraj";3;0;0;0;NA;347991;3;2020-06-27;235
2020-06-26;"Žilinský kraj";5;0;0;0;NA;347991;5;2020-06-26;232
2020-06-25;"Žilinský kraj";7;0;0;0;NA;347991;7;2020-06-25;227
2020-06-24;"Žilinský kraj";11;0;0;0;NA;347991;11;2020-06-24;220
2020-06-23;"Žilinský kraj";9;0;0;0;NA;347991;9;2020-06-23;209
2020-06-22;"Žilinský kraj";0;0;0;0;NA;347991;0;2020-06-22;200
2020-06-21;"Žilinský kraj";1;0;0;0;NA;347991;1;2020-06-21;200
2020-06-20;"Žilinský kraj";1;0;0;0;NA;347991;1;2020-06-20;199
2020-06-19;"Žilinský kraj";4;0;0;0;NA;347991;4;2020-06-19;198
2020-06-18;"Žilinský kraj";1;0;0;0;NA;347991;1;2020-06-18;194
2020-06-17;"Žilinský kraj";0;0;0;0;NA;347991;0;2020-06-17;193
2020-06-16;"Žilinský kraj";1;0;0;0;NA;347991;1;2020-06-16;193
2020-06-14;"Žilinský kraj";0;0;0;0;NA;347991;0;2020-06-14;192
2020-06-13;"Žilinský kraj";0;0;0;0;NA;347991;0;2020-06-13;192
2020-06-12;"Žilinský kraj";0;0;0;0;NA;347991;0;2020-06-12;192
2020-06-11;"Žilinský kraj";0;0;0;0;NA;347991;0;2020-06-11;192
2020-06-10;"Žilinský kraj";0;0;0;0;NA;347991;0;2020-06-10;192
2020-06-09;"Žilinský kraj";1;0;0;0;NA;347991;1;2020-06-09;192
2020-06-08;"Žilinský kraj";0;0;0;0;NA;347991;0;2020-06-08;191
2020-06-07;"Žilinský kraj";0;0;0;0;NA;347991;0;2020-06-07;191
2020-06-05;"Žilinský kraj";0;0;0;0;NA;347991;0;2020-06-05;191
2020-06-03;"Žilinský kraj";0;0;0;0;NA;347991;0;2020-06-03;191
2020-06-02;"Žilinský kraj";0;0;0;0;NA;347991;0;2020-06-02;191
2020-05-31;"Žilinský kraj";0;0;0;0;NA;347991;0;2020-05-31;191
2020-05-29;"Žilinský kraj";0;0;0;0;NA;347991;0;2020-05-29;191
2020-05-27;"Žilinský kraj";1;0;0;0;NA;347991;1;2020-05-27;191
2020-05-26;"Žilinský kraj";1;0;0;0;NA;347991;1;2020-05-26;190
2020-05-25;"Žilinský kraj";0;0;0;0;NA;347991;0;2020-05-25;189
2020-05-24;"Žilinský kraj";0;0;0;0;NA;347991;0;2020-05-24;189
2020-05-23;"Žilinský kraj";0;0;0;0;NA;347991;0;2020-05-23;189
2020-05-22;"Žilinský kraj";0;0;0;0;NA;347991;0;2020-05-22;189
2020-05-21;"Žilinský kraj";0;0;0;0;NA;347991;0;2020-05-21;189
2020-05-20;"Žilinský kraj";0;0;0;0;NA;347991;0;2020-05-20;189
2020-05-19;"Žilinský kraj";1;0;0;0;NA;347991;1;2020-05-19;189
2020-05-17;"Žilinský kraj";0;0;0;0;NA;347991;0;2020-05-17;188
2020-05-16;"Žilinský kraj";0;0;0;0;NA;347991;0;2020-05-16;188
2020-05-15;"Žilinský kraj";0;0;0;0;NA;347991;0;2020-05-15;188
2020-05-14;"Žilinský kraj";0;0;0;0;NA;347991;0;2020-05-14;188
2020-05-13;"Žilinský kraj";0;0;0;0;NA;347991;0;2020-05-13;188
2020-05-12;"Žilinský kraj";0;0;0;0;NA;347991;0;2020-05-12;188
2020-05-11;"Žilinský kraj";0;0;0;0;NA;347991;0;2020-05-11;188
2020-05-09;"Žilinský kraj";0;0;0;0;NA;347991;0;2020-05-09;188
2020-05-07;"Žilinský kraj";0;0;0;0;NA;347991;0;2020-05-07;188
2020-05-06;"Žilinský kraj";2;0;0;0;NA;347991;2;2020-05-06;188
2020-05-05;"Žilinský kraj";3;0;0;0;NA;347991;3;2020-05-05;186
2020-05-04;"Žilinský kraj";3;0;0;0;NA;347991;3;2020-05-04;183
2020-05-03;"Žilinský kraj";1;0;0;0;NA;347991;1;2020-05-03;180
2020-05-02;"Žilinský kraj";0;0;0;0;NA;347991;0;2020-05-02;179
2020-05-01;"Žilinský kraj";1;0;0;0;NA;347991;1;2020-05-01;179
2020-04-30;"Žilinský kraj";0;0;0;0;NA;347991;0;2020-04-30;178
2020-04-29;"Žilinský kraj";0;0;0;0;NA;347991;0;2020-04-29;178
2020-04-28;"Žilinský kraj";0;0;0;0;NA;347991;0;2020-04-28;178
2020-04-27;"Žilinský kraj";0;0;0;0;NA;347991;0;2020-04-27;178
2020-04-26;"Žilinský kraj";0;0;0;0;NA;347991;0;2020-04-26;178
2020-04-25;"Žilinský kraj";2;0;0;0;NA;347991;2;2020-04-25;178
2020-04-24;"Žilinský kraj";1;0;0;0;NA;347991;1;2020-04-24;176
2020-04-23;"Žilinský kraj";2;0;0;0;NA;347991;2;2020-04-23;175
2020-04-22;"Žilinský kraj";9;0;0;0;NA;347991;9;2020-04-22;173
2020-04-21;"Žilinský kraj";1;0;0;0;NA;347991;1;2020-04-21;164
2020-04-20;"Žilinský kraj";4;0;0;0;NA;347991;4;2020-04-20;163
2020-04-19;"Žilinský kraj";0;0;0;0;NA;347991;0;2020-04-19;159
2020-04-18;"Žilinský kraj";49;0;0;0;NA;347991;49;2020-04-18;159
2020-04-17;"Žilinský kraj";3;0;0;0;NA;347991;3;2020-04-17;110
2020-04-16;"Žilinský kraj";4;0;0;0;NA;347991;4;2020-04-16;107
2020-04-15;"Žilinský kraj";7;0;0;0;NA;347991;7;2020-04-15;103
2020-04-14;"Žilinský kraj";1;0;0;0;NA;347991;1;2020-04-14;96
2020-04-13;"Žilinský kraj";2;0;0;0;NA;347991;2;2020-04-13;95
2020-04-12;"Žilinský kraj";5;0;0;0;NA;347991;5;2020-04-12;93
2020-04-11;"Žilinský kraj";2;0;0;0;NA;347991;2;2020-04-11;88
2020-04-10;"Žilinský kraj";1;0;0;0;NA;347991;1;2020-04-10;86
2020-04-09;"Žilinský kraj";1;0;0;0;NA;347991;1;2020-04-09;85
2020-04-08;"Žilinský kraj";3;0;0;0;NA;347991;3;2020-04-08;84
2020-04-07;"Žilinský kraj";5;0;0;0;NA;347991;5;2020-04-07;81
2020-04-06;"Žilinský kraj";6;0;0;0;NA;347991;6;2020-04-06;76
2020-04-05;"Žilinský kraj";8;0;0;0;NA;347991;8;2020-04-05;70
2020-04-04;"Žilinský kraj";0;0;0;0;NA;347991;0;2020-04-04;62
2020-04-03;"Žilinský kraj";3;0;0;0;NA;347991;3;2020-04-03;62
2020-04-02;"Žilinský kraj";5;0;0;0;NA;347991;5;2020-04-02;59
2020-04-01;"Žilinský kraj";4;0;0;0;NA;347991;4;2020-04-01;54
2020-03-31;"Žilinský kraj";1;0;0;0;NA;347991;1;2020-03-31;50
2020-03-30;"Žilinský kraj";3;0;0;0;NA;347991;3;2020-03-30;49
2020-03-29;"Žilinský kraj";0;0;0;0;NA;347991;0;2020-03-29;46
2020-03-28;"Žilinský kraj";1;0;0;0;NA;347991;1;2020-03-28;46
2020-03-27;"Žilinský kraj";9;0;0;0;NA;347991;9;2020-03-27;45
2020-03-26;"Žilinský kraj";4;0;0;0;NA;347991;4;2020-03-26;36
2020-03-25;"Žilinský kraj";1;0;0;0;NA;347991;1;2020-03-25;32
2020-03-24;"Žilinský kraj";2;0;0;0;NA;347991;2;2020-03-24;31
2020-03-23;"Žilinský kraj";3;0;0;0;NA;347991;3;2020-03-23;29
2020-03-22;"Žilinský kraj";1;0;0;0;NA;347991;1;2020-03-22;26
2020-03-21;"Žilinský kraj";2;0;0;0;NA;347991;2;2020-03-21;25
2020-03-20;"Žilinský kraj";4;0;0;0;NA;347991;4;2020-03-20;23
2020-03-19;"Žilinský kraj";2;0;0;0;NA;347991;2;2020-03-19;19
2020-03-18;"Žilinský kraj";1;0;0;0;NA;347991;1;2020-03-18;17
2020-03-17;"Žilinský kraj";5;0;0;0;NA;347991;5;2020-03-17;16
2020-03-16;"Žilinský kraj";1;0;0;0;NA;347991;1;2020-03-16;11
2020-03-15;"Žilinský kraj";2;0;0;0;NA;347991;2;2020-03-15;10
2020-03-14;"Žilinský kraj";1;0;0;0;NA;347991;1;2020-03-14;8
2020-03-13;"Žilinský kraj";5;0;0;0;NA;347991;5;2020-03-13;7
2020-03-12;"Žilinský kraj";1;0;0;0;NA;347991;1;2020-03-12;2
2020-03-11;"Žilinský kraj";0;0;0;0;NA;347991;0;2020-03-11;1
2020-03-09;"Žilinský kraj";1;0;0;0;NA;347991;1;2020-03-09;1
2020-03-08;"Žilinský kraj";0;0;0;0;NA;347991;0;2020-03-08;0
2020-03-07;"Žilinský kraj";0;0;0;0;NA;347991;0;2020-03-07;0
2020-03-06;"Žilinský kraj";0;0;0;0;NA;347991;0;2020-03-06;0
