"Datum";"Region";"PCR_Pos";"Ag_Neg";"Ag_Pos";"Total";"Pocet.potvrdenych";"Potvrdenych";"newcases";"date";"positive"
2022-05-26;"Banskobystrický kraj";4;0;0;0;183085;274501;4;2022-05-26;274501
2022-05-25;"Banskobystrický kraj";14;199;4;203;NA;274501;18;2022-05-25;274497
2022-05-24;"Banskobystrický kraj";14;253;4;257;NA;274501;18;2022-05-24;274479
2022-05-23;"Banskobystrický kraj";12;551;6;557;NA;274501;18;2022-05-23;274461
2022-05-22;"Banskobystrický kraj";1;32;2;34;NA;274501;3;2022-05-22;274443
2022-05-21;"Banskobystrický kraj";9;13;1;14;NA;274501;10;2022-05-21;274440
2022-05-20;"Banskobystrický kraj";17;198;8;206;NA;274501;25;2022-05-20;274430
2022-05-19;"Banskobystrický kraj";6;383;4;387;NA;274501;10;2022-05-19;274405
2022-05-18;"Banskobystrický kraj";23;210;8;218;NA;274501;31;2022-05-18;274395
2022-05-17;"Banskobystrický kraj";6;295;7;302;NA;274501;13;2022-05-17;274364
2022-05-16;"Banskobystrický kraj";22;618;16;634;NA;274501;38;2022-05-16;274351
2022-05-15;"Banskobystrický kraj";4;27;1;28;NA;274501;5;2022-05-15;274313
2022-05-14;"Banskobystrický kraj";4;17;0;17;NA;274501;4;2022-05-14;274308
2022-05-13;"Banskobystrický kraj";32;323;6;329;NA;274501;38;2022-05-13;274304
2022-05-12;"Banskobystrický kraj";16;516;15;531;NA;274501;31;2022-05-12;274266
2022-05-11;"Banskobystrický kraj";19;374;9;383;NA;274501;28;2022-05-11;274235
2022-05-10;"Banskobystrický kraj";49;267;11;278;NA;274501;60;2022-05-10;274207
2022-05-09;"Banskobystrický kraj";35;714;24;738;NA;274501;59;2022-05-09;274147
2022-05-08;"Banskobystrický kraj";1;64;0;64;NA;274501;1;2022-05-08;274088
2022-05-07;"Banskobystrický kraj";6;111;1;112;NA;274501;7;2022-05-07;274087
2022-05-06;"Banskobystrický kraj";51;276;6;282;NA;274501;57;2022-05-06;274080
2022-05-05;"Banskobystrický kraj";41;555;11;566;NA;274501;52;2022-05-05;274023
2022-05-04;"Banskobystrický kraj";45;498;14;512;NA;274501;59;2022-05-04;273971
2022-05-03;"Banskobystrický kraj";60;421;5;426;NA;274501;65;2022-05-03;273912
2022-05-02;"Banskobystrický kraj";48;1063;38;1101;NA;274501;86;2022-05-02;273847
2022-05-01;"Banskobystrický kraj";12;69;1;70;NA;274501;13;2022-05-01;273761
2022-04-30;"Banskobystrický kraj";31;82;5;87;NA;274501;36;2022-04-30;273748
2022-04-29;"Banskobystrický kraj";57;681;16;697;NA;274501;73;2022-04-29;273712
2022-04-28;"Banskobystrický kraj";72;972;20;992;NA;274501;92;2022-04-28;273639
2022-04-27;"Banskobystrický kraj";85;866;29;895;NA;274501;114;2022-04-27;273547
2022-04-26;"Banskobystrický kraj";97;720;18;738;NA;274501;115;2022-04-26;273433
2022-04-25;"Banskobystrický kraj";148;1463;33;1496;NA;274501;181;2022-04-25;273318
2022-04-24;"Banskobystrický kraj";16;139;5;144;NA;274501;21;2022-04-24;273137
2022-04-23;"Banskobystrický kraj";110;64;9;73;NA;274501;119;2022-04-23;273116
2022-04-22;"Banskobystrický kraj";140;1044;32;1076;NA;274501;172;2022-04-22;272997
2022-04-21;"Banskobystrický kraj";154;1228;41;1269;NA;274501;195;2022-04-21;272825
2022-04-20;"Banskobystrický kraj";243;2052;141;2193;NA;274501;384;2022-04-20;272630
2022-04-19;"Banskobystrický kraj";209;1976;94;2070;NA;274501;303;2022-04-19;272246
2022-04-18;"Banskobystrický kraj";25;113;7;120;NA;274501;32;2022-04-18;271943
2022-04-17;"Banskobystrický kraj";105;54;3;57;NA;274501;108;2022-04-17;271911
2022-04-16;"Banskobystrický kraj";58;96;12;108;NA;274501;70;2022-04-16;271803
2022-04-15;"Banskobystrický kraj";44;106;5;111;NA;274501;49;2022-04-15;271733
2022-04-14;"Banskobystrický kraj";230;1095;31;1126;NA;274501;261;2022-04-14;271684
2022-04-13;"Banskobystrický kraj";212;932;60;992;NA;274501;272;2022-04-13;271423
2022-04-12;"Banskobystrický kraj";242;1066;60;1126;NA;274501;302;2022-04-12;271151
2022-04-11;"Banskobystrický kraj";300;2346;99;2445;NA;274501;399;2022-04-11;270849
2022-04-10;"Banskobystrický kraj";62;260;28;288;NA;274501;90;2022-04-10;270450
2022-04-09;"Banskobystrický kraj";147;112;16;128;NA;274501;163;2022-04-09;270360
2022-04-08;"Banskobystrický kraj";284;1193;95;1288;NA;274501;379;2022-04-08;270197
2022-04-07;"Banskobystrický kraj";298;1622;74;1696;NA;274501;372;2022-04-07;269818
2022-04-06;"Banskobystrický kraj";505;1191;89;1280;NA;274501;594;2022-04-06;269446
2022-04-05;"Banskobystrický kraj";458;1359;84;1443;NA;274501;542;2022-04-05;268852
2022-04-04;"Banskobystrický kraj";553;2810;177;2987;NA;274501;730;2022-04-04;268310
2022-04-03;"Banskobystrický kraj";66;441;83;524;NA;274501;149;2022-04-03;267580
2022-04-02;"Banskobystrický kraj";208;133;34;167;NA;274501;242;2022-04-02;267431
2022-04-01;"Banskobystrický kraj";529;1195;137;1332;NA;274501;666;2022-04-01;267189
2022-03-31;"Banskobystrický kraj";516;1775;102;1877;NA;274501;618;2022-03-31;266523
2022-03-30;"Banskobystrický kraj";734;1541;125;1666;NA;274501;859;2022-03-30;265905
2022-03-29;"Banskobystrický kraj";666;1406;161;1567;NA;274501;827;2022-03-29;265046
2022-03-28;"Banskobystrický kraj";618;2523;318;2841;NA;274501;936;2022-03-28;264219
2022-03-27;"Banskobystrický kraj";147;687;114;801;NA;274501;261;2022-03-27;263283
2022-03-26;"Banskobystrický kraj";343;150;53;203;NA;274501;396;2022-03-26;263022
2022-03-25;"Banskobystrický kraj";721;1382;192;1574;NA;274501;913;2022-03-25;262626
2022-03-24;"Banskobystrický kraj";769;1789;162;1951;NA;274501;931;2022-03-24;261713
2022-03-23;"Banskobystrický kraj";823;1643;201;1844;NA;274501;1024;2022-03-23;260782
2022-03-22;"Banskobystrický kraj";1148;1703;220;1923;NA;274501;1368;2022-03-22;259758
2022-03-21;"Banskobystrický kraj";879;2711;356;3067;NA;274501;1235;2022-03-21;258390
2022-03-20;"Banskobystrický kraj";172;605;174;779;NA;274501;346;2022-03-20;257155
2022-03-19;"Banskobystrický kraj";529;218;89;307;NA;274501;618;2022-03-19;256809
2022-03-18;"Banskobystrický kraj";819;2081;200;2281;NA;274501;1019;2022-03-18;256191
2022-03-17;"Banskobystrický kraj";981;3476;224;3700;NA;274501;1205;2022-03-17;255172
2022-03-16;"Banskobystrický kraj";1189;1396;235;1631;NA;274501;1424;2022-03-16;253967
2022-03-15;"Banskobystrický kraj";1420;1730;231;1961;NA;274501;1651;2022-03-15;252543
2022-03-14;"Banskobystrický kraj";948;3220;426;3646;NA;274501;1374;2022-03-14;250892
2022-03-13;"Banskobystrický kraj";224;577;216;793;NA;274501;440;2022-03-13;249518
2022-03-12;"Banskobystrický kraj";625;262;94;356;NA;274501;719;2022-03-12;249078
2022-03-11;"Banskobystrický kraj";1144;1817;287;2104;NA;274501;1431;2022-03-11;248359
2022-03-10;"Banskobystrický kraj";1325;2126;311;2437;NA;274501;1636;2022-03-10;246928
2022-03-09;"Banskobystrický kraj";1370;2036;333;2369;NA;274501;1703;2022-03-09;245292
2022-03-08;"Banskobystrický kraj";1738;2329;376;2705;NA;274501;2114;2022-03-08;243589
2022-03-07;"Banskobystrický kraj";1048;4977;604;5581;NA;274501;1652;2022-03-07;241475
2022-03-06;"Banskobystrický kraj";356;1265;278;1543;NA;274501;634;2022-03-06;239823
2022-03-05;"Banskobystrický kraj";745;497;180;677;NA;274501;925;2022-03-05;239189
2022-03-04;"Banskobystrický kraj";1302;2576;391;2967;NA;274501;1693;2022-03-04;238264
2022-03-03;"Banskobystrický kraj";1766;3466;386;3852;NA;274501;2152;2022-03-03;236571
2022-03-02;"Banskobystrický kraj";1515;5604;415;6019;NA;274501;1930;2022-03-02;234419
2022-03-01;"Banskobystrický kraj";1842;3325;396;3721;NA;274501;2238;2022-03-01;232489
2022-02-28;"Banskobystrický kraj";1050;4913;708;5621;NA;274501;1758;2022-02-28;230251
2022-02-27;"Banskobystrický kraj";604;1162;303;1465;NA;274501;907;2022-02-27;228493
2022-02-26;"Banskobystrický kraj";909;528;154;682;NA;274501;1063;2022-02-26;227586
2022-02-25;"Banskobystrický kraj";1591;2519;430;2949;NA;274501;2021;2022-02-25;226523
2022-02-24;"Banskobystrický kraj";1781;3858;404;4262;NA;274501;2185;2022-02-24;224502
2022-02-23;"Banskobystrický kraj";2094;2869;454;3323;NA;274501;2548;2022-02-23;222317
2022-02-22;"Banskobystrický kraj";2195;3737;469;4206;NA;274501;2664;2022-02-22;219769
2022-02-21;"Banskobystrický kraj";1409;5733;806;6539;NA;274501;2215;2022-02-21;217105
2022-02-20;"Banskobystrický kraj";484;1717;423;2140;NA;274501;907;2022-02-20;214890
2022-02-19;"Banskobystrický kraj";1180;774;242;1016;NA;274501;1422;2022-02-19;213983
2022-02-18;"Banskobystrický kraj";2473;3620;541;4161;NA;274501;3014;2022-02-18;212561
2022-02-17;"Banskobystrický kraj";1924;4239;460;4699;NA;274501;2384;2022-02-17;209547
2022-02-16;"Banskobystrický kraj";1856;3635;543;4178;NA;274501;2399;2022-02-16;207163
2022-02-15;"Banskobystrický kraj";2287;4460;584;5044;NA;274501;2871;2022-02-15;204764
2022-02-14;"Banskobystrický kraj";2071;6848;891;7739;NA;274501;2962;2022-02-14;201893
2022-02-13;"Banskobystrický kraj";577;2247;471;2718;NA;274501;1048;2022-02-13;198931
2022-02-12;"Banskobystrický kraj";1308;906;308;1214;NA;274501;1616;2022-02-12;197883
2022-02-11;"Banskobystrický kraj";2684;3845;555;4400;NA;274501;3239;2022-02-11;196267
2022-02-10;"Banskobystrický kraj";1765;5733;567;6300;NA;274501;2332;2022-02-10;193028
2022-02-09;"Banskobystrický kraj";2544;3794;569;4363;NA;274501;3113;2022-02-09;190696
2022-02-08;"Banskobystrický kraj";1806;4418;538;4956;NA;274501;2344;2022-02-08;187583
2022-02-07;"Banskobystrický kraj";1683;7388;728;8116;NA;274501;2411;2022-02-07;185239
2022-02-06;"Banskobystrický kraj";604;2244;392;2636;NA;274501;996;2022-02-06;182828
2022-02-05;"Banskobystrický kraj";1032;1434;233;1667;NA;274501;1265;2022-02-05;181832
2022-02-04;"Banskobystrický kraj";1866;3745;438;4183;NA;274501;2304;2022-02-04;180567
2022-02-03;"Banskobystrický kraj";1561;5433;359;5792;NA;274501;1920;2022-02-03;178263
2022-02-02;"Banskobystrický kraj";1716;4793;395;5188;NA;274501;2111;2022-02-02;176343
2022-02-01;"Banskobystrický kraj";1918;4558;410;4968;NA;274501;2328;2022-02-01;174232
2022-01-31;"Banskobystrický kraj";779;9006;553;9559;NA;274501;1332;2022-01-31;171904
2022-01-30;"Banskobystrický kraj";412;3055;267;3322;NA;274501;679;2022-01-30;170572
2022-01-29;"Banskobystrický kraj";981;1155;174;1329;NA;274501;1155;2022-01-29;169893
2022-01-28;"Banskobystrický kraj";1040;3814;313;4127;NA;274501;1353;2022-01-28;168738
2022-01-27;"Banskobystrický kraj";1035;4955;225;5180;NA;274501;1260;2022-01-27;167385
2022-01-26;"Banskobystrický kraj";1060;4035;213;4248;NA;274501;1273;2022-01-26;166125
2022-01-25;"Banskobystrický kraj";1001;6119;257;6376;NA;274501;1258;2022-01-25;164852
2022-01-24;"Banskobystrický kraj";557;10186;257;10443;NA;274501;814;2022-01-24;163594
2022-01-23;"Banskobystrický kraj";246;3710;129;3839;NA;274501;375;2022-01-23;162780
2022-01-22;"Banskobystrický kraj";411;1077;64;1141;NA;274501;475;2022-01-22;162405
2022-01-21;"Banskobystrický kraj";578;3491;113;3604;NA;274501;691;2022-01-21;161930
2022-01-20;"Banskobystrický kraj";490;3810;91;3901;NA;274501;581;2022-01-20;161239
2022-01-19;"Banskobystrický kraj";421;4173;98;4271;NA;274501;519;2022-01-19;160658
2022-01-18;"Banskobystrický kraj";517;4737;95;4832;NA;274501;612;2022-01-18;160139
2022-01-17;"Banskobystrický kraj";269;8102;114;8216;NA;274501;383;2022-01-17;159527
2022-01-16;"Banskobystrický kraj";63;2746;84;2830;NA;274501;147;2022-01-16;159144
2022-01-15;"Banskobystrický kraj";287;858;16;874;NA;274501;303;2022-01-15;158997
2022-01-14;"Banskobystrický kraj";165;2758;67;2825;NA;274501;232;2022-01-14;158694
2022-01-13;"Banskobystrický kraj";182;3411;57;3468;NA;274501;239;2022-01-13;158462
2022-01-12;"Banskobystrický kraj";241;3787;67;3854;NA;274501;308;2022-01-12;158223
2022-01-11;"Banskobystrický kraj";327;4970;74;5044;NA;274501;401;2022-01-11;157915
2022-01-10;"Banskobystrický kraj";219;8173;113;8286;NA;274501;332;2022-01-10;157514
2022-01-09;"Banskobystrický kraj";54;3514;38;3552;NA;274501;92;2022-01-09;157182
2022-01-08;"Banskobystrický kraj";177;1054;40;1094;NA;274501;217;2022-01-08;157090
2022-01-07;"Banskobystrický kraj";320;3087;86;3173;NA;274501;406;2022-01-07;156873
2022-01-06;"Banskobystrický kraj";101;985;21;1006;NA;274501;122;2022-01-06;156467
2022-01-05;"Banskobystrický kraj";376;2852;67;2919;NA;274501;443;2022-01-05;156345
2022-01-04;"Banskobystrický kraj";458;4197;72;4269;NA;274501;530;2022-01-04;155902
2022-01-03;"Banskobystrický kraj";420;8216;115;8331;NA;274501;535;2022-01-03;155372
2022-01-02;"Banskobystrický kraj";117;2239;95;2334;NA;274501;212;2022-01-02;154837
2022-01-01;"Banskobystrický kraj";33;80;4;84;NA;274501;37;2022-01-01;154625
2021-12-31;"Banskobystrický kraj";314;1803;68;1871;NA;274501;382;2021-12-31;154588
2021-12-30;"Banskobystrický kraj";308;2833;88;2921;NA;274501;396;2021-12-30;154206
2021-12-29;"Banskobystrický kraj";390;2448;83;2531;NA;274501;473;2021-12-29;153810
2021-12-28;"Banskobystrický kraj";492;2902;95;2997;NA;274501;587;2021-12-28;153337
2021-12-27;"Banskobystrický kraj";397;5029;203;5232;NA;274501;600;2021-12-27;152750
2021-12-26;"Banskobystrický kraj";76;1245;62;1307;NA;274501;138;2021-12-26;152150
2021-12-25;"Banskobystrický kraj";107;373;45;418;NA;274501;152;2021-12-25;152012
2021-12-24;"Banskobystrický kraj";116;213;10;223;NA;274501;126;2021-12-24;151860
2021-12-23;"Banskobystrický kraj";429;3501;107;3608;NA;274501;536;2021-12-23;151734
2021-12-22;"Banskobystrický kraj";393;3394;106;3500;NA;274501;499;2021-12-22;151198
2021-12-21;"Banskobystrický kraj";508;4173;88;4261;NA;274501;596;2021-12-21;150699
2021-12-20;"Banskobystrický kraj";424;7610;186;7796;NA;274501;610;2021-12-20;150103
2021-12-19;"Banskobystrický kraj";39;2681;87;2768;NA;274501;126;2021-12-19;149493
2021-12-18;"Banskobystrický kraj";333;1036;67;1103;NA;274501;400;2021-12-18;149367
2021-12-17;"Banskobystrický kraj";465;3805;102;3907;NA;274501;567;2021-12-17;148967
2021-12-16;"Banskobystrický kraj";499;4278;116;4394;NA;274501;615;2021-12-16;148400
2021-12-15;"Banskobystrický kraj";554;4772;102;4874;NA;274501;656;2021-12-15;147785
2021-12-14;"Banskobystrický kraj";729;4614;108;4722;NA;274501;837;2021-12-14;147129
2021-12-13;"Banskobystrický kraj";470;8201;222;8423;NA;274501;692;2021-12-13;146292
2021-12-12;"Banskobystrický kraj";161;3332;101;3433;NA;274501;262;2021-12-12;145600
2021-12-11;"Banskobystrický kraj";568;1166;82;1248;NA;274501;650;2021-12-11;145338
2021-12-10;"Banskobystrický kraj";731;4033;185;4218;NA;274501;916;2021-12-10;144688
2021-12-09;"Banskobystrický kraj";652;4381;139;4520;NA;274501;791;2021-12-09;143772
2021-12-08;"Banskobystrický kraj";1087;4100;169;4269;NA;274501;1256;2021-12-08;142981
2021-12-07;"Banskobystrický kraj";1104;5410;201;5611;NA;274501;1305;2021-12-07;141725
2021-12-06;"Banskobystrický kraj";647;9113;324;9437;NA;274501;971;2021-12-06;140420
2021-12-05;"Banskobystrický kraj";217;3425;155;3580;NA;274501;372;2021-12-05;139449
2021-12-04;"Banskobystrický kraj";654;1334;131;1465;NA;274501;785;2021-12-04;139077
2021-12-03;"Banskobystrický kraj";1117;5057;246;5303;NA;274501;1363;2021-12-03;138292
2021-12-02;"Banskobystrický kraj";1710;5259;258;5517;NA;274501;1968;2021-12-02;136929
2021-12-01;"Banskobystrický kraj";947;4753;264;5017;NA;274501;1211;2021-12-01;134961
2021-11-30;"Banskobystrický kraj";1266;6543;245;6788;NA;274501;1511;2021-11-30;133750
2021-11-29;"Banskobystrický kraj";591;10653;468;11121;NA;274501;1059;2021-11-29;132239
2021-11-28;"Banskobystrický kraj";418;4289;216;4505;NA;274501;634;2021-11-28;131180
2021-11-27;"Banskobystrický kraj";827;1781;208;1989;NA;274501;1035;2021-11-27;130546
2021-11-26;"Banskobystrický kraj";963;4771;354;5125;NA;274501;1317;2021-11-26;129511
2021-11-25;"Banskobystrický kraj";1110;5911;350;6261;NA;274501;1460;2021-11-25;128194
2021-11-24;"Banskobystrický kraj";1387;5956;330;6286;NA;274501;1717;2021-11-24;126734
2021-11-23;"Banskobystrický kraj";1436;6082;377;6459;NA;274501;1813;2021-11-23;125017
2021-11-22;"Banskobystrický kraj";489;8727;579;9306;NA;274501;1068;2021-11-22;123204
2021-11-21;"Banskobystrický kraj";408;4109;307;4416;NA;274501;715;2021-11-21;122136
2021-11-20;"Banskobystrický kraj";985;1758;199;1957;NA;274501;1184;2021-11-20;121421
2021-11-19;"Banskobystrický kraj";1006;4886;470;5356;NA;274501;1476;2021-11-19;120237
2021-11-18;"Banskobystrický kraj";979;8037;620;8657;NA;274501;1599;2021-11-18;118761
2021-11-17;"Banskobystrický kraj";772;1051;147;1198;NA;274501;919;2021-11-17;117162
2021-11-16;"Banskobystrický kraj";1130;5473;453;5926;NA;274501;1583;2021-11-16;116243
2021-11-15;"Banskobystrický kraj";749;7884;588;8472;NA;274501;1337;2021-11-15;114660
2021-11-14;"Banskobystrický kraj";311;2629;302;2931;NA;274501;613;2021-11-14;113323
2021-11-13;"Banskobystrický kraj";761;1471;214;1685;NA;274501;975;2021-11-13;112710
2021-11-12;"Banskobystrický kraj";972;5019;434;5453;NA;274501;1406;2021-11-12;111735
2021-11-11;"Banskobystrický kraj";1023;5584;345;5929;NA;274501;1368;2021-11-11;110329
2021-11-10;"Banskobystrický kraj";950;4713;333;5046;NA;274501;1283;2021-11-10;108961
2021-11-09;"Banskobystrický kraj";921;4616;283;4899;NA;274501;1204;2021-11-09;107678
2021-11-08;"Banskobystrický kraj";519;7249;488;7737;NA;274501;1007;2021-11-08;106474
2021-11-07;"Banskobystrický kraj";460;2479;258;2737;NA;274501;718;2021-11-07;105467
2021-11-06;"Banskobystrický kraj";505;1344;170;1514;NA;274501;675;2021-11-06;104749
2021-11-05;"Banskobystrický kraj";997;4773;342;5115;NA;274501;1339;2021-11-05;104074
2021-11-04;"Banskobystrický kraj";1086;4811;248;5059;NA;274501;1334;2021-11-04;102735
2021-11-03;"Banskobystrický kraj";976;4825;330;5155;NA;274501;1306;2021-11-03;101401
2021-11-02;"Banskobystrický kraj";538;5709;492;6201;NA;274501;1030;2021-11-02;100095
2021-11-01;"Banskobystrický kraj";390;1178;132;1310;NA;274501;522;2021-11-01;99065
2021-10-31;"Banskobystrický kraj";150;1700;210;1910;NA;274501;360;2021-10-31;98543
2021-10-30;"Banskobystrický kraj";449;1508;140;1648;NA;274501;589;2021-10-30;98183
2021-10-29;"Banskobystrický kraj";780;4178;286;4464;NA;274501;1066;2021-10-29;97594
2021-10-28;"Banskobystrický kraj";744;4182;247;4429;NA;274501;991;2021-10-28;96528
2021-10-27;"Banskobystrický kraj";664;4577;233;4810;NA;274501;897;2021-10-27;95537
2021-10-26;"Banskobystrický kraj";700;3673;187;3860;NA;274501;887;2021-10-26;94640
2021-10-25;"Banskobystrický kraj";376;5478;257;5735;NA;274501;633;2021-10-25;93753
2021-10-24;"Banskobystrický kraj";161;1707;143;1850;NA;274501;304;2021-10-24;93120
2021-10-23;"Banskobystrický kraj";238;1286;79;1365;NA;274501;317;2021-10-23;92816
2021-10-22;"Banskobystrický kraj";530;3816;185;4001;NA;274501;715;2021-10-22;92499
2021-10-21;"Banskobystrický kraj";416;4128;140;4268;NA;274501;556;2021-10-21;91784
2021-10-20;"Banskobystrický kraj";387;3615;123;3738;NA;274501;510;2021-10-20;91228
2021-10-19;"Banskobystrický kraj";419;4094;103;4197;NA;274501;522;2021-10-19;90718
2021-10-18;"Banskobystrický kraj";162;5286;175;5461;NA;274501;337;2021-10-18;90196
2021-10-17;"Banskobystrický kraj";26;1555;71;1626;NA;274501;97;2021-10-17;89859
2021-10-16;"Banskobystrický kraj";162;1387;50;1437;NA;274501;212;2021-10-16;89762
2021-10-15;"Banskobystrický kraj";187;3693;81;3774;NA;274501;268;2021-10-15;89550
2021-10-14;"Banskobystrický kraj";198;3705;47;3752;NA;274501;245;2021-10-14;89282
2021-10-13;"Banskobystrický kraj";217;3068;55;3123;NA;274501;272;2021-10-13;89037
2021-10-12;"Banskobystrický kraj";301;3743;59;3802;NA;274501;360;2021-10-12;88765
2021-10-11;"Banskobystrický kraj";128;4734;96;4830;NA;274501;224;2021-10-11;88405
2021-10-10;"Banskobystrický kraj";26;1815;53;1868;NA;274501;79;2021-10-10;88181
2021-10-09;"Banskobystrický kraj";73;1122;27;1149;NA;274501;100;2021-10-09;88102
2021-10-08;"Banskobystrický kraj";239;3027;61;3088;NA;274501;300;2021-10-08;88002
2021-10-07;"Banskobystrický kraj";179;3437;42;3479;NA;274501;221;2021-10-07;87702
2021-10-06;"Banskobystrický kraj";136;3862;48;3910;NA;274501;184;2021-10-06;87481
2021-10-05;"Banskobystrický kraj";209;2979;54;3033;NA;274501;263;2021-10-05;87297
2021-10-04;"Banskobystrický kraj";126;3725;64;3789;NA;274501;190;2021-10-04;87034
2021-10-03;"Banskobystrický kraj";11;1407;34;1441;NA;274501;45;2021-10-03;86844
2021-10-02;"Banskobystrický kraj";66;1042;26;1068;NA;274501;92;2021-10-02;86799
2021-10-01;"Banskobystrický kraj";158;3228;51;3279;NA;274501;209;2021-10-01;86707
2021-09-30;"Banskobystrický kraj";120;3362;30;3392;NA;274501;150;2021-09-30;86498
2021-09-29;"Banskobystrický kraj";118;2626;40;2666;NA;274501;158;2021-09-29;86348
2021-09-28;"Banskobystrický kraj";112;3061;45;3106;NA;274501;157;2021-09-28;86190
2021-09-27;"Banskobystrický kraj";90;4456;72;4528;NA;274501;162;2021-09-27;86033
2021-09-26;"Banskobystrický kraj";17;1498;31;1529;NA;274501;48;2021-09-26;85871
2021-09-25;"Banskobystrický kraj";17;1481;7;1488;NA;274501;24;2021-09-25;85823
2021-09-24;"Banskobystrický kraj";98;4254;32;4286;NA;274501;130;2021-09-24;85799
2021-09-23;"Banskobystrický kraj";63;3019;13;3032;NA;274501;76;2021-09-23;85669
2021-09-22;"Banskobystrický kraj";75;2442;19;2461;NA;274501;94;2021-09-22;85593
2021-09-21;"Banskobystrický kraj";125;2976;20;2996;NA;274501;145;2021-09-21;85499
2021-09-20;"Banskobystrický kraj";45;3951;30;3981;NA;274501;75;2021-09-20;85354
2021-09-19;"Banskobystrický kraj";6;1456;24;1480;NA;274501;30;2021-09-19;85279
2021-09-18;"Banskobystrický kraj";44;1318;15;1333;NA;274501;59;2021-09-18;85249
2021-09-17;"Banskobystrický kraj";73;3485;32;3517;NA;274501;105;2021-09-17;85190
2021-09-16;"Banskobystrický kraj";95;3019;29;3048;NA;274501;124;2021-09-16;85085
2021-09-15;"Banskobystrický kraj";22;394;1;395;NA;274501;23;2021-09-15;84961
2021-09-14;"Banskobystrický kraj";95;2508;28;2536;NA;274501;123;2021-09-14;84938
2021-09-13;"Banskobystrický kraj";29;3206;28;3234;NA;274501;57;2021-09-13;84815
2021-09-12;"Banskobystrický kraj";7;958;15;973;NA;274501;22;2021-09-12;84758
2021-09-11;"Banskobystrický kraj";31;865;11;876;NA;274501;42;2021-09-11;84736
2021-09-10;"Banskobystrický kraj";59;2250;24;2274;NA;274501;83;2021-09-10;84694
2021-09-09;"Banskobystrický kraj";46;2011;17;2028;NA;274501;63;2021-09-09;84611
2021-09-08;"Banskobystrický kraj";46;1713;27;1740;NA;274501;73;2021-09-08;84548
2021-09-07;"Banskobystrický kraj";27;1422;21;1443;NA;274501;48;2021-09-07;84475
2021-09-06;"Banskobystrický kraj";26;2570;13;2583;NA;274501;39;2021-09-06;84427
2021-09-05;"Banskobystrický kraj";9;742;2;744;NA;274501;11;2021-09-05;84388
2021-09-04;"Banskobystrický kraj";14;745;10;755;NA;274501;24;2021-09-04;84377
2021-09-03;"Banskobystrický kraj";49;2116;22;2138;NA;274501;71;2021-09-03;84353
2021-09-02;"Banskobystrický kraj";19;1730;25;1755;NA;274501;44;2021-09-02;84282
2021-09-01;"Banskobystrický kraj";6;230;6;236;NA;274501;12;2021-09-01;84238
2021-08-31;"Banskobystrický kraj";18;1406;13;1419;NA;274501;31;2021-08-31;84226
2021-08-30;"Banskobystrický kraj";23;1867;10;1877;NA;274501;33;2021-08-30;84195
2021-08-29;"Banskobystrický kraj";0;351;5;356;NA;274501;5;2021-08-29;84162
2021-08-28;"Banskobystrický kraj";9;827;5;832;NA;274501;14;2021-08-28;84157
2021-08-27;"Banskobystrický kraj";7;1608;12;1620;NA;274501;19;2021-08-27;84143
2021-08-26;"Banskobystrický kraj";7;1161;2;1163;NA;274501;9;2021-08-26;84124
2021-08-25;"Banskobystrický kraj";6;1052;1;1053;NA;274501;7;2021-08-25;84115
2021-08-24;"Banskobystrický kraj";12;1117;1;1118;NA;274501;13;2021-08-24;84108
2021-08-23;"Banskobystrický kraj";7;1368;5;1373;NA;274501;12;2021-08-23;84095
2021-08-22;"Banskobystrický kraj";0;773;2;775;NA;274501;2;2021-08-22;84083
2021-08-21;"Banskobystrický kraj";3;793;1;794;NA;274501;4;2021-08-21;84081
2021-08-20;"Banskobystrický kraj";5;1616;4;1620;NA;274501;9;2021-08-20;84077
2021-08-19;"Banskobystrický kraj";4;1092;3;1095;NA;274501;7;2021-08-19;84068
2021-08-18;"Banskobystrický kraj";1;1044;1;1045;NA;274501;2;2021-08-18;84061
2021-08-17;"Banskobystrický kraj";12;890;0;890;NA;274501;12;2021-08-17;84059
2021-08-16;"Banskobystrický kraj";7;1321;3;1324;NA;274501;10;2021-08-16;84047
2021-08-15;"Banskobystrický kraj";0;366;3;369;NA;274501;3;2021-08-15;84037
2021-08-14;"Banskobystrický kraj";6;435;1;436;NA;274501;7;2021-08-14;84034
2021-08-13;"Banskobystrický kraj";11;898;0;898;NA;274501;11;2021-08-13;84027
2021-08-12;"Banskobystrický kraj";10;951;1;952;NA;274501;11;2021-08-12;84016
2021-08-11;"Banskobystrický kraj";7;575;3;578;NA;274501;10;2021-08-11;84005
2021-08-10;"Banskobystrický kraj";7;678;2;680;NA;274501;9;2021-08-10;83995
2021-08-09;"Banskobystrický kraj";9;1064;0;1064;NA;274501;9;2021-08-09;83986
2021-08-08;"Banskobystrický kraj";4;335;1;336;NA;274501;5;2021-08-08;83977
2021-08-07;"Banskobystrický kraj";0;308;4;312;NA;274501;4;2021-08-07;83972
2021-08-06;"Banskobystrický kraj";5;929;2;931;NA;274501;7;2021-08-06;83968
2021-08-05;"Banskobystrický kraj";2;838;1;839;NA;274501;3;2021-08-05;83961
2021-08-04;"Banskobystrický kraj";2;579;1;580;NA;274501;3;2021-08-04;83958
2021-08-03;"Banskobystrický kraj";4;743;0;743;NA;274501;4;2021-08-03;83955
2021-08-02;"Banskobystrický kraj";6;934;0;934;NA;274501;6;2021-08-02;83951
2021-08-01;"Banskobystrický kraj";0;271;0;271;NA;274501;0;2021-08-01;83945
2021-07-31;"Banskobystrický kraj";1;370;4;374;NA;274501;5;2021-07-31;83945
2021-07-30;"Banskobystrický kraj";27;928;2;930;NA;274501;29;2021-07-30;83940
2021-07-29;"Banskobystrický kraj";2;890;1;891;NA;274501;3;2021-07-29;83911
2021-07-28;"Banskobystrický kraj";4;520;1;521;NA;274501;5;2021-07-28;83908
2021-07-27;"Banskobystrický kraj";15;1092;0;1092;NA;274501;15;2021-07-27;83903
2021-07-26;"Banskobystrický kraj";2;911;1;912;NA;274501;3;2021-07-26;83888
2021-07-25;"Banskobystrický kraj";0;367;1;368;NA;274501;1;2021-07-25;83885
2021-07-24;"Banskobystrický kraj";2;298;0;298;NA;274501;2;2021-07-24;83884
2021-07-23;"Banskobystrický kraj";7;840;0;840;NA;274501;7;2021-07-23;83882
2021-07-22;"Banskobystrický kraj";5;727;3;730;NA;274501;8;2021-07-22;83875
2021-07-21;"Banskobystrický kraj";2;560;0;560;NA;274501;2;2021-07-21;83867
2021-07-20;"Banskobystrický kraj";6;885;2;887;NA;274501;8;2021-07-20;83865
2021-07-19;"Banskobystrický kraj";1;854;3;857;NA;274501;4;2021-07-19;83857
2021-07-18;"Banskobystrický kraj";0;377;1;378;NA;274501;1;2021-07-18;83853
2021-07-17;"Banskobystrický kraj";1;324;0;324;NA;274501;1;2021-07-17;83852
2021-07-16;"Banskobystrický kraj";3;974;1;975;NA;274501;4;2021-07-16;83851
2021-07-15;"Banskobystrický kraj";1;1038;0;1038;NA;274501;1;2021-07-15;83847
2021-07-14;"Banskobystrický kraj";3;765;0;765;NA;274501;3;2021-07-14;83846
2021-07-13;"Banskobystrický kraj";2;695;0;695;NA;274501;2;2021-07-13;83843
2021-07-12;"Banskobystrický kraj";1;1057;0;1057;NA;274501;1;2021-07-12;83841
2021-07-11;"Banskobystrický kraj";0;446;0;446;NA;274501;0;2021-07-11;83840
2021-07-10;"Banskobystrický kraj";2;368;0;368;NA;274501;2;2021-07-10;83840
2021-07-09;"Banskobystrický kraj";3;1209;0;1209;NA;274501;3;2021-07-09;83838
2021-07-08;"Banskobystrický kraj";0;1083;1;1084;NA;274501;1;2021-07-08;83835
2021-07-07;"Banskobystrický kraj";1;798;0;798;NA;274501;1;2021-07-07;83834
2021-07-06;"Banskobystrický kraj";6;1365;0;1365;NA;274501;6;2021-07-06;83833
2021-07-05;"Banskobystrický kraj";2;392;1;393;NA;274501;3;2021-07-05;83827
2021-07-04;"Banskobystrický kraj";0;318;0;318;NA;274501;0;2021-07-04;83824
2021-07-03;"Banskobystrický kraj";1;413;1;414;NA;274501;2;2021-07-03;83824
2021-07-02;"Banskobystrický kraj";3;1045;0;1045;NA;274501;3;2021-07-02;83822
2021-07-01;"Banskobystrický kraj";0;705;1;706;NA;274501;1;2021-07-01;83819
2021-06-30;"Banskobystrický kraj";3;7607;1;7608;NA;274501;4;2021-06-30;83818
2021-06-29;"Banskobystrický kraj";2;4642;1;4643;NA;274501;3;2021-06-29;83814
2021-06-28;"Banskobystrický kraj";3;5695;1;5696;NA;274501;4;2021-06-28;83811
2021-06-27;"Banskobystrický kraj";0;4369;5;4374;NA;274501;5;2021-06-27;83807
2021-06-26;"Banskobystrický kraj";0;4289;4;4293;NA;274501;4;2021-06-26;83802
2021-06-25;"Banskobystrický kraj";2;6717;2;6719;NA;274501;4;2021-06-25;83798
2021-06-24;"Banskobystrický kraj";6;4585;2;4587;NA;274501;8;2021-06-24;83794
2021-06-23;"Banskobystrický kraj";4;4947;0;4947;NA;274501;4;2021-06-23;83786
2021-06-22;"Banskobystrický kraj";7;4527;0;4527;NA;274501;7;2021-06-22;83782
2021-06-21;"Banskobystrický kraj";6;5836;8;5844;NA;274501;14;2021-06-21;83775
2021-06-20;"Banskobystrický kraj";0;5055;7;5062;NA;274501;7;2021-06-20;83761
2021-06-19;"Banskobystrický kraj";0;5639;4;5643;NA;274501;4;2021-06-19;83754
2021-06-18;"Banskobystrický kraj";4;7642;1;7643;NA;274501;5;2021-06-18;83750
2021-06-17;"Banskobystrický kraj";2;5245;3;5248;NA;274501;5;2021-06-17;83745
2021-06-16;"Banskobystrický kraj";10;5951;5;5956;NA;274501;15;2021-06-16;83740
2021-06-15;"Banskobystrický kraj";9;5576;6;5582;NA;274501;15;2021-06-15;83725
2021-06-14;"Banskobystrický kraj";8;6922;7;6929;NA;274501;15;2021-06-14;83710
2021-06-13;"Banskobystrický kraj";0;6407;7;6414;NA;274501;7;2021-06-13;83695
2021-06-12;"Banskobystrický kraj";3;6338;6;6344;NA;274501;9;2021-06-12;83688
2021-06-11;"Banskobystrický kraj";5;9693;15;9708;NA;274501;20;2021-06-11;83679
2021-06-10;"Banskobystrický kraj";10;5726;8;5734;NA;274501;18;2021-06-10;83659
2021-06-09;"Banskobystrický kraj";9;5720;4;5724;NA;274501;13;2021-06-09;83641
2021-06-08;"Banskobystrický kraj";15;5645;10;5655;NA;274501;25;2021-06-08;83628
2021-06-07;"Banskobystrický kraj";4;7582;21;7603;NA;274501;25;2021-06-07;83603
2021-06-06;"Banskobystrický kraj";1;7497;12;7509;NA;274501;13;2021-06-06;83578
2021-06-05;"Banskobystrický kraj";15;7531;9;7540;NA;274501;24;2021-06-05;83565
2021-06-04;"Banskobystrický kraj";2;9352;14;9366;NA;274501;16;2021-06-04;83541
2021-06-03;"Banskobystrický kraj";8;6507;24;6531;NA;274501;32;2021-06-03;83525
2021-06-02;"Banskobystrický kraj";7;6837;6;6843;NA;274501;13;2021-06-02;83493
2021-06-01;"Banskobystrický kraj";12;7146;14;7160;NA;274501;26;2021-06-01;83480
2021-05-31;"Banskobystrický kraj";4;9546;31;9577;NA;274501;35;2021-05-31;83454
2021-05-30;"Banskobystrický kraj";3;8959;19;8978;NA;274501;22;2021-05-30;83419
2021-05-29;"Banskobystrický kraj";11;9763;18;9781;NA;274501;29;2021-05-29;83397
2021-05-28;"Banskobystrický kraj";13;11908;27;11935;NA;274501;40;2021-05-28;83368
2021-05-27;"Banskobystrický kraj";7;8760;12;8772;NA;274501;19;2021-05-27;83328
2021-05-26;"Banskobystrický kraj";18;7905;17;7922;NA;274501;35;2021-05-26;83309
2021-05-25;"Banskobystrický kraj";27;8951;30;8981;NA;274501;57;2021-05-25;83274
2021-05-24;"Banskobystrický kraj";9;12472;44;12516;NA;274501;53;2021-05-24;83217
2021-05-23;"Banskobystrický kraj";0;9798;27;9825;NA;274501;27;2021-05-23;83164
2021-05-22;"Banskobystrický kraj";20;9608;26;9634;NA;274501;46;2021-05-22;83137
2021-05-21;"Banskobystrický kraj";22;12796;25;12821;NA;274501;47;2021-05-21;83091
2021-05-20;"Banskobystrický kraj";14;8994;25;9019;NA;274501;39;2021-05-20;83044
2021-05-19;"Banskobystrický kraj";42;8608;21;8629;NA;274501;63;2021-05-19;83005
2021-05-18;"Banskobystrický kraj";27;9450;25;9475;NA;274501;52;2021-05-18;82942
2021-05-17;"Banskobystrický kraj";11;13399;33;13432;NA;274501;44;2021-05-17;82890
2021-05-16;"Banskobystrický kraj";15;14072;26;14098;NA;274501;41;2021-05-16;82846
2021-05-15;"Banskobystrický kraj";11;15356;29;15385;NA;274501;40;2021-05-15;82805
2021-05-14;"Banskobystrický kraj";35;18939;45;18984;NA;274501;80;2021-05-14;82765
2021-05-13;"Banskobystrický kraj";37;10605;40;10645;NA;274501;77;2021-05-13;82685
2021-05-12;"Banskobystrický kraj";31;10860;45;10905;NA;274501;76;2021-05-12;82608
2021-05-11;"Banskobystrický kraj";42;11328;48;11376;NA;274501;90;2021-05-11;82532
2021-05-10;"Banskobystrický kraj";28;17621;68;17689;NA;274501;96;2021-05-10;82442
2021-05-09;"Banskobystrický kraj";25;21902;68;21970;NA;274501;93;2021-05-09;82346
2021-05-08;"Banskobystrický kraj";11;14285;26;14311;NA;274501;37;2021-05-08;82253
2021-05-07;"Banskobystrický kraj";41;21809;78;21887;NA;274501;119;2021-05-07;82216
2021-05-06;"Banskobystrický kraj";36;12254;70;12324;NA;274501;106;2021-05-06;82097
2021-05-05;"Banskobystrický kraj";34;12595;63;12658;NA;274501;97;2021-05-05;81991
2021-05-04;"Banskobystrický kraj";83;13888;47;13935;NA;274501;130;2021-05-04;81894
2021-05-03;"Banskobystrický kraj";30;20875;80;20955;NA;274501;110;2021-05-03;81764
2021-05-02;"Banskobystrický kraj";6;33040;60;33100;NA;274501;66;2021-05-02;81654
2021-05-01;"Banskobystrický kraj";54;36903;67;36970;NA;274501;121;2021-05-01;81588
2021-04-30;"Banskobystrický kraj";38;34957;86;35043;NA;274501;124;2021-04-30;81467
2021-04-29;"Banskobystrický kraj";55;16839;68;16907;NA;274501;123;2021-04-29;81343
2021-04-28;"Banskobystrický kraj";66;17959;67;18026;NA;274501;133;2021-04-28;81220
2021-04-27;"Banskobystrický kraj";70;19152;73;19225;NA;274501;143;2021-04-27;81087
2021-04-26;"Banskobystrický kraj";34;28517;101;28618;NA;274501;135;2021-04-26;80944
2021-04-25;"Banskobystrický kraj";14;40601;106;40707;NA;274501;120;2021-04-25;80809
2021-04-24;"Banskobystrický kraj";40;51944;98;52042;NA;274501;138;2021-04-24;80689
2021-04-23;"Banskobystrický kraj";78;37922;88;38010;NA;274501;166;2021-04-23;80551
2021-04-22;"Banskobystrický kraj";51;17415;57;17472;NA;274501;108;2021-04-22;80385
2021-04-21;"Banskobystrický kraj";76;19218;94;19312;NA;274501;170;2021-04-21;80277
2021-04-20;"Banskobystrický kraj";116;21234;98;21332;NA;274501;214;2021-04-20;80107
2021-04-19;"Banskobystrický kraj";48;31408;105;31513;NA;274501;153;2021-04-19;79893
2021-04-18;"Banskobystrický kraj";16;43375;90;43465;NA;274501;106;2021-04-18;79740
2021-04-17;"Banskobystrický kraj";42;64939;92;65031;NA;274501;134;2021-04-17;79634
2021-04-16;"Banskobystrický kraj";72;37307;100;37407;NA;274501;172;2021-04-16;79500
2021-04-15;"Banskobystrický kraj";67;20127;83;20210;NA;274501;150;2021-04-15;79328
2021-04-14;"Banskobystrický kraj";69;21260;86;21346;NA;274501;155;2021-04-14;79178
2021-04-13;"Banskobystrický kraj";130;23076;77;23153;NA;274501;207;2021-04-13;79023
2021-04-12;"Banskobystrický kraj";60;32272;130;32402;NA;274501;190;2021-04-12;78816
2021-04-11;"Banskobystrický kraj";0;41367;88;41455;NA;274501;88;2021-04-11;78626
2021-04-10;"Banskobystrický kraj";56;64728;141;64869;NA;274501;197;2021-04-10;78538
2021-04-09;"Banskobystrický kraj";106;31570;118;31688;NA;274501;224;2021-04-09;78341
2021-04-08;"Banskobystrický kraj";132;19000;148;19148;NA;274501;280;2021-04-08;78117
2021-04-07;"Banskobystrický kraj";226;25121;94;25215;NA;274501;320;2021-04-07;77837
2021-04-06;"Banskobystrický kraj";93;42496;187;42683;NA;274501;280;2021-04-06;77517
2021-04-05;"Banskobystrický kraj";15;11797;87;11884;NA;274501;102;2021-04-05;77237
2021-04-04;"Banskobystrický kraj";24;19683;79;19762;NA;274501;103;2021-04-04;77135
2021-04-03;"Banskobystrický kraj";5;72553;211;72764;NA;274501;216;2021-04-03;77032
2021-04-02;"Banskobystrický kraj";71;13455;66;13521;NA;274501;137;2021-04-02;76816
2021-04-01;"Banskobystrický kraj";171;39407;200;39607;NA;274501;371;2021-04-01;76679
2021-03-31;"Banskobystrický kraj";147;25543;161;25704;NA;274501;308;2021-03-31;76308
2021-03-30;"Banskobystrický kraj";167;21442;159;21601;NA;274501;326;2021-03-30;76000
2021-03-29;"Banskobystrický kraj";119;29492;218;29710;NA;274501;337;2021-03-29;75674
2021-03-28;"Banskobystrický kraj";25;40610;189;40799;NA;274501;214;2021-03-28;75337
2021-03-27;"Banskobystrický kraj";85;63414;260;63674;NA;274501;345;2021-03-27;75123
2021-03-26;"Banskobystrický kraj";122;43671;240;43911;NA;274501;362;2021-03-26;74778
2021-03-25;"Banskobystrický kraj";120;21598;240;21838;NA;274501;360;2021-03-25;74416
2021-03-24;"Banskobystrický kraj";200;19337;227;19564;NA;274501;427;2021-03-24;74056
2021-03-23;"Banskobystrický kraj";241;21541;257;21798;NA;274501;498;2021-03-23;73629
2021-03-22;"Banskobystrický kraj";65;30480;274;30754;NA;274501;339;2021-03-22;73131
2021-03-21;"Banskobystrický kraj";31;40039;280;40319;NA;274501;311;2021-03-21;72792
2021-03-20;"Banskobystrický kraj";119;67926;383;68309;NA;274501;502;2021-03-20;72481
2021-03-19;"Banskobystrický kraj";240;44038;306;44344;NA;274501;546;2021-03-19;71979
2021-03-18;"Banskobystrický kraj";160;22469;273;22742;NA;274501;433;2021-03-18;71433
2021-03-17;"Banskobystrický kraj";262;21573;245;21818;NA;274501;507;2021-03-17;71000
2021-03-16;"Banskobystrický kraj";340;23349;224;23573;NA;274501;564;2021-03-16;70493
2021-03-15;"Banskobystrický kraj";95;32306;366;32672;NA;274501;461;2021-03-15;69929
2021-03-14;"Banskobystrický kraj";39;39212;218;39430;NA;274501;257;2021-03-14;69468
2021-03-13;"Banskobystrický kraj";209;67463;395;67858;NA;274501;604;2021-03-13;69211
2021-03-12;"Banskobystrický kraj";206;41444;330;41774;NA;274501;536;2021-03-12;68607
2021-03-11;"Banskobystrický kraj";228;21338;274;21612;NA;274501;502;2021-03-11;68071
2021-03-10;"Banskobystrický kraj";260;20408;241;20649;NA;274501;501;2021-03-10;67569
2021-03-09;"Banskobystrický kraj";352;21790;284;22074;NA;274501;636;2021-03-09;67068
2021-03-08;"Banskobystrický kraj";191;31471;427;31898;NA;274501;618;2021-03-08;66432
2021-03-07;"Banskobystrický kraj";60;39191;295;39486;NA;274501;355;2021-03-07;65814
2021-03-06;"Banskobystrický kraj";164;70897;410;71307;NA;274501;574;2021-03-06;65459
2021-03-05;"Banskobystrický kraj";221;42336;389;42725;NA;274501;610;2021-03-05;64885
2021-03-04;"Banskobystrický kraj";226;22009;334;22343;NA;274501;560;2021-03-04;64275
2021-03-03;"Banskobystrický kraj";317;21949;331;22280;NA;274501;648;2021-03-03;63715
2021-03-02;"Banskobystrický kraj";291;23160;354;23514;NA;274501;645;2021-03-02;63067
2021-03-01;"Banskobystrický kraj";151;31773;434;32207;NA;274501;585;2021-03-01;62422
2021-02-28;"Banskobystrický kraj";45;38665;336;39001;NA;274501;381;2021-02-28;61837
2021-02-27;"Banskobystrický kraj";289;66667;529;67196;NA;274501;818;2021-02-27;61456
2021-02-26;"Banskobystrický kraj";326;39674;468;40142;NA;274501;794;2021-02-26;60638
2021-02-25;"Banskobystrický kraj";375;18081;366;18447;NA;274501;741;2021-02-25;59844
2021-02-24;"Banskobystrický kraj";332;16735;373;17108;NA;274501;705;2021-02-24;59103
2021-02-23;"Banskobystrický kraj";462;19932;439;20371;NA;274501;901;2021-02-23;58398
2021-02-22;"Banskobystrický kraj";67;28643;598;29241;NA;274501;665;2021-02-22;57497
2021-02-21;"Banskobystrický kraj";68;37619;444;38063;NA;274501;512;2021-02-21;56832
2021-02-20;"Banskobystrický kraj";280;68851;598;69449;NA;274501;878;2021-02-20;56320
2021-02-19;"Banskobystrický kraj";420;39888;511;40399;NA;274501;931;2021-02-19;55442
2021-02-18;"Banskobystrický kraj";241;18618;396;19014;NA;274501;637;2021-02-18;54511
2021-02-17;"Banskobystrický kraj";415;16740;389;17129;NA;274501;804;2021-02-17;53874
2021-02-16;"Banskobystrický kraj";338;19731;368;20099;NA;274501;706;2021-02-16;53070
2021-02-15;"Banskobystrický kraj";118;35835;591;36426;NA;274501;709;2021-02-15;52364
2021-02-14;"Banskobystrický kraj";60;31894;386;32280;NA;274501;446;2021-02-14;51655
2021-02-13;"Banskobystrický kraj";202;53889;492;54381;NA;274501;694;2021-02-13;51209
2021-02-12;"Banskobystrický kraj";312;37270;533;37803;NA;274501;845;2021-02-12;50515
2021-02-11;"Banskobystrický kraj";305;21196;386;21582;NA;274501;691;2021-02-11;49670
2021-02-10;"Banskobystrický kraj";333;14790;344;15134;NA;274501;677;2021-02-10;48979
2021-02-09;"Banskobystrický kraj";329;18504;362;18866;NA;274501;691;2021-02-09;48302
2021-02-08;"Banskobystrický kraj";103;49716;695;50411;NA;274501;798;2021-02-08;47611
2021-02-07;"Banskobystrický kraj";70;37659;335;37994;NA;274501;405;2021-02-07;46813
2021-02-06;"Banskobystrický kraj";178;69388;570;69958;NA;274501;748;2021-02-06;46408
2021-02-05;"Banskobystrický kraj";282;24577;363;24940;NA;274501;645;2021-02-05;45660
2021-02-04;"Banskobystrický kraj";240;14367;430;14797;NA;274501;670;2021-02-04;45015
2021-02-03;"Banskobystrický kraj";350;9459;255;9714;NA;274501;605;2021-02-03;44345
2021-02-02;"Banskobystrický kraj";277;15741;334;16075;NA;274501;611;2021-02-02;43740
2021-02-01;"Banskobystrický kraj";75;24346;489;24835;NA;274501;564;2021-02-01;43129
2021-01-31;"Banskobystrický kraj";34;19983;201;20184;NA;274501;235;2021-01-31;42565
2021-01-30;"Banskobystrický kraj";163;63896;525;64421;NA;274501;688;2021-01-30;42330
2021-01-29;"Banskobystrický kraj";196;17368;274;17642;NA;274501;470;2021-01-29;41642
2021-01-28;"Banskobystrický kraj";218;15613;382;15995;NA;274501;600;2021-01-28;41172
2021-01-27;"Banskobystrický kraj";191;8132;200;8332;NA;274501;391;2021-01-27;40572
2021-01-26;"Banskobystrický kraj";238;19795;283;20078;NA;274501;521;2021-01-26;40181
2021-01-25;"Banskobystrický kraj";82;33666;412;34078;NA;274501;494;2021-01-25;39660
2021-01-24;"Banskobystrický kraj";38;35587;278;35865;NA;274501;316;2021-01-24;39166
2021-01-23;"Banskobystrický kraj";142;89058;523;89581;NA;274501;665;2021-01-23;38850
2021-01-22;"Banskobystrický kraj";175;25887;355;26242;NA;274501;530;2021-01-22;38185
2021-01-21;"Banskobystrický kraj";194;17063;279;17342;NA;274501;473;2021-01-21;37655
2021-01-20;"Banskobystrický kraj";231;9142;186;9328;NA;274501;417;2021-01-20;37182
2021-01-19;"Banskobystrický kraj";213;10708;311;11019;NA;274501;524;2021-01-19;36765
2021-01-18;"Banskobystrický kraj";94;7402;401;7803;NA;274501;495;2021-01-18;36241
2021-01-17;"Banskobystrický kraj";110;8154;77;8231;NA;274501;187;2021-01-17;35746
2021-01-16;"Banskobystrický kraj";58;2274;57;2331;NA;274501;115;2021-01-16;35559
2021-01-15;"Banskobystrický kraj";164;7673;217;7890;NA;274501;381;2021-01-15;35444
2021-01-14;"Banskobystrický kraj";220;5760;325;6085;NA;274501;545;2021-01-14;35063
2021-01-13;"Banskobystrický kraj";235;5974;217;6191;NA;274501;452;2021-01-13;34518
2021-01-12;"Banskobystrický kraj";194;6600;290;6890;NA;274501;484;2021-01-12;34066
2021-01-11;"Banskobystrický kraj";76;8231;481;8712;NA;274501;557;2021-01-11;33582
2021-01-10;"Banskobystrický kraj";110;433;4;437;NA;274501;114;2021-01-10;33025
2021-01-09;"Banskobystrický kraj";297;2378;81;2459;NA;274501;378;2021-01-09;32911
2021-01-08;"Banskobystrický kraj";435;9805;443;10248;NA;274501;878;2021-01-08;32533
2021-01-07;"Banskobystrický kraj";127;6322;366;6688;NA;274501;493;2021-01-07;31655
2021-01-06;"Banskobystrický kraj";305;3374;185;3559;NA;274501;490;2021-01-06;31162
2021-01-05;"Banskobystrický kraj";372;7349;533;7882;NA;274501;905;2021-01-05;30672
2021-01-04;"Banskobystrický kraj";130;7087;700;7787;NA;274501;830;2021-01-04;29767
2021-01-03;"Banskobystrický kraj";199;320;19;339;NA;274501;218;2021-01-03;28937
2021-01-02;"Banskobystrický kraj";123;702;85;787;NA;274501;208;2021-01-02;28719
2021-01-01;"Banskobystrický kraj";220;1958;132;2090;NA;274501;352;2021-01-01;28511
2020-12-31;"Banskobystrický kraj";499;7679;633;8312;NA;274501;1132;2020-12-31;28159
2020-12-30;"Banskobystrický kraj";593;7407;541;7948;NA;274501;1134;2020-12-30;27027
2020-12-29;"Banskobystrický kraj";240;7876;660;8536;NA;274501;900;2020-12-29;25893
2020-12-28;"Banskobystrický kraj";131;6120;720;6840;NA;274501;851;2020-12-28;24993
2020-12-27;"Banskobystrický kraj";116;541;25;566;NA;274501;141;2020-12-27;24142
2020-12-26;"Banskobystrický kraj";61;295;35;330;NA;274501;96;2020-12-26;24001
2020-12-25;"Banskobystrický kraj";65;888;10;898;NA;274501;75;2020-12-25;23905
2020-12-24;"Banskobystrický kraj";452;3685;135;3820;NA;274501;587;2020-12-24;23830
2020-12-23;"Banskobystrický kraj";368;9892;473;10365;NA;274501;841;2020-12-23;23243
2020-12-22;"Banskobystrický kraj";307;8468;619;9087;NA;274501;926;2020-12-22;22402
2020-12-21;"Banskobystrický kraj";286;4922;455;5377;NA;274501;741;2020-12-21;21476
2020-12-20;"Banskobystrický kraj";155;250;14;264;NA;274501;169;2020-12-20;20735
2020-12-19;"Banskobystrický kraj";170;3084;138;3222;NA;274501;308;2020-12-19;20566
2020-12-18;"Banskobystrický kraj";432;5959;331;6290;NA;274501;763;2020-12-18;20258
2020-12-17;"Banskobystrický kraj";468;8753;653;9406;NA;274501;1121;2020-12-17;19495
2020-12-16;"Banskobystrický kraj";379;10184;567;10751;NA;274501;946;2020-12-16;18374
2020-12-15;"Banskobystrický kraj";336;5281;425;5706;NA;274501;761;2020-12-15;17428
2020-12-14;"Banskobystrický kraj";148;4012;259;4271;NA;274501;407;2020-12-14;16667
2020-12-13;"Banskobystrický kraj";122;142;1;143;NA;274501;123;2020-12-13;16260
2020-12-12;"Banskobystrický kraj";137;2714;138;2852;NA;274501;275;2020-12-12;16137
2020-12-11;"Banskobystrický kraj";468;6633;362;6995;NA;274501;830;2020-12-11;15862
2020-12-10;"Banskobystrický kraj";280;5501;369;5870;NA;274501;649;2020-12-10;15032
2020-12-09;"Banskobystrický kraj";323;3941;205;4146;NA;274501;528;2020-12-09;14383
2020-12-08;"Banskobystrický kraj";256;3782;272;4054;NA;274501;528;2020-12-08;13855
2020-12-07;"Banskobystrický kraj";175;2633;177;2810;NA;274501;352;2020-12-07;13327
2020-12-06;"Banskobystrický kraj";121;507;11;518;NA;274501;132;2020-12-06;12975
2020-12-05;"Banskobystrický kraj";109;1099;34;1133;NA;274501;143;2020-12-05;12843
2020-12-04;"Banskobystrický kraj";339;3828;174;4002;NA;274501;513;2020-12-04;12700
2020-12-03;"Banskobystrický kraj";240;3193;234;3427;NA;274501;474;2020-12-03;12187
2020-12-02;"Banskobystrický kraj";217;4442;186;4628;NA;274501;403;2020-12-02;11713
2020-12-01;"Banskobystrický kraj";215;2702;134;2836;NA;274501;349;2020-12-01;11310
2020-11-30;"Banskobystrický kraj";74;4314;241;4555;NA;274501;315;2020-11-30;10961
2020-11-29;"Banskobystrický kraj";19;208;7;215;NA;274501;26;2020-11-29;10646
2020-11-28;"Banskobystrický kraj";81;1408;55;1463;NA;274501;136;2020-11-28;10620
2020-11-27;"Banskobystrický kraj";219;2566;123;2689;NA;274501;342;2020-11-27;10484
2020-11-26;"Banskobystrický kraj";208;2124;93;2217;NA;274501;301;2020-11-26;10142
2020-11-25;"Banskobystrický kraj";170;1952;86;2038;NA;274501;256;2020-11-25;9841
2020-11-24;"Banskobystrický kraj";166;2566;69;2635;NA;274501;235;2020-11-24;9585
2020-11-23;"Banskobystrický kraj";66;10147;193;10340;NA;274501;259;2020-11-23;9350
2020-11-22;"Banskobystrický kraj";38;104;1;105;NA;274501;39;2020-11-22;9091
2020-11-21;"Banskobystrický kraj";52;904;14;918;NA;274501;66;2020-11-21;9052
2020-11-20;"Banskobystrický kraj";127;2005;107;2112;NA;274501;234;2020-11-20;8986
2020-11-19;"Banskobystrický kraj";170;1218;82;1300;NA;274501;252;2020-11-19;8752
2020-11-18;"Banskobystrický kraj";153;698;65;763;NA;274501;218;2020-11-18;8500
2020-11-17;"Banskobystrický kraj";52;578;35;613;NA;274501;87;2020-11-17;8282
2020-11-16;"Banskobystrický kraj";106;470;25;495;NA;274501;131;2020-11-16;8195
2020-11-15;"Banskobystrický kraj";52;301;4;305;NA;274501;56;2020-11-15;8064
2020-11-14;"Banskobystrický kraj";73;305;2;307;NA;274501;75;2020-11-14;8008
2020-11-13;"Banskobystrický kraj";157;552;11;563;NA;274501;168;2020-11-13;7933
2020-11-12;"Banskobystrický kraj";218;952;44;996;NA;274501;262;2020-11-12;7765
2020-11-11;"Banskobystrický kraj";224;437;9;446;NA;274501;233;2020-11-11;7503
2020-11-10;"Banskobystrický kraj";263;463;18;481;NA;274501;281;2020-11-10;7270
2020-11-09;"Banskobystrický kraj";80;2678;31;2709;NA;274501;111;2020-11-09;6989
2020-11-08;"Banskobystrický kraj";82;981;16;997;NA;274501;98;2020-11-08;6878
2020-11-07;"Banskobystrický kraj";164;8828;94;8922;NA;274501;258;2020-11-07;6780
2020-11-06;"Banskobystrický kraj";227;2496;16;2512;NA;274501;243;2020-11-06;6522
2020-11-05;"Banskobystrický kraj";240;290;33;323;NA;274501;273;2020-11-05;6279
2020-11-04;"Banskobystrický kraj";254;1366;13;1379;NA;274501;267;2020-11-04;6006
2020-11-03;"Banskobystrický kraj";246;1332;4;1336;NA;274501;250;2020-11-03;5739
2020-11-02;"Banskobystrický kraj";90;2909;65;2974;NA;274501;155;2020-11-02;5489
2020-11-01;"Banskobystrický kraj";101;2671;42;2713;NA;274501;143;2020-11-01;5334
2020-10-31;"Banskobystrický kraj";199;13516;116;13632;NA;274501;315;2020-10-31;5191
2020-10-30;"Banskobystrický kraj";254;2829;20;2849;NA;274501;274;2020-10-30;4876
2020-10-29;"Banskobystrický kraj";372;969;42;1011;NA;274501;414;2020-10-29;4602
2020-10-28;"Banskobystrický kraj";285;302;30;332;NA;274501;315;2020-10-28;4188
2020-10-27;"Banskobystrický kraj";266;654;40;694;NA;274501;306;2020-10-27;3873
2020-10-26;"Banskobystrický kraj";38;234;29;263;NA;274501;67;2020-10-26;3567
2020-10-25;"Banskobystrický kraj";50;140;11;151;NA;274501;61;2020-10-25;3500
2020-10-24;"Banskobystrický kraj";315;114;12;126;NA;274501;327;2020-10-24;3439
2020-10-23;"Banskobystrický kraj";231;230;29;259;NA;274501;260;2020-10-23;3112
2020-10-22;"Banskobystrický kraj";264;253;24;277;NA;274501;288;2020-10-22;2852
2020-10-21;"Banskobystrický kraj";209;266;3;269;NA;274501;212;2020-10-21;2564
2020-10-20;"Banskobystrický kraj";210;66;3;69;NA;274501;213;2020-10-20;2352
2020-10-19;"Banskobystrický kraj";27;73;12;85;NA;274501;39;2020-10-19;2139
2020-10-18;"Banskobystrický kraj";49;0;0;0;NA;274501;49;2020-10-18;2100
2020-10-17;"Banskobystrický kraj";91;0;0;0;NA;274501;91;2020-10-17;2051
2020-10-16;"Banskobystrický kraj";224;37;3;40;NA;274501;227;2020-10-16;1960
2020-10-15;"Banskobystrický kraj";133;29;1;30;NA;274501;134;2020-10-15;1733
2020-10-14;"Banskobystrický kraj";139;31;1;32;NA;274501;140;2020-10-14;1599
2020-10-13;"Banskobystrický kraj";151;169;11;180;NA;274501;162;2020-10-13;1459
2020-10-12;"Banskobystrický kraj";11;110;4;114;NA;274501;15;2020-10-12;1297
2020-10-11;"Banskobystrický kraj";14;0;0;0;NA;274501;14;2020-10-11;1282
2020-10-10;"Banskobystrický kraj";53;0;0;0;NA;274501;53;2020-10-10;1268
2020-10-09;"Banskobystrický kraj";128;0;0;0;NA;274501;128;2020-10-09;1215
2020-10-08;"Banskobystrický kraj";99;0;0;0;NA;274501;99;2020-10-08;1087
2020-10-07;"Banskobystrický kraj";124;0;0;0;NA;274501;124;2020-10-07;988
2020-10-06;"Banskobystrický kraj";68;0;0;0;NA;274501;68;2020-10-06;864
2020-10-05;"Banskobystrický kraj";49;0;0;0;NA;274501;49;2020-10-05;796
2020-10-04;"Banskobystrický kraj";8;0;0;0;NA;274501;8;2020-10-04;747
2020-10-03;"Banskobystrický kraj";37;0;0;0;NA;274501;37;2020-10-03;739
2020-10-02;"Banskobystrický kraj";74;0;0;0;NA;274501;74;2020-10-02;702
2020-10-01;"Banskobystrický kraj";49;16;0;16;NA;274501;49;2020-10-01;628
2020-09-30;"Banskobystrický kraj";60;0;0;0;NA;274501;60;2020-09-30;579
2020-09-29;"Banskobystrický kraj";24;0;0;0;NA;274501;24;2020-09-29;519
2020-09-28;"Banskobystrický kraj";0;0;0;0;NA;274501;0;2020-09-28;495
2020-09-27;"Banskobystrický kraj";20;0;0;0;NA;274501;20;2020-09-27;495
2020-09-26;"Banskobystrický kraj";24;0;0;0;NA;274501;24;2020-09-26;475
2020-09-25;"Banskobystrický kraj";29;0;0;0;NA;274501;29;2020-09-25;451
2020-09-24;"Banskobystrický kraj";25;0;0;0;NA;274501;25;2020-09-24;422
2020-09-23;"Banskobystrický kraj";17;0;0;0;NA;274501;17;2020-09-23;397
2020-09-22;"Banskobystrický kraj";25;0;0;0;NA;274501;25;2020-09-22;380
2020-09-21;"Banskobystrický kraj";3;0;0;0;NA;274501;3;2020-09-21;355
2020-09-20;"Banskobystrický kraj";0;0;0;0;NA;274501;0;2020-09-20;352
2020-09-19;"Banskobystrický kraj";3;0;0;0;NA;274501;3;2020-09-19;352
2020-09-18;"Banskobystrický kraj";24;0;0;0;NA;274501;24;2020-09-18;349
2020-09-17;"Banskobystrický kraj";14;0;0;0;NA;274501;14;2020-09-17;325
2020-09-16;"Banskobystrický kraj";6;0;0;0;NA;274501;6;2020-09-16;311
2020-09-15;"Banskobystrický kraj";2;0;0;0;NA;274501;2;2020-09-15;305
2020-09-14;"Banskobystrický kraj";13;0;0;0;NA;274501;13;2020-09-14;303
2020-09-13;"Banskobystrický kraj";1;0;0;0;NA;274501;1;2020-09-13;290
2020-09-12;"Banskobystrický kraj";5;0;0;0;NA;274501;5;2020-09-12;289
2020-09-11;"Banskobystrický kraj";19;0;0;0;NA;274501;19;2020-09-11;284
2020-09-10;"Banskobystrický kraj";11;0;0;0;NA;274501;11;2020-09-10;265
2020-09-09;"Banskobystrický kraj";13;0;0;0;NA;274501;13;2020-09-09;254
2020-09-08;"Banskobystrický kraj";5;0;0;0;NA;274501;5;2020-09-08;241
2020-09-07;"Banskobystrický kraj";2;0;0;0;NA;274501;2;2020-09-07;236
2020-09-06;"Banskobystrický kraj";0;0;0;0;NA;274501;0;2020-09-06;234
2020-09-05;"Banskobystrický kraj";0;0;0;0;NA;274501;0;2020-09-05;234
2020-09-04;"Banskobystrický kraj";9;0;0;0;NA;274501;9;2020-09-04;234
2020-09-03;"Banskobystrický kraj";5;0;0;0;NA;274501;5;2020-09-03;225
2020-09-02;"Banskobystrický kraj";6;0;0;0;NA;274501;6;2020-09-02;220
2020-09-01;"Banskobystrický kraj";2;0;0;0;NA;274501;2;2020-09-01;214
2020-08-31;"Banskobystrický kraj";6;0;0;0;NA;274501;6;2020-08-31;212
2020-08-30;"Banskobystrický kraj";0;0;0;0;NA;274501;0;2020-08-30;206
2020-08-29;"Banskobystrický kraj";1;0;0;0;NA;274501;1;2020-08-29;206
2020-08-28;"Banskobystrický kraj";3;0;0;0;NA;274501;3;2020-08-28;205
2020-08-27;"Banskobystrický kraj";1;0;0;0;NA;274501;1;2020-08-27;202
2020-08-26;"Banskobystrický kraj";2;0;0;0;NA;274501;2;2020-08-26;201
2020-08-25;"Banskobystrický kraj";2;0;0;0;NA;274501;2;2020-08-25;199
2020-08-24;"Banskobystrický kraj";0;0;0;0;NA;274501;0;2020-08-24;197
2020-08-23;"Banskobystrický kraj";0;0;0;0;NA;274501;0;2020-08-23;197
2020-08-22;"Banskobystrický kraj";0;0;0;0;NA;274501;0;2020-08-22;197
2020-08-21;"Banskobystrický kraj";4;0;0;0;NA;274501;4;2020-08-21;197
2020-08-20;"Banskobystrický kraj";1;0;0;0;NA;274501;1;2020-08-20;193
2020-08-19;"Banskobystrický kraj";4;0;0;0;NA;274501;4;2020-08-19;192
2020-08-18;"Banskobystrický kraj";0;0;0;0;NA;274501;0;2020-08-18;188
2020-08-17;"Banskobystrický kraj";1;0;0;0;NA;274501;1;2020-08-17;188
2020-08-16;"Banskobystrický kraj";0;0;0;0;NA;274501;0;2020-08-16;187
2020-08-15;"Banskobystrický kraj";0;0;0;0;NA;274501;0;2020-08-15;187
2020-08-14;"Banskobystrický kraj";5;0;0;0;NA;274501;5;2020-08-14;187
2020-08-13;"Banskobystrický kraj";0;0;0;0;NA;274501;0;2020-08-13;182
2020-08-12;"Banskobystrický kraj";0;0;0;0;NA;274501;0;2020-08-12;182
2020-08-11;"Banskobystrický kraj";2;0;0;0;NA;274501;2;2020-08-11;182
2020-08-10;"Banskobystrický kraj";3;0;0;0;NA;274501;3;2020-08-10;180
2020-08-09;"Banskobystrický kraj";0;0;0;0;NA;274501;0;2020-08-09;177
2020-08-08;"Banskobystrický kraj";2;0;0;0;NA;274501;2;2020-08-08;177
2020-08-07;"Banskobystrický kraj";1;0;0;0;NA;274501;1;2020-08-07;175
2020-08-06;"Banskobystrický kraj";1;0;0;0;NA;274501;1;2020-08-06;174
2020-08-05;"Banskobystrický kraj";0;0;0;0;NA;274501;0;2020-08-05;173
2020-08-04;"Banskobystrický kraj";3;0;0;0;NA;274501;3;2020-08-04;173
2020-08-03;"Banskobystrický kraj";0;0;0;0;NA;274501;0;2020-08-03;170
2020-08-02;"Banskobystrický kraj";0;0;0;0;NA;274501;0;2020-08-02;170
2020-08-01;"Banskobystrický kraj";1;0;0;0;NA;274501;1;2020-08-01;170
2020-07-31;"Banskobystrický kraj";2;0;0;0;NA;274501;2;2020-07-31;169
2020-07-30;"Banskobystrický kraj";1;0;0;0;NA;274501;1;2020-07-30;167
2020-07-29;"Banskobystrický kraj";0;0;0;0;NA;274501;0;2020-07-29;166
2020-07-28;"Banskobystrický kraj";2;0;0;0;NA;274501;2;2020-07-28;166
2020-07-27;"Banskobystrický kraj";3;0;0;0;NA;274501;3;2020-07-27;164
2020-07-26;"Banskobystrický kraj";0;0;0;0;NA;274501;0;2020-07-26;161
2020-07-25;"Banskobystrický kraj";0;0;0;0;NA;274501;0;2020-07-25;161
2020-07-24;"Banskobystrický kraj";9;0;0;0;NA;274501;9;2020-07-24;161
2020-07-23;"Banskobystrický kraj";0;0;0;0;NA;274501;0;2020-07-23;152
2020-07-22;"Banskobystrický kraj";3;0;0;0;NA;274501;3;2020-07-22;152
2020-07-21;"Banskobystrický kraj";3;0;0;0;NA;274501;3;2020-07-21;149
2020-07-20;"Banskobystrický kraj";1;0;0;0;NA;274501;1;2020-07-20;146
2020-07-19;"Banskobystrický kraj";1;0;0;0;NA;274501;1;2020-07-19;145
2020-07-18;"Banskobystrický kraj";0;0;0;0;NA;274501;0;2020-07-18;144
2020-07-17;"Banskobystrický kraj";2;0;0;0;NA;274501;2;2020-07-17;144
2020-07-16;"Banskobystrický kraj";1;0;0;0;NA;274501;1;2020-07-16;142
2020-07-15;"Banskobystrický kraj";4;0;0;0;NA;274501;4;2020-07-15;141
2020-07-14;"Banskobystrický kraj";2;0;0;0;NA;274501;2;2020-07-14;137
2020-07-13;"Banskobystrický kraj";1;0;0;0;NA;274501;1;2020-07-13;135
2020-07-12;"Banskobystrický kraj";0;0;0;0;NA;274501;0;2020-07-12;134
2020-07-11;"Banskobystrický kraj";0;0;0;0;NA;274501;0;2020-07-11;134
2020-07-10;"Banskobystrický kraj";3;0;0;0;NA;274501;3;2020-07-10;134
2020-07-09;"Banskobystrický kraj";9;0;0;0;NA;274501;9;2020-07-09;131
2020-07-08;"Banskobystrický kraj";0;0;0;0;NA;274501;0;2020-07-08;122
2020-07-07;"Banskobystrický kraj";4;0;0;0;NA;274501;4;2020-07-07;122
2020-07-06;"Banskobystrický kraj";0;0;0;0;NA;274501;0;2020-07-06;118
2020-07-05;"Banskobystrický kraj";0;0;0;0;NA;274501;0;2020-07-05;118
2020-07-04;"Banskobystrický kraj";1;0;0;0;NA;274501;1;2020-07-04;118
2020-07-03;"Banskobystrický kraj";4;0;0;0;NA;274501;4;2020-07-03;117
2020-07-02;"Banskobystrický kraj";0;0;0;0;NA;274501;0;2020-07-02;113
2020-07-01;"Banskobystrický kraj";1;0;0;0;NA;274501;1;2020-07-01;113
2020-06-30;"Banskobystrický kraj";0;12;0;12;NA;274501;0;2020-06-30;112
2020-06-29;"Banskobystrický kraj";0;0;0;0;NA;274501;0;2020-06-29;112
2020-06-28;"Banskobystrický kraj";0;0;0;0;NA;274501;0;2020-06-28;112
2020-06-27;"Banskobystrický kraj";0;0;0;0;NA;274501;0;2020-06-27;112
2020-06-26;"Banskobystrický kraj";0;0;0;0;NA;274501;0;2020-06-26;112
2020-06-25;"Banskobystrický kraj";1;0;0;0;NA;274501;1;2020-06-25;112
2020-06-24;"Banskobystrický kraj";0;0;0;0;NA;274501;0;2020-06-24;111
2020-06-23;"Banskobystrický kraj";6;0;0;0;NA;274501;6;2020-06-23;111
2020-06-22;"Banskobystrický kraj";0;0;0;0;NA;274501;0;2020-06-22;105
2020-06-21;"Banskobystrický kraj";0;0;0;0;NA;274501;0;2020-06-21;105
2020-06-20;"Banskobystrický kraj";0;0;0;0;NA;274501;0;2020-06-20;105
2020-06-19;"Banskobystrický kraj";2;0;0;0;NA;274501;2;2020-06-19;105
2020-06-18;"Banskobystrický kraj";10;0;0;0;NA;274501;10;2020-06-18;103
2020-06-17;"Banskobystrický kraj";1;0;0;0;NA;274501;1;2020-06-17;93
2020-06-16;"Banskobystrický kraj";0;0;0;0;NA;274501;0;2020-06-16;92
2020-06-14;"Banskobystrický kraj";2;0;0;0;NA;274501;2;2020-06-14;92
2020-06-13;"Banskobystrický kraj";2;0;0;0;NA;274501;2;2020-06-13;90
2020-06-12;"Banskobystrický kraj";0;0;0;0;NA;274501;0;2020-06-12;88
2020-06-11;"Banskobystrický kraj";1;0;0;0;NA;274501;1;2020-06-11;88
2020-06-10;"Banskobystrický kraj";0;0;0;0;NA;274501;0;2020-06-10;87
2020-06-09;"Banskobystrický kraj";0;0;0;0;NA;274501;0;2020-06-09;87
2020-06-08;"Banskobystrický kraj";0;0;0;0;NA;274501;0;2020-06-08;87
2020-06-07;"Banskobystrický kraj";0;0;0;0;NA;274501;0;2020-06-07;87
2020-06-05;"Banskobystrický kraj";2;0;0;0;NA;274501;2;2020-06-05;87
2020-06-03;"Banskobystrický kraj";0;0;0;0;NA;274501;0;2020-06-03;85
2020-06-02;"Banskobystrický kraj";0;0;0;0;NA;274501;0;2020-06-02;85
2020-05-31;"Banskobystrický kraj";0;0;0;0;NA;274501;0;2020-05-31;85
2020-05-29;"Banskobystrický kraj";0;0;0;0;NA;274501;0;2020-05-29;85
2020-05-27;"Banskobystrický kraj";1;0;0;0;NA;274501;1;2020-05-27;85
2020-05-26;"Banskobystrický kraj";0;0;0;0;NA;274501;0;2020-05-26;84
2020-05-25;"Banskobystrický kraj";0;0;0;0;NA;274501;0;2020-05-25;84
2020-05-24;"Banskobystrický kraj";0;0;0;0;NA;274501;0;2020-05-24;84
2020-05-23;"Banskobystrický kraj";1;0;0;0;NA;274501;1;2020-05-23;84
2020-05-22;"Banskobystrický kraj";0;0;0;0;NA;274501;0;2020-05-22;83
2020-05-21;"Banskobystrický kraj";0;0;0;0;NA;274501;0;2020-05-21;83
2020-05-20;"Banskobystrický kraj";1;0;0;0;NA;274501;1;2020-05-20;83
2020-05-19;"Banskobystrický kraj";0;0;0;0;NA;274501;0;2020-05-19;82
2020-05-17;"Banskobystrický kraj";0;0;0;0;NA;274501;0;2020-05-17;82
2020-05-16;"Banskobystrický kraj";0;0;0;0;NA;274501;0;2020-05-16;82
2020-05-15;"Banskobystrický kraj";0;0;0;0;NA;274501;0;2020-05-15;82
2020-05-14;"Banskobystrický kraj";0;0;0;0;NA;274501;0;2020-05-14;82
2020-05-13;"Banskobystrický kraj";0;0;0;0;NA;274501;0;2020-05-13;82
2020-05-12;"Banskobystrický kraj";1;0;0;0;NA;274501;1;2020-05-12;82
2020-05-11;"Banskobystrický kraj";0;0;0;0;NA;274501;0;2020-05-11;81
2020-05-09;"Banskobystrický kraj";0;0;0;0;NA;274501;0;2020-05-09;81
2020-05-07;"Banskobystrický kraj";2;0;0;0;NA;274501;2;2020-05-07;81
2020-05-06;"Banskobystrický kraj";1;0;0;0;NA;274501;1;2020-05-06;79
2020-05-05;"Banskobystrický kraj";2;0;0;0;NA;274501;2;2020-05-05;78
2020-05-04;"Banskobystrický kraj";0;0;0;0;NA;274501;0;2020-05-04;76
2020-05-03;"Banskobystrický kraj";0;0;0;0;NA;274501;0;2020-05-03;76
2020-05-02;"Banskobystrický kraj";0;0;0;0;NA;274501;0;2020-05-02;76
2020-05-01;"Banskobystrický kraj";0;0;0;0;NA;274501;0;2020-05-01;76
2020-04-30;"Banskobystrický kraj";1;0;0;0;NA;274501;1;2020-04-30;76
2020-04-29;"Banskobystrický kraj";1;0;0;0;NA;274501;1;2020-04-29;75
2020-04-28;"Banskobystrický kraj";0;0;0;0;NA;274501;0;2020-04-28;74
2020-04-27;"Banskobystrický kraj";0;0;0;0;NA;274501;0;2020-04-27;74
2020-04-26;"Banskobystrický kraj";0;0;0;0;NA;274501;0;2020-04-26;74
2020-04-25;"Banskobystrický kraj";2;0;0;0;NA;274501;2;2020-04-25;74
2020-04-24;"Banskobystrický kraj";3;0;0;0;NA;274501;3;2020-04-24;72
2020-04-23;"Banskobystrický kraj";2;0;0;0;NA;274501;2;2020-04-23;69
2020-04-22;"Banskobystrický kraj";2;0;0;0;NA;274501;2;2020-04-22;67
2020-04-21;"Banskobystrický kraj";2;0;0;0;NA;274501;2;2020-04-21;65
2020-04-20;"Banskobystrický kraj";0;0;0;0;NA;274501;0;2020-04-20;63
2020-04-19;"Banskobystrický kraj";0;0;0;0;NA;274501;0;2020-04-19;63
2020-04-18;"Banskobystrický kraj";8;0;0;0;NA;274501;8;2020-04-18;63
2020-04-17;"Banskobystrický kraj";2;0;0;0;NA;274501;2;2020-04-17;55
2020-04-16;"Banskobystrický kraj";0;0;0;0;NA;274501;0;2020-04-16;53
2020-04-15;"Banskobystrický kraj";10;0;0;0;NA;274501;10;2020-04-15;53
2020-04-14;"Banskobystrický kraj";0;0;0;0;NA;274501;0;2020-04-14;43
2020-04-13;"Banskobystrický kraj";2;0;0;0;NA;274501;2;2020-04-13;43
2020-04-12;"Banskobystrický kraj";4;0;0;0;NA;274501;4;2020-04-12;41
2020-04-11;"Banskobystrický kraj";1;0;0;0;NA;274501;1;2020-04-11;37
2020-04-10;"Banskobystrický kraj";0;0;0;0;NA;274501;0;2020-04-10;36
2020-04-09;"Banskobystrický kraj";2;0;0;0;NA;274501;2;2020-04-09;36
2020-04-08;"Banskobystrický kraj";0;0;0;0;NA;274501;0;2020-04-08;34
2020-04-07;"Banskobystrický kraj";4;0;0;0;NA;274501;4;2020-04-07;34
2020-04-06;"Banskobystrický kraj";10;0;0;0;NA;274501;10;2020-04-06;30
2020-04-05;"Banskobystrický kraj";9;0;0;0;NA;274501;9;2020-04-05;20
2020-04-04;"Banskobystrický kraj";0;0;0;0;NA;274501;0;2020-04-04;11
2020-04-03;"Banskobystrický kraj";2;0;0;0;NA;274501;2;2020-04-03;11
2020-04-02;"Banskobystrický kraj";2;0;0;0;NA;274501;2;2020-04-02;9
2020-04-01;"Banskobystrický kraj";5;0;0;0;NA;274501;5;2020-04-01;7
2020-03-31;"Banskobystrický kraj";3;0;0;0;NA;274501;3;2020-03-31;2
2020-03-30;"Banskobystrický kraj";1;0;0;0;NA;274501;1;2020-03-30;-1
2020-03-29;"Banskobystrický kraj";2;0;0;0;NA;274501;2;2020-03-29;-2
2020-03-28;"Banskobystrický kraj";1;0;0;0;NA;274501;1;2020-03-28;-4
2020-03-27;"Banskobystrický kraj";1;0;0;0;NA;274501;1;2020-03-27;-5
2020-03-26;"Banskobystrický kraj";1;0;0;0;NA;274501;1;2020-03-26;-6
2020-03-25;"Banskobystrický kraj";0;0;0;0;NA;274501;0;2020-03-25;-7
2020-03-24;"Banskobystrický kraj";1;0;0;0;NA;274501;1;2020-03-24;-7
2020-03-23;"Banskobystrický kraj";1;0;0;0;NA;274501;1;2020-03-23;-8
2020-03-22;"Banskobystrický kraj";0;0;0;0;NA;274501;0;2020-03-22;-9
2020-03-21;"Banskobystrický kraj";3;0;0;0;NA;274501;3;2020-03-21;-9
2020-03-20;"Banskobystrický kraj";0;0;0;0;NA;274501;0;2020-03-20;-12
2020-03-19;"Banskobystrický kraj";2;0;0;0;NA;274501;2;2020-03-19;-12
2020-03-18;"Banskobystrický kraj";1;0;0;0;NA;274501;1;2020-03-18;-14
2020-03-17;"Banskobystrický kraj";1;0;0;0;NA;274501;1;2020-03-17;-15
2020-03-16;"Banskobystrický kraj";0;0;0;0;NA;274501;0;2020-03-16;-16
2020-03-15;"Banskobystrický kraj";1;0;0;0;NA;274501;1;2020-03-15;-16
2020-03-14;"Banskobystrický kraj";0;0;0;0;NA;274501;0;2020-03-14;-17
2020-03-13;"Banskobystrický kraj";1;0;0;0;NA;274501;1;2020-03-13;-17
2020-03-12;"Banskobystrický kraj";0;0;0;0;NA;274501;0;2020-03-12;-18
2020-03-11;"Banskobystrický kraj";0;0;0;0;NA;274501;0;2020-03-11;-18
2020-03-09;"Banskobystrický kraj";0;0;0;0;NA;274501;0;2020-03-09;-18
2020-03-08;"Banskobystrický kraj";0;0;0;0;NA;274501;0;2020-03-08;-18
2020-03-07;"Banskobystrický kraj";0;0;0;0;NA;274501;0;2020-03-07;-18
2020-03-06;"Banskobystrický kraj";0;0;0;0;NA;274501;0;2020-03-06;-18
2022-05-26;"Bratislavský kraj";46;22;0;22;251273;344588;46;2022-05-26;344588
2022-05-25;"Bratislavský kraj";36;485;4;489;NA;344588;40;2022-05-25;344542
2022-05-24;"Bratislavský kraj";46;849;10;859;NA;344588;56;2022-05-24;344502
2022-05-23;"Bratislavský kraj";66;799;11;810;NA;344588;77;2022-05-23;344446
2022-05-22;"Bratislavský kraj";25;288;4;292;NA;344588;29;2022-05-22;344369
2022-05-21;"Bratislavský kraj";35;258;6;264;NA;344588;41;2022-05-21;344340
2022-05-20;"Bratislavský kraj";39;907;2;909;NA;344588;41;2022-05-20;344299
2022-05-19;"Bratislavský kraj";50;928;11;939;NA;344588;61;2022-05-19;344258
2022-05-18;"Bratislavský kraj";66;763;10;773;NA;344588;76;2022-05-18;344197
2022-05-17;"Bratislavský kraj";49;903;15;918;NA;344588;64;2022-05-17;344121
2022-05-16;"Bratislavský kraj";56;988;16;1004;NA;344588;72;2022-05-16;344057
2022-05-15;"Bratislavský kraj";16;316;5;321;NA;344588;21;2022-05-15;343985
2022-05-14;"Bratislavský kraj";33;410;11;421;NA;344588;44;2022-05-14;343964
2022-05-13;"Bratislavský kraj";63;962;8;970;NA;344588;71;2022-05-13;343920
2022-05-12;"Bratislavský kraj";59;936;13;949;NA;344588;72;2022-05-12;343849
2022-05-11;"Bratislavský kraj";89;988;17;1005;NA;344588;106;2022-05-11;343777
2022-05-10;"Bratislavský kraj";82;1004;17;1021;NA;344588;99;2022-05-10;343671
2022-05-09;"Bratislavský kraj";89;1108;36;1144;NA;344588;125;2022-05-09;343572
2022-05-08;"Bratislavský kraj";31;360;7;367;NA;344588;38;2022-05-08;343447
2022-05-07;"Bratislavský kraj";79;349;8;357;NA;344588;87;2022-05-07;343409
2022-05-06;"Bratislavský kraj";89;1043;14;1057;NA;344588;103;2022-05-06;343322
2022-05-05;"Bratislavský kraj";137;1136;11;1147;NA;344588;148;2022-05-05;343219
2022-05-04;"Bratislavský kraj";153;1159;28;1187;NA;344588;181;2022-05-04;343071
2022-05-03;"Bratislavský kraj";137;1206;29;1235;NA;344588;166;2022-05-03;342890
2022-05-02;"Bratislavský kraj";174;2123;51;2174;NA;344588;225;2022-05-02;342724
2022-05-01;"Bratislavský kraj";54;655;15;670;NA;344588;69;2022-05-01;342499
2022-04-30;"Bratislavský kraj";178;705;9;714;NA;344588;187;2022-04-30;342430
2022-04-29;"Bratislavský kraj";192;1911;34;1945;NA;344588;226;2022-04-29;342243
2022-04-28;"Bratislavský kraj";206;1731;21;1752;NA;344588;227;2022-04-28;342017
2022-04-27;"Bratislavský kraj";188;1875;24;1899;NA;344588;212;2022-04-27;341790
2022-04-26;"Bratislavský kraj";292;1786;37;1823;NA;344588;329;2022-04-26;341578
2022-04-25;"Bratislavský kraj";199;2342;46;2388;NA;344588;245;2022-04-25;341249
2022-04-24;"Bratislavský kraj";126;815;31;846;NA;344588;157;2022-04-24;341004
2022-04-23;"Bratislavský kraj";216;760;18;778;NA;344588;234;2022-04-23;340847
2022-04-22;"Bratislavský kraj";343;1780;43;1823;NA;344588;386;2022-04-22;340613
2022-04-21;"Bratislavský kraj";359;1933;59;1992;NA;344588;418;2022-04-21;340227
2022-04-20;"Bratislavský kraj";543;2153;48;2201;NA;344588;591;2022-04-20;339809
2022-04-19;"Bratislavský kraj";253;2891;99;2990;NA;344588;352;2022-04-19;339218
2022-04-18;"Bratislavský kraj";174;710;26;736;NA;344588;200;2022-04-18;338866
2022-04-17;"Bratislavský kraj";315;655;27;682;NA;344588;342;2022-04-17;338666
2022-04-16;"Bratislavský kraj";170;761;33;794;NA;344588;203;2022-04-16;338324
2022-04-15;"Bratislavský kraj";281;835;25;860;NA;344588;306;2022-04-15;338121
2022-04-14;"Bratislavský kraj";538;1896;63;1959;NA;344588;601;2022-04-14;337815
2022-04-13;"Bratislavský kraj";555;1917;47;1964;NA;344588;602;2022-04-13;337214
2022-04-12;"Bratislavský kraj";612;2239;68;2307;NA;344588;680;2022-04-12;336612
2022-04-11;"Bratislavský kraj";514;2967;105;3072;NA;344588;619;2022-04-11;335932
2022-04-10;"Bratislavský kraj";293;963;63;1026;NA;344588;356;2022-04-10;335313
2022-04-09;"Bratislavský kraj";610;898;43;941;NA;344588;653;2022-04-09;334957
2022-04-08;"Bratislavský kraj";668;1746;82;1828;NA;344588;750;2022-04-08;334304
2022-04-07;"Bratislavský kraj";833;2348;96;2444;NA;344588;929;2022-04-07;333554
2022-04-06;"Bratislavský kraj";865;2042;100;2142;NA;344588;965;2022-04-06;332625
2022-04-05;"Bratislavský kraj";914;2358;127;2485;NA;344588;1041;2022-04-05;331660
2022-04-04;"Bratislavský kraj";827;3232;167;3399;NA;344588;994;2022-04-04;330619
2022-04-03;"Bratislavský kraj";589;1031;70;1101;NA;344588;659;2022-04-03;329625
2022-04-02;"Bratislavský kraj";863;1128;75;1203;NA;344588;938;2022-04-02;328966
2022-04-01;"Bratislavský kraj";1381;2274;128;2402;NA;344588;1509;2022-04-01;328028
2022-03-31;"Bratislavský kraj";1305;2861;154;3015;NA;344588;1459;2022-03-31;326519
2022-03-30;"Bratislavský kraj";1516;2133;161;2294;NA;344588;1677;2022-03-30;325060
2022-03-29;"Bratislavský kraj";1327;2570;216;2786;NA;344588;1543;2022-03-29;323383
2022-03-28;"Bratislavský kraj";1275;4214;267;4481;NA;344588;1542;2022-03-28;321840
2022-03-27;"Bratislavský kraj";962;1236;151;1387;NA;344588;1113;2022-03-27;320298
2022-03-26;"Bratislavský kraj";1391;1170;105;1275;NA;344588;1496;2022-03-26;319185
2022-03-25;"Bratislavský kraj";1793;2513;170;2683;NA;344588;1963;2022-03-25;317689
2022-03-24;"Bratislavský kraj";1708;2866;197;3063;NA;344588;1905;2022-03-24;315726
2022-03-23;"Bratislavský kraj";2093;2832;200;3032;NA;344588;2293;2022-03-23;313821
2022-03-22;"Bratislavský kraj";1857;2889;236;3125;NA;344588;2093;2022-03-22;311528
2022-03-21;"Bratislavský kraj";1469;4361;383;4744;NA;344588;1852;2022-03-21;309435
2022-03-20;"Bratislavský kraj";935;1359;181;1540;NA;344588;1116;2022-03-20;307583
2022-03-19;"Bratislavský kraj";1672;1510;142;1652;NA;344588;1814;2022-03-19;306467
2022-03-18;"Bratislavský kraj";1977;2942;209;3151;NA;344588;2186;2022-03-18;304653
2022-03-17;"Bratislavský kraj";2024;3501;253;3754;NA;344588;2277;2022-03-17;302467
2022-03-16;"Bratislavský kraj";1895;2773;265;3038;NA;344588;2160;2022-03-16;300190
2022-03-15;"Bratislavský kraj";1982;3813;343;4156;NA;344588;2325;2022-03-15;298030
2022-03-14;"Bratislavský kraj";1557;4138;348;4486;NA;344588;1905;2022-03-14;295705
2022-03-13;"Bratislavský kraj";738;1324;166;1490;NA;344588;904;2022-03-13;293800
2022-03-12;"Bratislavský kraj";1632;1264;110;1374;NA;344588;1742;2022-03-12;292896
2022-03-11;"Bratislavský kraj";1184;3161;318;3479;NA;344588;1502;2022-03-11;291154
2022-03-10;"Bratislavský kraj";1706;3603;355;3958;NA;344588;2061;2022-03-10;289652
2022-03-09;"Bratislavský kraj";1723;2818;276;3094;NA;344588;1999;2022-03-09;287591
2022-03-08;"Bratislavský kraj";1925;3830;342;4172;NA;344588;2267;2022-03-08;285592
2022-03-07;"Bratislavský kraj";1451;4303;486;4789;NA;344588;1937;2022-03-07;283325
2022-03-06;"Bratislavský kraj";850;1557;217;1774;NA;344588;1067;2022-03-06;281388
2022-03-05;"Bratislavský kraj";1203;1345;183;1528;NA;344588;1386;2022-03-05;280321
2022-03-04;"Bratislavský kraj";1443;3024;309;3333;NA;344588;1752;2022-03-04;278935
2022-03-03;"Bratislavský kraj";1599;3287;330;3617;NA;344588;1929;2022-03-03;277183
2022-03-02;"Bratislavský kraj";1677;2555;319;2874;NA;344588;1996;2022-03-02;275254
2022-03-01;"Bratislavský kraj";1560;3676;344;4020;NA;344588;1904;2022-03-01;273258
2022-02-28;"Bratislavský kraj";1593;4052;472;4524;NA;344588;2065;2022-02-28;271354
2022-02-27;"Bratislavský kraj";1156;1746;227;1973;NA;344588;1383;2022-02-27;269289
2022-02-26;"Bratislavský kraj";1228;1749;209;1958;NA;344588;1437;2022-02-26;267906
2022-02-25;"Bratislavský kraj";1692;3604;323;3927;NA;344588;2015;2022-02-25;266469
2022-02-24;"Bratislavský kraj";1760;3992;324;4316;NA;344588;2084;2022-02-24;264454
2022-02-23;"Bratislavský kraj";2105;3450;393;3843;NA;344588;2498;2022-02-23;262370
2022-02-22;"Bratislavský kraj";2951;4213;384;4597;NA;344588;3335;2022-02-22;259872
2022-02-21;"Bratislavský kraj";781;5116;517;5633;NA;344588;1298;2022-02-21;256537
2022-02-20;"Bratislavský kraj";1314;2005;294;2299;NA;344588;1608;2022-02-20;255239
2022-02-19;"Bratislavský kraj";1510;1929;235;2164;NA;344588;1745;2022-02-19;253631
2022-02-18;"Bratislavský kraj";2315;3835;378;4213;NA;344588;2693;2022-02-18;251886
2022-02-17;"Bratislavský kraj";2279;4412;416;4828;NA;344588;2695;2022-02-17;249193
2022-02-16;"Bratislavský kraj";2137;3749;419;4168;NA;344588;2556;2022-02-16;246498
2022-02-15;"Bratislavský kraj";2276;4894;475;5369;NA;344588;2751;2022-02-15;243942
2022-02-14;"Bratislavský kraj";2700;6170;601;6771;NA;344588;3301;2022-02-14;241191
2022-02-13;"Bratislavský kraj";1343;2248;395;2643;NA;344588;1738;2022-02-13;237890
2022-02-12;"Bratislavský kraj";1872;2273;336;2609;NA;344588;2208;2022-02-12;236152
2022-02-11;"Bratislavský kraj";2431;5054;419;5473;NA;344588;2850;2022-02-11;233944
2022-02-10;"Bratislavský kraj";2595;4563;427;4990;NA;344588;3022;2022-02-10;231094
2022-02-09;"Bratislavský kraj";2414;4706;477;5183;NA;344588;2891;2022-02-09;228072
2022-02-08;"Bratislavský kraj";2878;5134;512;5646;NA;344588;3390;2022-02-08;225181
2022-02-07;"Bratislavský kraj";2636;6970;668;7638;NA;344588;3304;2022-02-07;221791
2022-02-06;"Bratislavský kraj";1680;3005;382;3387;NA;344588;2062;2022-02-06;218487
2022-02-05;"Bratislavský kraj";2156;2456;315;2771;NA;344588;2471;2022-02-05;216425
2022-02-04;"Bratislavský kraj";2586;4679;408;5087;NA;344588;2994;2022-02-04;213954
2022-02-03;"Bratislavský kraj";2540;6005;435;6440;NA;344588;2975;2022-02-03;210960
2022-02-02;"Bratislavský kraj";2655;5035;465;5500;NA;344588;3120;2022-02-02;207985
2022-02-01;"Bratislavský kraj";2758;6001;469;6470;NA;344588;3227;2022-02-01;204865
2022-01-31;"Bratislavský kraj";2172;8357;712;9069;NA;344588;2884;2022-01-31;201638
2022-01-30;"Bratislavský kraj";1418;3314;362;3676;NA;344588;1780;2022-01-30;198754
2022-01-29;"Bratislavský kraj";1762;3138;326;3464;NA;344588;2088;2022-01-29;196974
2022-01-28;"Bratislavský kraj";2237;5047;389;5436;NA;344588;2626;2022-01-28;194886
2022-01-27;"Bratislavský kraj";2014;5975;334;6309;NA;344588;2348;2022-01-27;192260
2022-01-26;"Bratislavský kraj";1792;4895;367;5262;NA;344588;2159;2022-01-26;189912
2022-01-25;"Bratislavský kraj";1933;5551;385;5936;NA;344588;2318;2022-01-25;187753
2022-01-24;"Bratislavský kraj";1173;7911;315;8226;NA;344588;1488;2022-01-24;185435
2022-01-23;"Bratislavský kraj";862;3289;151;3440;NA;344588;1013;2022-01-23;183947
2022-01-22;"Bratislavský kraj";1130;2802;125;2927;NA;344588;1255;2022-01-22;182934
2022-01-21;"Bratislavský kraj";1057;4656;166;4822;NA;344588;1223;2022-01-21;181679
2022-01-20;"Bratislavský kraj";940;4893;146;5039;NA;344588;1086;2022-01-20;180456
2022-01-19;"Bratislavský kraj";857;4618;169;4787;NA;344588;1026;2022-01-19;179370
2022-01-18;"Bratislavský kraj";794;5002;163;5165;NA;344588;957;2022-01-18;178344
2022-01-17;"Bratislavský kraj";534;7242;150;7392;NA;344588;684;2022-01-17;177387
2022-01-16;"Bratislavský kraj";300;2854;77;2931;NA;344588;377;2022-01-16;176703
2022-01-15;"Bratislavský kraj";543;2139;71;2210;NA;344588;614;2022-01-15;176326
2022-01-14;"Bratislavský kraj";356;3692;70;3762;NA;344588;426;2022-01-14;175712
2022-01-13;"Bratislavský kraj";382;4579;82;4661;NA;344588;464;2022-01-13;175286
2022-01-12;"Bratislavský kraj";415;4014;71;4085;NA;344588;486;2022-01-12;174822
2022-01-11;"Bratislavský kraj";407;4910;110;5020;NA;344588;517;2022-01-11;174336
2022-01-10;"Bratislavský kraj";413;6380;101;6481;NA;344588;514;2022-01-10;173819
2022-01-09;"Bratislavský kraj";187;3080;71;3151;NA;344588;258;2022-01-09;173305
2022-01-08;"Bratislavský kraj";323;1951;58;2009;NA;344588;381;2022-01-08;173047
2022-01-07;"Bratislavský kraj";436;3809;100;3909;NA;344588;536;2022-01-07;172666
2022-01-06;"Bratislavský kraj";192;2163;51;2214;NA;344588;243;2022-01-06;172130
2022-01-05;"Bratislavský kraj";426;4047;69;4116;NA;344588;495;2022-01-05;171887
2022-01-04;"Bratislavský kraj";446;4467;101;4568;NA;344588;547;2022-01-04;171392
2022-01-03;"Bratislavský kraj";578;5672;129;5801;NA;344588;707;2022-01-03;170845
2022-01-02;"Bratislavský kraj";198;3137;80;3217;NA;344588;278;2022-01-02;170138
2022-01-01;"Bratislavský kraj";7;1103;36;1139;NA;344588;43;2022-01-01;169860
2021-12-31;"Bratislavský kraj";371;3443;92;3535;NA;344588;463;2021-12-31;169817
2021-12-30;"Bratislavský kraj";468;3619;119;3738;NA;344588;587;2021-12-30;169354
2021-12-29;"Bratislavský kraj";404;3598;85;3683;NA;344588;489;2021-12-29;168767
2021-12-28;"Bratislavský kraj";578;4329;121;4450;NA;344588;699;2021-12-28;168278
2021-12-27;"Bratislavský kraj";656;4693;108;4801;NA;344588;764;2021-12-27;167579
2021-12-26;"Bratislavský kraj";198;2549;83;2632;NA;344588;281;2021-12-26;166815
2021-12-25;"Bratislavský kraj";34;1160;53;1213;NA;344588;87;2021-12-25;166534
2021-12-24;"Bratislavský kraj";171;2214;55;2269;NA;344588;226;2021-12-24;166447
2021-12-23;"Bratislavský kraj";678;4134;115;4249;NA;344588;793;2021-12-23;166221
2021-12-22;"Bratislavský kraj";575;4919;118;5037;NA;344588;693;2021-12-22;165428
2021-12-21;"Bratislavský kraj";625;5628;167;5795;NA;344588;792;2021-12-21;164735
2021-12-20;"Bratislavský kraj";528;6163;158;6321;NA;344588;686;2021-12-20;163943
2021-12-19;"Bratislavský kraj";250;3042;98;3140;NA;344588;348;2021-12-19;163257
2021-12-18;"Bratislavský kraj";528;2654;103;2757;NA;344588;631;2021-12-18;162909
2021-12-17;"Bratislavský kraj";683;4917;145;5062;NA;344588;828;2021-12-17;162278
2021-12-16;"Bratislavský kraj";730;5576;162;5738;NA;344588;892;2021-12-16;161450
2021-12-15;"Bratislavský kraj";881;4884;158;5042;NA;344588;1039;2021-12-15;160558
2021-12-14;"Bratislavský kraj";869;5397;179;5576;NA;344588;1048;2021-12-14;159519
2021-12-13;"Bratislavský kraj";648;7614;239;7853;NA;344588;887;2021-12-13;158471
2021-12-12;"Bratislavský kraj";534;3474;129;3603;NA;344588;663;2021-12-12;157584
2021-12-11;"Bratislavský kraj";698;2377;153;2530;NA;344588;851;2021-12-11;156921
2021-12-10;"Bratislavský kraj";796;4728;186;4914;NA;344588;982;2021-12-10;156070
2021-12-09;"Bratislavský kraj";1040;4152;174;4326;NA;344588;1214;2021-12-09;155088
2021-12-08;"Bratislavský kraj";1172;4602;196;4798;NA;344588;1368;2021-12-08;153874
2021-12-07;"Bratislavský kraj";1236;5173;257;5430;NA;344588;1493;2021-12-07;152506
2021-12-06;"Bratislavský kraj";1434;8714;312;9026;NA;344588;1746;2021-12-06;151013
2021-12-05;"Bratislavský kraj";633;3874;197;4071;NA;344588;830;2021-12-05;149267
2021-12-04;"Bratislavský kraj";936;4332;195;4527;NA;344588;1131;2021-12-04;148437
2021-12-03;"Bratislavský kraj";1222;4351;269;4620;NA;344588;1491;2021-12-03;147306
2021-12-02;"Bratislavský kraj";2053;5097;311;5408;NA;344588;2364;2021-12-02;145815
2021-12-01;"Bratislavský kraj";1161;9058;295;9353;NA;344588;1456;2021-12-01;143451
2021-11-30;"Bratislavský kraj";1442;6508;355;6863;NA;344588;1797;2021-11-30;141995
2021-11-29;"Bratislavský kraj";863;8823;452;9275;NA;344588;1315;2021-11-29;140198
2021-11-28;"Bratislavský kraj";617;5102;295;5397;NA;344588;912;2021-11-28;138883
2021-11-27;"Bratislavský kraj";1026;3497;329;3826;NA;344588;1355;2021-11-27;137971
2021-11-26;"Bratislavský kraj";1346;5483;422;5905;NA;344588;1768;2021-11-26;136616
2021-11-25;"Bratislavský kraj";1415;6383;451;6834;NA;344588;1866;2021-11-25;134848
2021-11-24;"Bratislavský kraj";1286;6849;467;7316;NA;344588;1753;2021-11-24;132982
2021-11-23;"Bratislavský kraj";1651;6351;433;6784;NA;344588;2084;2021-11-23;131229
2021-11-22;"Bratislavský kraj";1197;8722;584;9306;NA;344588;1781;2021-11-22;129145
2021-11-21;"Bratislavský kraj";702;4324;320;4644;NA;344588;1022;2021-11-21;127364
2021-11-20;"Bratislavský kraj";1005;3514;360;3874;NA;344588;1365;2021-11-20;126342
2021-11-19;"Bratislavský kraj";1444;5927;549;6476;NA;344588;1993;2021-11-19;124977
2021-11-18;"Bratislavský kraj";1052;6358;548;6906;NA;344588;1600;2021-11-18;122984
2021-11-17;"Bratislavský kraj";832;2439;308;2747;NA;344588;1140;2021-11-17;121384
2021-11-16;"Bratislavský kraj";1067;5792;443;6235;NA;344588;1510;2021-11-16;120244
2021-11-15;"Bratislavský kraj";1014;6330;519;6849;NA;344588;1533;2021-11-15;118734
2021-11-14;"Bratislavský kraj";448;3202;335;3537;NA;344588;783;2021-11-14;117201
2021-11-13;"Bratislavský kraj";587;3251;313;3564;NA;344588;900;2021-11-13;116418
2021-11-12;"Bratislavský kraj";856;5723;357;6080;NA;344588;1213;2021-11-12;115518
2021-11-11;"Bratislavský kraj";787;6028;355;6383;NA;344588;1142;2021-11-11;114305
2021-11-10;"Bratislavský kraj";840;5903;385;6288;NA;344588;1225;2021-11-10;113163
2021-11-09;"Bratislavský kraj";939;5733;350;6083;NA;344588;1289;2021-11-09;111938
2021-11-08;"Bratislavský kraj";579;5641;404;6045;NA;344588;983;2021-11-08;110649
2021-11-07;"Bratislavský kraj";363;2836;244;3080;NA;344588;607;2021-11-07;109666
2021-11-06;"Bratislavský kraj";538;2901;243;3144;NA;344588;781;2021-11-06;109059
2021-11-05;"Bratislavský kraj";801;5640;318;5958;NA;344588;1119;2021-11-05;108278
2021-11-04;"Bratislavský kraj";768;5233;273;5506;NA;344588;1041;2021-11-04;107159
2021-11-03;"Bratislavský kraj";690;5120;290;5410;NA;344588;980;2021-11-03;106118
2021-11-02;"Bratislavský kraj";422;6356;327;6683;NA;344588;749;2021-11-02;105138
2021-11-01;"Bratislavský kraj";395;1733;136;1869;NA;344588;531;2021-11-01;104389
2021-10-31;"Bratislavský kraj";209;2280;163;2443;NA;344588;372;2021-10-31;103858
2021-10-30;"Bratislavský kraj";429;2138;118;2256;NA;344588;547;2021-10-30;103486
2021-10-29;"Bratislavský kraj";445;4757;219;4976;NA;344588;664;2021-10-29;102939
2021-10-28;"Bratislavský kraj";372;4777;179;4956;NA;344588;551;2021-10-28;102275
2021-10-27;"Bratislavský kraj";376;4522;164;4686;NA;344588;540;2021-10-27;101724
2021-10-26;"Bratislavský kraj";461;4492;188;4680;NA;344588;649;2021-10-26;101184
2021-10-25;"Bratislavský kraj";379;5347;192;5539;NA;344588;571;2021-10-25;100535
2021-10-24;"Bratislavský kraj";114;2369;91;2460;NA;344588;205;2021-10-24;99964
2021-10-23;"Bratislavský kraj";301;2666;91;2757;NA;344588;392;2021-10-23;99759
2021-10-22;"Bratislavský kraj";309;4466;122;4588;NA;344588;431;2021-10-22;99367
2021-10-21;"Bratislavský kraj";244;4544;101;4645;NA;344588;345;2021-10-21;98936
2021-10-20;"Bratislavský kraj";262;3897;95;3992;NA;344588;357;2021-10-20;98591
2021-10-19;"Bratislavský kraj";260;4116;68;4184;NA;344588;328;2021-10-19;98234
2021-10-18;"Bratislavský kraj";250;5014;114;5128;NA;344588;364;2021-10-18;97906
2021-10-17;"Bratislavský kraj";54;2460;73;2533;NA;344588;127;2021-10-17;97542
2021-10-16;"Bratislavský kraj";185;2687;63;2750;NA;344588;248;2021-10-16;97415
2021-10-15;"Bratislavský kraj";169;4200;64;4264;NA;344588;233;2021-10-15;97167
2021-10-14;"Bratislavský kraj";173;4714;61;4775;NA;344588;234;2021-10-14;96934
2021-10-13;"Bratislavský kraj";143;3671;76;3747;NA;344588;219;2021-10-13;96700
2021-10-12;"Bratislavský kraj";183;4037;78;4115;NA;344588;261;2021-10-12;96481
2021-10-11;"Bratislavský kraj";191;4798;88;4886;NA;344588;279;2021-10-11;96220
2021-10-10;"Bratislavský kraj";29;2176;43;2219;NA;344588;72;2021-10-10;95941
2021-10-09;"Bratislavský kraj";141;2419;34;2453;NA;344588;175;2021-10-09;95869
2021-10-08;"Bratislavský kraj";130;4511;63;4574;NA;344588;193;2021-10-08;95694
2021-10-07;"Bratislavský kraj";92;4137;61;4198;NA;344588;153;2021-10-07;95501
2021-10-06;"Bratislavský kraj";147;4028;68;4096;NA;344588;215;2021-10-06;95348
2021-10-05;"Bratislavský kraj";164;4468;70;4538;NA;344588;234;2021-10-05;95133
2021-10-04;"Bratislavský kraj";129;4653;79;4732;NA;344588;208;2021-10-04;94899
2021-10-03;"Bratislavský kraj";41;2144;42;2186;NA;344588;83;2021-10-03;94691
2021-10-02;"Bratislavský kraj";104;2605;40;2645;NA;344588;144;2021-10-02;94608
2021-10-01;"Bratislavský kraj";108;4818;57;4875;NA;344588;165;2021-10-01;94464
2021-09-30;"Bratislavský kraj";90;3854;60;3914;NA;344588;150;2021-09-30;94299
2021-09-29;"Bratislavský kraj";115;3508;58;3566;NA;344588;173;2021-09-29;94149
2021-09-28;"Bratislavský kraj";144;4003;48;4051;NA;344588;192;2021-09-28;93976
2021-09-27;"Bratislavský kraj";123;4427;70;4497;NA;344588;193;2021-09-27;93784
2021-09-26;"Bratislavský kraj";32;2194;31;2225;NA;344588;63;2021-09-26;93591
2021-09-25;"Bratislavský kraj";85;2742;38;2780;NA;344588;123;2021-09-25;93528
2021-09-24;"Bratislavský kraj";82;4212;59;4271;NA;344588;141;2021-09-24;93405
2021-09-23;"Bratislavský kraj";90;3975;51;4026;NA;344588;141;2021-09-23;93264
2021-09-22;"Bratislavský kraj";84;3757;63;3820;NA;344588;147;2021-09-22;93123
2021-09-21;"Bratislavský kraj";95;3574;39;3613;NA;344588;134;2021-09-21;92976
2021-09-20;"Bratislavský kraj";84;3937;31;3968;NA;344588;115;2021-09-20;92842
2021-09-19;"Bratislavský kraj";31;1850;28;1878;NA;344588;59;2021-09-19;92727
2021-09-18;"Bratislavský kraj";60;1989;19;2008;NA;344588;79;2021-09-18;92668
2021-09-17;"Bratislavský kraj";87;3443;27;3470;NA;344588;114;2021-09-17;92589
2021-09-16;"Bratislavský kraj";57;3781;43;3824;NA;344588;100;2021-09-16;92475
2021-09-15;"Bratislavský kraj";41;1104;21;1125;NA;344588;62;2021-09-15;92375
2021-09-14;"Bratislavský kraj";78;3518;31;3549;NA;344588;109;2021-09-14;92313
2021-09-13;"Bratislavský kraj";47;3191;28;3219;NA;344588;75;2021-09-13;92204
2021-09-12;"Bratislavský kraj";13;1713;21;1734;NA;344588;34;2021-09-12;92129
2021-09-11;"Bratislavský kraj";36;2064;13;2077;NA;344588;49;2021-09-11;92095
2021-09-10;"Bratislavský kraj";47;3628;18;3646;NA;344588;65;2021-09-10;92046
2021-09-09;"Bratislavský kraj";50;3010;30;3040;NA;344588;80;2021-09-09;91981
2021-09-08;"Bratislavský kraj";56;2925;20;2945;NA;344588;76;2021-09-08;91901
2021-09-07;"Bratislavský kraj";50;3272;18;3290;NA;344588;68;2021-09-07;91825
2021-09-06;"Bratislavský kraj";63;2821;29;2850;NA;344588;92;2021-09-06;91757
2021-09-05;"Bratislavský kraj";10;1682;14;1696;NA;344588;24;2021-09-05;91665
2021-09-04;"Bratislavský kraj";41;2612;11;2623;NA;344588;52;2021-09-04;91641
2021-09-03;"Bratislavský kraj";55;3016;14;3030;NA;344588;69;2021-09-03;91589
2021-09-02;"Bratislavský kraj";35;2423;23;2446;NA;344588;58;2021-09-02;91520
2021-09-01;"Bratislavský kraj";16;929;9;938;NA;344588;25;2021-09-01;91462
2021-08-31;"Bratislavský kraj";28;5197;22;5219;NA;344588;50;2021-08-31;91437
2021-08-30;"Bratislavský kraj";24;2403;13;2416;NA;344588;37;2021-08-30;91387
2021-08-29;"Bratislavský kraj";11;1016;6;1022;NA;344588;17;2021-08-29;91350
2021-08-28;"Bratislavský kraj";24;1714;11;1725;NA;344588;35;2021-08-28;91333
2021-08-27;"Bratislavský kraj";19;2850;9;2859;NA;344588;28;2021-08-27;91298
2021-08-26;"Bratislavský kraj";15;2382;19;2401;NA;344588;34;2021-08-26;91270
2021-08-25;"Bratislavský kraj";29;1888;10;1898;NA;344588;39;2021-08-25;91236
2021-08-24;"Bratislavský kraj";22;1785;4;1789;NA;344588;26;2021-08-24;91197
2021-08-23;"Bratislavský kraj";21;2183;7;2190;NA;344588;28;2021-08-23;91171
2021-08-22;"Bratislavský kraj";5;1383;8;1391;NA;344588;13;2021-08-22;91143
2021-08-21;"Bratislavský kraj";18;1681;4;1685;NA;344588;22;2021-08-21;91130
2021-08-20;"Bratislavský kraj";27;2747;19;2766;NA;344588;46;2021-08-20;91108
2021-08-19;"Bratislavský kraj";15;2122;9;2131;NA;344588;24;2021-08-19;91062
2021-08-18;"Bratislavský kraj";16;1659;11;1670;NA;344588;27;2021-08-18;91038
2021-08-17;"Bratislavský kraj";18;1608;5;1613;NA;344588;23;2021-08-17;91011
2021-08-16;"Bratislavský kraj";18;2559;12;2571;NA;344588;30;2021-08-16;90988
2021-08-15;"Bratislavský kraj";3;1169;6;1175;NA;344588;9;2021-08-15;90958
2021-08-14;"Bratislavský kraj";11;1519;4;1523;NA;344588;15;2021-08-14;90949
2021-08-13;"Bratislavský kraj";32;2634;7;2641;NA;344588;39;2021-08-13;90934
2021-08-12;"Bratislavský kraj";16;1824;9;1833;NA;344588;25;2021-08-12;90895
2021-08-11;"Bratislavský kraj";22;1621;5;1626;NA;344588;27;2021-08-11;90870
2021-08-10;"Bratislavský kraj";15;1630;7;1637;NA;344588;22;2021-08-10;90843
2021-08-09;"Bratislavský kraj";35;1927;9;1936;NA;344588;44;2021-08-09;90821
2021-08-08;"Bratislavský kraj";3;1152;4;1156;NA;344588;7;2021-08-08;90777
2021-08-07;"Bratislavský kraj";6;1572;9;1581;NA;344588;15;2021-08-07;90770
2021-08-06;"Bratislavský kraj";9;2510;10;2520;NA;344588;19;2021-08-06;90755
2021-08-05;"Bratislavský kraj";10;1651;7;1658;NA;344588;17;2021-08-05;90736
2021-08-04;"Bratislavský kraj";9;1578;0;1578;NA;344588;9;2021-08-04;90719
2021-08-03;"Bratislavský kraj";11;1507;5;1512;NA;344588;16;2021-08-03;90710
2021-08-02;"Bratislavský kraj";15;1749;11;1760;NA;344588;26;2021-08-02;90694
2021-08-01;"Bratislavský kraj";4;1224;8;1232;NA;344588;12;2021-08-01;90668
2021-07-31;"Bratislavský kraj";7;1623;2;1625;NA;344588;9;2021-07-31;90656
2021-07-30;"Bratislavský kraj";15;2540;7;2547;NA;344588;22;2021-07-30;90647
2021-07-29;"Bratislavský kraj";19;1790;7;1797;NA;344588;26;2021-07-29;90625
2021-07-28;"Bratislavský kraj";8;1538;11;1549;NA;344588;19;2021-07-28;90599
2021-07-27;"Bratislavský kraj";9;1476;5;1481;NA;344588;14;2021-07-27;90580
2021-07-26;"Bratislavský kraj";17;1806;7;1813;NA;344588;24;2021-07-26;90566
2021-07-25;"Bratislavský kraj";4;1411;2;1413;NA;344588;6;2021-07-25;90542
2021-07-24;"Bratislavský kraj";9;1732;3;1735;NA;344588;12;2021-07-24;90536
2021-07-23;"Bratislavský kraj";6;2400;3;2403;NA;344588;9;2021-07-23;90524
2021-07-22;"Bratislavský kraj";12;1944;6;1950;NA;344588;18;2021-07-22;90515
2021-07-21;"Bratislavský kraj";5;1860;6;1866;NA;344588;11;2021-07-21;90497
2021-07-20;"Bratislavský kraj";19;1559;1;1560;NA;344588;20;2021-07-20;90486
2021-07-19;"Bratislavský kraj";15;2259;3;2262;NA;344588;18;2021-07-19;90466
2021-07-18;"Bratislavský kraj";2;1462;3;1465;NA;344588;5;2021-07-18;90448
2021-07-17;"Bratislavský kraj";3;1870;2;1872;NA;344588;5;2021-07-17;90443
2021-07-16;"Bratislavský kraj";8;2834;4;2838;NA;344588;12;2021-07-16;90438
2021-07-15;"Bratislavský kraj";5;1677;0;1677;NA;344588;5;2021-07-15;90426
2021-07-14;"Bratislavský kraj";5;1904;3;1907;NA;344588;8;2021-07-14;90421
2021-07-13;"Bratislavský kraj";4;1584;4;1588;NA;344588;8;2021-07-13;90413
2021-07-12;"Bratislavský kraj";6;1780;5;1785;NA;344588;11;2021-07-12;90405
2021-07-11;"Bratislavský kraj";3;1896;3;1899;NA;344588;6;2021-07-11;90394
2021-07-10;"Bratislavský kraj";5;2240;3;2243;NA;344588;8;2021-07-10;90388
2021-07-09;"Bratislavský kraj";13;3546;7;3553;NA;344588;20;2021-07-09;90380
2021-07-08;"Bratislavský kraj";9;2433;4;2437;NA;344588;13;2021-07-08;90360
2021-07-07;"Bratislavský kraj";5;2792;4;2796;NA;344588;9;2021-07-07;90347
2021-07-06;"Bratislavský kraj";19;2771;4;2775;NA;344588;23;2021-07-06;90338
2021-07-05;"Bratislavský kraj";5;2481;5;2486;NA;344588;10;2021-07-05;90315
2021-07-04;"Bratislavský kraj";3;1824;2;1826;NA;344588;5;2021-07-04;90305
2021-07-03;"Bratislavský kraj";8;2205;5;2210;NA;344588;13;2021-07-03;90300
2021-07-02;"Bratislavský kraj";4;2227;4;2231;NA;344588;8;2021-07-02;90287
2021-07-01;"Bratislavský kraj";6;1809;5;1814;NA;344588;11;2021-07-01;90279
2021-06-30;"Bratislavský kraj";2;11548;11;11559;NA;344588;13;2021-06-30;90268
2021-06-29;"Bratislavský kraj";5;6831;7;6838;NA;344588;12;2021-06-29;90255
2021-06-28;"Bratislavský kraj";16;6654;24;6678;NA;344588;40;2021-06-28;90243
2021-06-27;"Bratislavský kraj";4;6689;11;6700;NA;344588;15;2021-06-27;90203
2021-06-26;"Bratislavský kraj";3;8741;6;8747;NA;344588;9;2021-06-26;90188
2021-06-25;"Bratislavský kraj";7;10285;15;10300;NA;344588;22;2021-06-25;90179
2021-06-24;"Bratislavský kraj";3;7384;16;7400;NA;344588;19;2021-06-24;90157
2021-06-23;"Bratislavský kraj";4;7346;12;7358;NA;344588;16;2021-06-23;90138
2021-06-22;"Bratislavský kraj";6;7244;10;7254;NA;344588;16;2021-06-22;90122
2021-06-21;"Bratislavský kraj";5;7641;9;7650;NA;344588;14;2021-06-21;90106
2021-06-20;"Bratislavský kraj";0;7369;5;7374;NA;344588;5;2021-06-20;90092
2021-06-19;"Bratislavský kraj";3;9226;4;9230;NA;344588;7;2021-06-19;90087
2021-06-18;"Bratislavský kraj";5;12763;9;12772;NA;344588;14;2021-06-18;90080
2021-06-17;"Bratislavský kraj";3;8625;13;8638;NA;344588;16;2021-06-17;90066
2021-06-16;"Bratislavský kraj";3;7105;4;7109;NA;344588;7;2021-06-16;90050
2021-06-15;"Bratislavský kraj";7;7309;17;7326;NA;344588;24;2021-06-15;90043
2021-06-14;"Bratislavský kraj";4;8231;9;8240;NA;344588;13;2021-06-14;90019
2021-06-13;"Bratislavský kraj";2;8791;11;8802;NA;344588;13;2021-06-13;90006
2021-06-12;"Bratislavský kraj";4;11152;11;11163;NA;344588;15;2021-06-12;89993
2021-06-11;"Bratislavský kraj";9;13644;21;13665;NA;344588;30;2021-06-11;89978
2021-06-10;"Bratislavský kraj";12;8637;15;8652;NA;344588;27;2021-06-10;89948
2021-06-09;"Bratislavský kraj";12;7596;12;7608;NA;344588;24;2021-06-09;89921
2021-06-08;"Bratislavský kraj";13;7907;29;7936;NA;344588;42;2021-06-08;89897
2021-06-07;"Bratislavský kraj";13;9247;43;9290;NA;344588;56;2021-06-07;89855
2021-06-06;"Bratislavský kraj";3;10350;20;10370;NA;344588;23;2021-06-06;89799
2021-06-05;"Bratislavský kraj";2;12692;15;12707;NA;344588;17;2021-06-05;89776
2021-06-04;"Bratislavský kraj";10;13846;31;13877;NA;344588;41;2021-06-04;89759
2021-06-03;"Bratislavský kraj";12;9615;19;9634;NA;344588;31;2021-06-03;89718
2021-06-02;"Bratislavský kraj";10;8684;17;8701;NA;344588;27;2021-06-02;89687
2021-06-01;"Bratislavský kraj";3;8812;25;8837;NA;344588;28;2021-06-01;89660
2021-05-31;"Bratislavský kraj";18;11248;32;11280;NA;344588;50;2021-05-31;89632
2021-05-30;"Bratislavský kraj";1;11758;17;11775;NA;344588;18;2021-05-30;89582
2021-05-29;"Bratislavský kraj";4;12245;8;12253;NA;344588;12;2021-05-29;89564
2021-05-28;"Bratislavský kraj";14;15865;23;15888;NA;344588;37;2021-05-28;89552
2021-05-27;"Bratislavský kraj";5;11321;18;11339;NA;344588;23;2021-05-27;89515
2021-05-26;"Bratislavský kraj";20;10709;17;10726;NA;344588;37;2021-05-26;89492
2021-05-25;"Bratislavský kraj";19;11864;31;11895;NA;344588;50;2021-05-25;89455
2021-05-24;"Bratislavský kraj";12;12966;23;12989;NA;344588;35;2021-05-24;89405
2021-05-23;"Bratislavský kraj";7;13074;24;13098;NA;344588;31;2021-05-23;89370
2021-05-22;"Bratislavský kraj";6;14044;22;14066;NA;344588;28;2021-05-22;89339
2021-05-21;"Bratislavský kraj";15;18996;22;19018;NA;344588;37;2021-05-21;89311
2021-05-20;"Bratislavský kraj";15;14112;17;14129;NA;344588;32;2021-05-20;89274
2021-05-19;"Bratislavský kraj";21;11958;24;11982;NA;344588;45;2021-05-19;89242
2021-05-18;"Bratislavský kraj";14;13005;33;13038;NA;344588;47;2021-05-18;89197
2021-05-17;"Bratislavský kraj";15;13854;29;13883;NA;344588;44;2021-05-17;89150
2021-05-16;"Bratislavský kraj";12;19797;32;19829;NA;344588;44;2021-05-16;89106
2021-05-15;"Bratislavský kraj";1;18113;30;18143;NA;344588;31;2021-05-15;89062
2021-05-14;"Bratislavský kraj";15;22228;30;22258;NA;344588;45;2021-05-14;89031
2021-05-13;"Bratislavský kraj";9;16211;17;16228;NA;344588;26;2021-05-13;88986
2021-05-12;"Bratislavský kraj";11;14638;28;14666;NA;344588;39;2021-05-12;88960
2021-05-11;"Bratislavský kraj";29;16741;32;16773;NA;344588;61;2021-05-11;88921
2021-05-10;"Bratislavský kraj";27;19991;64;20055;NA;344588;91;2021-05-10;88860
2021-05-09;"Bratislavský kraj";9;29358;32;29390;NA;344588;41;2021-05-09;88769
2021-05-08;"Bratislavský kraj";5;19451;24;19475;NA;344588;29;2021-05-08;88728
2021-05-07;"Bratislavský kraj";32;28211;65;28276;NA;344588;97;2021-05-07;88699
2021-05-06;"Bratislavský kraj";19;20079;52;20131;NA;344588;71;2021-05-06;88602
2021-05-05;"Bratislavský kraj";29;15526;31;15557;NA;344588;60;2021-05-05;88531
2021-05-04;"Bratislavský kraj";46;19143;53;19196;NA;344588;99;2021-05-04;88471
2021-05-03;"Bratislavský kraj";37;22322;64;22386;NA;344588;101;2021-05-03;88372
2021-05-02;"Bratislavský kraj";38;43064;75;43139;NA;344588;113;2021-05-02;88271
2021-05-01;"Bratislavský kraj";11;39905;40;39945;NA;344588;51;2021-05-01;88158
2021-04-30;"Bratislavský kraj";43;47403;82;47485;NA;344588;125;2021-04-30;88107
2021-04-29;"Bratislavský kraj";48;30257;96;30353;NA;344588;144;2021-04-29;87982
2021-04-28;"Bratislavský kraj";40;28905;78;28983;NA;344588;118;2021-04-28;87838
2021-04-27;"Bratislavský kraj";41;30168;52;30220;NA;344588;93;2021-04-27;87720
2021-04-26;"Bratislavský kraj";59;34733;97;34830;NA;344588;156;2021-04-26;87627
2021-04-25;"Bratislavský kraj";8;57615;74;57689;NA;344588;82;2021-04-25;87471
2021-04-24;"Bratislavský kraj";28;74858;66;74924;NA;344588;94;2021-04-24;87389
2021-04-23;"Bratislavský kraj";70;48614;62;48676;NA;344588;132;2021-04-23;87295
2021-04-22;"Bratislavský kraj";39;31037;72;31109;NA;344588;111;2021-04-22;87163
2021-04-21;"Bratislavský kraj";48;30442;62;30504;NA;344588;110;2021-04-21;87052
2021-04-20;"Bratislavský kraj";58;35216;63;35279;NA;344588;121;2021-04-20;86942
2021-04-19;"Bratislavský kraj";48;39500;80;39580;NA;344588;128;2021-04-19;86821
2021-04-18;"Bratislavský kraj";35;62300;76;62376;NA;344588;111;2021-04-18;86693
2021-04-17;"Bratislavský kraj";13;80359;111;80470;NA;344588;124;2021-04-17;86582
2021-04-16;"Bratislavský kraj";62;47296;80;47376;NA;344588;142;2021-04-16;86458
2021-04-15;"Bratislavský kraj";34;32176;74;32250;NA;344588;108;2021-04-15;86316
2021-04-14;"Bratislavský kraj";65;33961;88;34049;NA;344588;153;2021-04-14;86208
2021-04-13;"Bratislavský kraj";82;35512;82;35594;NA;344588;164;2021-04-13;86055
2021-04-12;"Bratislavský kraj";77;42286;115;42401;NA;344588;192;2021-04-12;85891
2021-04-11;"Bratislavský kraj";42;61151;123;61274;NA;344588;165;2021-04-11;85699
2021-04-10;"Bratislavský kraj";14;77874;167;78041;NA;344588;181;2021-04-10;85534
2021-04-09;"Bratislavský kraj";72;41556;97;41653;NA;344588;169;2021-04-09;85353
2021-04-08;"Bratislavský kraj";71;28866;95;28961;NA;344588;166;2021-04-08;85184
2021-04-07;"Bratislavský kraj";96;38061;101;38162;NA;344588;197;2021-04-07;85018
2021-04-06;"Bratislavský kraj";94;56204;179;56383;NA;344588;273;2021-04-06;84821
2021-04-05;"Bratislavský kraj";85;18538;85;18623;NA;344588;170;2021-04-05;84548
2021-04-04;"Bratislavský kraj";37;29225;75;29300;NA;344588;112;2021-04-04;84378
2021-04-03;"Bratislavský kraj";52;79865;220;80085;NA;344588;272;2021-04-03;84266
2021-04-02;"Bratislavský kraj";33;23790;104;23894;NA;344588;137;2021-04-02;83994
2021-04-01;"Bratislavský kraj";119;57388;159;57547;NA;344588;278;2021-04-01;83857
2021-03-31;"Bratislavský kraj";105;46371;177;46548;NA;344588;282;2021-03-31;83579
2021-03-30;"Bratislavský kraj";100;39599;144;39743;NA;344588;244;2021-03-30;83297
2021-03-29;"Bratislavský kraj";153;40364;178;40542;NA;344588;331;2021-03-29;83053
2021-03-28;"Bratislavský kraj";59;53372;137;53509;NA;344588;196;2021-03-28;82722
2021-03-27;"Bratislavský kraj";53;79834;240;80074;NA;344588;293;2021-03-27;82526
2021-03-26;"Bratislavský kraj";114;56108;191;56299;NA;344588;305;2021-03-26;82233
2021-03-25;"Bratislavský kraj";76;36859;172;37031;NA;344588;248;2021-03-25;81928
2021-03-24;"Bratislavský kraj";120;30567;201;30768;NA;344588;321;2021-03-24;81680
2021-03-23;"Bratislavský kraj";138;36438;190;36628;NA;344588;328;2021-03-23;81359
2021-03-22;"Bratislavský kraj";110;42756;220;42976;NA;344588;330;2021-03-22;81031
2021-03-21;"Bratislavský kraj";54;61299;212;61511;NA;344588;266;2021-03-21;80701
2021-03-20;"Bratislavský kraj";59;73300;228;73528;NA;344588;287;2021-03-20;80435
2021-03-19;"Bratislavský kraj";139;54576;257;54833;NA;344588;396;2021-03-19;80148
2021-03-18;"Bratislavský kraj";142;34611;192;34803;NA;344588;334;2021-03-18;79752
2021-03-17;"Bratislavský kraj";177;30482;217;30699;NA;344588;394;2021-03-17;79418
2021-03-16;"Bratislavský kraj";258;36798;287;37085;NA;344588;545;2021-03-16;79024
2021-03-15;"Bratislavský kraj";180;38226;255;38481;NA;344588;435;2021-03-15;78479
2021-03-14;"Bratislavský kraj";75;52611;275;52886;NA;344588;350;2021-03-14;78044
2021-03-13;"Bratislavský kraj";110;81405;341;81746;NA;344588;451;2021-03-13;77694
2021-03-12;"Bratislavský kraj";152;55233;312;55545;NA;344588;464;2021-03-12;77243
2021-03-11;"Bratislavský kraj";178;34678;286;34964;NA;344588;464;2021-03-11;76779
2021-03-10;"Bratislavský kraj";164;31061;280;31341;NA;344588;444;2021-03-10;76315
2021-03-09;"Bratislavský kraj";242;37687;267;37954;NA;344588;509;2021-03-09;75871
2021-03-08;"Bratislavský kraj";255;41199;348;41547;NA;344588;603;2021-03-08;75362
2021-03-07;"Bratislavský kraj";142;52812;301;53113;NA;344588;443;2021-03-07;74759
2021-03-06;"Bratislavský kraj";79;71821;415;72236;NA;344588;494;2021-03-06;74316
2021-03-05;"Bratislavský kraj";238;50653;293;50946;NA;344588;531;2021-03-05;73822
2021-03-04;"Bratislavský kraj";204;34544;344;34888;NA;344588;548;2021-03-04;73291
2021-03-03;"Bratislavský kraj";250;30527;364;30891;NA;344588;614;2021-03-03;72743
2021-03-02;"Bratislavský kraj";267;39735;388;40123;NA;344588;655;2021-03-02;72129
2021-03-01;"Bratislavský kraj";320;38222;432;38654;NA;344588;752;2021-03-01;71474
2021-02-28;"Bratislavský kraj";184;50323;323;50646;NA;344588;507;2021-02-28;70722
2021-02-27;"Bratislavský kraj";151;76580;464;77044;NA;344588;615;2021-02-27;70215
2021-02-26;"Bratislavský kraj";277;47326;401;47727;NA;344588;678;2021-02-26;69600
2021-02-25;"Bratislavský kraj";277;28769;405;29174;NA;344588;682;2021-02-25;68922
2021-02-24;"Bratislavský kraj";217;27095;412;27507;NA;344588;629;2021-02-24;68240
2021-02-23;"Bratislavský kraj";257;31297;395;31692;NA;344588;652;2021-02-23;67611
2021-02-22;"Bratislavský kraj";353;36607;483;37090;NA;344588;836;2021-02-22;66959
2021-02-21;"Bratislavský kraj";185;54150;396;54546;NA;344588;581;2021-02-21;66123
2021-02-20;"Bratislavský kraj";167;74814;550;75364;NA;344588;717;2021-02-20;65542
2021-02-19;"Bratislavský kraj";280;44882;416;45298;NA;344588;696;2021-02-19;64825
2021-02-18;"Bratislavský kraj";263;26379;371;26750;NA;344588;634;2021-02-18;64129
2021-02-17;"Bratislavský kraj";264;22820;316;23136;NA;344588;580;2021-02-17;63495
2021-02-16;"Bratislavský kraj";289;28262;352;28614;NA;344588;641;2021-02-16;62915
2021-02-15;"Bratislavský kraj";248;36893;396;37289;NA;344588;644;2021-02-15;62274
2021-02-14;"Bratislavský kraj";153;47948;323;48271;NA;344588;476;2021-02-14;61630
2021-02-13;"Bratislavský kraj";173;68589;515;69104;NA;344588;688;2021-02-13;61154
2021-02-12;"Bratislavský kraj";282;35729;327;36056;NA;344588;609;2021-02-12;60466
2021-02-11;"Bratislavský kraj";337;24565;285;24850;NA;344588;622;2021-02-11;59857
2021-02-10;"Bratislavský kraj";314;22944;356;23300;NA;344588;670;2021-02-10;59235
2021-02-09;"Bratislavský kraj";288;36565;454;37019;NA;344588;742;2021-02-09;58565
2021-02-08;"Bratislavský kraj";484;31896;397;32293;NA;344588;881;2021-02-08;57823
2021-02-07;"Bratislavský kraj";243;51290;425;51715;NA;344588;668;2021-02-07;56942
2021-02-06;"Bratislavský kraj";116;61682;501;62183;NA;344588;617;2021-02-06;56274
2021-02-05;"Bratislavský kraj";327;27033;375;27408;NA;344588;702;2021-02-05;55657
2021-02-04;"Bratislavský kraj";555;17260;348;17608;NA;344588;903;2021-02-04;54955
2021-02-03;"Bratislavský kraj";161;13020;352;13372;NA;344588;513;2021-02-03;54052
2021-02-02;"Bratislavský kraj";397;25947;480;26427;NA;344588;877;2021-02-02;53539
2021-02-01;"Bratislavský kraj";221;35541;513;36054;NA;344588;734;2021-02-01;52662
2021-01-31;"Bratislavský kraj";180;35693;425;36118;NA;344588;605;2021-01-31;51928
2021-01-30;"Bratislavský kraj";310;49588;521;50109;NA;344588;831;2021-01-30;51323
2021-01-29;"Bratislavský kraj";344;16568;344;16912;NA;344588;688;2021-01-29;50492
2021-01-28;"Bratislavský kraj";307;10715;297;11012;NA;344588;604;2021-01-28;49804
2021-01-27;"Bratislavský kraj";336;22222;345;22567;NA;344588;681;2021-01-27;49200
2021-01-26;"Bratislavský kraj";297;21894;300;22194;NA;344588;597;2021-01-26;48519
2021-01-25;"Bratislavský kraj";356;23335;249;23584;NA;344588;605;2021-01-25;47922
2021-01-24;"Bratislavský kraj";175;37903;404;38307;NA;344588;579;2021-01-24;47317
2021-01-23;"Bratislavský kraj";396;79453;690;80143;NA;344588;1086;2021-01-23;46738
2021-01-22;"Bratislavský kraj";199;42055;365;42420;NA;344588;564;2021-01-22;45652
2021-01-21;"Bratislavský kraj";255;105746;1317;107063;NA;344588;1572;2021-01-21;45088
2021-01-20;"Bratislavský kraj";360;27289;452;27741;NA;344588;812;2021-01-20;43516
2021-01-19;"Bratislavský kraj";375;15318;346;15664;NA;344588;721;2021-01-19;42704
2021-01-18;"Bratislavský kraj";357;12533;707;13240;NA;344588;1064;2021-01-18;41983
2021-01-17;"Bratislavský kraj";244;482;26;508;NA;344588;270;2021-01-17;40919
2021-01-16;"Bratislavský kraj";70;3016;156;3172;NA;344588;226;2021-01-16;40649
2021-01-15;"Bratislavský kraj";251;7896;256;8152;NA;344588;507;2021-01-15;40423
2021-01-14;"Bratislavský kraj";363;8523;273;8796;NA;344588;636;2021-01-14;39916
2021-01-13;"Bratislavský kraj";336;8490;327;8817;NA;344588;663;2021-01-13;39280
2021-01-12;"Bratislavský kraj";450;10509;455;10964;NA;344588;905;2021-01-12;38617
2021-01-11;"Bratislavský kraj";397;19863;364;20227;NA;344588;761;2021-01-11;37712
2021-01-10;"Bratislavský kraj";252;1507;79;1586;NA;344588;331;2021-01-10;36951
2021-01-09;"Bratislavský kraj";351;4721;277;4998;NA;344588;628;2021-01-09;36620
2021-01-08;"Bratislavský kraj";556;10045;436;10481;NA;344588;992;2021-01-08;35992
2021-01-07;"Bratislavský kraj";537;6872;352;7224;NA;344588;889;2021-01-07;35000
2021-01-06;"Bratislavský kraj";271;3329;216;3545;NA;344588;487;2021-01-06;34111
2021-01-05;"Bratislavský kraj";619;10635;814;11449;NA;344588;1433;2021-01-05;33624
2021-01-04;"Bratislavský kraj";601;8226;538;8764;NA;344588;1139;2021-01-04;32191
2021-01-03;"Bratislavský kraj";77;433;41;474;NA;344588;118;2021-01-03;31052
2021-01-02;"Bratislavský kraj";185;462;57;519;NA;344588;242;2021-01-02;30934
2021-01-01;"Bratislavský kraj";235;3277;131;3408;NA;344588;366;2021-01-01;30692
2020-12-31;"Bratislavský kraj";925;14135;519;14654;NA;344588;1444;2020-12-31;30326
2020-12-30;"Bratislavský kraj";650;9164;533;9697;NA;344588;1183;2020-12-30;28882
2020-12-29;"Bratislavský kraj";303;10108;699;10807;NA;344588;1002;2020-12-29;27699
2020-12-28;"Bratislavský kraj";255;7784;473;8257;NA;344588;728;2020-12-28;26697
2020-12-27;"Bratislavský kraj";160;709;76;785;NA;344588;236;2020-12-27;25969
2020-12-26;"Bratislavský kraj";75;480;27;507;NA;344588;102;2020-12-26;25733
2020-12-25;"Bratislavský kraj";114;503;38;541;NA;344588;152;2020-12-25;25631
2020-12-24;"Bratislavský kraj";536;3367;104;3471;NA;344588;640;2020-12-24;25479
2020-12-23;"Bratislavský kraj";416;12590;447;13037;NA;344588;863;2020-12-23;24839
2020-12-22;"Bratislavský kraj";327;14587;699;15286;NA;344588;1026;2020-12-22;23976
2020-12-21;"Bratislavský kraj";392;14972;1946;16918;NA;344588;2338;2020-12-21;22950
2020-12-20;"Bratislavský kraj";180;797;57;854;NA;344588;237;2020-12-20;20612
2020-12-19;"Bratislavský kraj";396;3314;130;3444;NA;344588;526;2020-12-19;20375
2020-12-18;"Bratislavský kraj";306;9938;345;10283;NA;344588;651;2020-12-18;19849
2020-12-17;"Bratislavský kraj";502;9739;386;10125;NA;344588;888;2020-12-17;19198
2020-12-16;"Bratislavský kraj";282;10201;418;10619;NA;344588;700;2020-12-16;18310
2020-12-15;"Bratislavský kraj";423;10450;454;10904;NA;344588;877;2020-12-15;17610
2020-12-14;"Bratislavský kraj";279;6793;261;7054;NA;344588;540;2020-12-14;16733
2020-12-13;"Bratislavský kraj";125;139;10;149;NA;344588;135;2020-12-13;16193
2020-12-12;"Bratislavský kraj";361;3886;157;4043;NA;344588;518;2020-12-12;16058
2020-12-11;"Bratislavský kraj";326;6824;235;7059;NA;344588;561;2020-12-11;15540
2020-12-10;"Bratislavský kraj";286;5279;166;5445;NA;344588;452;2020-12-10;14979
2020-12-09;"Bratislavský kraj";382;4778;177;4955;NA;344588;559;2020-12-09;14527
2020-12-08;"Bratislavský kraj";234;6243;207;6450;NA;344588;441;2020-12-08;13968
2020-12-07;"Bratislavský kraj";272;4639;152;4791;NA;344588;424;2020-12-07;13527
2020-12-06;"Bratislavský kraj";61;1625;52;1677;NA;344588;113;2020-12-06;13103
2020-12-05;"Bratislavský kraj";266;2221;41;2262;NA;344588;307;2020-12-05;12990
2020-12-04;"Bratislavský kraj";200;4954;99;5053;NA;344588;299;2020-12-04;12683
2020-12-03;"Bratislavský kraj";213;5672;95;5767;NA;344588;308;2020-12-03;12384
2020-12-02;"Bratislavský kraj";205;3462;103;3565;NA;344588;308;2020-12-02;12076
2020-12-01;"Bratislavský kraj";255;3889;172;4061;NA;344588;427;2020-12-01;11768
2020-11-30;"Bratislavský kraj";152;2153;121;2274;NA;344588;273;2020-11-30;11341
2020-11-29;"Bratislavský kraj";52;201;24;225;NA;344588;76;2020-11-29;11068
2020-11-28;"Bratislavský kraj";232;2624;33;2657;NA;344588;265;2020-11-28;10992
2020-11-27;"Bratislavský kraj";54;2540;64;2604;NA;344588;118;2020-11-27;10727
2020-11-26;"Bratislavský kraj";129;1976;60;2036;NA;344588;189;2020-11-26;10609
2020-11-25;"Bratislavský kraj";140;1770;47;1817;NA;344588;187;2020-11-25;10420
2020-11-24;"Bratislavský kraj";81;2988;67;3055;NA;344588;148;2020-11-24;10233
2020-11-23;"Bratislavský kraj";67;7083;58;7141;NA;344588;125;2020-11-23;10085
2020-11-22;"Bratislavský kraj";36;81;7;88;NA;344588;43;2020-11-22;9960
2020-11-21;"Bratislavský kraj";109;2126;47;2173;NA;344588;156;2020-11-21;9917
2020-11-20;"Bratislavský kraj";118;2876;48;2924;NA;344588;166;2020-11-20;9761
2020-11-19;"Bratislavský kraj";173;987;29;1016;NA;344588;202;2020-11-19;9595
2020-11-18;"Bratislavský kraj";118;616;75;691;NA;344588;193;2020-11-18;9393
2020-11-17;"Bratislavský kraj";108;928;23;951;NA;344588;131;2020-11-17;9200
2020-11-16;"Bratislavský kraj";82;651;9;660;NA;344588;91;2020-11-16;9069
2020-11-15;"Bratislavský kraj";47;236;0;236;NA;344588;47;2020-11-15;8978
2020-11-14;"Bratislavský kraj";53;1834;15;1849;NA;344588;68;2020-11-14;8931
2020-11-13;"Bratislavský kraj";94;2096;21;2117;NA;344588;115;2020-11-13;8863
2020-11-12;"Bratislavský kraj";141;1727;6;1733;NA;344588;147;2020-11-12;8748
2020-11-11;"Bratislavský kraj";159;1429;12;1441;NA;344588;171;2020-11-11;8601
2020-11-10;"Bratislavský kraj";136;805;14;819;NA;344588;150;2020-11-10;8430
2020-11-09;"Bratislavský kraj";70;616;8;624;NA;344588;78;2020-11-09;8280
2020-11-08;"Bratislavský kraj";82;869;6;875;NA;344588;88;2020-11-08;8202
2020-11-07;"Bratislavský kraj";88;4039;17;4056;NA;344588;105;2020-11-07;8114
2020-11-06;"Bratislavský kraj";281;6441;25;6466;NA;344588;306;2020-11-06;8009
2020-11-05;"Bratislavský kraj";175;476;11;487;NA;344588;186;2020-11-05;7703
2020-11-04;"Bratislavský kraj";65;411;10;421;NA;344588;75;2020-11-04;7517
2020-11-03;"Bratislavský kraj";251;1085;12;1097;NA;344588;263;2020-11-03;7442
2020-11-02;"Bratislavský kraj";202;3365;22;3387;NA;344588;224;2020-11-02;7179
2020-11-01;"Bratislavský kraj";227;8694;39;8733;NA;344588;266;2020-11-01;6955
2020-10-31;"Bratislavský kraj";173;22407;123;22530;NA;344588;296;2020-10-31;6689
2020-10-30;"Bratislavský kraj";158;17350;138;17488;NA;344588;296;2020-10-30;6393
2020-10-29;"Bratislavský kraj";262;116;4;120;NA;344588;266;2020-10-29;6097
2020-10-28;"Bratislavský kraj";220;260;15;275;NA;344588;235;2020-10-28;5831
2020-10-27;"Bratislavský kraj";256;145;4;149;NA;344588;260;2020-10-27;5596
2020-10-26;"Bratislavský kraj";123;229;11;240;NA;344588;134;2020-10-26;5336
2020-10-25;"Bratislavský kraj";152;33;2;35;NA;344588;154;2020-10-25;5202
2020-10-24;"Bratislavský kraj";170;221;6;227;NA;344588;176;2020-10-24;5048
2020-10-23;"Bratislavský kraj";151;144;8;152;NA;344588;159;2020-10-23;4872
2020-10-22;"Bratislavský kraj";192;204;15;219;NA;344588;207;2020-10-22;4713
2020-10-21;"Bratislavský kraj";66;90;6;96;NA;344588;72;2020-10-21;4506
2020-10-20;"Bratislavský kraj";183;97;4;101;NA;344588;187;2020-10-20;4434
2020-10-19;"Bratislavský kraj";148;80;3;83;NA;344588;151;2020-10-19;4247
2020-10-18;"Bratislavský kraj";75;92;0;92;NA;344588;75;2020-10-18;4096
2020-10-17;"Bratislavský kraj";136;0;0;0;NA;344588;136;2020-10-17;4021
2020-10-16;"Bratislavský kraj";103;14;1;15;NA;344588;104;2020-10-16;3885
2020-10-15;"Bratislavský kraj";135;6;1;7;NA;344588;136;2020-10-15;3781
2020-10-14;"Bratislavský kraj";127;4;0;4;NA;344588;127;2020-10-14;3645
2020-10-13;"Bratislavský kraj";86;108;8;116;NA;344588;94;2020-10-13;3518
2020-10-12;"Bratislavský kraj";46;0;0;0;NA;344588;46;2020-10-12;3424
2020-10-11;"Bratislavský kraj";80;0;0;0;NA;344588;80;2020-10-11;3378
2020-10-10;"Bratislavský kraj";55;0;0;0;NA;344588;55;2020-10-10;3298
2020-10-09;"Bratislavský kraj";148;0;0;0;NA;344588;148;2020-10-09;3243
2020-10-08;"Bratislavský kraj";100;0;0;0;NA;344588;100;2020-10-08;3095
2020-10-07;"Bratislavský kraj";107;0;0;0;NA;344588;107;2020-10-07;2995
2020-10-06;"Bratislavský kraj";108;0;0;0;NA;344588;108;2020-10-06;2888
2020-10-05;"Bratislavský kraj";30;0;0;0;NA;344588;30;2020-10-05;2780
2020-10-04;"Bratislavský kraj";49;0;0;0;NA;344588;49;2020-10-04;2750
2020-10-03;"Bratislavský kraj";82;0;0;0;NA;344588;82;2020-10-03;2701
2020-10-02;"Bratislavský kraj";101;0;0;0;NA;344588;101;2020-10-02;2619
2020-10-01;"Bratislavský kraj";72;0;0;0;NA;344588;72;2020-10-01;2518
2020-09-30;"Bratislavský kraj";91;0;0;0;NA;344588;91;2020-09-30;2446
2020-09-29;"Bratislavský kraj";74;0;0;0;NA;344588;74;2020-09-29;2355
2020-09-28;"Bratislavský kraj";29;0;0;0;NA;344588;29;2020-09-28;2281
2020-09-27;"Bratislavský kraj";48;0;0;0;NA;344588;48;2020-09-27;2252
2020-09-26;"Bratislavský kraj";86;0;0;0;NA;344588;86;2020-09-26;2204
2020-09-25;"Bratislavský kraj";97;0;0;0;NA;344588;97;2020-09-25;2118
2020-09-24;"Bratislavský kraj";73;0;0;0;NA;344588;73;2020-09-24;2021
2020-09-23;"Bratislavský kraj";55;0;0;0;NA;344588;55;2020-09-23;1948
2020-09-22;"Bratislavský kraj";81;0;0;0;NA;344588;81;2020-09-22;1893
2020-09-21;"Bratislavský kraj";32;0;0;0;NA;344588;32;2020-09-21;1812
2020-09-20;"Bratislavský kraj";25;0;0;0;NA;344588;25;2020-09-20;1780
2020-09-19;"Bratislavský kraj";59;0;0;0;NA;344588;59;2020-09-19;1755
2020-09-18;"Bratislavský kraj";42;0;0;0;NA;344588;42;2020-09-18;1696
2020-09-17;"Bratislavský kraj";52;0;0;0;NA;344588;52;2020-09-17;1654
2020-09-16;"Bratislavský kraj";32;0;0;0;NA;344588;32;2020-09-16;1602
2020-09-15;"Bratislavský kraj";26;0;0;0;NA;344588;26;2020-09-15;1570
2020-09-14;"Bratislavský kraj";24;0;0;0;NA;344588;24;2020-09-14;1544
2020-09-13;"Bratislavský kraj";11;0;0;0;NA;344588;11;2020-09-13;1520
2020-09-12;"Bratislavský kraj";24;0;0;0;NA;344588;24;2020-09-12;1509
2020-09-11;"Bratislavský kraj";50;0;0;0;NA;344588;50;2020-09-11;1485
2020-09-10;"Bratislavský kraj";47;0;0;0;NA;344588;47;2020-09-10;1435
2020-09-09;"Bratislavský kraj";40;0;0;0;NA;344588;40;2020-09-09;1388
2020-09-08;"Bratislavský kraj";58;0;0;0;NA;344588;58;2020-09-08;1348
2020-09-07;"Bratislavský kraj";39;0;0;0;NA;344588;39;2020-09-07;1290
2020-09-06;"Bratislavský kraj";11;0;0;0;NA;344588;11;2020-09-06;1251
2020-09-05;"Bratislavský kraj";37;0;0;0;NA;344588;37;2020-09-05;1240
2020-09-04;"Bratislavský kraj";87;0;0;0;NA;344588;87;2020-09-04;1203
2020-09-03;"Bratislavský kraj";51;0;0;0;NA;344588;51;2020-09-03;1116
2020-09-02;"Bratislavský kraj";50;0;0;0;NA;344588;50;2020-09-02;1065
2020-09-01;"Bratislavský kraj";16;0;0;0;NA;344588;16;2020-09-01;1015
2020-08-31;"Bratislavský kraj";19;0;0;0;NA;344588;19;2020-08-31;999
2020-08-30;"Bratislavský kraj";9;0;0;0;NA;344588;9;2020-08-30;980
2020-08-29;"Bratislavský kraj";12;0;0;0;NA;344588;12;2020-08-29;971
2020-08-28;"Bratislavský kraj";35;0;0;0;NA;344588;35;2020-08-28;959
2020-08-27;"Bratislavský kraj";33;0;0;0;NA;344588;33;2020-08-27;924
2020-08-26;"Bratislavský kraj";27;0;0;0;NA;344588;27;2020-08-26;891
2020-08-25;"Bratislavský kraj";29;0;0;0;NA;344588;29;2020-08-25;864
2020-08-24;"Bratislavský kraj";6;0;0;0;NA;344588;6;2020-08-24;835
2020-08-23;"Bratislavský kraj";45;0;0;0;NA;344588;45;2020-08-23;829
2020-08-22;"Bratislavský kraj";13;0;0;0;NA;344588;13;2020-08-22;784
2020-08-21;"Bratislavský kraj";46;0;0;0;NA;344588;46;2020-08-21;771
2020-08-20;"Bratislavský kraj";41;0;0;0;NA;344588;41;2020-08-20;725
2020-08-19;"Bratislavský kraj";27;0;0;0;NA;344588;27;2020-08-19;684
2020-08-18;"Bratislavský kraj";47;0;0;0;NA;344588;47;2020-08-18;657
2020-08-17;"Bratislavský kraj";2;0;0;0;NA;344588;2;2020-08-17;610
2020-08-16;"Bratislavský kraj";3;0;0;0;NA;344588;3;2020-08-16;608
2020-08-15;"Bratislavský kraj";18;0;0;0;NA;344588;18;2020-08-15;605
2020-08-14;"Bratislavský kraj";16;0;0;0;NA;344588;16;2020-08-14;587
2020-08-13;"Bratislavský kraj";12;0;0;0;NA;344588;12;2020-08-13;571
2020-08-12;"Bratislavský kraj";10;0;0;0;NA;344588;10;2020-08-12;559
2020-08-11;"Bratislavský kraj";23;0;0;0;NA;344588;23;2020-08-11;549
2020-08-10;"Bratislavský kraj";2;0;0;0;NA;344588;2;2020-08-10;526
2020-08-09;"Bratislavský kraj";2;0;0;0;NA;344588;2;2020-08-09;524
2020-08-08;"Bratislavský kraj";1;0;0;0;NA;344588;1;2020-08-08;522
2020-08-07;"Bratislavský kraj";9;0;0;0;NA;344588;9;2020-08-07;521
2020-08-06;"Bratislavský kraj";15;0;0;0;NA;344588;15;2020-08-06;512
2020-08-05;"Bratislavský kraj";11;0;0;0;NA;344588;11;2020-08-05;497
2020-08-04;"Bratislavský kraj";21;0;0;0;NA;344588;21;2020-08-04;486
2020-08-03;"Bratislavský kraj";7;0;0;0;NA;344588;7;2020-08-03;465
2020-08-02;"Bratislavský kraj";0;0;0;0;NA;344588;0;2020-08-02;458
2020-08-01;"Bratislavský kraj";0;0;0;0;NA;344588;0;2020-08-01;458
2020-07-31;"Bratislavský kraj";14;0;0;0;NA;344588;14;2020-07-31;458
2020-07-30;"Bratislavský kraj";6;0;0;0;NA;344588;6;2020-07-30;444
2020-07-29;"Bratislavský kraj";7;0;0;0;NA;344588;7;2020-07-29;438
2020-07-28;"Bratislavský kraj";14;0;0;0;NA;344588;14;2020-07-28;431
2020-07-27;"Bratislavský kraj";3;0;0;0;NA;344588;3;2020-07-27;417
2020-07-26;"Bratislavský kraj";0;0;0;0;NA;344588;0;2020-07-26;414
2020-07-25;"Bratislavský kraj";8;0;0;0;NA;344588;8;2020-07-25;414
2020-07-24;"Bratislavský kraj";2;0;0;0;NA;344588;2;2020-07-24;406
2020-07-23;"Bratislavský kraj";8;0;0;0;NA;344588;8;2020-07-23;404
2020-07-22;"Bratislavský kraj";11;0;0;0;NA;344588;11;2020-07-22;396
2020-07-21;"Bratislavský kraj";8;0;0;0;NA;344588;8;2020-07-21;385
2020-07-20;"Bratislavský kraj";12;0;0;0;NA;344588;12;2020-07-20;377
2020-07-19;"Bratislavský kraj";0;0;0;0;NA;344588;0;2020-07-19;365
2020-07-18;"Bratislavský kraj";2;0;0;0;NA;344588;2;2020-07-18;365
2020-07-17;"Bratislavský kraj";2;0;0;0;NA;344588;2;2020-07-17;363
2020-07-16;"Bratislavský kraj";6;0;0;0;NA;344588;6;2020-07-16;361
2020-07-15;"Bratislavský kraj";3;0;0;0;NA;344588;3;2020-07-15;355
2020-07-14;"Bratislavský kraj";2;0;0;0;NA;344588;2;2020-07-14;352
2020-07-13;"Bratislavský kraj";2;0;0;0;NA;344588;2;2020-07-13;350
2020-07-12;"Bratislavský kraj";0;0;0;0;NA;344588;0;2020-07-12;348
2020-07-11;"Bratislavský kraj";0;0;0;0;NA;344588;0;2020-07-11;348
2020-07-10;"Bratislavský kraj";8;0;0;0;NA;344588;8;2020-07-10;348
2020-07-09;"Bratislavský kraj";2;0;0;0;NA;344588;2;2020-07-09;340
2020-07-08;"Bratislavský kraj";11;0;0;0;NA;344588;11;2020-07-08;338
2020-07-07;"Bratislavský kraj";5;0;0;0;NA;344588;5;2020-07-07;327
2020-07-06;"Bratislavský kraj";1;0;0;0;NA;344588;1;2020-07-06;322
2020-07-05;"Bratislavský kraj";0;0;0;0;NA;344588;0;2020-07-05;321
2020-07-04;"Bratislavský kraj";3;0;0;0;NA;344588;3;2020-07-04;321
2020-07-03;"Bratislavský kraj";1;0;0;0;NA;344588;1;2020-07-03;318
2020-07-02;"Bratislavský kraj";0;0;0;0;NA;344588;0;2020-07-02;317
2020-07-01;"Bratislavský kraj";7;0;0;0;NA;344588;7;2020-07-01;317
2020-06-30;"Bratislavský kraj";3;0;0;0;NA;344588;3;2020-06-30;310
2020-06-29;"Bratislavský kraj";1;0;0;0;NA;344588;1;2020-06-29;307
2020-06-28;"Bratislavský kraj";0;0;0;0;NA;344588;0;2020-06-28;306
2020-06-27;"Bratislavský kraj";1;0;0;0;NA;344588;1;2020-06-27;306
2020-06-26;"Bratislavský kraj";6;0;0;0;NA;344588;6;2020-06-26;305
2020-06-25;"Bratislavský kraj";0;0;0;0;NA;344588;0;2020-06-25;299
2020-06-24;"Bratislavský kraj";3;0;0;0;NA;344588;3;2020-06-24;299
2020-06-23;"Bratislavský kraj";0;0;0;0;NA;344588;0;2020-06-23;296
2020-06-22;"Bratislavský kraj";1;0;0;0;NA;344588;1;2020-06-22;296
2020-06-21;"Bratislavský kraj";0;0;0;0;NA;344588;0;2020-06-21;295
2020-06-20;"Bratislavský kraj";0;0;0;0;NA;344588;0;2020-06-20;295
2020-06-19;"Bratislavský kraj";3;0;0;0;NA;344588;3;2020-06-19;295
2020-06-18;"Bratislavský kraj";0;0;0;0;NA;344588;0;2020-06-18;292
2020-06-17;"Bratislavský kraj";0;0;0;0;NA;344588;0;2020-06-17;292
2020-06-16;"Bratislavský kraj";0;0;0;0;NA;344588;0;2020-06-16;292
2020-06-14;"Bratislavský kraj";2;0;0;0;NA;344588;2;2020-06-14;292
2020-06-13;"Bratislavský kraj";1;0;0;0;NA;344588;1;2020-06-13;290
2020-06-12;"Bratislavský kraj";2;0;0;0;NA;344588;2;2020-06-12;289
2020-06-11;"Bratislavský kraj";0;0;0;0;NA;344588;0;2020-06-11;287
2020-06-10;"Bratislavský kraj";0;0;0;0;NA;344588;0;2020-06-10;287
2020-06-09;"Bratislavský kraj";0;0;0;0;NA;344588;0;2020-06-09;287
2020-06-08;"Bratislavský kraj";1;0;0;0;NA;344588;1;2020-06-08;287
2020-06-07;"Bratislavský kraj";0;0;0;0;NA;344588;0;2020-06-07;286
2020-06-05;"Bratislavský kraj";0;0;0;0;NA;344588;0;2020-06-05;286
2020-06-03;"Bratislavský kraj";1;0;0;0;NA;344588;1;2020-06-03;286
2020-06-02;"Bratislavský kraj";0;0;0;0;NA;344588;0;2020-06-02;285
2020-05-31;"Bratislavský kraj";0;0;0;0;NA;344588;0;2020-05-31;285
2020-05-29;"Bratislavský kraj";0;0;0;0;NA;344588;0;2020-05-29;285
2020-05-27;"Bratislavský kraj";1;0;0;0;NA;344588;1;2020-05-27;285
2020-05-26;"Bratislavský kraj";0;0;0;0;NA;344588;0;2020-05-26;284
2020-05-25;"Bratislavský kraj";0;0;0;0;NA;344588;0;2020-05-25;284
2020-05-24;"Bratislavský kraj";0;0;0;0;NA;344588;0;2020-05-24;284
2020-05-23;"Bratislavský kraj";2;0;0;0;NA;344588;2;2020-05-23;284
2020-05-22;"Bratislavský kraj";0;0;0;0;NA;344588;0;2020-05-22;282
2020-05-21;"Bratislavský kraj";0;0;0;0;NA;344588;0;2020-05-21;282
2020-05-20;"Bratislavský kraj";0;0;0;0;NA;344588;0;2020-05-20;282
2020-05-19;"Bratislavský kraj";0;0;0;0;NA;344588;0;2020-05-19;282
2020-05-17;"Bratislavský kraj";0;0;0;0;NA;344588;0;2020-05-17;282
2020-05-16;"Bratislavský kraj";0;0;0;0;NA;344588;0;2020-05-16;282
2020-05-15;"Bratislavský kraj";0;0;0;0;NA;344588;0;2020-05-15;282
2020-05-14;"Bratislavský kraj";0;0;0;0;NA;344588;0;2020-05-14;282
2020-05-13;"Bratislavský kraj";0;0;0;0;NA;344588;0;2020-05-13;282
2020-05-12;"Bratislavský kraj";2;0;0;0;NA;344588;2;2020-05-12;282
2020-05-11;"Bratislavský kraj";0;0;0;0;NA;344588;0;2020-05-11;280
2020-05-09;"Bratislavský kraj";0;0;0;0;NA;344588;0;2020-05-09;280
2020-05-07;"Bratislavský kraj";1;0;0;0;NA;344588;1;2020-05-07;280
2020-05-06;"Bratislavský kraj";3;0;0;0;NA;344588;3;2020-05-06;279
2020-05-05;"Bratislavský kraj";0;0;0;0;NA;344588;0;2020-05-05;276
2020-05-04;"Bratislavský kraj";0;0;0;0;NA;344588;0;2020-05-04;276
2020-05-03;"Bratislavský kraj";2;0;0;0;NA;344588;2;2020-05-03;276
2020-05-02;"Bratislavský kraj";0;0;0;0;NA;344588;0;2020-05-02;274
2020-05-01;"Bratislavský kraj";0;0;0;0;NA;344588;0;2020-05-01;274
2020-04-30;"Bratislavský kraj";5;0;0;0;NA;344588;5;2020-04-30;274
2020-04-29;"Bratislavský kraj";0;0;0;0;NA;344588;0;2020-04-29;269
2020-04-28;"Bratislavský kraj";2;0;0;0;NA;344588;2;2020-04-28;269
2020-04-27;"Bratislavský kraj";0;0;0;0;NA;344588;0;2020-04-27;267
2020-04-26;"Bratislavský kraj";1;0;0;0;NA;344588;1;2020-04-26;267
2020-04-25;"Bratislavský kraj";0;0;0;0;NA;344588;0;2020-04-25;266
2020-04-24;"Bratislavský kraj";2;0;0;0;NA;344588;2;2020-04-24;266
2020-04-23;"Bratislavský kraj";6;0;0;0;NA;344588;6;2020-04-23;264
2020-04-22;"Bratislavský kraj";11;0;0;0;NA;344588;11;2020-04-22;258
2020-04-21;"Bratislavský kraj";4;0;0;0;NA;344588;4;2020-04-21;247
2020-04-20;"Bratislavský kraj";0;0;0;0;NA;344588;0;2020-04-20;243
2020-04-19;"Bratislavský kraj";4;0;0;0;NA;344588;4;2020-04-19;243
2020-04-18;"Bratislavský kraj";5;0;0;0;NA;344588;5;2020-04-18;239
2020-04-17;"Bratislavský kraj";6;0;0;0;NA;344588;6;2020-04-17;234
2020-04-16;"Bratislavský kraj";15;0;0;0;NA;344588;15;2020-04-16;228
2020-04-15;"Bratislavský kraj";11;0;0;0;NA;344588;11;2020-04-15;213
2020-04-14;"Bratislavský kraj";19;0;0;0;NA;344588;19;2020-04-14;202
2020-04-13;"Bratislavský kraj";53;0;0;0;NA;344588;53;2020-04-13;183
2020-04-12;"Bratislavský kraj";3;0;0;0;NA;344588;3;2020-04-12;130
2020-04-11;"Bratislavský kraj";1;0;0;0;NA;344588;1;2020-04-11;127
2020-04-10;"Bratislavský kraj";8;0;0;0;NA;344588;8;2020-04-10;126
2020-04-09;"Bratislavský kraj";3;0;0;0;NA;344588;3;2020-04-09;118
2020-04-08;"Bratislavský kraj";3;0;0;0;NA;344588;3;2020-04-08;115
2020-04-07;"Bratislavský kraj";24;0;0;0;NA;344588;24;2020-04-07;112
2020-04-06;"Bratislavský kraj";5;0;0;0;NA;344588;5;2020-04-06;88
2020-04-05;"Bratislavský kraj";6;0;0;0;NA;344588;6;2020-04-05;83
2020-04-04;"Bratislavský kraj";2;0;0;0;NA;344588;2;2020-04-04;77
2020-04-03;"Bratislavský kraj";1;0;0;0;NA;344588;1;2020-04-03;75
2020-04-02;"Bratislavský kraj";2;0;0;0;NA;344588;2;2020-04-02;74
2020-04-01;"Bratislavský kraj";5;0;0;0;NA;344588;5;2020-04-01;72
2020-03-31;"Bratislavský kraj";19;0;0;0;NA;344588;19;2020-03-31;67
2020-03-30;"Bratislavský kraj";6;0;0;0;NA;344588;6;2020-03-30;48
2020-03-29;"Bratislavský kraj";8;0;0;0;NA;344588;8;2020-03-29;42
2020-03-28;"Bratislavský kraj";4;0;0;0;NA;344588;4;2020-03-28;34
2020-03-27;"Bratislavský kraj";3;0;0;0;NA;344588;3;2020-03-27;30
2020-03-26;"Bratislavský kraj";15;0;0;0;NA;344588;15;2020-03-26;27
2020-03-25;"Bratislavský kraj";1;0;0;0;NA;344588;1;2020-03-25;12
2020-03-24;"Bratislavský kraj";4;0;0;0;NA;344588;4;2020-03-24;11
2020-03-23;"Bratislavský kraj";9;0;0;0;NA;344588;9;2020-03-23;7
2020-03-22;"Bratislavský kraj";2;0;0;0;NA;344588;2;2020-03-22;-2
2020-03-21;"Bratislavský kraj";22;0;0;0;NA;344588;22;2020-03-21;-4
2020-03-20;"Bratislavský kraj";3;0;0;0;NA;344588;3;2020-03-20;-26
2020-03-19;"Bratislavský kraj";4;0;0;0;NA;344588;4;2020-03-19;-29
2020-03-18;"Bratislavský kraj";3;0;0;0;NA;344588;3;2020-03-18;-33
2020-03-17;"Bratislavský kraj";13;0;0;0;NA;344588;13;2020-03-17;-36
2020-03-16;"Bratislavský kraj";1;0;0;0;NA;344588;1;2020-03-16;-49
2020-03-15;"Bratislavský kraj";4;0;0;0;NA;344588;4;2020-03-15;-50
2020-03-14;"Bratislavský kraj";9;0;0;0;NA;344588;9;2020-03-14;-54
2020-03-13;"Bratislavský kraj";2;0;0;0;NA;344588;2;2020-03-13;-63
2020-03-12;"Bratislavský kraj";8;0;0;0;NA;344588;8;2020-03-12;-65
2020-03-11;"Bratislavský kraj";3;0;0;0;NA;344588;3;2020-03-11;-73
2020-03-09;"Bratislavský kraj";0;0;0;0;NA;344588;0;2020-03-09;-76
2020-03-08;"Bratislavský kraj";2;0;0;0;NA;344588;2;2020-03-08;-76
2020-03-07;"Bratislavský kraj";2;0;0;0;NA;344588;2;2020-03-07;-78
2020-03-06;"Bratislavský kraj";1;0;0;0;NA;344588;1;2020-03-06;-80
2022-05-26;"Košický kraj";27;0;0;0;235960;346464;27;2022-05-26;346464
2022-05-25;"Košický kraj";40;149;5;154;NA;346464;45;2022-05-25;346437
2022-05-24;"Košický kraj";20;210;11;221;NA;346464;31;2022-05-24;346392
2022-05-23;"Košický kraj";20;678;40;718;NA;346464;60;2022-05-23;346361
2022-05-22;"Košický kraj";2;52;9;61;NA;346464;11;2022-05-22;346301
2022-05-21;"Košický kraj";16;52;4;56;NA;346464;20;2022-05-21;346290
2022-05-20;"Košický kraj";30;214;12;226;NA;346464;42;2022-05-20;346270
2022-05-19;"Košický kraj";35;467;13;480;NA;346464;48;2022-05-19;346228
2022-05-18;"Košický kraj";48;257;11;268;NA;346464;59;2022-05-18;346180
2022-05-17;"Košický kraj";49;324;17;341;NA;346464;66;2022-05-17;346121
2022-05-16;"Košický kraj";22;389;29;418;NA;346464;51;2022-05-16;346055
2022-05-15;"Košický kraj";10;205;21;226;NA;346464;31;2022-05-15;346004
2022-05-14;"Košický kraj";38;177;18;195;NA;346464;56;2022-05-14;345973
2022-05-13;"Košický kraj";63;459;32;491;NA;346464;95;2022-05-13;345917
2022-05-12;"Košický kraj";54;393;25;418;NA;346464;79;2022-05-12;345822
2022-05-11;"Košický kraj";44;602;40;642;NA;346464;84;2022-05-11;345743
2022-05-10;"Košický kraj";47;421;41;462;NA;346464;88;2022-05-10;345659
2022-05-09;"Košický kraj";33;663;59;722;NA;346464;92;2022-05-09;345571
2022-05-08;"Košický kraj";9;230;22;252;NA;346464;31;2022-05-08;345479
2022-05-07;"Košický kraj";36;242;16;258;NA;346464;52;2022-05-07;345448
2022-05-06;"Košický kraj";73;453;42;495;NA;346464;115;2022-05-06;345396
2022-05-05;"Košický kraj";66;571;42;613;NA;346464;108;2022-05-05;345281
2022-05-04;"Košický kraj";56;528;40;568;NA;346464;96;2022-05-04;345173
2022-05-03;"Košický kraj";104;776;46;822;NA;346464;150;2022-05-03;345077
2022-05-02;"Košický kraj";97;1285;106;1391;NA;346464;203;2022-05-02;344927
2022-05-01;"Košický kraj";16;249;34;283;NA;346464;50;2022-05-01;344724
2022-04-30;"Košický kraj";106;308;28;336;NA;346464;134;2022-04-30;344674
2022-04-29;"Košický kraj";124;843;49;892;NA;346464;173;2022-04-29;344540
2022-04-28;"Košický kraj";108;1107;72;1179;NA;346464;180;2022-04-28;344367
2022-04-27;"Košický kraj";184;1254;54;1308;NA;346464;238;2022-04-27;344187
2022-04-26;"Košický kraj";160;1786;78;1864;NA;346464;238;2022-04-26;343949
2022-04-25;"Košický kraj";208;1912;121;2033;NA;346464;329;2022-04-25;343711
2022-04-24;"Košický kraj";43;553;59;612;NA;346464;102;2022-04-24;343382
2022-04-23;"Košický kraj";183;497;46;543;NA;346464;229;2022-04-23;343280
2022-04-22;"Košický kraj";237;1202;80;1282;NA;346464;317;2022-04-22;343051
2022-04-21;"Košický kraj";169;1571;110;1681;NA;346464;279;2022-04-21;342734
2022-04-20;"Košický kraj";331;1796;91;1887;NA;346464;422;2022-04-20;342455
2022-04-19;"Košický kraj";306;2580;181;2761;NA;346464;487;2022-04-19;342033
2022-04-18;"Košický kraj";63;715;60;775;NA;346464;123;2022-04-18;341546
2022-04-17;"Košický kraj";163;305;32;337;NA;346464;195;2022-04-17;341423
2022-04-16;"Košický kraj";129;540;88;628;NA;346464;217;2022-04-16;341228
2022-04-15;"Košický kraj";65;410;25;435;NA;346464;90;2022-04-15;341011
2022-04-14;"Košický kraj";364;1677;106;1783;NA;346464;470;2022-04-14;340921
2022-04-13;"Košický kraj";417;1889;104;1993;NA;346464;521;2022-04-13;340451
2022-04-12;"Košický kraj";254;1713;136;1849;NA;346464;390;2022-04-12;339930
2022-04-11;"Košický kraj";418;2765;184;2949;NA;346464;602;2022-04-11;339540
2022-04-10;"Košický kraj";164;795;66;861;NA;346464;230;2022-04-10;338938
2022-04-09;"Košický kraj";210;623;55;678;NA;346464;265;2022-04-09;338708
2022-04-08;"Košický kraj";373;1705;151;1856;NA;346464;524;2022-04-08;338443
2022-04-07;"Košický kraj";428;2176;173;2349;NA;346464;601;2022-04-07;337919
2022-04-06;"Košický kraj";580;1845;172;2017;NA;346464;752;2022-04-06;337318
2022-04-05;"Košický kraj";721;1818;187;2005;NA;346464;908;2022-04-05;336566
2022-04-04;"Košický kraj";694;3029;326;3355;NA;346464;1020;2022-04-04;335658
2022-04-03;"Košický kraj";208;861;136;997;NA;346464;344;2022-04-03;334638
2022-04-02;"Košický kraj";331;628;86;714;NA;346464;417;2022-04-02;334294
2022-04-01;"Košický kraj";714;1919;227;2146;NA;346464;941;2022-04-01;333877
2022-03-31;"Košický kraj";745;1899;205;2104;NA;346464;950;2022-03-31;332936
2022-03-30;"Košický kraj";1081;2171;241;2412;NA;346464;1322;2022-03-30;331986
2022-03-29;"Košický kraj";683;2337;310;2647;NA;346464;993;2022-03-29;330664
2022-03-28;"Košický kraj";886;3310;435;3745;NA;346464;1321;2022-03-28;329671
2022-03-27;"Košický kraj";355;1168;230;1398;NA;346464;585;2022-03-27;328350
2022-03-26;"Košický kraj";593;940;165;1105;NA;346464;758;2022-03-26;327765
2022-03-25;"Košický kraj";958;1831;316;2147;NA;346464;1274;2022-03-25;327007
2022-03-24;"Košický kraj";998;2433;328;2761;NA;346464;1326;2022-03-24;325733
2022-03-23;"Košický kraj";1143;2615;348;2963;NA;346464;1491;2022-03-23;324407
2022-03-22;"Košický kraj";1508;2766;378;3144;NA;346464;1886;2022-03-22;322916
2022-03-21;"Košický kraj";1241;3484;530;4014;NA;346464;1771;2022-03-21;321030
2022-03-20;"Košický kraj";199;1514;318;1832;NA;346464;517;2022-03-20;319259
2022-03-19;"Košický kraj";952;1133;241;1374;NA;346464;1193;2022-03-19;318742
2022-03-18;"Košický kraj";1382;2278;343;2621;NA;346464;1725;2022-03-18;317549
2022-03-17;"Košický kraj";1181;2717;358;3075;NA;346464;1539;2022-03-17;315824
2022-03-16;"Košický kraj";1631;4800;372;5172;NA;346464;2003;2022-03-16;314285
2022-03-15;"Košický kraj";1591;2889;436;3325;NA;346464;2027;2022-03-15;312282
2022-03-14;"Košický kraj";1424;3479;585;4064;NA;346464;2009;2022-03-14;310255
2022-03-13;"Košický kraj";565;1711;375;2086;NA;346464;940;2022-03-13;308246
2022-03-12;"Košický kraj";1227;1263;218;1481;NA;346464;1445;2022-03-12;307306
2022-03-11;"Košický kraj";1451;2815;513;3328;NA;346464;1964;2022-03-11;305861
2022-03-10;"Košický kraj";990;3158;406;3564;NA;346464;1396;2022-03-10;303897
2022-03-09;"Košický kraj";1545;3322;397;3719;NA;346464;1942;2022-03-09;302501
2022-03-08;"Košický kraj";1487;3633;441;4074;NA;346464;1928;2022-03-08;300559
2022-03-07;"Košický kraj";1347;4968;713;5681;NA;346464;2060;2022-03-07;298631
2022-03-06;"Košický kraj";297;1811;372;2183;NA;346464;669;2022-03-06;296571
2022-03-05;"Košický kraj";874;1317;264;1581;NA;346464;1138;2022-03-05;295902
2022-03-04;"Košický kraj";1255;3130;424;3554;NA;346464;1679;2022-03-04;294764
2022-03-03;"Košický kraj";1111;3543;433;3976;NA;346464;1544;2022-03-03;293085
2022-03-02;"Košický kraj";1458;3437;455;3892;NA;346464;1913;2022-03-02;291541
2022-03-01;"Košický kraj";1723;3720;487;4207;NA;346464;2210;2022-03-01;289628
2022-02-28;"Košický kraj";1345;5497;805;6302;NA;346464;2150;2022-02-28;287418
2022-02-27;"Košický kraj";465;2397;440;2837;NA;346464;905;2022-02-27;285268
2022-02-26;"Košický kraj";979;1348;329;1677;NA;346464;1308;2022-02-26;284363
2022-02-25;"Košický kraj";1691;3274;510;3784;NA;346464;2201;2022-02-25;283055
2022-02-24;"Košický kraj";1988;4033;594;4627;NA;346464;2582;2022-02-24;280854
2022-02-23;"Košický kraj";1787;4151;558;4709;NA;346464;2345;2022-02-23;278272
2022-02-22;"Košický kraj";2649;4695;660;5355;NA;346464;3309;2022-02-22;275927
2022-02-21;"Košický kraj";1646;6499;910;7409;NA;346464;2556;2022-02-21;272618
2022-02-20;"Košický kraj";577;2919;578;3497;NA;346464;1155;2022-02-20;270062
2022-02-19;"Košický kraj";1941;2169;409;2578;NA;346464;2350;2022-02-19;268907
2022-02-18;"Košický kraj";2210;4534;640;5174;NA;346464;2850;2022-02-18;266557
2022-02-17;"Košický kraj";2555;4668;675;5343;NA;346464;3230;2022-02-17;263707
2022-02-16;"Košický kraj";2153;5477;736;6213;NA;346464;2889;2022-02-16;260477
2022-02-15;"Košický kraj";2768;5507;830;6337;NA;346464;3598;2022-02-15;257588
2022-02-14;"Košický kraj";2337;8076;1104;9180;NA;346464;3441;2022-02-14;253990
2022-02-13;"Košický kraj";1235;4248;809;5057;NA;346464;2044;2022-02-13;250549
2022-02-12;"Košický kraj";1728;2014;524;2538;NA;346464;2252;2022-02-12;248505
2022-02-11;"Košický kraj";2665;4797;633;5430;NA;346464;3298;2022-02-11;246253
2022-02-10;"Košický kraj";2135;5323;728;6051;NA;346464;2863;2022-02-10;242955
2022-02-09;"Košický kraj";2067;5940;743;6683;NA;346464;2810;2022-02-09;240092
2022-02-08;"Košický kraj";2993;6143;762;6905;NA;346464;3755;2022-02-08;237282
2022-02-07;"Košický kraj";1939;7973;978;8951;NA;346464;2917;2022-02-07;233527
2022-02-06;"Košický kraj";998;4482;680;5162;NA;346464;1678;2022-02-06;230610
2022-02-05;"Košický kraj";2209;2454;434;2888;NA;346464;2643;2022-02-05;228932
2022-02-04;"Košický kraj";2563;5634;632;6266;NA;346464;3195;2022-02-04;226289
2022-02-03;"Košický kraj";1916;6379;659;7038;NA;346464;2575;2022-02-03;223094
2022-02-02;"Košický kraj";2498;6923;629;7552;NA;346464;3127;2022-02-02;220519
2022-02-01;"Košický kraj";2173;6706;678;7384;NA;346464;2851;2022-02-01;217392
2022-01-31;"Košický kraj";2020;9960;841;10801;NA;346464;2861;2022-01-31;214541
2022-01-30;"Košický kraj";1002;5716;541;6257;NA;346464;1543;2022-01-30;211680
2022-01-29;"Košický kraj";1731;2720;387;3107;NA;346464;2118;2022-01-29;210137
2022-01-28;"Košický kraj";1743;5571;492;6063;NA;346464;2235;2022-01-28;208019
2022-01-27;"Košický kraj";1553;5792;413;6205;NA;346464;1966;2022-01-27;205784
2022-01-26;"Košický kraj";1683;5613;399;6012;NA;346464;2082;2022-01-26;203818
2022-01-25;"Košický kraj";1409;6210;404;6614;NA;346464;1813;2022-01-25;201736
2022-01-24;"Košický kraj";1141;8669;431;9100;NA;346464;1572;2022-01-24;199923
2022-01-23;"Košický kraj";516;5418;287;5705;NA;346464;803;2022-01-23;198351
2022-01-22;"Košický kraj";914;2528;177;2705;NA;346464;1091;2022-01-22;197548
2022-01-21;"Košický kraj";589;5194;227;5421;NA;346464;816;2022-01-21;196457
2022-01-20;"Košický kraj";769;5379;200;5579;NA;346464;969;2022-01-20;195641
2022-01-19;"Košický kraj";629;5329;178;5507;NA;346464;807;2022-01-19;194672
2022-01-18;"Košický kraj";716;5758;140;5898;NA;346464;856;2022-01-18;193865
2022-01-17;"Košický kraj";486;9004;187;9191;NA;346464;673;2022-01-17;193009
2022-01-16;"Košický kraj";51;5264;137;5401;NA;346464;188;2022-01-16;192336
2022-01-15;"Košický kraj";422;2208;69;2277;NA;346464;491;2022-01-15;192148
2022-01-14;"Košický kraj";175;4208;93;4301;NA;346464;268;2022-01-14;191657
2022-01-13;"Košický kraj";165;4919;77;4996;NA;346464;242;2022-01-13;191389
2022-01-12;"Košický kraj";295;4609;78;4687;NA;346464;373;2022-01-12;191147
2022-01-11;"Košický kraj";349;5295;70;5365;NA;346464;419;2022-01-11;190774
2022-01-10;"Košický kraj";290;8254;128;8382;NA;346464;418;2022-01-10;190355
2022-01-09;"Košický kraj";230;5838;86;5924;NA;346464;316;2022-01-09;189937
2022-01-08;"Košický kraj";157;2417;57;2474;NA;346464;214;2022-01-08;189621
2022-01-07;"Košický kraj";388;5017;129;5146;NA;346464;517;2022-01-07;189407
2022-01-06;"Košický kraj";118;1576;55;1631;NA;346464;173;2022-01-06;188890
2022-01-05;"Košický kraj";354;5082;102;5184;NA;346464;456;2022-01-05;188717
2022-01-04;"Košický kraj";450;5273;84;5357;NA;346464;534;2022-01-04;188261
2022-01-03;"Košický kraj";439;7970;140;8110;NA;346464;579;2022-01-03;187727
2022-01-02;"Košický kraj";284;4614;109;4723;NA;346464;393;2022-01-02;187148
2022-01-01;"Košický kraj";28;360;18;378;NA;346464;46;2022-01-01;186755
2021-12-31;"Košický kraj";122;2999;86;3085;NA;346464;208;2021-12-31;186709
2021-12-30;"Košický kraj";401;3949;118;4067;NA;346464;519;2021-12-30;186501
2021-12-29;"Košický kraj";378;4194;111;4305;NA;346464;489;2021-12-29;185982
2021-12-28;"Košický kraj";509;4450;125;4575;NA;346464;634;2021-12-28;185493
2021-12-27;"Košický kraj";495;6822;205;7027;NA;346464;700;2021-12-27;184859
2021-12-26;"Košický kraj";109;2510;115;2625;NA;346464;224;2021-12-26;184159
2021-12-25;"Košický kraj";30;644;43;687;NA;346464;73;2021-12-25;183935
2021-12-24;"Košický kraj";95;1055;50;1105;NA;346464;145;2021-12-24;183862
2021-12-23;"Košický kraj";644;4479;131;4610;NA;346464;775;2021-12-23;183717
2021-12-22;"Košický kraj";224;4309;106;4415;NA;346464;330;2021-12-22;182942
2021-12-21;"Košický kraj";544;6491;138;6629;NA;346464;682;2021-12-21;182612
2021-12-20;"Košický kraj";464;8630;196;8826;NA;346464;660;2021-12-20;181930
2021-12-19;"Košický kraj";137;5447;177;5624;NA;346464;314;2021-12-19;181270
2021-12-18;"Košický kraj";414;2555;102;2657;NA;346464;516;2021-12-18;180956
2021-12-17;"Košický kraj";428;4832;145;4977;NA;346464;573;2021-12-17;180440
2021-12-16;"Košický kraj";476;5845;168;6013;NA;346464;644;2021-12-16;179867
2021-12-15;"Košický kraj";508;5956;172;6128;NA;346464;680;2021-12-15;179223
2021-12-14;"Košický kraj";957;5789;172;5961;NA;346464;1129;2021-12-14;178543
2021-12-13;"Košický kraj";679;9657;248;9905;NA;346464;927;2021-12-13;177414
2021-12-12;"Košický kraj";243;6657;198;6855;NA;346464;441;2021-12-12;176487
2021-12-11;"Košický kraj";519;2996;134;3130;NA;346464;653;2021-12-11;176046
2021-12-10;"Košický kraj";936;5465;185;5650;NA;346464;1121;2021-12-10;175393
2021-12-09;"Košický kraj";755;5779;198;5977;NA;346464;953;2021-12-09;174272
2021-12-08;"Košický kraj";1095;6574;275;6849;NA;346464;1370;2021-12-08;173319
2021-12-07;"Košický kraj";1212;6323;267;6590;NA;346464;1479;2021-12-07;171949
2021-12-06;"Košický kraj";904;10627;313;10940;NA;346464;1217;2021-12-06;170470
2021-12-05;"Košický kraj";404;7756;263;8019;NA;346464;667;2021-12-05;169253
2021-12-04;"Košický kraj";1007;3097;180;3277;NA;346464;1187;2021-12-04;168586
2021-12-03;"Košický kraj";1338;6065;271;6336;NA;346464;1609;2021-12-03;167399
2021-12-02;"Košický kraj";2209;5654;302;5956;NA;346464;2511;2021-12-02;165790
2021-12-01;"Košický kraj";1016;6483;388;6871;NA;346464;1404;2021-12-01;163279
2021-11-30;"Košický kraj";1125;8173;471;8644;NA;346464;1596;2021-11-30;161875
2021-11-29;"Košický kraj";993;14057;634;14691;NA;346464;1627;2021-11-29;160279
2021-11-28;"Košický kraj";972;10211;473;10684;NA;346464;1445;2021-11-28;158652
2021-11-27;"Košický kraj";1103;3566;219;3785;NA;346464;1322;2021-11-27;157207
2021-11-26;"Košický kraj";1395;6059;383;6442;NA;346464;1778;2021-11-26;155885
2021-11-25;"Košický kraj";1373;7016;499;7515;NA;346464;1872;2021-11-25;154107
2021-11-24;"Košický kraj";1194;7067;473;7540;NA;346464;1667;2021-11-24;152235
2021-11-23;"Košický kraj";1178;7185;488;7673;NA;346464;1666;2021-11-23;150568
2021-11-22;"Košický kraj";861;10709;741;11450;NA;346464;1602;2021-11-22;148902
2021-11-21;"Košický kraj";985;7394;657;8051;NA;346464;1642;2021-11-21;147300
2021-11-20;"Košický kraj";1083;2859;295;3154;NA;346464;1378;2021-11-20;145658
2021-11-19;"Košický kraj";1078;7543;516;8059;NA;346464;1594;2021-11-19;144280
2021-11-18;"Košický kraj";1061;9410;719;10129;NA;346464;1780;2021-11-18;142686
2021-11-17;"Košický kraj";1319;2824;262;3086;NA;346464;1581;2021-11-17;140906
2021-11-16;"Košický kraj";1484;7135;543;7678;NA;346464;2027;2021-11-16;139325
2021-11-15;"Košický kraj";902;10812;754;11566;NA;346464;1656;2021-11-15;137298
2021-11-14;"Košický kraj";715;5756;455;6211;NA;346464;1170;2021-11-14;135642
2021-11-13;"Košický kraj";869;2686;312;2998;NA;346464;1181;2021-11-13;134472
2021-11-12;"Košický kraj";1132;5616;410;6026;NA;346464;1542;2021-11-12;133291
2021-11-11;"Košický kraj";1035;6139;460;6599;NA;346464;1495;2021-11-11;131749
2021-11-10;"Košický kraj";933;6633;497;7130;NA;346464;1430;2021-11-10;130254
2021-11-09;"Košický kraj";967;5540;389;5929;NA;346464;1356;2021-11-09;128824
2021-11-08;"Košický kraj";701;7838;601;8439;NA;346464;1302;2021-11-08;127468
2021-11-07;"Košický kraj";691;4578;425;5003;NA;346464;1116;2021-11-07;126166
2021-11-06;"Košický kraj";996;2276;217;2493;NA;346464;1213;2021-11-06;125050
2021-11-05;"Košický kraj";1029;4905;367;5272;NA;346464;1396;2021-11-05;123837
2021-11-04;"Košický kraj";1000;5354;360;5714;NA;346464;1360;2021-11-04;122441
2021-11-03;"Košický kraj";1051;5749;361;6110;NA;346464;1412;2021-11-03;121081
2021-11-02;"Košický kraj";915;8775;566;9341;NA;346464;1481;2021-11-02;119669
2021-11-01;"Košický kraj";181;1999;265;2264;NA;346464;446;2021-11-01;118188
2021-10-31;"Košický kraj";385;2337;227;2564;NA;346464;612;2021-10-31;117742
2021-10-30;"Košický kraj";641;2380;180;2560;NA;346464;821;2021-10-30;117130
2021-10-29;"Košický kraj";750;4608;289;4897;NA;346464;1039;2021-10-29;116309
2021-10-28;"Košický kraj";823;5115;255;5370;NA;346464;1078;2021-10-28;115270
2021-10-27;"Košický kraj";723;4831;259;5090;NA;346464;982;2021-10-27;114192
2021-10-26;"Košický kraj";618;5049;225;5274;NA;346464;843;2021-10-26;113210
2021-10-25;"Košický kraj";268;6747;292;7039;NA;346464;560;2021-10-25;112367
2021-10-24;"Košický kraj";170;3447;205;3652;NA;346464;375;2021-10-24;111807
2021-10-23;"Košický kraj";397;1953;86;2039;NA;346464;483;2021-10-23;111432
2021-10-22;"Košický kraj";474;4679;130;4809;NA;346464;604;2021-10-22;110949
2021-10-21;"Košický kraj";669;5094;172;5266;NA;346464;841;2021-10-21;110345
2021-10-20;"Košický kraj";398;4963;152;5115;NA;346464;550;2021-10-20;109504
2021-10-19;"Košický kraj";579;4870;161;5031;NA;346464;740;2021-10-19;108954
2021-10-18;"Košický kraj";180;7090;171;7261;NA;346464;351;2021-10-18;108214
2021-10-17;"Košický kraj";70;3614;125;3739;NA;346464;195;2021-10-17;107863
2021-10-16;"Košický kraj";312;1839;40;1879;NA;346464;352;2021-10-16;107668
2021-10-15;"Košický kraj";312;4530;77;4607;NA;346464;389;2021-10-15;107316
2021-10-14;"Košický kraj";327;4652;95;4747;NA;346464;422;2021-10-14;106927
2021-10-13;"Košický kraj";168;4168;88;4256;NA;346464;256;2021-10-13;106505
2021-10-12;"Košický kraj";391;4119;75;4194;NA;346464;466;2021-10-12;106249
2021-10-11;"Košický kraj";119;6351;121;6472;NA;346464;240;2021-10-11;105783
2021-10-10;"Košický kraj";104;2921;63;2984;NA;346464;167;2021-10-10;105543
2021-10-09;"Košický kraj";111;1687;43;1730;NA;346464;154;2021-10-09;105376
2021-10-08;"Košický kraj";274;4143;68;4211;NA;346464;342;2021-10-08;105222
2021-10-07;"Košický kraj";277;4399;74;4473;NA;346464;351;2021-10-07;104880
2021-10-06;"Košický kraj";178;4369;89;4458;NA;346464;267;2021-10-06;104529
2021-10-05;"Košický kraj";345;4542;78;4620;NA;346464;423;2021-10-05;104262
2021-10-04;"Košický kraj";122;6094;110;6204;NA;346464;232;2021-10-04;103839
2021-10-03;"Košický kraj";133;3176;74;3250;NA;346464;207;2021-10-03;103607
2021-10-02;"Košický kraj";124;2567;41;2608;NA;346464;165;2021-10-02;103400
2021-10-01;"Košický kraj";181;4251;73;4324;NA;346464;254;2021-10-01;103235
2021-09-30;"Košický kraj";244;4780;71;4851;NA;346464;315;2021-09-30;102981
2021-09-29;"Košický kraj";183;3824;64;3888;NA;346464;247;2021-09-29;102666
2021-09-28;"Košický kraj";303;4339;80;4419;NA;346464;383;2021-09-28;102419
2021-09-27;"Košický kraj";117;6358;77;6435;NA;346464;194;2021-09-27;102036
2021-09-26;"Košický kraj";13;2809;44;2853;NA;346464;57;2021-09-26;101842
2021-09-25;"Košický kraj";162;2521;35;2556;NA;346464;197;2021-09-25;101785
2021-09-24;"Košický kraj";183;4756;43;4799;NA;346464;226;2021-09-24;101588
2021-09-23;"Košický kraj";142;3880;51;3931;NA;346464;193;2021-09-23;101362
2021-09-22;"Košický kraj";151;4436;52;4488;NA;346464;203;2021-09-22;101169
2021-09-21;"Košický kraj";234;4441;44;4485;NA;346464;278;2021-09-21;100966
2021-09-20;"Košický kraj";158;6017;73;6090;NA;346464;231;2021-09-20;100688
2021-09-19;"Košický kraj";15;2487;30;2517;NA;346464;45;2021-09-19;100457
2021-09-18;"Košický kraj";187;2504;24;2528;NA;346464;211;2021-09-18;100412
2021-09-17;"Košický kraj";121;4797;41;4838;NA;346464;162;2021-09-17;100201
2021-09-16;"Košický kraj";228;4503;71;4574;NA;346464;299;2021-09-16;100039
2021-09-15;"Košický kraj";52;989;16;1005;NA;346464;68;2021-09-15;99740
2021-09-14;"Košický kraj";142;3456;47;3503;NA;346464;189;2021-09-14;99672
2021-09-13;"Košický kraj";96;4949;48;4997;NA;346464;144;2021-09-13;99483
2021-09-12;"Košický kraj";14;2003;31;2034;NA;346464;45;2021-09-12;99339
2021-09-11;"Košický kraj";105;2186;19;2205;NA;346464;124;2021-09-11;99294
2021-09-10;"Košický kraj";125;4293;42;4335;NA;346464;167;2021-09-10;99170
2021-09-09;"Košický kraj";115;3226;30;3256;NA;346464;145;2021-09-09;99003
2021-09-08;"Košický kraj";86;2753;36;2789;NA;346464;122;2021-09-08;98858
2021-09-07;"Košický kraj";79;2686;53;2739;NA;346464;132;2021-09-07;98736
2021-09-06;"Košický kraj";41;2786;36;2822;NA;346464;77;2021-09-06;98604
2021-09-05;"Košický kraj";52;1393;18;1411;NA;346464;70;2021-09-05;98527
2021-09-04;"Košický kraj";37;1678;12;1690;NA;346464;49;2021-09-04;98457
2021-09-03;"Košický kraj";47;2913;35;2948;NA;346464;82;2021-09-03;98408
2021-09-02;"Košický kraj";56;2686;26;2712;NA;346464;82;2021-09-02;98326
2021-09-01;"Košický kraj";95;629;13;642;NA;346464;108;2021-09-01;98244
2021-08-31;"Košický kraj";30;2525;22;2547;NA;346464;52;2021-08-31;98136
2021-08-30;"Košický kraj";8;2404;28;2432;NA;346464;36;2021-08-30;98084
2021-08-29;"Košický kraj";16;603;1;604;NA;346464;17;2021-08-29;98048
2021-08-28;"Košický kraj";14;2103;11;2114;NA;346464;25;2021-08-28;98031
2021-08-27;"Košický kraj";22;2908;16;2924;NA;346464;38;2021-08-27;98006
2021-08-26;"Košický kraj";19;2292;13;2305;NA;346464;32;2021-08-26;97968
2021-08-25;"Košický kraj";33;2010;6;2016;NA;346464;39;2021-08-25;97936
2021-08-24;"Košický kraj";14;2337;3;2340;NA;346464;17;2021-08-24;97897
2021-08-23;"Košický kraj";33;2461;5;2466;NA;346464;38;2021-08-23;97880
2021-08-22;"Košický kraj";4;1457;8;1465;NA;346464;12;2021-08-22;97842
2021-08-21;"Košický kraj";35;2134;5;2139;NA;346464;40;2021-08-21;97830
2021-08-20;"Košický kraj";13;3215;5;3220;NA;346464;18;2021-08-20;97790
2021-08-19;"Košický kraj";14;2178;6;2184;NA;346464;20;2021-08-19;97772
2021-08-18;"Košický kraj";30;1827;8;1835;NA;346464;38;2021-08-18;97752
2021-08-17;"Košický kraj";24;1619;3;1622;NA;346464;27;2021-08-17;97714
2021-08-16;"Košický kraj";3;2236;10;2246;NA;346464;13;2021-08-16;97687
2021-08-15;"Košický kraj";1;778;5;783;NA;346464;6;2021-08-15;97674
2021-08-14;"Košický kraj";15;1222;1;1223;NA;346464;16;2021-08-14;97668
2021-08-13;"Košický kraj";14;1928;8;1936;NA;346464;22;2021-08-13;97652
2021-08-12;"Košický kraj";10;1248;3;1251;NA;346464;13;2021-08-12;97630
2021-08-11;"Košický kraj";6;1368;5;1373;NA;346464;11;2021-08-11;97617
2021-08-10;"Košický kraj";10;1352;8;1360;NA;346464;18;2021-08-10;97606
2021-08-09;"Košický kraj";12;1651;3;1654;NA;346464;15;2021-08-09;97588
2021-08-08;"Košický kraj";8;688;1;689;NA;346464;9;2021-08-08;97573
2021-08-07;"Košický kraj";3;1125;3;1128;NA;346464;6;2021-08-07;97564
2021-08-06;"Košický kraj";9;1614;6;1620;NA;346464;15;2021-08-06;97558
2021-08-05;"Košický kraj";26;1254;6;1260;NA;346464;32;2021-08-05;97543
2021-08-04;"Košický kraj";8;1373;5;1378;NA;346464;13;2021-08-04;97511
2021-08-03;"Košický kraj";33;1121;3;1124;NA;346464;36;2021-08-03;97498
2021-08-02;"Košický kraj";6;1702;8;1710;NA;346464;14;2021-08-02;97462
2021-08-01;"Košický kraj";1;662;1;663;NA;346464;2;2021-08-01;97448
2021-07-31;"Košický kraj";17;1153;2;1155;NA;346464;19;2021-07-31;97446
2021-07-30;"Košický kraj";12;1657;7;1664;NA;346464;19;2021-07-30;97427
2021-07-29;"Košický kraj";7;1242;5;1247;NA;346464;12;2021-07-29;97408
2021-07-28;"Košický kraj";15;956;5;961;NA;346464;20;2021-07-28;97396
2021-07-27;"Košický kraj";17;1180;7;1187;NA;346464;24;2021-07-27;97376
2021-07-26;"Košický kraj";3;1666;9;1675;NA;346464;12;2021-07-26;97352
2021-07-25;"Košický kraj";0;719;3;722;NA;346464;3;2021-07-25;97340
2021-07-24;"Košický kraj";18;996;4;1000;NA;346464;22;2021-07-24;97337
2021-07-23;"Košický kraj";9;1524;5;1529;NA;346464;14;2021-07-23;97315
2021-07-22;"Košický kraj";1;1254;4;1258;NA;346464;5;2021-07-22;97301
2021-07-21;"Košický kraj";4;1117;3;1120;NA;346464;7;2021-07-21;97296
2021-07-20;"Košický kraj";6;1355;1;1356;NA;346464;7;2021-07-20;97289
2021-07-19;"Košický kraj";2;1517;2;1519;NA;346464;4;2021-07-19;97282
2021-07-18;"Košický kraj";0;644;0;644;NA;346464;0;2021-07-18;97278
2021-07-17;"Košický kraj";3;1101;5;1106;NA;346464;8;2021-07-17;97278
2021-07-16;"Košický kraj";3;1609;4;1613;NA;346464;7;2021-07-16;97270
2021-07-15;"Košický kraj";4;1383;4;1387;NA;346464;8;2021-07-15;97263
2021-07-14;"Košický kraj";2;1175;4;1179;NA;346464;6;2021-07-14;97255
2021-07-13;"Košický kraj";4;1331;1;1332;NA;346464;5;2021-07-13;97249
2021-07-12;"Košický kraj";3;1894;3;1897;NA;346464;6;2021-07-12;97244
2021-07-11;"Košický kraj";1;537;2;539;NA;346464;3;2021-07-11;97238
2021-07-10;"Košický kraj";9;1167;0;1167;NA;346464;9;2021-07-10;97235
2021-07-09;"Košický kraj";5;2005;5;2010;NA;346464;10;2021-07-09;97226
2021-07-08;"Košický kraj";13;1282;2;1284;NA;346464;15;2021-07-08;97216
2021-07-07;"Košický kraj";6;1524;1;1525;NA;346464;7;2021-07-07;97201
2021-07-06;"Košický kraj";4;1886;2;1888;NA;346464;6;2021-07-06;97194
2021-07-05;"Košický kraj";1;573;1;574;NA;346464;2;2021-07-05;97188
2021-07-04;"Košický kraj";0;482;2;484;NA;346464;2;2021-07-04;97186
2021-07-03;"Košický kraj";2;1227;0;1227;NA;346464;2;2021-07-03;97184
2021-07-02;"Košický kraj";2;1883;3;1886;NA;346464;5;2021-07-02;97182
2021-07-01;"Košický kraj";0;1211;2;1213;NA;346464;2;2021-07-01;97177
2021-06-30;"Košický kraj";5;9306;7;9313;NA;346464;12;2021-06-30;97175
2021-06-29;"Košický kraj";6;5692;7;5699;NA;346464;13;2021-06-29;97163
2021-06-28;"Košický kraj";5;6129;2;6131;NA;346464;7;2021-06-28;97150
2021-06-27;"Košický kraj";8;4636;3;4639;NA;346464;11;2021-06-27;97143
2021-06-26;"Košický kraj";4;5699;14;5713;NA;346464;18;2021-06-26;97132
2021-06-25;"Košický kraj";5;6981;2;6983;NA;346464;7;2021-06-25;97114
2021-06-24;"Košický kraj";1;5072;3;5075;NA;346464;4;2021-06-24;97107
2021-06-23;"Košický kraj";8;5373;3;5376;NA;346464;11;2021-06-23;97103
2021-06-22;"Košický kraj";1;5269;3;5272;NA;346464;4;2021-06-22;97092
2021-06-21;"Košický kraj";5;6830;11;6841;NA;346464;16;2021-06-21;97088
2021-06-20;"Košický kraj";0;4882;6;4888;NA;346464;6;2021-06-20;97072
2021-06-19;"Košický kraj";7;6473;1;6474;NA;346464;8;2021-06-19;97066
2021-06-18;"Košický kraj";4;7969;8;7977;NA;346464;12;2021-06-18;97058
2021-06-17;"Košický kraj";6;6128;3;6131;NA;346464;9;2021-06-17;97046
2021-06-16;"Košický kraj";11;6059;7;6066;NA;346464;18;2021-06-16;97037
2021-06-15;"Košický kraj";12;6301;2;6303;NA;346464;14;2021-06-15;97019
2021-06-14;"Košický kraj";10;7076;9;7085;NA;346464;19;2021-06-14;97005
2021-06-13;"Košický kraj";7;6948;8;6956;NA;346464;15;2021-06-13;96986
2021-06-12;"Košický kraj";7;7485;9;7494;NA;346464;16;2021-06-12;96971
2021-06-11;"Košický kraj";15;8973;6;8979;NA;346464;21;2021-06-11;96955
2021-06-10;"Košický kraj";11;6588;16;6604;NA;346464;27;2021-06-10;96934
2021-06-09;"Košický kraj";37;6056;7;6063;NA;346464;44;2021-06-09;96907
2021-06-08;"Košický kraj";33;7019;13;7032;NA;346464;46;2021-06-08;96863
2021-06-07;"Košický kraj";11;8106;22;8128;NA;346464;33;2021-06-07;96817
2021-06-06;"Košický kraj";1;7843;7;7850;NA;346464;8;2021-06-06;96784
2021-06-05;"Košický kraj";21;9286;3;9289;NA;346464;24;2021-06-05;96776
2021-06-04;"Košický kraj";26;11418;20;11438;NA;346464;46;2021-06-04;96752
2021-06-03;"Košický kraj";23;6467;14;6481;NA;346464;37;2021-06-03;96706
2021-06-02;"Košický kraj";15;7180;24;7204;NA;346464;39;2021-06-02;96669
2021-06-01;"Košický kraj";13;7562;10;7572;NA;346464;23;2021-06-01;96630
2021-05-31;"Košický kraj";13;9256;18;9274;NA;346464;31;2021-05-31;96607
2021-05-30;"Košický kraj";3;11215;10;11225;NA;346464;13;2021-05-30;96576
2021-05-29;"Košický kraj";25;10942;22;10964;NA;346464;47;2021-05-29;96563
2021-05-28;"Košický kraj";17;13055;29;13084;NA;346464;46;2021-05-28;96516
2021-05-27;"Košický kraj";19;7924;26;7950;NA;346464;45;2021-05-27;96470
2021-05-26;"Košický kraj";35;8118;27;8145;NA;346464;62;2021-05-26;96425
2021-05-25;"Košický kraj";33;9296;29;9325;NA;346464;62;2021-05-25;96363
2021-05-24;"Košický kraj";10;10855;27;10882;NA;346464;37;2021-05-24;96301
2021-05-23;"Košický kraj";4;12151;15;12166;NA;346464;19;2021-05-23;96264
2021-05-22;"Košický kraj";27;12601;19;12620;NA;346464;46;2021-05-22;96245
2021-05-21;"Košický kraj";24;14910;27;14937;NA;346464;51;2021-05-21;96199
2021-05-20;"Košický kraj";20;9422;28;9450;NA;346464;48;2021-05-20;96148
2021-05-19;"Košický kraj";30;10421;21;10442;NA;346464;51;2021-05-19;96100
2021-05-18;"Košický kraj";34;10254;36;10290;NA;346464;70;2021-05-18;96049
2021-05-17;"Košický kraj";20;12686;38;12724;NA;346464;58;2021-05-17;95979
2021-05-16;"Košický kraj";37;17865;20;17885;NA;346464;57;2021-05-16;95921
2021-05-15;"Košický kraj";22;25602;28;25630;NA;346464;50;2021-05-15;95864
2021-05-14;"Košický kraj";32;21824;42;21866;NA;346464;74;2021-05-14;95814
2021-05-13;"Košický kraj";39;10172;32;10204;NA;346464;71;2021-05-13;95740
2021-05-12;"Košický kraj";85;10868;33;10901;NA;346464;118;2021-05-12;95669
2021-05-11;"Košický kraj";68;11166;32;11198;NA;346464;100;2021-05-11;95551
2021-05-10;"Košický kraj";25;17044;42;17086;NA;346464;67;2021-05-10;95451
2021-05-09;"Košický kraj";84;25594;55;25649;NA;346464;139;2021-05-09;95384
2021-05-08;"Košický kraj";18;23399;23;23422;NA;346464;41;2021-05-08;95245
2021-05-07;"Košický kraj";51;24497;57;24554;NA;346464;108;2021-05-07;95204
2021-05-06;"Košický kraj";55;11847;43;11890;NA;346464;98;2021-05-06;95096
2021-05-05;"Košický kraj";23;12124;35;12159;NA;346464;58;2021-05-05;94998
2021-05-04;"Košický kraj";143;13562;38;13600;NA;346464;181;2021-05-04;94940
2021-05-03;"Košický kraj";37;16944;68;17012;NA;346464;105;2021-05-03;94759
2021-05-02;"Košický kraj";45;36096;56;36152;NA;346464;101;2021-05-02;94654
2021-05-01;"Košický kraj";54;52075;76;52151;NA;346464;130;2021-05-01;94553
2021-04-30;"Košický kraj";59;44602;94;44696;NA;346464;153;2021-04-30;94423
2021-04-29;"Košický kraj";76;17014;53;17067;NA;346464;129;2021-04-29;94270
2021-04-28;"Košický kraj";99;17970;52;18022;NA;346464;151;2021-04-28;94141
2021-04-27;"Košický kraj";108;20670;43;20713;NA;346464;151;2021-04-27;93990
2021-04-26;"Košický kraj";39;25915;96;26011;NA;346464;135;2021-04-26;93839
2021-04-25;"Košický kraj";23;48355;57;48412;NA;346464;80;2021-04-25;93704
2021-04-24;"Košický kraj";68;90124;114;90238;NA;346464;182;2021-04-24;93624
2021-04-23;"Košický kraj";110;41232;72;41304;NA;346464;182;2021-04-23;93442
2021-04-22;"Košický kraj";56;16772;44;16816;NA;346464;100;2021-04-22;93260
2021-04-21;"Košický kraj";114;19519;61;19580;NA;346464;175;2021-04-21;93160
2021-04-20;"Košický kraj";81;25432;63;25495;NA;346464;144;2021-04-20;92985
2021-04-19;"Košický kraj";93;29950;108;30058;NA;346464;201;2021-04-19;92841
2021-04-18;"Košický kraj";10;48913;82;48995;NA;346464;92;2021-04-18;92640
2021-04-17;"Košický kraj";187;83856;103;83959;NA;346464;290;2021-04-17;92548
2021-04-16;"Košický kraj";83;41568;127;41695;NA;346464;210;2021-04-16;92258
2021-04-15;"Košický kraj";104;18522;93;18615;NA;346464;197;2021-04-15;92048
2021-04-14;"Košický kraj";119;20089;64;20153;NA;346464;183;2021-04-14;91851
2021-04-13;"Košický kraj";81;23175;120;23295;NA;346464;201;2021-04-13;91668
2021-04-12;"Košický kraj";129;26573;124;26697;NA;346464;253;2021-04-12;91467
2021-04-11;"Košický kraj";29;46949;80;47029;NA;346464;109;2021-04-11;91214
2021-04-10;"Košický kraj";138;100114;183;100297;NA;346464;321;2021-04-10;91105
2021-04-09;"Košický kraj";168;35206;133;35339;NA;346464;301;2021-04-09;90784
2021-04-08;"Košický kraj";81;18530;90;18620;NA;346464;171;2021-04-08;90483
2021-04-07;"Košický kraj";232;28027;194;28221;NA;346464;426;2021-04-07;90312
2021-04-06;"Košický kraj";121;36495;164;36659;NA;346464;285;2021-04-06;89886
2021-04-05;"Košický kraj";19;14361;66;14427;NA;346464;85;2021-04-05;89601
2021-04-04;"Košický kraj";33;15089;66;15155;NA;346464;99;2021-04-04;89516
2021-04-03;"Košický kraj";138;97664;241;97905;NA;346464;379;2021-04-03;89417
2021-04-02;"Košický kraj";128;24515;76;24591;NA;346464;204;2021-04-02;89038
2021-04-01;"Košický kraj";165;46151;156;46307;NA;346464;321;2021-04-01;88834
2021-03-31;"Košický kraj";160;29659;124;29783;NA;346464;284;2021-03-31;88513
2021-03-30;"Košický kraj";229;24038;163;24201;NA;346464;392;2021-03-30;88229
2021-03-29;"Košický kraj";78;28843;194;29037;NA;346464;272;2021-03-29;87837
2021-03-28;"Košický kraj";39;44263;128;44391;NA;346464;167;2021-03-28;87565
2021-03-27;"Košický kraj";222;96602;265;96867;NA;346464;487;2021-03-27;87398
2021-03-26;"Košický kraj";233;45252;202;45454;NA;346464;435;2021-03-26;86911
2021-03-25;"Košický kraj";133;23804;175;23979;NA;346464;308;2021-03-25;86476
2021-03-24;"Košický kraj";165;20696;155;20851;NA;346464;320;2021-03-24;86168
2021-03-23;"Košický kraj";202;22434;192;22626;NA;346464;394;2021-03-23;85848
2021-03-22;"Košický kraj";169;26890;228;27118;NA;346464;397;2021-03-22;85454
2021-03-21;"Košický kraj";109;46746;167;46913;NA;346464;276;2021-03-21;85057
2021-03-20;"Košický kraj";126;101334;311;101645;NA;346464;437;2021-03-20;84781
2021-03-19;"Košický kraj";205;45632;260;45892;NA;346464;465;2021-03-19;84344
2021-03-18;"Košický kraj";274;23827;212;24039;NA;346464;486;2021-03-18;83879
2021-03-17;"Košický kraj";177;21548;195;21743;NA;346464;372;2021-03-17;83393
2021-03-16;"Košický kraj";386;23454;226;23680;NA;346464;612;2021-03-16;83021
2021-03-15;"Košický kraj";173;27900;297;28197;NA;346464;470;2021-03-15;82409
2021-03-14;"Košický kraj";145;44354;220;44574;NA;346464;365;2021-03-14;81939
2021-03-13;"Košický kraj";146;103790;483;104273;NA;346464;629;2021-03-13;81574
2021-03-12;"Košický kraj";366;47871;321;48192;NA;346464;687;2021-03-12;80945
2021-03-11;"Košický kraj";396;23229;263;23492;NA;346464;659;2021-03-11;80258
2021-03-10;"Košický kraj";121;22205;269;22474;NA;346464;390;2021-03-10;79599
2021-03-09;"Košický kraj";676;24509;300;24809;NA;346464;976;2021-03-09;79209
2021-03-08;"Košický kraj";559;29852;344;30196;NA;346464;903;2021-03-08;78233
2021-03-07;"Košický kraj";45;44230;299;44529;NA;346464;344;2021-03-07;77330
2021-03-06;"Košický kraj";177;105598;532;106130;NA;346464;709;2021-03-06;76986
2021-03-05;"Košický kraj";439;45567;424;45991;NA;346464;863;2021-03-05;76277
2021-03-04;"Košický kraj";417;23862;320;24182;NA;346464;737;2021-03-04;75414
2021-03-03;"Košický kraj";390;23169;298;23467;NA;346464;688;2021-03-03;74677
2021-03-02;"Košický kraj";464;24158;368;24526;NA;346464;832;2021-03-02;73989
2021-03-01;"Košický kraj";389;30013;514;30527;NA;346464;903;2021-03-01;73157
2021-02-28;"Košický kraj";265;43053;334;43387;NA;346464;599;2021-02-28;72254
2021-02-27;"Košický kraj";301;100559;784;101343;NA;346464;1085;2021-02-27;71655
2021-02-26;"Košický kraj";440;45466;492;45958;NA;346464;932;2021-02-26;70570
2021-02-25;"Košický kraj";331;19872;342;20214;NA;346464;673;2021-02-25;69638
2021-02-24;"Košický kraj";263;18751;505;19256;NA;346464;768;2021-02-24;68965
2021-02-23;"Košický kraj";642;21605;341;21946;NA;346464;983;2021-02-23;68197
2021-02-22;"Košický kraj";362;30858;434;31292;NA;346464;796;2021-02-22;67214
2021-02-21;"Košický kraj";170;40464;385;40849;NA;346464;555;2021-02-21;66418
2021-02-20;"Košický kraj";283;92550;770;93320;NA;346464;1053;2021-02-20;65863
2021-02-19;"Košický kraj";507;41579;583;42162;NA;346464;1090;2021-02-19;64810
2021-02-18;"Košický kraj";397;18442;345;18787;NA;346464;742;2021-02-18;63720
2021-02-17;"Košický kraj";322;18080;387;18467;NA;346464;709;2021-02-17;62978
2021-02-16;"Košický kraj";600;22111;463;22574;NA;346464;1063;2021-02-16;62269
2021-02-15;"Košický kraj";216;27633;419;28052;NA;346464;635;2021-02-15;61206
2021-02-14;"Košický kraj";241;56743;524;57267;NA;346464;765;2021-02-14;60571
2021-02-13;"Košický kraj";206;93745;765;94510;NA;346464;971;2021-02-13;59806
2021-02-12;"Košický kraj";448;49924;611;50535;NA;346464;1059;2021-02-12;58835
2021-02-11;"Košický kraj";435;14524;323;14847;NA;346464;758;2021-02-11;57776
2021-02-10;"Košický kraj";360;18475;431;18906;NA;346464;791;2021-02-10;57018
2021-02-09;"Košický kraj";544;24841;463;25304;NA;346464;1007;2021-02-09;56227
2021-02-08;"Košický kraj";237;24836;392;25228;NA;346464;629;2021-02-08;55220
2021-02-07;"Košický kraj";208;56897;612;57509;NA;346464;820;2021-02-07;54591
2021-02-06;"Košický kraj";318;104357;884;105241;NA;346464;1202;2021-02-06;53771
2021-02-05;"Košický kraj";384;43186;494;43680;NA;346464;878;2021-02-05;52569
2021-02-04;"Košický kraj";391;14512;371;14883;NA;346464;762;2021-02-04;51691
2021-02-03;"Košický kraj";296;12599;339;12938;NA;346464;635;2021-02-03;50929
2021-02-02;"Košický kraj";473;43883;1212;45095;NA;346464;1685;2021-02-02;50294
2021-02-01;"Košický kraj";415;21984;362;22346;NA;346464;777;2021-02-01;48609
2021-01-31;"Košický kraj";142;54690;617;55307;NA;346464;759;2021-01-31;47832
2021-01-30;"Košický kraj";320;76722;661;77383;NA;346464;981;2021-01-30;47073
2021-01-29;"Košický kraj";311;37164;466;37630;NA;346464;777;2021-01-29;46092
2021-01-28;"Košický kraj";540;9006;244;9250;NA;346464;784;2021-01-28;45315
2021-01-27;"Košický kraj";265;7575;211;7786;NA;346464;476;2021-01-27;44531
2021-01-26;"Košický kraj";530;14210;245;14455;NA;346464;775;2021-01-26;44055
2021-01-25;"Košický kraj";226;26431;413;26844;NA;346464;639;2021-01-25;43280
2021-01-24;"Košický kraj";150;44419;581;45000;NA;346464;731;2021-01-24;42641
2021-01-23;"Košický kraj";232;82705;857;83562;NA;346464;1089;2021-01-23;41910
2021-01-22;"Košický kraj";316;19997;265;20262;NA;346464;581;2021-01-22;40821
2021-01-21;"Košický kraj";274;14053;159;14212;NA;346464;433;2021-01-21;40240
2021-01-20;"Košický kraj";374;10844;201;11045;NA;346464;575;2021-01-20;39807
2021-01-19;"Košický kraj";248;9717;181;9898;NA;346464;429;2021-01-19;39232
2021-01-18;"Košický kraj";333;7659;262;7921;NA;346464;595;2021-01-18;38803
2021-01-17;"Košický kraj";155;535;14;549;NA;346464;169;2021-01-17;38208
2021-01-16;"Košický kraj";153;1403;47;1450;NA;346464;200;2021-01-16;38039
2021-01-15;"Košický kraj";308;6443;213;6656;NA;346464;521;2021-01-15;37839
2021-01-14;"Košický kraj";358;5471;221;5692;NA;346464;579;2021-01-14;37318
2021-01-13;"Košický kraj";421;4897;226;5123;NA;346464;647;2021-01-13;36739
2021-01-12;"Košický kraj";482;6473;237;6710;NA;346464;719;2021-01-12;36092
2021-01-11;"Košický kraj";309;7553;286;7839;NA;346464;595;2021-01-11;35373
2021-01-10;"Košický kraj";193;136;6;142;NA;346464;199;2021-01-10;34778
2021-01-09;"Košický kraj";469;1134;45;1179;NA;346464;514;2021-01-09;34579
2021-01-08;"Košický kraj";551;7106;348;7454;NA;346464;899;2021-01-08;34065
2021-01-07;"Košický kraj";251;5853;398;6251;NA;346464;649;2021-01-07;33166
2021-01-06;"Košický kraj";442;429;33;462;NA;346464;475;2021-01-06;32517
2021-01-05;"Košický kraj";584;7633;527;8160;NA;346464;1111;2021-01-05;32042
2021-01-04;"Košický kraj";407;6479;660;7139;NA;346464;1067;2021-01-04;30931
2021-01-03;"Košický kraj";118;661;22;683;NA;346464;140;2021-01-03;29864
2021-01-02;"Košický kraj";88;440;52;492;NA;346464;140;2021-01-02;29724
2021-01-01;"Košický kraj";398;725;49;774;NA;346464;447;2021-01-01;29584
2020-12-31;"Košický kraj";625;7509;453;7962;NA;346464;1078;2020-12-31;29137
2020-12-30;"Košický kraj";590;6076;395;6471;NA;346464;985;2020-12-30;28059
2020-12-29;"Košický kraj";419;7454;596;8050;NA;346464;1015;2020-12-29;27074
2020-12-28;"Košický kraj";356;7933;756;8689;NA;346464;1112;2020-12-28;26059
2020-12-27;"Košický kraj";159;147;16;163;NA;346464;175;2020-12-27;24947
2020-12-26;"Košický kraj";163;274;23;297;NA;346464;186;2020-12-26;24772
2020-12-25;"Košický kraj";237;140;10;150;NA;346464;247;2020-12-25;24586
2020-12-24;"Košický kraj";564;1470;90;1560;NA;346464;654;2020-12-24;24339
2020-12-23;"Košický kraj";304;7339;327;7666;NA;346464;631;2020-12-23;23685
2020-12-22;"Košický kraj";438;7284;429;7713;NA;346464;867;2020-12-22;23054
2020-12-21;"Košický kraj";405;6703;504;7207;NA;346464;909;2020-12-21;22187
2020-12-20;"Košický kraj";215;73;11;84;NA;346464;226;2020-12-20;21278
2020-12-19;"Košický kraj";207;1309;63;1372;NA;346464;270;2020-12-19;21052
2020-12-18;"Košický kraj";310;7707;292;7999;NA;346464;602;2020-12-18;20782
2020-12-17;"Košický kraj";463;5101;253;5354;NA;346464;716;2020-12-17;20180
2020-12-16;"Košický kraj";455;5725;295;6020;NA;346464;750;2020-12-16;19464
2020-12-15;"Košický kraj";319;4787;327;5114;NA;346464;646;2020-12-15;18714
2020-12-14;"Košický kraj";256;2905;225;3130;NA;346464;481;2020-12-14;18068
2020-12-13;"Košický kraj";47;181;2;183;NA;346464;49;2020-12-13;17587
2020-12-12;"Košický kraj";369;1587;118;1705;NA;346464;487;2020-12-12;17538
2020-12-11;"Košický kraj";354;5328;256;5584;NA;346464;610;2020-12-11;17051
2020-12-10;"Košický kraj";283;3987;174;4161;NA;346464;457;2020-12-10;16441
2020-12-09;"Košický kraj";279;3786;166;3952;NA;346464;445;2020-12-09;15984
2020-12-08;"Košický kraj";226;4105;355;4460;NA;346464;581;2020-12-08;15539
2020-12-07;"Košický kraj";270;2383;106;2489;NA;346464;376;2020-12-07;14958
2020-12-06;"Košický kraj";121;482;33;515;NA;346464;154;2020-12-06;14582
2020-12-05;"Košický kraj";90;1096;48;1144;NA;346464;138;2020-12-05;14428
2020-12-04;"Košický kraj";224;2680;82;2762;NA;346464;306;2020-12-04;14290
2020-12-03;"Košický kraj";211;7717;173;7890;NA;346464;384;2020-12-03;13984
2020-12-02;"Košický kraj";193;8132;496;8628;NA;346464;689;2020-12-02;13600
2020-12-01;"Košický kraj";178;2237;124;2361;NA;346464;302;2020-12-01;12911
2020-11-30;"Košický kraj";171;3598;59;3657;NA;346464;230;2020-11-30;12609
2020-11-29;"Košický kraj";31;325;17;342;NA;346464;48;2020-11-29;12379
2020-11-28;"Košický kraj";69;721;52;773;NA;346464;121;2020-11-28;12331
2020-11-27;"Košický kraj";149;2921;78;2999;NA;346464;227;2020-11-27;12210
2020-11-26;"Košický kraj";239;1234;60;1294;NA;346464;299;2020-11-26;11983
2020-11-25;"Košický kraj";237;1785;123;1908;NA;346464;360;2020-11-25;11684
2020-11-24;"Košický kraj";196;1976;67;2043;NA;346464;263;2020-11-24;11324
2020-11-23;"Košický kraj";51;4115;63;4178;NA;346464;114;2020-11-23;11061
2020-11-22;"Košický kraj";57;57;5;62;NA;346464;62;2020-11-22;10947
2020-11-21;"Košický kraj";87;858;36;894;NA;346464;123;2020-11-21;10885
2020-11-20;"Košický kraj";176;3084;49;3133;NA;346464;225;2020-11-20;10762
2020-11-19;"Košický kraj";206;1736;48;1784;NA;346464;254;2020-11-19;10537
2020-11-18;"Košický kraj";122;532;17;549;NA;346464;139;2020-11-18;10283
2020-11-17;"Košický kraj";152;82;9;91;NA;346464;161;2020-11-17;10144
2020-11-16;"Košický kraj";114;596;27;623;NA;346464;141;2020-11-16;9983
2020-11-15;"Košický kraj";15;338;7;345;NA;346464;22;2020-11-15;9842
2020-11-14;"Košický kraj";234;520;12;532;NA;346464;246;2020-11-14;9820
2020-11-13;"Košický kraj";207;664;29;693;NA;346464;236;2020-11-13;9574
2020-11-12;"Košický kraj";192;736;13;749;NA;346464;205;2020-11-12;9338
2020-11-11;"Košický kraj";301;593;7;600;NA;346464;308;2020-11-11;9133
2020-11-10;"Košický kraj";190;541;11;552;NA;346464;201;2020-11-10;8825
2020-11-09;"Košický kraj";129;380;17;397;NA;346464;146;2020-11-09;8624
2020-11-08;"Košický kraj";78;1306;8;1314;NA;346464;86;2020-11-08;8478
2020-11-07;"Košický kraj";192;3909;22;3931;NA;346464;214;2020-11-07;8392
2020-11-06;"Košický kraj";195;5310;34;5344;NA;346464;229;2020-11-06;8178
2020-11-05;"Košický kraj";342;330;31;361;NA;346464;373;2020-11-05;7949
2020-11-04;"Košický kraj";101;154;6;160;NA;346464;107;2020-11-04;7576
2020-11-03;"Košický kraj";358;1122;13;1135;NA;346464;371;2020-11-03;7469
2020-11-02;"Košický kraj";111;6125;56;6181;NA;346464;167;2020-11-02;7098
2020-11-01;"Košický kraj";346;6522;34;6556;NA;346464;380;2020-11-01;6931
2020-10-31;"Košický kraj";82;14035;106;14141;NA;346464;188;2020-10-31;6551
2020-10-30;"Košický kraj";379;2835;27;2862;NA;346464;406;2020-10-30;6363
2020-10-29;"Košický kraj";333;983;13;996;NA;346464;346;2020-10-29;5957
2020-10-28;"Košický kraj";224;305;13;318;NA;346464;237;2020-10-28;5611
2020-10-27;"Košický kraj";386;439;21;460;NA;346464;407;2020-10-27;5374
2020-10-26;"Košický kraj";56;212;12;224;NA;346464;68;2020-10-26;4967
2020-10-25;"Košický kraj";154;79;2;81;NA;346464;156;2020-10-25;4899
2020-10-24;"Košický kraj";313;118;16;134;NA;346464;329;2020-10-24;4743
2020-10-23;"Košický kraj";315;331;8;339;NA;346464;323;2020-10-23;4414
2020-10-22;"Košický kraj";349;530;16;546;NA;346464;365;2020-10-22;4091
2020-10-21;"Košický kraj";129;84;2;86;NA;346464;131;2020-10-21;3726
2020-10-20;"Košický kraj";181;14;1;15;NA;346464;182;2020-10-20;3595
2020-10-19;"Košický kraj";64;38;1;39;NA;346464;65;2020-10-19;3413
2020-10-18;"Košický kraj";158;0;0;0;NA;346464;158;2020-10-18;3348
2020-10-17;"Košický kraj";142;0;0;0;NA;346464;142;2020-10-17;3190
2020-10-16;"Košický kraj";206;19;0;19;NA;346464;206;2020-10-16;3048
2020-10-15;"Košický kraj";177;19;5;24;NA;346464;182;2020-10-15;2842
2020-10-14;"Košický kraj";211;8;0;8;NA;346464;211;2020-10-14;2660
2020-10-13;"Košický kraj";179;80;3;83;NA;346464;182;2020-10-13;2449
2020-10-12;"Košický kraj";74;0;0;0;NA;346464;74;2020-10-12;2267
2020-10-11;"Košický kraj";121;0;0;0;NA;346464;121;2020-10-11;2193
2020-10-10;"Košický kraj";70;0;0;0;NA;346464;70;2020-10-10;2072
2020-10-09;"Košický kraj";188;0;0;0;NA;346464;188;2020-10-09;2002
2020-10-08;"Košický kraj";102;0;0;0;NA;346464;102;2020-10-08;1814
2020-10-07;"Košický kraj";158;0;0;0;NA;346464;158;2020-10-07;1712
2020-10-06;"Košický kraj";70;0;0;0;NA;346464;70;2020-10-06;1554
2020-10-05;"Košický kraj";39;0;0;0;NA;346464;39;2020-10-05;1484
2020-10-04;"Košický kraj";45;0;0;0;NA;346464;45;2020-10-04;1445
2020-10-03;"Košický kraj";105;0;0;0;NA;346464;105;2020-10-03;1400
2020-10-02;"Košický kraj";57;0;0;0;NA;346464;57;2020-10-02;1295
2020-10-01;"Košický kraj";69;0;0;0;NA;346464;69;2020-10-01;1238
2020-09-30;"Košický kraj";95;0;0;0;NA;346464;95;2020-09-30;1169
2020-09-29;"Košický kraj";75;0;0;0;NA;346464;75;2020-09-29;1074
2020-09-28;"Košický kraj";19;0;0;0;NA;346464;19;2020-09-28;999
2020-09-27;"Košický kraj";21;0;0;0;NA;346464;21;2020-09-27;980
2020-09-26;"Košický kraj";53;0;0;0;NA;346464;53;2020-09-26;959
2020-09-25;"Košický kraj";72;0;0;0;NA;346464;72;2020-09-25;906
2020-09-24;"Košický kraj";35;0;0;0;NA;346464;35;2020-09-24;834
2020-09-23;"Košický kraj";23;0;0;0;NA;346464;23;2020-09-23;799
2020-09-22;"Košický kraj";39;0;0;0;NA;346464;39;2020-09-22;776
2020-09-21;"Košický kraj";5;0;0;0;NA;346464;5;2020-09-21;737
2020-09-20;"Košický kraj";3;0;0;0;NA;346464;3;2020-09-20;732
2020-09-19;"Košický kraj";13;0;0;0;NA;346464;13;2020-09-19;729
2020-09-18;"Košický kraj";20;0;0;0;NA;346464;20;2020-09-18;716
2020-09-17;"Košický kraj";22;0;0;0;NA;346464;22;2020-09-17;696
2020-09-16;"Košický kraj";12;0;0;0;NA;346464;12;2020-09-16;674
2020-09-15;"Košický kraj";10;0;0;0;NA;346464;10;2020-09-15;662
2020-09-14;"Košický kraj";6;0;0;0;NA;346464;6;2020-09-14;652
2020-09-13;"Košický kraj";3;0;0;0;NA;346464;3;2020-09-13;646
2020-09-12;"Košický kraj";16;0;0;0;NA;346464;16;2020-09-12;643
2020-09-11;"Košický kraj";20;0;0;0;NA;346464;20;2020-09-11;627
2020-09-10;"Košický kraj";11;0;0;0;NA;346464;11;2020-09-10;607
2020-09-09;"Košický kraj";37;0;0;0;NA;346464;37;2020-09-09;596
2020-09-08;"Košický kraj";10;0;0;0;NA;346464;10;2020-09-08;559
2020-09-07;"Košický kraj";4;0;0;0;NA;346464;4;2020-09-07;549
2020-09-06;"Košický kraj";2;0;0;0;NA;346464;2;2020-09-06;545
2020-09-05;"Košický kraj";10;0;0;0;NA;346464;10;2020-09-05;543
2020-09-04;"Košický kraj";14;0;0;0;NA;346464;14;2020-09-04;533
2020-09-03;"Košický kraj";22;0;0;0;NA;346464;22;2020-09-03;519
2020-09-02;"Košický kraj";13;0;0;0;NA;346464;13;2020-09-02;497
2020-09-01;"Košický kraj";21;0;0;0;NA;346464;21;2020-09-01;484
2020-08-31;"Košický kraj";9;0;0;0;NA;346464;9;2020-08-31;463
2020-08-30;"Košický kraj";21;0;0;0;NA;346464;21;2020-08-30;454
2020-08-29;"Košický kraj";1;0;0;0;NA;346464;1;2020-08-29;433
2020-08-28;"Košický kraj";19;0;0;0;NA;346464;19;2020-08-28;432
2020-08-27;"Košický kraj";15;0;0;0;NA;346464;15;2020-08-27;413
2020-08-26;"Košický kraj";8;0;0;0;NA;346464;8;2020-08-26;398
2020-08-25;"Košický kraj";23;0;0;0;NA;346464;23;2020-08-25;390
2020-08-24;"Košický kraj";6;0;0;0;NA;346464;6;2020-08-24;367
2020-08-23;"Košický kraj";8;0;0;0;NA;346464;8;2020-08-23;361
2020-08-22;"Košický kraj";13;0;0;0;NA;346464;13;2020-08-22;353
2020-08-21;"Košický kraj";10;0;0;0;NA;346464;10;2020-08-21;340
2020-08-20;"Košický kraj";10;0;0;0;NA;346464;10;2020-08-20;330
2020-08-19;"Košický kraj";3;0;0;0;NA;346464;3;2020-08-19;320
2020-08-18;"Košický kraj";7;0;0;0;NA;346464;7;2020-08-18;317
2020-08-17;"Košický kraj";2;0;0;0;NA;346464;2;2020-08-17;310
2020-08-16;"Košický kraj";2;0;0;0;NA;346464;2;2020-08-16;308
2020-08-15;"Košický kraj";3;0;0;0;NA;346464;3;2020-08-15;306
2020-08-14;"Košický kraj";1;0;0;0;NA;346464;1;2020-08-14;303
2020-08-13;"Košický kraj";3;0;0;0;NA;346464;3;2020-08-13;302
2020-08-12;"Košický kraj";12;0;0;0;NA;346464;12;2020-08-12;299
2020-08-11;"Košický kraj";5;0;0;0;NA;346464;5;2020-08-11;287
2020-08-10;"Košický kraj";1;0;0;0;NA;346464;1;2020-08-10;282
2020-08-09;"Košický kraj";0;0;0;0;NA;346464;0;2020-08-09;281
2020-08-08;"Košický kraj";5;0;0;0;NA;346464;5;2020-08-08;281
2020-08-07;"Košický kraj";7;0;0;0;NA;346464;7;2020-08-07;276
2020-08-06;"Košický kraj";3;0;0;0;NA;346464;3;2020-08-06;269
2020-08-05;"Košický kraj";4;0;0;0;NA;346464;4;2020-08-05;266
2020-08-04;"Košický kraj";1;0;0;0;NA;346464;1;2020-08-04;262
2020-08-03;"Košický kraj";1;0;0;0;NA;346464;1;2020-08-03;261
2020-08-02;"Košický kraj";0;0;0;0;NA;346464;0;2020-08-02;260
2020-08-01;"Košický kraj";0;0;0;0;NA;346464;0;2020-08-01;260
2020-07-31;"Košický kraj";0;0;0;0;NA;346464;0;2020-07-31;260
2020-07-30;"Košický kraj";2;0;0;0;NA;346464;2;2020-07-30;260
2020-07-29;"Košický kraj";1;0;0;0;NA;346464;1;2020-07-29;258
2020-07-28;"Košický kraj";9;0;0;0;NA;346464;9;2020-07-28;257
2020-07-27;"Košický kraj";4;0;0;0;NA;346464;4;2020-07-27;248
2020-07-26;"Košický kraj";0;0;0;0;NA;346464;0;2020-07-26;244
2020-07-25;"Košický kraj";2;0;0;0;NA;346464;2;2020-07-25;244
2020-07-24;"Košický kraj";2;0;0;0;NA;346464;2;2020-07-24;242
2020-07-23;"Košický kraj";1;0;0;0;NA;346464;1;2020-07-23;240
2020-07-22;"Košický kraj";1;0;0;0;NA;346464;1;2020-07-22;239
2020-07-21;"Košický kraj";0;0;0;0;NA;346464;0;2020-07-21;238
2020-07-20;"Košický kraj";0;0;0;0;NA;346464;0;2020-07-20;238
2020-07-19;"Košický kraj";0;0;0;0;NA;346464;0;2020-07-19;238
2020-07-18;"Košický kraj";1;0;0;0;NA;346464;1;2020-07-18;238
2020-07-17;"Košický kraj";1;0;0;0;NA;346464;1;2020-07-17;237
2020-07-16;"Košický kraj";0;0;0;0;NA;346464;0;2020-07-16;236
2020-07-15;"Košický kraj";2;0;0;0;NA;346464;2;2020-07-15;236
2020-07-14;"Košický kraj";1;0;0;0;NA;346464;1;2020-07-14;234
2020-07-13;"Košický kraj";1;0;0;0;NA;346464;1;2020-07-13;233
2020-07-12;"Košický kraj";0;0;0;0;NA;346464;0;2020-07-12;232
2020-07-11;"Košický kraj";0;0;0;0;NA;346464;0;2020-07-11;232
2020-07-10;"Košický kraj";1;0;0;0;NA;346464;1;2020-07-10;232
2020-07-09;"Košický kraj";1;0;0;0;NA;346464;1;2020-07-09;231
2020-07-08;"Košický kraj";12;0;0;0;NA;346464;12;2020-07-08;230
2020-07-07;"Košický kraj";0;0;0;0;NA;346464;0;2020-07-07;218
2020-07-06;"Košický kraj";0;0;0;0;NA;346464;0;2020-07-06;218
2020-07-05;"Košický kraj";0;0;0;0;NA;346464;0;2020-07-05;218
2020-07-04;"Košický kraj";0;0;0;0;NA;346464;0;2020-07-04;218
2020-07-03;"Košický kraj";1;0;0;0;NA;346464;1;2020-07-03;218
2020-07-02;"Košický kraj";0;0;0;0;NA;346464;0;2020-07-02;217
2020-07-01;"Košický kraj";1;0;0;0;NA;346464;1;2020-07-01;217
2020-06-30;"Košický kraj";0;0;0;0;NA;346464;0;2020-06-30;216
2020-06-29;"Košický kraj";0;0;0;0;NA;346464;0;2020-06-29;216
2020-06-28;"Košický kraj";0;0;0;0;NA;346464;0;2020-06-28;216
2020-06-27;"Košický kraj";0;0;0;0;NA;346464;0;2020-06-27;216
2020-06-26;"Košický kraj";0;0;0;0;NA;346464;0;2020-06-26;216
2020-06-25;"Košický kraj";3;0;0;0;NA;346464;3;2020-06-25;216
2020-06-24;"Košický kraj";3;0;0;0;NA;346464;3;2020-06-24;213
2020-06-23;"Košický kraj";3;0;0;0;NA;346464;3;2020-06-23;210
2020-06-22;"Košický kraj";0;0;0;0;NA;346464;0;2020-06-22;207
2020-06-21;"Košický kraj";0;0;0;0;NA;346464;0;2020-06-21;207
2020-06-20;"Košický kraj";0;0;0;0;NA;346464;0;2020-06-20;207
2020-06-19;"Košický kraj";0;0;0;0;NA;346464;0;2020-06-19;207
2020-06-18;"Košický kraj";1;0;0;0;NA;346464;1;2020-06-18;207
2020-06-17;"Košický kraj";0;0;0;0;NA;346464;0;2020-06-17;206
2020-06-16;"Košický kraj";2;0;0;0;NA;346464;2;2020-06-16;206
2020-06-14;"Košický kraj";0;0;0;0;NA;346464;0;2020-06-14;204
2020-06-13;"Košický kraj";0;0;0;0;NA;346464;0;2020-06-13;204
2020-06-12;"Košický kraj";0;0;0;0;NA;346464;0;2020-06-12;204
2020-06-11;"Košický kraj";0;0;0;0;NA;346464;0;2020-06-11;204
2020-06-10;"Košický kraj";6;0;0;0;NA;346464;6;2020-06-10;204
2020-06-09;"Košický kraj";0;0;0;0;NA;346464;0;2020-06-09;198
2020-06-08;"Košický kraj";0;0;0;0;NA;346464;0;2020-06-08;198
2020-06-07;"Košický kraj";2;0;0;0;NA;346464;2;2020-06-07;198
2020-06-05;"Košický kraj";0;0;0;0;NA;346464;0;2020-06-05;196
2020-06-03;"Košický kraj";0;0;0;0;NA;346464;0;2020-06-03;196
2020-06-02;"Košický kraj";1;0;0;0;NA;346464;1;2020-06-02;196
2020-05-31;"Košický kraj";0;0;0;0;NA;346464;0;2020-05-31;195
2020-05-29;"Košický kraj";1;0;0;0;NA;346464;1;2020-05-29;195
2020-05-27;"Košický kraj";0;0;0;0;NA;346464;0;2020-05-27;194
2020-05-26;"Košický kraj";1;0;0;0;NA;346464;1;2020-05-26;194
2020-05-25;"Košický kraj";1;0;0;0;NA;346464;1;2020-05-25;193
2020-05-24;"Košický kraj";0;0;0;0;NA;346464;0;2020-05-24;192
2020-05-23;"Košický kraj";0;0;0;0;NA;346464;0;2020-05-23;192
2020-05-22;"Košický kraj";0;0;0;0;NA;346464;0;2020-05-22;192
2020-05-21;"Košický kraj";0;0;0;0;NA;346464;0;2020-05-21;192
2020-05-20;"Košický kraj";3;0;0;0;NA;346464;3;2020-05-20;192
2020-05-19;"Košický kraj";0;0;0;0;NA;346464;0;2020-05-19;189
2020-05-17;"Košický kraj";1;0;0;0;NA;346464;1;2020-05-17;189
2020-05-16;"Košický kraj";1;0;0;0;NA;346464;1;2020-05-16;188
2020-05-15;"Košický kraj";10;0;0;0;NA;346464;10;2020-05-15;187
2020-05-14;"Košický kraj";1;0;0;0;NA;346464;1;2020-05-14;177
2020-05-13;"Košický kraj";6;0;0;0;NA;346464;6;2020-05-13;176
2020-05-12;"Košický kraj";0;0;0;0;NA;346464;0;2020-05-12;170
2020-05-11;"Košický kraj";0;0;0;0;NA;346464;0;2020-05-11;170
2020-05-09;"Košický kraj";0;0;0;0;NA;346464;0;2020-05-09;170
2020-05-07;"Košický kraj";0;0;0;0;NA;346464;0;2020-05-07;170
2020-05-06;"Košický kraj";1;0;0;0;NA;346464;1;2020-05-06;170
2020-05-05;"Košický kraj";0;0;0;0;NA;346464;0;2020-05-05;169
2020-05-04;"Košický kraj";0;0;0;0;NA;346464;0;2020-05-04;169
2020-05-03;"Košický kraj";0;0;0;0;NA;346464;0;2020-05-03;169
2020-05-02;"Košický kraj";1;0;0;0;NA;346464;1;2020-05-02;169
2020-05-01;"Košický kraj";0;0;0;0;NA;346464;0;2020-05-01;168
2020-04-30;"Košický kraj";1;0;0;0;NA;346464;1;2020-04-30;168
2020-04-29;"Košický kraj";1;0;0;0;NA;346464;1;2020-04-29;167
2020-04-28;"Košický kraj";1;0;0;0;NA;346464;1;2020-04-28;166
2020-04-27;"Košický kraj";1;0;0;0;NA;346464;1;2020-04-27;165
2020-04-26;"Košický kraj";0;0;0;0;NA;346464;0;2020-04-26;164
2020-04-25;"Košický kraj";0;0;0;0;NA;346464;0;2020-04-25;164
2020-04-24;"Košický kraj";3;0;0;0;NA;346464;3;2020-04-24;164
2020-04-23;"Košický kraj";4;0;0;0;NA;346464;4;2020-04-23;161
2020-04-22;"Košický kraj";21;0;0;0;NA;346464;21;2020-04-22;157
2020-04-21;"Košický kraj";4;0;0;0;NA;346464;4;2020-04-21;136
2020-04-20;"Košický kraj";0;0;0;0;NA;346464;0;2020-04-20;132
2020-04-19;"Košický kraj";1;0;0;0;NA;346464;1;2020-04-19;132
2020-04-18;"Košický kraj";2;0;0;0;NA;346464;2;2020-04-18;131
2020-04-17;"Košický kraj";7;0;0;0;NA;346464;7;2020-04-17;129
2020-04-16;"Košický kraj";29;0;0;0;NA;346464;29;2020-04-16;122
2020-04-15;"Košický kraj";50;0;0;0;NA;346464;50;2020-04-15;93
2020-04-14;"Košický kraj";4;0;0;0;NA;346464;4;2020-04-14;43
2020-04-13;"Košický kraj";5;0;0;0;NA;346464;5;2020-04-13;39
2020-04-12;"Košický kraj";4;0;0;0;NA;346464;4;2020-04-12;34
2020-04-11;"Košický kraj";2;0;0;0;NA;346464;2;2020-04-11;30
2020-04-10;"Košický kraj";1;0;0;0;NA;346464;1;2020-04-10;28
2020-04-09;"Košický kraj";4;0;0;0;NA;346464;4;2020-04-09;27
2020-04-08;"Košický kraj";5;0;0;0;NA;346464;5;2020-04-08;23
2020-04-07;"Košický kraj";34;0;0;0;NA;346464;34;2020-04-07;18
2020-04-06;"Košický kraj";6;0;0;0;NA;346464;6;2020-04-06;-16
2020-04-05;"Košický kraj";4;0;0;0;NA;346464;4;2020-04-05;-22
2020-04-04;"Košický kraj";5;0;0;0;NA;346464;5;2020-04-04;-26
2020-04-03;"Košický kraj";4;0;0;0;NA;346464;4;2020-04-03;-31
2020-04-02;"Košický kraj";3;0;0;0;NA;346464;3;2020-04-02;-35
2020-04-01;"Košický kraj";3;0;0;0;NA;346464;3;2020-04-01;-38
2020-03-31;"Košický kraj";1;0;0;0;NA;346464;1;2020-03-31;-41
2020-03-30;"Košický kraj";5;0;0;0;NA;346464;5;2020-03-30;-42
2020-03-29;"Košický kraj";0;0;0;0;NA;346464;0;2020-03-29;-47
2020-03-28;"Košický kraj";1;0;0;0;NA;346464;1;2020-03-28;-47
2020-03-27;"Košický kraj";1;0;0;0;NA;346464;1;2020-03-27;-48
2020-03-26;"Košický kraj";3;0;0;0;NA;346464;3;2020-03-26;-49
2020-03-25;"Košický kraj";2;0;0;0;NA;346464;2;2020-03-25;-52
2020-03-24;"Košický kraj";0;0;0;0;NA;346464;0;2020-03-24;-54
2020-03-23;"Košický kraj";2;0;0;0;NA;346464;2;2020-03-23;-54
2020-03-22;"Košický kraj";0;0;0;0;NA;346464;0;2020-03-22;-56
2020-03-21;"Košický kraj";3;0;0;0;NA;346464;3;2020-03-21;-56
2020-03-20;"Košický kraj";1;0;0;0;NA;346464;1;2020-03-20;-59
2020-03-19;"Košický kraj";0;0;0;0;NA;346464;0;2020-03-19;-60
2020-03-18;"Košický kraj";0;0;0;0;NA;346464;0;2020-03-18;-60
2020-03-17;"Košický kraj";0;0;0;0;NA;346464;0;2020-03-17;-60
2020-03-16;"Košický kraj";3;0;0;0;NA;346464;3;2020-03-16;-60
2020-03-15;"Košický kraj";1;0;0;0;NA;346464;1;2020-03-15;-63
2020-03-14;"Košický kraj";0;0;0;0;NA;346464;0;2020-03-14;-64
2020-03-13;"Košický kraj";2;0;0;0;NA;346464;2;2020-03-13;-64
2020-03-12;"Košický kraj";0;0;0;0;NA;346464;0;2020-03-12;-66
2020-03-11;"Košický kraj";0;0;0;0;NA;346464;0;2020-03-11;-66
2020-03-09;"Košický kraj";1;0;0;0;NA;346464;1;2020-03-09;-66
2020-03-08;"Košický kraj";0;0;0;0;NA;346464;0;2020-03-08;-67
2020-03-07;"Košický kraj";0;0;0;0;NA;346464;0;2020-03-07;-67
2020-03-06;"Košický kraj";0;0;0;0;NA;346464;0;2020-03-06;-67
2022-05-26;"Nitriansky kraj";17;12;2;14;185724;284407;19;2022-05-26;284407
2022-05-25;"Nitriansky kraj";14;66;4;70;NA;284407;18;2022-05-25;284388
2022-05-24;"Nitriansky kraj";14;119;1;120;NA;284407;15;2022-05-24;284370
2022-05-23;"Nitriansky kraj";10;220;5;225;NA;284407;15;2022-05-23;284355
2022-05-22;"Nitriansky kraj";1;72;0;72;NA;284407;1;2022-05-22;284340
2022-05-21;"Nitriansky kraj";9;93;6;99;NA;284407;15;2022-05-21;284339
2022-05-20;"Nitriansky kraj";19;65;1;66;NA;284407;20;2022-05-20;284324
2022-05-19;"Nitriansky kraj";16;128;1;129;NA;284407;17;2022-05-19;284304
2022-05-18;"Nitriansky kraj";18;245;5;250;NA;284407;23;2022-05-18;284287
2022-05-17;"Nitriansky kraj";25;173;3;176;NA;284407;28;2022-05-17;284264
2022-05-16;"Nitriansky kraj";39;242;7;249;NA;284407;46;2022-05-16;284236
2022-05-15;"Nitriansky kraj";8;62;3;65;NA;284407;11;2022-05-15;284190
2022-05-14;"Nitriansky kraj";12;26;1;27;NA;284407;13;2022-05-14;284179
2022-05-13;"Nitriansky kraj";39;142;10;152;NA;284407;49;2022-05-13;284166
2022-05-12;"Nitriansky kraj";18;150;10;160;NA;284407;28;2022-05-12;284117
2022-05-11;"Nitriansky kraj";35;199;9;208;NA;284407;44;2022-05-11;284089
2022-05-10;"Nitriansky kraj";26;201;5;206;NA;284407;31;2022-05-10;284045
2022-05-09;"Nitriansky kraj";38;279;11;290;NA;284407;49;2022-05-09;284014
2022-05-08;"Nitriansky kraj";0;95;8;103;NA;284407;8;2022-05-08;283965
2022-05-07;"Nitriansky kraj";11;27;1;28;NA;284407;12;2022-05-07;283957
2022-05-06;"Nitriansky kraj";47;182;8;190;NA;284407;55;2022-05-06;283945
2022-05-05;"Nitriansky kraj";45;261;8;269;NA;284407;53;2022-05-05;283890
2022-05-04;"Nitriansky kraj";59;295;18;313;NA;284407;77;2022-05-04;283837
2022-05-03;"Nitriansky kraj";65;319;9;328;NA;284407;74;2022-05-03;283760
2022-05-02;"Nitriansky kraj";69;644;30;674;NA;284407;99;2022-05-02;283686
2022-05-01;"Nitriansky kraj";12;194;8;202;NA;284407;20;2022-05-01;283587
2022-04-30;"Nitriansky kraj";64;206;10;216;NA;284407;74;2022-04-30;283567
2022-04-29;"Nitriansky kraj";93;578;14;592;NA;284407;107;2022-04-29;283493
2022-04-28;"Nitriansky kraj";93;835;19;854;NA;284407;112;2022-04-28;283386
2022-04-27;"Nitriansky kraj";126;727;24;751;NA;284407;150;2022-04-27;283274
2022-04-26;"Nitriansky kraj";156;881;29;910;NA;284407;185;2022-04-26;283124
2022-04-25;"Nitriansky kraj";136;1115;52;1167;NA;284407;188;2022-04-25;282939
2022-04-24;"Nitriansky kraj";48;296;12;308;NA;284407;60;2022-04-24;282751
2022-04-23;"Nitriansky kraj";79;250;5;255;NA;284407;84;2022-04-23;282691
2022-04-22;"Nitriansky kraj";101;744;26;770;NA;284407;127;2022-04-22;282607
2022-04-21;"Nitriansky kraj";219;803;15;818;NA;284407;234;2022-04-21;282480
2022-04-20;"Nitriansky kraj";194;1007;33;1040;NA;284407;227;2022-04-20;282246
2022-04-19;"Nitriansky kraj";234;2106;83;2189;NA;284407;317;2022-04-19;282019
2022-04-18;"Nitriansky kraj";111;516;14;530;NA;284407;125;2022-04-18;281702
2022-04-17;"Nitriansky kraj";136;258;8;266;NA;284407;144;2022-04-17;281577
2022-04-16;"Nitriansky kraj";87;362;24;386;NA;284407;111;2022-04-16;281433
2022-04-15;"Nitriansky kraj";105;395;10;405;NA;284407;115;2022-04-15;281322
2022-04-14;"Nitriansky kraj";255;721;32;753;NA;284407;287;2022-04-14;281207
2022-04-13;"Nitriansky kraj";223;906;60;966;NA;284407;283;2022-04-13;280920
2022-04-12;"Nitriansky kraj";291;1043;60;1103;NA;284407;351;2022-04-12;280637
2022-04-11;"Nitriansky kraj";278;1668;101;1769;NA;284407;379;2022-04-11;280286
2022-04-10;"Nitriansky kraj";154;512;43;555;NA;284407;197;2022-04-10;279907
2022-04-09;"Nitriansky kraj";176;391;29;420;NA;284407;205;2022-04-09;279710
2022-04-08;"Nitriansky kraj";363;1066;76;1142;NA;284407;439;2022-04-08;279505
2022-04-07;"Nitriansky kraj";427;1293;115;1408;NA;284407;542;2022-04-07;279066
2022-04-06;"Nitriansky kraj";406;1191;98;1289;NA;284407;504;2022-04-06;278524
2022-04-05;"Nitriansky kraj";783;1195;110;1305;NA;284407;893;2022-04-05;278020
2022-04-04;"Nitriansky kraj";572;1570;152;1722;NA;284407;724;2022-04-04;277127
2022-04-03;"Nitriansky kraj";199;918;98;1016;NA;284407;297;2022-04-03;276403
2022-04-02;"Nitriansky kraj";362;450;45;495;NA;284407;407;2022-04-02;276106
2022-04-01;"Nitriansky kraj";614;1283;129;1412;NA;284407;743;2022-04-01;275699
2022-03-31;"Nitriansky kraj";685;1558;159;1717;NA;284407;844;2022-03-31;274956
2022-03-30;"Nitriansky kraj";751;1233;132;1365;NA;284407;883;2022-03-30;274112
2022-03-29;"Nitriansky kraj";1187;1523;175;1698;NA;284407;1362;2022-03-29;273229
2022-03-28;"Nitriansky kraj";711;1954;288;2242;NA;284407;999;2022-03-28;271867
2022-03-27;"Nitriansky kraj";463;790;148;938;NA;284407;611;2022-03-27;270868
2022-03-26;"Nitriansky kraj";653;408;83;491;NA;284407;736;2022-03-26;270257
2022-03-25;"Nitriansky kraj";918;1128;220;1348;NA;284407;1138;2022-03-25;269521
2022-03-24;"Nitriansky kraj";1391;1262;194;1456;NA;284407;1585;2022-03-24;268383
2022-03-23;"Nitriansky kraj";1401;1456;232;1688;NA;284407;1633;2022-03-23;266798
2022-03-22;"Nitriansky kraj";1360;1553;199;1752;NA;284407;1559;2022-03-22;265165
2022-03-21;"Nitriansky kraj";1304;2135;351;2486;NA;284407;1655;2022-03-21;263606
2022-03-20;"Nitriansky kraj";552;933;226;1159;NA;284407;778;2022-03-20;261951
2022-03-19;"Nitriansky kraj";839;424;146;570;NA;284407;985;2022-03-19;261173
2022-03-18;"Nitriansky kraj";1205;1201;271;1472;NA;284407;1476;2022-03-18;260188
2022-03-17;"Nitriansky kraj";1734;1473;236;1709;NA;284407;1970;2022-03-17;258712
2022-03-16;"Nitriansky kraj";1214;1472;232;1704;NA;284407;1446;2022-03-16;256742
2022-03-15;"Nitriansky kraj";1590;1566;256;1822;NA;284407;1846;2022-03-15;255296
2022-03-14;"Nitriansky kraj";1325;2630;384;3014;NA;284407;1709;2022-03-14;253450
2022-03-13;"Nitriansky kraj";527;992;202;1194;NA;284407;729;2022-03-13;251741
2022-03-12;"Nitriansky kraj";711;739;169;908;NA;284407;880;2022-03-12;251012
2022-03-11;"Nitriansky kraj";1085;1890;365;2255;NA;284407;1450;2022-03-11;250132
2022-03-10;"Nitriansky kraj";1403;2015;313;2328;NA;284407;1716;2022-03-10;248682
2022-03-09;"Nitriansky kraj";1452;2118;323;2441;NA;284407;1775;2022-03-09;246966
2022-03-08;"Nitriansky kraj";1695;2542;350;2892;NA;284407;2045;2022-03-08;245191
2022-03-07;"Nitriansky kraj";1115;3386;521;3907;NA;284407;1636;2022-03-07;243146
2022-03-06;"Nitriansky kraj";566;1509;350;1859;NA;284407;916;2022-03-06;241510
2022-03-05;"Nitriansky kraj";614;1239;214;1453;NA;284407;828;2022-03-05;240594
2022-03-04;"Nitriansky kraj";1315;1597;323;1920;NA;284407;1638;2022-03-04;239766
2022-03-03;"Nitriansky kraj";1405;2944;379;3323;NA;284407;1784;2022-03-03;238128
2022-03-02;"Nitriansky kraj";1417;2717;422;3139;NA;284407;1839;2022-03-02;236344
2022-03-01;"Nitriansky kraj";1380;2422;412;2834;NA;284407;1792;2022-03-01;234505
2022-02-28;"Nitriansky kraj";1577;4819;599;5418;NA;284407;2176;2022-02-28;232713
2022-02-27;"Nitriansky kraj";797;1271;294;1565;NA;284407;1091;2022-02-27;230537
2022-02-26;"Nitriansky kraj";895;799;217;1016;NA;284407;1112;2022-02-26;229446
2022-02-25;"Nitriansky kraj";1400;2314;339;2653;NA;284407;1739;2022-02-25;228334
2022-02-24;"Nitriansky kraj";1592;3586;389;3975;NA;284407;1981;2022-02-24;226595
2022-02-23;"Nitriansky kraj";1885;3930;476;4406;NA;284407;2361;2022-02-23;224614
2022-02-22;"Nitriansky kraj";2323;3849;502;4351;NA;284407;2825;2022-02-22;222253
2022-02-21;"Nitriansky kraj";1593;6250;816;7066;NA;284407;2409;2022-02-21;219428
2022-02-20;"Nitriansky kraj";1049;1987;439;2426;NA;284407;1488;2022-02-20;217019
2022-02-19;"Nitriansky kraj";1084;1341;336;1677;NA;284407;1420;2022-02-19;215531
2022-02-18;"Nitriansky kraj";2021;3277;583;3860;NA;284407;2604;2022-02-18;214111
2022-02-17;"Nitriansky kraj";2134;3890;480;4370;NA;284407;2614;2022-02-17;211507
2022-02-16;"Nitriansky kraj";2152;3945;532;4477;NA;284407;2684;2022-02-16;208893
2022-02-15;"Nitriansky kraj";2093;4069;780;4849;NA;284407;2873;2022-02-15;206209
2022-02-14;"Nitriansky kraj";2094;6253;921;7174;NA;284407;3015;2022-02-14;203336
2022-02-13;"Nitriansky kraj";1146;2832;547;3379;NA;284407;1693;2022-02-13;200321
2022-02-12;"Nitriansky kraj";1301;1171;343;1514;NA;284407;1644;2022-02-12;198628
2022-02-11;"Nitriansky kraj";2042;2942;561;3503;NA;284407;2603;2022-02-11;196984
2022-02-10;"Nitriansky kraj";2374;3366;537;3903;NA;284407;2911;2022-02-10;194381
2022-02-09;"Nitriansky kraj";2133;4802;653;5455;NA;284407;2786;2022-02-09;191470
2022-02-08;"Nitriansky kraj";1801;4935;736;5671;NA;284407;2537;2022-02-08;188684
2022-02-07;"Nitriansky kraj";2240;6803;762;7565;NA;284407;3002;2022-02-07;186147
2022-02-06;"Nitriansky kraj";1309;2690;494;3184;NA;284407;1803;2022-02-06;183145
2022-02-05;"Nitriansky kraj";1609;1504;358;1862;NA;284407;1967;2022-02-05;181342
2022-02-04;"Nitriansky kraj";1848;4185;510;4695;NA;284407;2358;2022-02-04;179375
2022-02-03;"Nitriansky kraj";2425;4186;491;4677;NA;284407;2916;2022-02-03;177017
2022-02-02;"Nitriansky kraj";1903;5318;766;6084;NA;284407;2669;2022-02-02;174101
2022-02-01;"Nitriansky kraj";2288;4717;597;5314;NA;284407;2885;2022-02-01;171432
2022-01-31;"Nitriansky kraj";1329;8991;746;9737;NA;284407;2075;2022-01-31;168547
2022-01-30;"Nitriansky kraj";777;3498;471;3969;NA;284407;1248;2022-01-30;166472
2022-01-29;"Nitriansky kraj";1099;1670;298;1968;NA;284407;1397;2022-01-29;165224
2022-01-28;"Nitriansky kraj";1610;4217;374;4591;NA;284407;1984;2022-01-28;163827
2022-01-27;"Nitriansky kraj";1429;3796;289;4085;NA;284407;1718;2022-01-27;161843
2022-01-26;"Nitriansky kraj";1392;4444;306;4750;NA;284407;1698;2022-01-26;160125
2022-01-25;"Nitriansky kraj";1591;4624;426;5050;NA;284407;2017;2022-01-25;158427
2022-01-24;"Nitriansky kraj";770;7459;359;7818;NA;284407;1129;2022-01-24;156410
2022-01-23;"Nitriansky kraj";327;3109;205;3314;NA;284407;532;2022-01-23;155281
2022-01-22;"Nitriansky kraj";596;1974;153;2127;NA;284407;749;2022-01-22;154749
2022-01-21;"Nitriansky kraj";532;3472;141;3613;NA;284407;673;2022-01-21;154000
2022-01-20;"Nitriansky kraj";737;3537;129;3666;NA;284407;866;2022-01-20;153327
2022-01-19;"Nitriansky kraj";614;4581;121;4702;NA;284407;735;2022-01-19;152461
2022-01-18;"Nitriansky kraj";650;3329;125;3454;NA;284407;775;2022-01-18;151726
2022-01-17;"Nitriansky kraj";439;7781;152;7933;NA;284407;591;2022-01-17;150951
2022-01-16;"Nitriansky kraj";140;3191;71;3262;NA;284407;211;2022-01-16;150360
2022-01-15;"Nitriansky kraj";268;1651;50;1701;NA;284407;318;2022-01-15;150149
2022-01-14;"Nitriansky kraj";167;2900;68;2968;NA;284407;235;2022-01-14;149831
2022-01-13;"Nitriansky kraj";244;3297;53;3350;NA;284407;297;2022-01-13;149596
2022-01-12;"Nitriansky kraj";298;4325;66;4391;NA;284407;364;2022-01-12;149299
2022-01-11;"Nitriansky kraj";424;3990;50;4040;NA;284407;474;2022-01-11;148935
2022-01-10;"Nitriansky kraj";292;7648;71;7719;NA;284407;363;2022-01-10;148461
2022-01-09;"Nitriansky kraj";100;3419;48;3467;NA;284407;148;2022-01-09;148098
2022-01-08;"Nitriansky kraj";206;1352;47;1399;NA;284407;253;2022-01-08;147950
2022-01-07;"Nitriansky kraj";326;2970;74;3044;NA;284407;400;2022-01-07;147697
2022-01-06;"Nitriansky kraj";125;910;33;943;NA;284407;158;2022-01-06;147297
2022-01-05;"Nitriansky kraj";357;4227;66;4293;NA;284407;423;2022-01-05;147139
2022-01-04;"Nitriansky kraj";453;3697;85;3782;NA;284407;538;2022-01-04;146716
2022-01-03;"Nitriansky kraj";353;7361;117;7478;NA;284407;470;2022-01-03;146178
2022-01-02;"Nitriansky kraj";25;3035;95;3130;NA;284407;120;2022-01-02;145708
2022-01-01;"Nitriansky kraj";71;177;9;186;NA;284407;80;2022-01-01;145588
2021-12-31;"Nitriansky kraj";382;1506;69;1575;NA;284407;451;2021-12-31;145508
2021-12-30;"Nitriansky kraj";325;3330;89;3419;NA;284407;414;2021-12-30;145057
2021-12-29;"Nitriansky kraj";347;2371;61;2432;NA;284407;408;2021-12-29;144643
2021-12-28;"Nitriansky kraj";628;2501;88;2589;NA;284407;716;2021-12-28;144235
2021-12-27;"Nitriansky kraj";402;4253;169;4422;NA;284407;571;2021-12-27;143519
2021-12-26;"Nitriansky kraj";84;1039;53;1092;NA;284407;137;2021-12-26;142948
2021-12-25;"Nitriansky kraj";22;499;31;530;NA;284407;53;2021-12-25;142811
2021-12-24;"Nitriansky kraj";175;448;26;474;NA;284407;201;2021-12-24;142758
2021-12-23;"Nitriansky kraj";472;3420;110;3530;NA;284407;582;2021-12-23;142557
2021-12-22;"Nitriansky kraj";398;3517;95;3612;NA;284407;493;2021-12-22;141975
2021-12-21;"Nitriansky kraj";735;2913;93;3006;NA;284407;828;2021-12-21;141482
2021-12-20;"Nitriansky kraj";407;6754;169;6923;NA;284407;576;2021-12-20;140654
2021-12-19;"Nitriansky kraj";198;3587;98;3685;NA;284407;296;2021-12-19;140078
2021-12-18;"Nitriansky kraj";361;1456;96;1552;NA;284407;457;2021-12-18;139782
2021-12-17;"Nitriansky kraj";409;4934;153;5087;NA;284407;562;2021-12-17;139325
2021-12-16;"Nitriansky kraj";429;4230;144;4374;NA;284407;573;2021-12-16;138763
2021-12-15;"Nitriansky kraj";639;5682;143;5825;NA;284407;782;2021-12-15;138190
2021-12-14;"Nitriansky kraj";907;4720;200;4920;NA;284407;1107;2021-12-14;137408
2021-12-13;"Nitriansky kraj";524;7388;291;7679;NA;284407;815;2021-12-13;136301
2021-12-12;"Nitriansky kraj";289;3893;174;4067;NA;284407;463;2021-12-12;135486
2021-12-11;"Nitriansky kraj";458;1754;121;1875;NA;284407;579;2021-12-11;135023
2021-12-10;"Nitriansky kraj";591;4868;177;5045;NA;284407;768;2021-12-10;134444
2021-12-09;"Nitriansky kraj";741;3428;202;3630;NA;284407;943;2021-12-09;133676
2021-12-08;"Nitriansky kraj";954;5136;200;5336;NA;284407;1154;2021-12-08;132733
2021-12-07;"Nitriansky kraj";900;4045;197;4242;NA;284407;1097;2021-12-07;131579
2021-12-06;"Nitriansky kraj";699;8196;339;8535;NA;284407;1038;2021-12-06;130482
2021-12-05;"Nitriansky kraj";337;4314;192;4506;NA;284407;529;2021-12-05;129444
2021-12-04;"Nitriansky kraj";758;2045;180;2225;NA;284407;938;2021-12-04;128915
2021-12-03;"Nitriansky kraj";920;5783;237;6020;NA;284407;1157;2021-12-03;127977
2021-12-02;"Nitriansky kraj";1388;3898;267;4165;NA;284407;1655;2021-12-02;126820
2021-12-01;"Nitriansky kraj";982;4107;261;4368;NA;284407;1243;2021-12-01;125165
2021-11-30;"Nitriansky kraj";751;5575;241;5816;NA;284407;992;2021-11-30;123922
2021-11-29;"Nitriansky kraj";665;10167;500;10667;NA;284407;1165;2021-11-29;122930
2021-11-28;"Nitriansky kraj";357;6214;300;6514;NA;284407;657;2021-11-28;121765
2021-11-27;"Nitriansky kraj";560;2879;281;3160;NA;284407;841;2021-11-27;121108
2021-11-26;"Nitriansky kraj";824;5529;290;5819;NA;284407;1114;2021-11-26;120267
2021-11-25;"Nitriansky kraj";847;4154;342;4496;NA;284407;1189;2021-11-25;119153
2021-11-24;"Nitriansky kraj";875;4422;325;4747;NA;284407;1200;2021-11-24;117964
2021-11-23;"Nitriansky kraj";1103;5148;353;5501;NA;284407;1456;2021-11-23;116764
2021-11-22;"Nitriansky kraj";545;7126;465;7591;NA;284407;1010;2021-11-22;115308
2021-11-21;"Nitriansky kraj";345;3410;314;3724;NA;284407;659;2021-11-21;114298
2021-11-20;"Nitriansky kraj";579;1865;252;2117;NA;284407;831;2021-11-20;113639
2021-11-19;"Nitriansky kraj";571;4256;349;4605;NA;284407;920;2021-11-19;112808
2021-11-18;"Nitriansky kraj";677;4883;420;5303;NA;284407;1097;2021-11-18;111888
2021-11-17;"Nitriansky kraj";479;1622;207;1829;NA;284407;686;2021-11-17;110791
2021-11-16;"Nitriansky kraj";668;3882;266;4148;NA;284407;934;2021-11-16;110105
2021-11-15;"Nitriansky kraj";556;6033;440;6473;NA;284407;996;2021-11-15;109171
2021-11-14;"Nitriansky kraj";229;2796;259;3055;NA;284407;488;2021-11-14;108175
2021-11-13;"Nitriansky kraj";387;1473;201;1674;NA;284407;588;2021-11-13;107687
2021-11-12;"Nitriansky kraj";552;3096;270;3366;NA;284407;822;2021-11-12;107099
2021-11-11;"Nitriansky kraj";539;3545;238;3783;NA;284407;777;2021-11-11;106277
2021-11-10;"Nitriansky kraj";411;3494;234;3728;NA;284407;645;2021-11-10;105500
2021-11-09;"Nitriansky kraj";413;3313;210;3523;NA;284407;623;2021-11-09;104855
2021-11-08;"Nitriansky kraj";464;4936;331;5267;NA;284407;795;2021-11-08;104232
2021-11-07;"Nitriansky kraj";209;2074;161;2235;NA;284407;370;2021-11-07;103437
2021-11-06;"Nitriansky kraj";236;1407;114;1521;NA;284407;350;2021-11-06;103067
2021-11-05;"Nitriansky kraj";407;2583;185;2768;NA;284407;592;2021-11-05;102717
2021-11-04;"Nitriansky kraj";437;3083;168;3251;NA;284407;605;2021-11-04;102125
2021-11-03;"Nitriansky kraj";525;2891;157;3048;NA;284407;682;2021-11-03;101520
2021-11-02;"Nitriansky kraj";320;4279;239;4518;NA;284407;559;2021-11-02;100838
2021-11-01;"Nitriansky kraj";136;712;61;773;NA;284407;197;2021-11-01;100279
2021-10-31;"Nitriansky kraj";109;1234;114;1348;NA;284407;223;2021-10-31;100082
2021-10-30;"Nitriansky kraj";202;1218;82;1300;NA;284407;284;2021-10-30;99859
2021-10-29;"Nitriansky kraj";347;2481;120;2601;NA;284407;467;2021-10-29;99575
2021-10-28;"Nitriansky kraj";281;2603;95;2698;NA;284407;376;2021-10-28;99108
2021-10-27;"Nitriansky kraj";340;2923;112;3035;NA;284407;452;2021-10-27;98732
2021-10-26;"Nitriansky kraj";297;2926;117;3043;NA;284407;414;2021-10-26;98280
2021-10-25;"Nitriansky kraj";171;3599;124;3723;NA;284407;295;2021-10-25;97866
2021-10-24;"Nitriansky kraj";58;1914;74;1988;NA;284407;132;2021-10-24;97571
2021-10-23;"Nitriansky kraj";173;1815;77;1892;NA;284407;250;2021-10-23;97439
2021-10-22;"Nitriansky kraj";202;2216;68;2284;NA;284407;270;2021-10-22;97189
2021-10-21;"Nitriansky kraj";214;2793;65;2858;NA;284407;279;2021-10-21;96919
2021-10-20;"Nitriansky kraj";218;2328;74;2402;NA;284407;292;2021-10-20;96640
2021-10-19;"Nitriansky kraj";250;2929;65;2994;NA;284407;315;2021-10-19;96348
2021-10-18;"Nitriansky kraj";81;3259;90;3349;NA;284407;171;2021-10-18;96033
2021-10-17;"Nitriansky kraj";36;3010;92;3102;NA;284407;128;2021-10-17;95862
2021-10-16;"Nitriansky kraj";37;1477;38;1515;NA;284407;75;2021-10-16;95734
2021-10-15;"Nitriansky kraj";145;2653;34;2687;NA;284407;179;2021-10-15;95659
2021-10-14;"Nitriansky kraj";95;2389;30;2419;NA;284407;125;2021-10-14;95480
2021-10-13;"Nitriansky kraj";91;2248;36;2284;NA;284407;127;2021-10-13;95355
2021-10-12;"Nitriansky kraj";119;2905;34;2939;NA;284407;153;2021-10-12;95228
2021-10-11;"Nitriansky kraj";91;2703;42;2745;NA;284407;133;2021-10-11;95075
2021-10-10;"Nitriansky kraj";33;1527;22;1549;NA;284407;55;2021-10-10;94942
2021-10-09;"Nitriansky kraj";17;1395;17;1412;NA;284407;34;2021-10-09;94887
2021-10-08;"Nitriansky kraj";61;3004;37;3041;NA;284407;98;2021-10-08;94853
2021-10-07;"Nitriansky kraj";59;2829;30;2859;NA;284407;89;2021-10-07;94755
2021-10-06;"Nitriansky kraj";66;2657;28;2685;NA;284407;94;2021-10-06;94666
2021-10-05;"Nitriansky kraj";97;2536;32;2568;NA;284407;129;2021-10-05;94572
2021-10-04;"Nitriansky kraj";56;3263;49;3312;NA;284407;105;2021-10-04;94443
2021-10-03;"Nitriansky kraj";10;1591;24;1615;NA;284407;34;2021-10-03;94338
2021-10-02;"Nitriansky kraj";46;1567;20;1587;NA;284407;66;2021-10-02;94304
2021-10-01;"Nitriansky kraj";26;2860;34;2894;NA;284407;60;2021-10-01;94238
2021-09-30;"Nitriansky kraj";66;2468;15;2483;NA;284407;81;2021-09-30;94178
2021-09-29;"Nitriansky kraj";92;2266;16;2282;NA;284407;108;2021-09-29;94097
2021-09-28;"Nitriansky kraj";86;2893;27;2920;NA;284407;113;2021-09-28;93989
2021-09-27;"Nitriansky kraj";50;3633;41;3674;NA;284407;91;2021-09-27;93876
2021-09-26;"Nitriansky kraj";12;1635;20;1655;NA;284407;32;2021-09-26;93785
2021-09-25;"Nitriansky kraj";43;1456;20;1476;NA;284407;63;2021-09-25;93753
2021-09-24;"Nitriansky kraj";35;2783;15;2798;NA;284407;50;2021-09-24;93690
2021-09-23;"Nitriansky kraj";69;2503;20;2523;NA;284407;89;2021-09-23;93640
2021-09-22;"Nitriansky kraj";68;2380;17;2397;NA;284407;85;2021-09-22;93551
2021-09-21;"Nitriansky kraj";70;2684;30;2714;NA;284407;100;2021-09-21;93466
2021-09-20;"Nitriansky kraj";41;2497;21;2518;NA;284407;62;2021-09-20;93366
2021-09-19;"Nitriansky kraj";16;1553;20;1573;NA;284407;36;2021-09-19;93304
2021-09-18;"Nitriansky kraj";42;1421;19;1440;NA;284407;61;2021-09-18;93268
2021-09-17;"Nitriansky kraj";54;2757;30;2787;NA;284407;84;2021-09-17;93207
2021-09-16;"Nitriansky kraj";55;2499;44;2543;NA;284407;99;2021-09-16;93123
2021-09-15;"Nitriansky kraj";34;538;12;550;NA;284407;46;2021-09-15;93024
2021-09-14;"Nitriansky kraj";52;1821;20;1841;NA;284407;72;2021-09-14;92978
2021-09-13;"Nitriansky kraj";27;2373;27;2400;NA;284407;54;2021-09-13;92906
2021-09-12;"Nitriansky kraj";4;1182;17;1199;NA;284407;21;2021-09-12;92852
2021-09-11;"Nitriansky kraj";36;1181;8;1189;NA;284407;44;2021-09-11;92831
2021-09-10;"Nitriansky kraj";25;2133;12;2145;NA;284407;37;2021-09-10;92787
2021-09-09;"Nitriansky kraj";15;1611;20;1631;NA;284407;35;2021-09-09;92750
2021-09-08;"Nitriansky kraj";30;1463;22;1485;NA;284407;52;2021-09-08;92715
2021-09-07;"Nitriansky kraj";35;1460;9;1469;NA;284407;44;2021-09-07;92663
2021-09-06;"Nitriansky kraj";19;1668;27;1695;NA;284407;46;2021-09-06;92619
2021-09-05;"Nitriansky kraj";10;1007;8;1015;NA;284407;18;2021-09-05;92573
2021-09-04;"Nitriansky kraj";18;1119;10;1129;NA;284407;28;2021-09-04;92555
2021-09-03;"Nitriansky kraj";20;1743;17;1760;NA;284407;37;2021-09-03;92527
2021-09-02;"Nitriansky kraj";16;1389;14;1403;NA;284407;30;2021-09-02;92490
2021-09-01;"Nitriansky kraj";9;337;2;339;NA;284407;11;2021-09-01;92460
2021-08-31;"Nitriansky kraj";10;1360;6;1366;NA;284407;16;2021-08-31;92449
2021-08-30;"Nitriansky kraj";8;1381;10;1391;NA;284407;18;2021-08-30;92433
2021-08-29;"Nitriansky kraj";2;450;1;451;NA;284407;3;2021-08-29;92415
2021-08-28;"Nitriansky kraj";5;1071;3;1074;NA;284407;8;2021-08-28;92412
2021-08-27;"Nitriansky kraj";7;1804;4;1808;NA;284407;11;2021-08-27;92404
2021-08-26;"Nitriansky kraj";2;1255;6;1261;NA;284407;8;2021-08-26;92393
2021-08-25;"Nitriansky kraj";15;1087;3;1090;NA;284407;18;2021-08-25;92385
2021-08-24;"Nitriansky kraj";6;990;2;992;NA;284407;8;2021-08-24;92367
2021-08-23;"Nitriansky kraj";13;1271;4;1275;NA;284407;17;2021-08-23;92359
2021-08-22;"Nitriansky kraj";0;1167;3;1170;NA;284407;3;2021-08-22;92342
2021-08-21;"Nitriansky kraj";1;853;2;855;NA;284407;3;2021-08-21;92339
2021-08-20;"Nitriansky kraj";8;1580;5;1585;NA;284407;13;2021-08-20;92336
2021-08-19;"Nitriansky kraj";11;1167;4;1171;NA;284407;15;2021-08-19;92323
2021-08-18;"Nitriansky kraj";8;1180;7;1187;NA;284407;15;2021-08-18;92308
2021-08-17;"Nitriansky kraj";4;1035;3;1038;NA;284407;7;2021-08-17;92293
2021-08-16;"Nitriansky kraj";7;1129;4;1133;NA;284407;11;2021-08-16;92286
2021-08-15;"Nitriansky kraj";2;662;1;663;NA;284407;3;2021-08-15;92275
2021-08-14;"Nitriansky kraj";1;878;5;883;NA;284407;6;2021-08-14;92272
2021-08-13;"Nitriansky kraj";0;957;1;958;NA;284407;1;2021-08-13;92266
2021-08-12;"Nitriansky kraj";5;765;0;765;NA;284407;5;2021-08-12;92265
2021-08-11;"Nitriansky kraj";3;527;1;528;NA;284407;4;2021-08-11;92260
2021-08-10;"Nitriansky kraj";3;570;1;571;NA;284407;4;2021-08-10;92256
2021-08-09;"Nitriansky kraj";3;992;1;993;NA;284407;4;2021-08-09;92252
2021-08-08;"Nitriansky kraj";0;668;1;669;NA;284407;1;2021-08-08;92248
2021-08-07;"Nitriansky kraj";0;557;1;558;NA;284407;1;2021-08-07;92247
2021-08-06;"Nitriansky kraj";5;799;0;799;NA;284407;5;2021-08-06;92246
2021-08-05;"Nitriansky kraj";6;612;0;612;NA;284407;6;2021-08-05;92241
2021-08-04;"Nitriansky kraj";1;497;2;499;NA;284407;3;2021-08-04;92235
2021-08-03;"Nitriansky kraj";5;1455;0;1455;NA;284407;5;2021-08-03;92232
2021-08-02;"Nitriansky kraj";1;683;4;687;NA;284407;5;2021-08-02;92227
2021-08-01;"Nitriansky kraj";1;606;0;606;NA;284407;1;2021-08-01;92222
2021-07-31;"Nitriansky kraj";1;514;1;515;NA;284407;2;2021-07-31;92221
2021-07-30;"Nitriansky kraj";2;827;0;827;NA;284407;2;2021-07-30;92219
2021-07-29;"Nitriansky kraj";3;720;2;722;NA;284407;5;2021-07-29;92217
2021-07-28;"Nitriansky kraj";4;598;0;598;NA;284407;4;2021-07-28;92212
2021-07-27;"Nitriansky kraj";12;602;1;603;NA;284407;13;2021-07-27;92208
2021-07-26;"Nitriansky kraj";7;970;1;971;NA;284407;8;2021-07-26;92195
2021-07-25;"Nitriansky kraj";1;654;1;655;NA;284407;2;2021-07-25;92187
2021-07-24;"Nitriansky kraj";0;620;0;620;NA;284407;0;2021-07-24;92185
2021-07-23;"Nitriansky kraj";3;851;1;852;NA;284407;4;2021-07-23;92185
2021-07-22;"Nitriansky kraj";5;689;0;689;NA;284407;5;2021-07-22;92181
2021-07-21;"Nitriansky kraj";6;650;2;652;NA;284407;8;2021-07-21;92176
2021-07-20;"Nitriansky kraj";1;527;1;528;NA;284407;2;2021-07-20;92168
2021-07-19;"Nitriansky kraj";2;965;0;965;NA;284407;2;2021-07-19;92166
2021-07-18;"Nitriansky kraj";1;747;0;747;NA;284407;1;2021-07-18;92164
2021-07-17;"Nitriansky kraj";5;612;0;612;NA;284407;5;2021-07-17;92163
2021-07-16;"Nitriansky kraj";2;876;0;876;NA;284407;2;2021-07-16;92158
2021-07-15;"Nitriansky kraj";11;708;0;708;NA;284407;11;2021-07-15;92156
2021-07-14;"Nitriansky kraj";4;646;0;646;NA;284407;4;2021-07-14;92145
2021-07-13;"Nitriansky kraj";2;697;2;699;NA;284407;4;2021-07-13;92141
2021-07-12;"Nitriansky kraj";1;819;0;819;NA;284407;1;2021-07-12;92137
2021-07-11;"Nitriansky kraj";1;961;0;961;NA;284407;1;2021-07-11;92136
2021-07-10;"Nitriansky kraj";1;630;0;630;NA;284407;1;2021-07-10;92135
2021-07-09;"Nitriansky kraj";3;1000;0;1000;NA;284407;3;2021-07-09;92134
2021-07-08;"Nitriansky kraj";0;683;0;683;NA;284407;0;2021-07-08;92131
2021-07-07;"Nitriansky kraj";2;935;2;937;NA;284407;4;2021-07-07;92131
2021-07-06;"Nitriansky kraj";1;1269;1;1270;NA;284407;2;2021-07-06;92127
2021-07-05;"Nitriansky kraj";1;507;0;507;NA;284407;1;2021-07-05;92125
2021-07-04;"Nitriansky kraj";0;821;1;822;NA;284407;1;2021-07-04;92124
2021-07-03;"Nitriansky kraj";0;611;0;611;NA;284407;0;2021-07-03;92123
2021-07-02;"Nitriansky kraj";0;1259;0;1259;NA;284407;0;2021-07-02;92123
2021-07-01;"Nitriansky kraj";0;369;1;370;NA;284407;1;2021-07-01;92123
2021-06-30;"Nitriansky kraj";1;6777;2;6779;NA;284407;3;2021-06-30;92122
2021-06-29;"Nitriansky kraj";1;3536;0;3536;NA;284407;1;2021-06-29;92119
2021-06-28;"Nitriansky kraj";3;4393;0;4393;NA;284407;3;2021-06-28;92118
2021-06-27;"Nitriansky kraj";0;3263;0;3263;NA;284407;0;2021-06-27;92115
2021-06-26;"Nitriansky kraj";1;4979;3;4982;NA;284407;4;2021-06-26;92115
2021-06-25;"Nitriansky kraj";8;5182;1;5183;NA;284407;9;2021-06-25;92111
2021-06-24;"Nitriansky kraj";1;3354;0;3354;NA;284407;1;2021-06-24;92102
2021-06-23;"Nitriansky kraj";1;3033;0;3033;NA;284407;1;2021-06-23;92101
2021-06-22;"Nitriansky kraj";1;3240;3;3243;NA;284407;4;2021-06-22;92100
2021-06-21;"Nitriansky kraj";8;5362;8;5370;NA;284407;16;2021-06-21;92096
2021-06-20;"Nitriansky kraj";0;4437;6;4443;NA;284407;6;2021-06-20;92080
2021-06-19;"Nitriansky kraj";0;5983;4;5987;NA;284407;4;2021-06-19;92074
2021-06-18;"Nitriansky kraj";4;6453;3;6456;NA;284407;7;2021-06-18;92070
2021-06-17;"Nitriansky kraj";5;4152;1;4153;NA;284407;6;2021-06-17;92063
2021-06-16;"Nitriansky kraj";4;3694;3;3697;NA;284407;7;2021-06-16;92057
2021-06-15;"Nitriansky kraj";1;3995;0;3995;NA;284407;1;2021-06-15;92050
2021-06-14;"Nitriansky kraj";0;5875;3;5878;NA;284407;3;2021-06-14;92049
2021-06-13;"Nitriansky kraj";0;6073;3;6076;NA;284407;3;2021-06-13;92046
2021-06-12;"Nitriansky kraj";1;8293;1;8294;NA;284407;2;2021-06-12;92043
2021-06-11;"Nitriansky kraj";3;6891;4;6895;NA;284407;7;2021-06-11;92041
2021-06-10;"Nitriansky kraj";7;4539;1;4540;NA;284407;8;2021-06-10;92034
2021-06-09;"Nitriansky kraj";2;4706;2;4708;NA;284407;4;2021-06-09;92026
2021-06-08;"Nitriansky kraj";8;4239;3;4242;NA;284407;11;2021-06-08;92022
2021-06-07;"Nitriansky kraj";6;5841;8;5849;NA;284407;14;2021-06-07;92011
2021-06-06;"Nitriansky kraj";0;6981;4;6985;NA;284407;4;2021-06-06;91997
2021-06-05;"Nitriansky kraj";6;9089;9;9098;NA;284407;15;2021-06-05;91993
2021-06-04;"Nitriansky kraj";9;7639;5;7644;NA;284407;14;2021-06-04;91978
2021-06-03;"Nitriansky kraj";2;5064;6;5070;NA;284407;8;2021-06-03;91964
2021-06-02;"Nitriansky kraj";11;5119;11;5130;NA;284407;22;2021-06-02;91956
2021-06-01;"Nitriansky kraj";3;4862;2;4864;NA;284407;5;2021-06-01;91934
2021-05-31;"Nitriansky kraj";8;8933;8;8941;NA;284407;16;2021-05-31;91929
2021-05-30;"Nitriansky kraj";1;9067;8;9075;NA;284407;9;2021-05-30;91913
2021-05-29;"Nitriansky kraj";2;13610;7;13617;NA;284407;9;2021-05-29;91904
2021-05-28;"Nitriansky kraj";10;8872;6;8878;NA;284407;16;2021-05-28;91895
2021-05-27;"Nitriansky kraj";4;6164;5;6169;NA;284407;9;2021-05-27;91879
2021-05-26;"Nitriansky kraj";11;8509;10;8519;NA;284407;21;2021-05-26;91870
2021-05-25;"Nitriansky kraj";15;7350;8;7358;NA;284407;23;2021-05-25;91849
2021-05-24;"Nitriansky kraj";14;9816;17;9833;NA;284407;31;2021-05-24;91826
2021-05-23;"Nitriansky kraj";1;9456;13;9469;NA;284407;14;2021-05-23;91795
2021-05-22;"Nitriansky kraj";7;16939;11;16950;NA;284407;18;2021-05-22;91781
2021-05-21;"Nitriansky kraj";18;10632;15;10647;NA;284407;33;2021-05-21;91763
2021-05-20;"Nitriansky kraj";8;7185;7;7192;NA;284407;15;2021-05-20;91730
2021-05-19;"Nitriansky kraj";20;6787;14;6801;NA;284407;34;2021-05-19;91715
2021-05-18;"Nitriansky kraj";23;7797;18;7815;NA;284407;41;2021-05-18;91681
2021-05-17;"Nitriansky kraj";22;9774;20;9794;NA;284407;42;2021-05-17;91640
2021-05-16;"Nitriansky kraj";4;13830;15;13845;NA;284407;19;2021-05-16;91598
2021-05-15;"Nitriansky kraj";5;25389;23;25412;NA;284407;28;2021-05-15;91579
2021-05-14;"Nitriansky kraj";18;13385;23;13408;NA;284407;41;2021-05-14;91551
2021-05-13;"Nitriansky kraj";24;8289;19;8308;NA;284407;43;2021-05-13;91510
2021-05-12;"Nitriansky kraj";10;7682;26;7708;NA;284407;36;2021-05-12;91467
2021-05-11;"Nitriansky kraj";36;8169;13;8182;NA;284407;49;2021-05-11;91431
2021-05-10;"Nitriansky kraj";16;13800;42;13842;NA;284407;58;2021-05-10;91382
2021-05-09;"Nitriansky kraj";8;21879;35;21914;NA;284407;43;2021-05-09;91324
2021-05-08;"Nitriansky kraj";0;24318;29;24347;NA;284407;29;2021-05-08;91281
2021-05-07;"Nitriansky kraj";32;14915;20;14935;NA;284407;52;2021-05-07;91252
2021-05-06;"Nitriansky kraj";30;9463;20;9483;NA;284407;50;2021-05-06;91200
2021-05-05;"Nitriansky kraj";19;8527;23;8550;NA;284407;42;2021-05-05;91150
2021-05-04;"Nitriansky kraj";46;9385;27;9412;NA;284407;73;2021-05-04;91108
2021-05-03;"Nitriansky kraj";32;14490;44;14534;NA;284407;76;2021-05-03;91035
2021-05-02;"Nitriansky kraj";4;31751;46;31797;NA;284407;50;2021-05-02;90959
2021-05-01;"Nitriansky kraj";23;60451;43;60494;NA;284407;66;2021-05-01;90909
2021-04-30;"Nitriansky kraj";28;31803;53;31856;NA;284407;81;2021-04-30;90843
2021-04-29;"Nitriansky kraj";27;14265;34;14299;NA;284407;61;2021-04-29;90762
2021-04-28;"Nitriansky kraj";36;14716;45;14761;NA;284407;81;2021-04-28;90701
2021-04-27;"Nitriansky kraj";51;13154;35;13189;NA;284407;86;2021-04-27;90620
2021-04-26;"Nitriansky kraj";38;21029;44;21073;NA;284407;82;2021-04-26;90534
2021-04-25;"Nitriansky kraj";7;44312;46;44358;NA;284407;53;2021-04-25;90452
2021-04-24;"Nitriansky kraj";23;93455;72;93527;NA;284407;95;2021-04-24;90399
2021-04-23;"Nitriansky kraj";54;35145;51;35196;NA;284407;105;2021-04-23;90304
2021-04-22;"Nitriansky kraj";32;15435;44;15479;NA;284407;76;2021-04-22;90199
2021-04-21;"Nitriansky kraj";38;14228;45;14273;NA;284407;83;2021-04-21;90123
2021-04-20;"Nitriansky kraj";67;16058;51;16109;NA;284407;118;2021-04-20;90040
2021-04-19;"Nitriansky kraj";35;24819;59;24878;NA;284407;94;2021-04-19;89922
2021-04-18;"Nitriansky kraj";0;39569;27;39596;NA;284407;27;2021-04-18;89828
2021-04-17;"Nitriansky kraj";34;92102;82;92184;NA;284407;116;2021-04-17;89801
2021-04-16;"Nitriansky kraj";46;32348;37;32385;NA;284407;83;2021-04-16;89685
2021-04-15;"Nitriansky kraj";75;16215;52;16267;NA;284407;127;2021-04-15;89602
2021-04-14;"Nitriansky kraj";43;15303;42;15345;NA;284407;85;2021-04-14;89475
2021-04-13;"Nitriansky kraj";110;15104;44;15148;NA;284407;154;2021-04-13;89390
2021-04-12;"Nitriansky kraj";29;22817;50;22867;NA;284407;79;2021-04-12;89236
2021-04-11;"Nitriansky kraj";1;37537;31;37568;NA;284407;32;2021-04-11;89157
2021-04-10;"Nitriansky kraj";35;95851;115;95966;NA;284407;150;2021-04-10;89125
2021-04-09;"Nitriansky kraj";69;30669;58;30727;NA;284407;127;2021-04-09;88975
2021-04-08;"Nitriansky kraj";71;15361;36;15397;NA;284407;107;2021-04-08;88848
2021-04-07;"Nitriansky kraj";64;18541;47;18588;NA;284407;111;2021-04-07;88741
2021-04-06;"Nitriansky kraj";65;33218;112;33330;NA;284407;177;2021-04-06;88630
2021-04-05;"Nitriansky kraj";37;12673;48;12721;NA;284407;85;2021-04-05;88453
2021-04-04;"Nitriansky kraj";5;17887;35;17922;NA;284407;40;2021-04-04;88368
2021-04-03;"Nitriansky kraj";26;85465;153;85618;NA;284407;179;2021-04-03;88328
2021-04-02;"Nitriansky kraj";32;18743;46;18789;NA;284407;78;2021-04-02;88149
2021-04-01;"Nitriansky kraj";63;24640;83;24723;NA;284407;146;2021-04-01;88071
2021-03-31;"Nitriansky kraj";73;21752;94;21846;NA;284407;167;2021-03-31;87925
2021-03-30;"Nitriansky kraj";125;17122;83;17205;NA;284407;208;2021-03-30;87758
2021-03-29;"Nitriansky kraj";81;25139;100;25239;NA;284407;181;2021-03-29;87550
2021-03-28;"Nitriansky kraj";6;45581;106;45687;NA;284407;112;2021-03-28;87369
2021-03-27;"Nitriansky kraj";39;104104;174;104278;NA;284407;213;2021-03-27;87257
2021-03-26;"Nitriansky kraj";90;40444;115;40559;NA;284407;205;2021-03-26;87044
2021-03-25;"Nitriansky kraj";95;19219;94;19313;NA;284407;189;2021-03-25;86839
2021-03-24;"Nitriansky kraj";90;14787;91;14878;NA;284407;181;2021-03-24;86650
2021-03-23;"Nitriansky kraj";167;16753;66;16819;NA;284407;233;2021-03-23;86469
2021-03-22;"Nitriansky kraj";101;24886;125;25011;NA;284407;226;2021-03-22;86236
2021-03-21;"Nitriansky kraj";27;42773;99;42872;NA;284407;126;2021-03-21;86010
2021-03-20;"Nitriansky kraj";36;100640;207;100847;NA;284407;243;2021-03-20;85884
2021-03-19;"Nitriansky kraj";76;37312;102;37414;NA;284407;178;2021-03-19;85641
2021-03-18;"Nitriansky kraj";103;20051;113;20164;NA;284407;216;2021-03-18;85463
2021-03-17;"Nitriansky kraj";87;15839;127;15966;NA;284407;214;2021-03-17;85247
2021-03-16;"Nitriansky kraj";172;18085;121;18206;NA;284407;293;2021-03-16;85033
2021-03-15;"Nitriansky kraj";130;24481;165;24646;NA;284407;295;2021-03-15;84740
2021-03-14;"Nitriansky kraj";3;45770;107;45877;NA;284407;110;2021-03-14;84445
2021-03-13;"Nitriansky kraj";65;112573;242;112815;NA;284407;307;2021-03-13;84335
2021-03-12;"Nitriansky kraj";127;40777;159;40936;NA;284407;286;2021-03-12;84028
2021-03-11;"Nitriansky kraj";131;18686;130;18816;NA;284407;261;2021-03-11;83742
2021-03-10;"Nitriansky kraj";96;17422;143;17565;NA;284407;239;2021-03-10;83481
2021-03-09;"Nitriansky kraj";260;17635;149;17784;NA;284407;409;2021-03-09;83242
2021-03-08;"Nitriansky kraj";145;27214;172;27386;NA;284407;317;2021-03-08;82833
2021-03-07;"Nitriansky kraj";48;46867;185;47052;NA;284407;233;2021-03-07;82516
2021-03-06;"Nitriansky kraj";86;112027;327;112354;NA;284407;413;2021-03-06;82283
2021-03-05;"Nitriansky kraj";133;39068;200;39268;NA;284407;333;2021-03-05;81870
2021-03-04;"Nitriansky kraj";176;18340;173;18513;NA;284407;349;2021-03-04;81537
2021-03-03;"Nitriansky kraj";172;17210;177;17387;NA;284407;349;2021-03-03;81188
2021-03-02;"Nitriansky kraj";274;21003;366;21369;NA;284407;640;2021-03-02;80839
2021-03-01;"Nitriansky kraj";133;27881;279;28160;NA;284407;412;2021-03-01;80199
2021-02-28;"Nitriansky kraj";80;40866;218;41084;NA;284407;298;2021-02-28;79787
2021-02-27;"Nitriansky kraj";101;106352;496;106848;NA;284407;597;2021-02-27;79489
2021-02-26;"Nitriansky kraj";109;36788;308;37096;NA;284407;417;2021-02-26;78892
2021-02-25;"Nitriansky kraj";188;15243;212;15455;NA;284407;400;2021-02-25;78475
2021-02-24;"Nitriansky kraj";125;13833;260;14093;NA;284407;385;2021-02-24;78075
2021-02-23;"Nitriansky kraj";273;15402;273;15675;NA;284407;546;2021-02-23;77690
2021-02-22;"Nitriansky kraj";154;26478;330;26808;NA;284407;484;2021-02-22;77144
2021-02-21;"Nitriansky kraj";22;43664;320;43984;NA;284407;342;2021-02-21;76660
2021-02-20;"Nitriansky kraj";128;109038;586;109624;NA;284407;714;2021-02-20;76318
2021-02-19;"Nitriansky kraj";173;36849;328;37177;NA;284407;501;2021-02-19;75604
2021-02-18;"Nitriansky kraj";202;17045;275;17320;NA;284407;477;2021-02-18;75103
2021-02-17;"Nitriansky kraj";198;12080;310;12390;NA;284407;508;2021-02-17;74626
2021-02-16;"Nitriansky kraj";284;16066;288;16354;NA;284407;572;2021-02-16;74118
2021-02-15;"Nitriansky kraj";122;28636;474;29110;NA;284407;596;2021-02-15;73546
2021-02-14;"Nitriansky kraj";8;49392;315;49707;NA;284407;323;2021-02-14;72950
2021-02-13;"Nitriansky kraj";127;110294;690;110984;NA;284407;817;2021-02-13;72627
2021-02-12;"Nitriansky kraj";162;33405;407;33812;NA;284407;569;2021-02-12;71810
2021-02-11;"Nitriansky kraj";195;12406;270;12676;NA;284407;465;2021-02-11;71241
2021-02-10;"Nitriansky kraj";186;17770;644;18414;NA;284407;830;2021-02-10;70776
2021-02-09;"Nitriansky kraj";260;18530;385;18915;NA;284407;645;2021-02-09;69946
2021-02-08;"Nitriansky kraj";177;37530;569;38099;NA;284407;746;2021-02-08;69301
2021-02-07;"Nitriansky kraj";20;52307;513;52820;NA;284407;533;2021-02-07;68555
2021-02-06;"Nitriansky kraj";129;101439;764;102203;NA;284407;893;2021-02-06;68022
2021-02-05;"Nitriansky kraj";244;26137;491;26628;NA;284407;735;2021-02-05;67129
2021-02-04;"Nitriansky kraj";308;15681;512;16193;NA;284407;820;2021-02-04;66394
2021-02-03;"Nitriansky kraj";191;13459;382;13841;NA;284407;573;2021-02-03;65574
2021-02-02;"Nitriansky kraj";327;17880;382;18262;NA;284407;709;2021-02-02;65001
2021-02-01;"Nitriansky kraj";221;24002;460;24462;NA;284407;681;2021-02-01;64292
2021-01-31;"Nitriansky kraj";9;46215;507;46722;NA;284407;516;2021-01-31;63611
2021-01-30;"Nitriansky kraj";152;99241;1090;100331;NA;284407;1242;2021-01-30;63095
2021-01-29;"Nitriansky kraj";302;22461;477;22938;NA;284407;779;2021-01-29;61853
2021-01-28;"Nitriansky kraj";269;11370;398;11768;NA;284407;667;2021-01-28;61074
2021-01-27;"Nitriansky kraj";235;6758;299;7057;NA;284407;534;2021-01-27;60407
2021-01-26;"Nitriansky kraj";345;16015;454;16469;NA;284407;799;2021-01-26;59873
2021-01-25;"Nitriansky kraj";201;21909;434;22343;NA;284407;635;2021-01-25;59074
2021-01-24;"Nitriansky kraj";12;79041;897;79938;NA;284407;909;2021-01-24;58439
2021-01-23;"Nitriansky kraj";277;97845;1446;99291;NA;284407;1723;2021-01-23;57530
2021-01-22;"Nitriansky kraj";139;35924;619;36543;NA;284407;758;2021-01-22;55807
2021-01-21;"Nitriansky kraj";305;14649;412;15061;NA;284407;717;2021-01-21;55049
2021-01-20;"Nitriansky kraj";326;11991;625;12616;NA;284407;951;2021-01-20;54332
2021-01-19;"Nitriansky kraj";344;11015;633;11648;NA;284407;977;2021-01-19;53381
2021-01-18;"Nitriansky kraj";367;8901;519;9420;NA;284407;886;2021-01-18;52404
2021-01-17;"Nitriansky kraj";97;15061;275;15336;NA;284407;372;2021-01-17;51518
2021-01-16;"Nitriansky kraj";64;36838;679;37517;NA;284407;743;2021-01-16;51146
2021-01-15;"Nitriansky kraj";373;15940;474;16414;NA;284407;847;2021-01-15;50403
2021-01-14;"Nitriansky kraj";627;10577;452;11029;NA;284407;1079;2021-01-14;49556
2021-01-13;"Nitriansky kraj";663;9234;484;9718;NA;284407;1147;2021-01-13;48477
2021-01-12;"Nitriansky kraj";642;8805;545;9350;NA;284407;1187;2021-01-12;47330
2021-01-11;"Nitriansky kraj";422;8347;513;8860;NA;284407;935;2021-01-11;46143
2021-01-10;"Nitriansky kraj";44;19841;730;20571;NA;284407;774;2021-01-10;45208
2021-01-09;"Nitriansky kraj";532;36823;1071;37894;NA;284407;1603;2021-01-09;44434
2021-01-08;"Nitriansky kraj";817;14001;691;14692;NA;284407;1508;2021-01-08;42831
2021-01-07;"Nitriansky kraj";438;10121;795;10916;NA;284407;1233;2021-01-07;41323
2021-01-06;"Nitriansky kraj";259;3192;197;3389;NA;284407;456;2021-01-06;40090
2021-01-05;"Nitriansky kraj";732;8918;1208;10126;NA;284407;1940;2021-01-05;39634
2021-01-04;"Nitriansky kraj";362;8409;1287;9696;NA;284407;1649;2021-01-04;37694
2021-01-03;"Nitriansky kraj";42;84;20;104;NA;284407;62;2021-01-03;36045
2021-01-02;"Nitriansky kraj";249;1090;26;1116;NA;284407;275;2021-01-02;35983
2021-01-01;"Nitriansky kraj";119;781;95;876;NA;284407;214;2021-01-01;35708
2020-12-31;"Nitriansky kraj";786;7646;962;8608;NA;284407;1748;2020-12-31;35494
2020-12-30;"Nitriansky kraj";1094;9619;1165;10784;NA;284407;2259;2020-12-30;33746
2020-12-29;"Nitriansky kraj";607;8028;1245;9273;NA;284407;1852;2020-12-29;31487
2020-12-28;"Nitriansky kraj";83;6804;1220;8024;NA;284407;1303;2020-12-28;29635
2020-12-27;"Nitriansky kraj";22;60;8;68;NA;284407;30;2020-12-27;28332
2020-12-26;"Nitriansky kraj";54;297;56;353;NA;284407;110;2020-12-26;28302
2020-12-25;"Nitriansky kraj";35;60;11;71;NA;284407;46;2020-12-25;28192
2020-12-24;"Nitriansky kraj";514;1861;176;2037;NA;284407;690;2020-12-24;28146
2020-12-23;"Nitriansky kraj";349;14679;782;15461;NA;284407;1131;2020-12-23;27456
2020-12-22;"Nitriansky kraj";673;10623;949;11572;NA;284407;1622;2020-12-22;26325
2020-12-21;"Nitriansky kraj";128;7587;931;8518;NA;284407;1059;2020-12-21;24703
2020-12-20;"Nitriansky kraj";77;50;10;60;NA;284407;87;2020-12-20;23644
2020-12-19;"Nitriansky kraj";262;2259;159;2418;NA;284407;421;2020-12-19;23557
2020-12-18;"Nitriansky kraj";512;7946;518;8464;NA;284407;1030;2020-12-18;23136
2020-12-17;"Nitriansky kraj";586;6519;486;7005;NA;284407;1072;2020-12-17;22106
2020-12-16;"Nitriansky kraj";357;8097;500;8597;NA;284407;857;2020-12-16;21034
2020-12-15;"Nitriansky kraj";461;9084;750;9834;NA;284407;1211;2020-12-15;20177
2020-12-14;"Nitriansky kraj";217;7816;797;8613;NA;284407;1014;2020-12-14;18966
2020-12-13;"Nitriansky kraj";12;69;6;75;NA;284407;18;2020-12-13;17952
2020-12-12;"Nitriansky kraj";341;1832;125;1957;NA;284407;466;2020-12-12;17934
2020-12-11;"Nitriansky kraj";409;5117;384;5501;NA;284407;793;2020-12-11;17468
2020-12-10;"Nitriansky kraj";360;5239;345;5584;NA;284407;705;2020-12-10;16675
2020-12-09;"Nitriansky kraj";362;5494;529;6023;NA;284407;891;2020-12-09;15970
2020-12-08;"Nitriansky kraj";340;8168;548;8716;NA;284407;888;2020-12-08;15079
2020-12-07;"Nitriansky kraj";139;6243;573;6816;NA;284407;712;2020-12-07;14191
2020-12-06;"Nitriansky kraj";15;89;4;93;NA;284407;19;2020-12-06;13479
2020-12-05;"Nitriansky kraj";136;1388;19;1407;NA;284407;155;2020-12-05;13460
2020-12-04;"Nitriansky kraj";232;2884;74;2958;NA;284407;306;2020-12-04;13305
2020-12-03;"Nitriansky kraj";248;2471;110;2581;NA;284407;358;2020-12-03;12999
2020-12-02;"Nitriansky kraj";252;2580;151;2731;NA;284407;403;2020-12-02;12641
2020-12-01;"Nitriansky kraj";331;2891;131;3022;NA;284407;462;2020-12-01;12238
2020-11-30;"Nitriansky kraj";91;4228;188;4416;NA;284407;279;2020-11-30;11776
2020-11-29;"Nitriansky kraj";3;634;42;676;NA;284407;45;2020-11-29;11497
2020-11-28;"Nitriansky kraj";135;892;31;923;NA;284407;166;2020-11-28;11452
2020-11-27;"Nitriansky kraj";177;2069;73;2142;NA;284407;250;2020-11-27;11286
2020-11-26;"Nitriansky kraj";191;2813;80;2893;NA;284407;271;2020-11-26;11036
2020-11-25;"Nitriansky kraj";325;2478;91;2569;NA;284407;416;2020-11-25;10765
2020-11-24;"Nitriansky kraj";147;1641;64;1705;NA;284407;211;2020-11-24;10349
2020-11-23;"Nitriansky kraj";102;9891;212;10103;NA;284407;314;2020-11-23;10138
2020-11-22;"Nitriansky kraj";7;1176;25;1201;NA;284407;32;2020-11-22;9824
2020-11-21;"Nitriansky kraj";86;1083;38;1121;NA;284407;124;2020-11-21;9792
2020-11-20;"Nitriansky kraj";264;4180;103;4283;NA;284407;367;2020-11-20;9668
2020-11-19;"Nitriansky kraj";185;3065;134;3199;NA;284407;319;2020-11-19;9301
2020-11-18;"Nitriansky kraj";188;2214;79;2293;NA;284407;267;2020-11-18;8982
2020-11-17;"Nitriansky kraj";178;596;29;625;NA;284407;207;2020-11-17;8715
2020-11-16;"Nitriansky kraj";139;1877;75;1952;NA;284407;214;2020-11-16;8508
2020-11-15;"Nitriansky kraj";14;180;5;185;NA;284407;19;2020-11-15;8294
2020-11-14;"Nitriansky kraj";114;1131;32;1163;NA;284407;146;2020-11-14;8275
2020-11-13;"Nitriansky kraj";210;936;46;982;NA;284407;256;2020-11-13;8129
2020-11-12;"Nitriansky kraj";256;1195;35;1230;NA;284407;291;2020-11-12;7873
2020-11-11;"Nitriansky kraj";279;1247;22;1269;NA;284407;301;2020-11-11;7582
2020-11-10;"Nitriansky kraj";192;2623;39;2662;NA;284407;231;2020-11-10;7281
2020-11-09;"Nitriansky kraj";128;3136;43;3179;NA;284407;171;2020-11-09;7050
2020-11-08;"Nitriansky kraj";43;1462;32;1494;NA;284407;75;2020-11-08;6879
2020-11-07;"Nitriansky kraj";130;1046;4;1050;NA;284407;134;2020-11-07;6804
2020-11-06;"Nitriansky kraj";210;2264;32;2296;NA;284407;242;2020-11-06;6670
2020-11-05;"Nitriansky kraj";178;313;14;327;NA;284407;192;2020-11-05;6428
2020-11-04;"Nitriansky kraj";211;297;16;313;NA;284407;227;2020-11-04;6236
2020-11-03;"Nitriansky kraj";216;435;25;460;NA;284407;241;2020-11-03;6009
2020-11-02;"Nitriansky kraj";171;4208;46;4254;NA;284407;217;2020-11-02;5768
2020-11-01;"Nitriansky kraj";130;2546;27;2573;NA;284407;157;2020-11-01;5551
2020-10-31;"Nitriansky kraj";261;10466;134;10600;NA;284407;395;2020-10-31;5394
2020-10-30;"Nitriansky kraj";204;2593;42;2635;NA;284407;246;2020-10-30;4999
2020-10-29;"Nitriansky kraj";293;841;39;880;NA;284407;332;2020-10-29;4753
2020-10-28;"Nitriansky kraj";216;608;59;667;NA;284407;275;2020-10-28;4421
2020-10-27;"Nitriansky kraj";296;550;47;597;NA;284407;343;2020-10-27;4146
2020-10-26;"Nitriansky kraj";69;633;56;689;NA;284407;125;2020-10-26;3803
2020-10-25;"Nitriansky kraj";50;62;8;70;NA;284407;58;2020-10-25;3678
2020-10-24;"Nitriansky kraj";169;237;11;248;NA;284407;180;2020-10-24;3620
2020-10-23;"Nitriansky kraj";282;762;41;803;NA;284407;323;2020-10-23;3440
2020-10-22;"Nitriansky kraj";137;444;39;483;NA;284407;176;2020-10-22;3117
2020-10-21;"Nitriansky kraj";146;208;3;211;NA;284407;149;2020-10-21;2941
2020-10-20;"Nitriansky kraj";197;78;6;84;NA;284407;203;2020-10-20;2792
2020-10-19;"Nitriansky kraj";148;79;1;80;NA;284407;149;2020-10-19;2589
2020-10-18;"Nitriansky kraj";22;0;0;0;NA;284407;22;2020-10-18;2440
2020-10-17;"Nitriansky kraj";67;0;0;0;NA;284407;67;2020-10-17;2418
2020-10-16;"Nitriansky kraj";133;28;3;31;NA;284407;136;2020-10-16;2351
2020-10-15;"Nitriansky kraj";106;31;2;33;NA;284407;108;2020-10-15;2215
2020-10-14;"Nitriansky kraj";80;22;4;26;NA;284407;84;2020-10-14;2107
2020-10-13;"Nitriansky kraj";101;82;2;84;NA;284407;103;2020-10-13;2023
2020-10-12;"Nitriansky kraj";36;0;0;0;NA;284407;36;2020-10-12;1920
2020-10-11;"Nitriansky kraj";8;0;0;0;NA;284407;8;2020-10-11;1884
2020-10-10;"Nitriansky kraj";107;0;0;0;NA;284407;107;2020-10-10;1876
2020-10-09;"Nitriansky kraj";120;0;0;0;NA;284407;120;2020-10-09;1769
2020-10-08;"Nitriansky kraj";132;0;0;0;NA;284407;132;2020-10-08;1649
2020-10-07;"Nitriansky kraj";81;0;0;0;NA;284407;81;2020-10-07;1517
2020-10-06;"Nitriansky kraj";48;0;0;0;NA;284407;48;2020-10-06;1436
2020-10-05;"Nitriansky kraj";20;0;0;0;NA;284407;20;2020-10-05;1388
2020-10-04;"Nitriansky kraj";17;0;0;0;NA;284407;17;2020-10-04;1368
2020-10-03;"Nitriansky kraj";96;0;0;0;NA;284407;96;2020-10-03;1351
2020-10-02;"Nitriansky kraj";108;0;0;0;NA;284407;108;2020-10-02;1255
2020-10-01;"Nitriansky kraj";95;0;0;0;NA;284407;95;2020-10-01;1147
2020-09-30;"Nitriansky kraj";100;0;0;0;NA;284407;100;2020-09-30;1052
2020-09-29;"Nitriansky kraj";50;0;0;0;NA;284407;50;2020-09-29;952
2020-09-28;"Nitriansky kraj";22;0;0;0;NA;284407;22;2020-09-28;902
2020-09-27;"Nitriansky kraj";16;0;0;0;NA;284407;16;2020-09-27;880
2020-09-26;"Nitriansky kraj";64;0;0;0;NA;284407;64;2020-09-26;864
2020-09-25;"Nitriansky kraj";90;0;0;0;NA;284407;90;2020-09-25;800
2020-09-24;"Nitriansky kraj";51;0;0;0;NA;284407;51;2020-09-24;710
2020-09-23;"Nitriansky kraj";70;0;0;0;NA;284407;70;2020-09-23;659
2020-09-22;"Nitriansky kraj";18;0;0;0;NA;284407;18;2020-09-22;589
2020-09-21;"Nitriansky kraj";10;0;0;0;NA;284407;10;2020-09-21;571
2020-09-20;"Nitriansky kraj";4;0;0;0;NA;284407;4;2020-09-20;561
2020-09-19;"Nitriansky kraj";14;0;0;0;NA;284407;14;2020-09-19;557
2020-09-18;"Nitriansky kraj";19;0;0;0;NA;284407;19;2020-09-18;543
2020-09-17;"Nitriansky kraj";30;0;0;0;NA;284407;30;2020-09-17;524
2020-09-16;"Nitriansky kraj";6;0;0;0;NA;284407;6;2020-09-16;494
2020-09-15;"Nitriansky kraj";19;0;0;0;NA;284407;19;2020-09-15;488
2020-09-14;"Nitriansky kraj";28;0;0;0;NA;284407;28;2020-09-14;469
2020-09-13;"Nitriansky kraj";3;0;0;0;NA;284407;3;2020-09-13;441
2020-09-12;"Nitriansky kraj";12;0;0;0;NA;284407;12;2020-09-12;438
2020-09-11;"Nitriansky kraj";23;0;0;0;NA;284407;23;2020-09-11;426
2020-09-10;"Nitriansky kraj";29;0;0;0;NA;284407;29;2020-09-10;403
2020-09-09;"Nitriansky kraj";19;0;0;0;NA;284407;19;2020-09-09;374
2020-09-08;"Nitriansky kraj";17;0;0;0;NA;284407;17;2020-09-08;355
2020-09-07;"Nitriansky kraj";17;0;0;0;NA;284407;17;2020-09-07;338
2020-09-06;"Nitriansky kraj";0;0;0;0;NA;284407;0;2020-09-06;321
2020-09-05;"Nitriansky kraj";22;0;0;0;NA;284407;22;2020-09-05;321
2020-09-04;"Nitriansky kraj";34;0;0;0;NA;284407;34;2020-09-04;299
2020-09-03;"Nitriansky kraj";15;0;0;0;NA;284407;15;2020-09-03;265
2020-09-02;"Nitriansky kraj";15;0;0;0;NA;284407;15;2020-09-02;250
2020-09-01;"Nitriansky kraj";2;0;0;0;NA;284407;2;2020-09-01;235
2020-08-31;"Nitriansky kraj";12;0;0;0;NA;284407;12;2020-08-31;233
2020-08-30;"Nitriansky kraj";1;0;0;0;NA;284407;1;2020-08-30;221
2020-08-29;"Nitriansky kraj";7;46;0;46;NA;284407;7;2020-08-29;220
2020-08-28;"Nitriansky kraj";12;0;0;0;NA;284407;12;2020-08-28;213
2020-08-27;"Nitriansky kraj";12;0;0;0;NA;284407;12;2020-08-27;201
2020-08-26;"Nitriansky kraj";4;0;0;0;NA;284407;4;2020-08-26;189
2020-08-25;"Nitriansky kraj";8;0;0;0;NA;284407;8;2020-08-25;185
2020-08-24;"Nitriansky kraj";1;0;0;0;NA;284407;1;2020-08-24;177
2020-08-23;"Nitriansky kraj";1;0;0;0;NA;284407;1;2020-08-23;176
2020-08-22;"Nitriansky kraj";2;0;0;0;NA;284407;2;2020-08-22;175
2020-08-21;"Nitriansky kraj";0;0;0;0;NA;284407;0;2020-08-21;173
2020-08-20;"Nitriansky kraj";7;0;0;0;NA;284407;7;2020-08-20;173
2020-08-19;"Nitriansky kraj";1;0;0;0;NA;284407;1;2020-08-19;166
2020-08-18;"Nitriansky kraj";2;0;0;0;NA;284407;2;2020-08-18;165
2020-08-17;"Nitriansky kraj";1;0;0;0;NA;284407;1;2020-08-17;163
2020-08-16;"Nitriansky kraj";0;0;0;0;NA;284407;0;2020-08-16;162
2020-08-15;"Nitriansky kraj";2;0;0;0;NA;284407;2;2020-08-15;162
2020-08-14;"Nitriansky kraj";1;0;0;0;NA;284407;1;2020-08-14;160
2020-08-13;"Nitriansky kraj";4;0;0;0;NA;284407;4;2020-08-13;159
2020-08-12;"Nitriansky kraj";0;0;0;0;NA;284407;0;2020-08-12;155
2020-08-11;"Nitriansky kraj";1;0;0;0;NA;284407;1;2020-08-11;155
2020-08-10;"Nitriansky kraj";0;0;0;0;NA;284407;0;2020-08-10;154
2020-08-09;"Nitriansky kraj";0;0;0;0;NA;284407;0;2020-08-09;154
2020-08-08;"Nitriansky kraj";0;0;0;0;NA;284407;0;2020-08-08;154
2020-08-07;"Nitriansky kraj";4;0;0;0;NA;284407;4;2020-08-07;154
2020-08-06;"Nitriansky kraj";4;0;0;0;NA;284407;4;2020-08-06;150
2020-08-05;"Nitriansky kraj";0;0;0;0;NA;284407;0;2020-08-05;146
2020-08-04;"Nitriansky kraj";7;0;0;0;NA;284407;7;2020-08-04;146
2020-08-03;"Nitriansky kraj";0;0;0;0;NA;284407;0;2020-08-03;139
2020-08-02;"Nitriansky kraj";0;0;0;0;NA;284407;0;2020-08-02;139
2020-08-01;"Nitriansky kraj";0;0;0;0;NA;284407;0;2020-08-01;139
2020-07-31;"Nitriansky kraj";0;0;0;0;NA;284407;0;2020-07-31;139
2020-07-30;"Nitriansky kraj";0;0;0;0;NA;284407;0;2020-07-30;139
2020-07-29;"Nitriansky kraj";0;0;0;0;NA;284407;0;2020-07-29;139
2020-07-28;"Nitriansky kraj";0;0;0;0;NA;284407;0;2020-07-28;139
2020-07-27;"Nitriansky kraj";0;0;0;0;NA;284407;0;2020-07-27;139
2020-07-26;"Nitriansky kraj";0;0;0;0;NA;284407;0;2020-07-26;139
2020-07-25;"Nitriansky kraj";0;0;0;0;NA;284407;0;2020-07-25;139
2020-07-24;"Nitriansky kraj";1;0;0;0;NA;284407;1;2020-07-24;139
2020-07-23;"Nitriansky kraj";3;0;0;0;NA;284407;3;2020-07-23;138
2020-07-22;"Nitriansky kraj";2;0;0;0;NA;284407;2;2020-07-22;135
2020-07-21;"Nitriansky kraj";14;0;0;0;NA;284407;14;2020-07-21;133
2020-07-20;"Nitriansky kraj";11;0;0;0;NA;284407;11;2020-07-20;119
2020-07-19;"Nitriansky kraj";0;0;0;0;NA;284407;0;2020-07-19;108
2020-07-18;"Nitriansky kraj";0;0;0;0;NA;284407;0;2020-07-18;108
2020-07-17;"Nitriansky kraj";0;0;0;0;NA;284407;0;2020-07-17;108
2020-07-16;"Nitriansky kraj";4;0;0;0;NA;284407;4;2020-07-16;108
2020-07-15;"Nitriansky kraj";5;0;0;0;NA;284407;5;2020-07-15;104
2020-07-14;"Nitriansky kraj";0;0;0;0;NA;284407;0;2020-07-14;99
2020-07-13;"Nitriansky kraj";0;0;0;0;NA;284407;0;2020-07-13;99
2020-07-12;"Nitriansky kraj";0;0;0;0;NA;284407;0;2020-07-12;99
2020-07-11;"Nitriansky kraj";0;0;0;0;NA;284407;0;2020-07-11;99
2020-07-10;"Nitriansky kraj";0;0;0;0;NA;284407;0;2020-07-10;99
2020-07-09;"Nitriansky kraj";1;0;0;0;NA;284407;1;2020-07-09;99
2020-07-08;"Nitriansky kraj";2;0;0;0;NA;284407;2;2020-07-08;98
2020-07-07;"Nitriansky kraj";0;0;0;0;NA;284407;0;2020-07-07;96
2020-07-06;"Nitriansky kraj";0;0;0;0;NA;284407;0;2020-07-06;96
2020-07-05;"Nitriansky kraj";0;0;0;0;NA;284407;0;2020-07-05;96
2020-07-04;"Nitriansky kraj";0;0;0;0;NA;284407;0;2020-07-04;96
2020-07-03;"Nitriansky kraj";0;0;0;0;NA;284407;0;2020-07-03;96
2020-07-02;"Nitriansky kraj";0;0;0;0;NA;284407;0;2020-07-02;96
2020-07-01;"Nitriansky kraj";3;0;0;0;NA;284407;3;2020-07-01;96
2020-06-30;"Nitriansky kraj";0;0;0;0;NA;284407;0;2020-06-30;93
2020-06-29;"Nitriansky kraj";0;0;0;0;NA;284407;0;2020-06-29;93
2020-06-28;"Nitriansky kraj";0;0;0;0;NA;284407;0;2020-06-28;93
2020-06-27;"Nitriansky kraj";0;0;0;0;NA;284407;0;2020-06-27;93
2020-06-26;"Nitriansky kraj";0;0;0;0;NA;284407;0;2020-06-26;93
2020-06-25;"Nitriansky kraj";0;0;0;0;NA;284407;0;2020-06-25;93
2020-06-24;"Nitriansky kraj";1;0;0;0;NA;284407;1;2020-06-24;93
2020-06-23;"Nitriansky kraj";0;0;0;0;NA;284407;0;2020-06-23;92
2020-06-22;"Nitriansky kraj";0;0;0;0;NA;284407;0;2020-06-22;92
2020-06-21;"Nitriansky kraj";0;0;0;0;NA;284407;0;2020-06-21;92
2020-06-20;"Nitriansky kraj";0;0;0;0;NA;284407;0;2020-06-20;92
2020-06-19;"Nitriansky kraj";0;0;0;0;NA;284407;0;2020-06-19;92
2020-06-18;"Nitriansky kraj";0;0;0;0;NA;284407;0;2020-06-18;92
2020-06-17;"Nitriansky kraj";0;0;0;0;NA;284407;0;2020-06-17;92
2020-06-16;"Nitriansky kraj";0;0;0;0;NA;284407;0;2020-06-16;92
2020-06-14;"Nitriansky kraj";0;0;0;0;NA;284407;0;2020-06-14;92
2020-06-13;"Nitriansky kraj";0;0;0;0;NA;284407;0;2020-06-13;92
2020-06-12;"Nitriansky kraj";0;0;0;0;NA;284407;0;2020-06-12;92
2020-06-11;"Nitriansky kraj";0;0;0;0;NA;284407;0;2020-06-11;92
2020-06-10;"Nitriansky kraj";1;0;0;0;NA;284407;1;2020-06-10;92
2020-06-09;"Nitriansky kraj";1;0;0;0;NA;284407;1;2020-06-09;91
2020-06-08;"Nitriansky kraj";0;0;0;0;NA;284407;0;2020-06-08;90
2020-06-07;"Nitriansky kraj";0;0;0;0;NA;284407;0;2020-06-07;90
2020-06-05;"Nitriansky kraj";0;0;0;0;NA;284407;0;2020-06-05;90
2020-06-03;"Nitriansky kraj";0;0;0;0;NA;284407;0;2020-06-03;90
2020-06-02;"Nitriansky kraj";1;0;0;0;NA;284407;1;2020-06-02;90
2020-05-31;"Nitriansky kraj";0;0;0;0;NA;284407;0;2020-05-31;89
2020-05-29;"Nitriansky kraj";0;0;0;0;NA;284407;0;2020-05-29;89
2020-05-27;"Nitriansky kraj";0;0;0;0;NA;284407;0;2020-05-27;89
2020-05-26;"Nitriansky kraj";0;0;0;0;NA;284407;0;2020-05-26;89
2020-05-25;"Nitriansky kraj";0;0;0;0;NA;284407;0;2020-05-25;89
2020-05-24;"Nitriansky kraj";2;0;0;0;NA;284407;2;2020-05-24;89
2020-05-23;"Nitriansky kraj";0;0;0;0;NA;284407;0;2020-05-23;87
2020-05-22;"Nitriansky kraj";1;0;0;0;NA;284407;1;2020-05-22;87
2020-05-21;"Nitriansky kraj";0;0;0;0;NA;284407;0;2020-05-21;86
2020-05-20;"Nitriansky kraj";0;0;0;0;NA;284407;0;2020-05-20;86
2020-05-19;"Nitriansky kraj";0;0;0;0;NA;284407;0;2020-05-19;86
2020-05-17;"Nitriansky kraj";0;0;0;0;NA;284407;0;2020-05-17;86
2020-05-16;"Nitriansky kraj";0;0;0;0;NA;284407;0;2020-05-16;86
2020-05-15;"Nitriansky kraj";1;0;0;0;NA;284407;1;2020-05-15;86
2020-05-14;"Nitriansky kraj";0;0;0;0;NA;284407;0;2020-05-14;85
2020-05-13;"Nitriansky kraj";0;0;0;0;NA;284407;0;2020-05-13;85
2020-05-12;"Nitriansky kraj";0;0;0;0;NA;284407;0;2020-05-12;85
2020-05-11;"Nitriansky kraj";2;0;0;0;NA;284407;2;2020-05-11;85
2020-05-09;"Nitriansky kraj";0;0;0;0;NA;284407;0;2020-05-09;83
2020-05-07;"Nitriansky kraj";1;0;0;0;NA;284407;1;2020-05-07;83
2020-05-06;"Nitriansky kraj";9;0;0;0;NA;284407;9;2020-05-06;82
2020-05-05;"Nitriansky kraj";0;0;0;0;NA;284407;0;2020-05-05;73
2020-05-04;"Nitriansky kraj";5;0;0;0;NA;284407;5;2020-05-04;73
2020-05-03;"Nitriansky kraj";2;0;0;0;NA;284407;2;2020-05-03;68
2020-05-02;"Nitriansky kraj";0;0;0;0;NA;284407;0;2020-05-02;66
2020-05-01;"Nitriansky kraj";1;0;0;0;NA;284407;1;2020-05-01;66
2020-04-30;"Nitriansky kraj";0;0;0;0;NA;284407;0;2020-04-30;65
2020-04-29;"Nitriansky kraj";0;0;0;0;NA;284407;0;2020-04-29;65
2020-04-28;"Nitriansky kraj";1;0;0;0;NA;284407;1;2020-04-28;65
2020-04-27;"Nitriansky kraj";0;0;0;0;NA;284407;0;2020-04-27;64
2020-04-26;"Nitriansky kraj";0;0;0;0;NA;284407;0;2020-04-26;64
2020-04-25;"Nitriansky kraj";0;0;0;0;NA;284407;0;2020-04-25;64
2020-04-24;"Nitriansky kraj";0;0;0;0;NA;284407;0;2020-04-24;64
2020-04-23;"Nitriansky kraj";3;0;0;0;NA;284407;3;2020-04-23;64
2020-04-22;"Nitriansky kraj";16;0;0;0;NA;284407;16;2020-04-22;61
2020-04-21;"Nitriansky kraj";6;0;0;0;NA;284407;6;2020-04-21;45
2020-04-20;"Nitriansky kraj";5;0;0;0;NA;284407;5;2020-04-20;39
2020-04-19;"Nitriansky kraj";0;0;0;0;NA;284407;0;2020-04-19;34
2020-04-18;"Nitriansky kraj";0;0;0;0;NA;284407;0;2020-04-18;34
2020-04-17;"Nitriansky kraj";7;0;0;0;NA;284407;7;2020-04-17;34
2020-04-16;"Nitriansky kraj";0;0;0;0;NA;284407;0;2020-04-16;27
2020-04-15;"Nitriansky kraj";6;0;0;0;NA;284407;6;2020-04-15;27
2020-04-14;"Nitriansky kraj";2;0;0;0;NA;284407;2;2020-04-14;21
2020-04-13;"Nitriansky kraj";1;0;0;0;NA;284407;1;2020-04-13;19
2020-04-12;"Nitriansky kraj";3;0;0;0;NA;284407;3;2020-04-12;18
2020-04-11;"Nitriansky kraj";1;0;0;0;NA;284407;1;2020-04-11;15
2020-04-10;"Nitriansky kraj";1;0;0;0;NA;284407;1;2020-04-10;14
2020-04-09;"Nitriansky kraj";0;0;0;0;NA;284407;0;2020-04-09;13
2020-04-08;"Nitriansky kraj";2;0;0;0;NA;284407;2;2020-04-08;13
2020-04-07;"Nitriansky kraj";3;0;0;0;NA;284407;3;2020-04-07;11
2020-04-06;"Nitriansky kraj";4;0;0;0;NA;284407;4;2020-04-06;8
2020-04-05;"Nitriansky kraj";5;0;0;0;NA;284407;5;2020-04-05;4
2020-04-04;"Nitriansky kraj";0;0;0;0;NA;284407;0;2020-04-04;-1
2020-04-03;"Nitriansky kraj";0;0;0;0;NA;284407;0;2020-04-03;-1
2020-04-02;"Nitriansky kraj";1;0;0;0;NA;284407;1;2020-04-02;-1
2020-04-01;"Nitriansky kraj";0;0;0;0;NA;284407;0;2020-04-01;-2
2020-03-31;"Nitriansky kraj";3;0;0;0;NA;284407;3;2020-03-31;-2
2020-03-30;"Nitriansky kraj";3;0;0;0;NA;284407;3;2020-03-30;-5
2020-03-29;"Nitriansky kraj";3;0;0;0;NA;284407;3;2020-03-29;-8
2020-03-28;"Nitriansky kraj";1;0;0;0;NA;284407;1;2020-03-28;-11
2020-03-27;"Nitriansky kraj";1;0;0;0;NA;284407;1;2020-03-27;-12
2020-03-26;"Nitriansky kraj";1;0;0;0;NA;284407;1;2020-03-26;-13
2020-03-25;"Nitriansky kraj";1;0;0;0;NA;284407;1;2020-03-25;-14
2020-03-24;"Nitriansky kraj";0;0;0;0;NA;284407;0;2020-03-24;-15
2020-03-23;"Nitriansky kraj";2;0;0;0;NA;284407;2;2020-03-23;-15
2020-03-22;"Nitriansky kraj";2;0;0;0;NA;284407;2;2020-03-22;-17
2020-03-21;"Nitriansky kraj";2;0;0;0;NA;284407;2;2020-03-21;-19
2020-03-20;"Nitriansky kraj";1;0;0;0;NA;284407;1;2020-03-20;-21
2020-03-19;"Nitriansky kraj";1;0;0;0;NA;284407;1;2020-03-19;-22
2020-03-18;"Nitriansky kraj";2;0;0;0;NA;284407;2;2020-03-18;-23
2020-03-17;"Nitriansky kraj";1;0;0;0;NA;284407;1;2020-03-17;-25
2020-03-16;"Nitriansky kraj";0;0;0;0;NA;284407;0;2020-03-16;-26
2020-03-15;"Nitriansky kraj";4;0;0;0;NA;284407;4;2020-03-15;-26
2020-03-14;"Nitriansky kraj";1;0;0;0;NA;284407;1;2020-03-14;-30
2020-03-13;"Nitriansky kraj";0;0;0;0;NA;284407;0;2020-03-13;-31
2020-03-12;"Nitriansky kraj";0;0;0;0;NA;284407;0;2020-03-12;-31
2020-03-11;"Nitriansky kraj";0;0;0;0;NA;284407;0;2020-03-11;-31
2020-03-09;"Nitriansky kraj";0;0;0;0;NA;284407;0;2020-03-09;-31
2020-03-08;"Nitriansky kraj";0;0;0;0;NA;284407;0;2020-03-08;-31
2020-03-07;"Nitriansky kraj";0;0;0;0;NA;284407;0;2020-03-07;-31
2020-03-06;"Nitriansky kraj";0;0;0;0;NA;284407;0;2020-03-06;-31
2022-05-26;"Prešovský kraj";26;0;0;0;262755;365584;26;2022-05-26;365584
2022-05-25;"Prešovský kraj";22;154;7;161;NA;365584;29;2022-05-25;365558
2022-05-24;"Prešovský kraj";31;271;18;289;NA;365584;49;2022-05-24;365529
2022-05-23;"Prešovský kraj";27;617;38;655;NA;365584;65;2022-05-23;365480
2022-05-22;"Prešovský kraj";4;44;2;46;NA;365584;6;2022-05-22;365415
2022-05-21;"Prešovský kraj";19;92;0;92;NA;365584;19;2022-05-21;365409
2022-05-20;"Prešovský kraj";31;336;21;357;NA;365584;52;2022-05-20;365390
2022-05-19;"Prešovský kraj";21;269;7;276;NA;365584;28;2022-05-19;365338
2022-05-18;"Prešovský kraj";42;280;8;288;NA;365584;50;2022-05-18;365310
2022-05-17;"Prešovský kraj";31;282;13;295;NA;365584;44;2022-05-17;365260
2022-05-16;"Prešovský kraj";28;543;57;600;NA;365584;85;2022-05-16;365216
2022-05-15;"Prešovský kraj";4;85;8;93;NA;365584;12;2022-05-15;365131
2022-05-14;"Prešovský kraj";30;134;5;139;NA;365584;35;2022-05-14;365119
2022-05-13;"Prešovský kraj";33;309;13;322;NA;365584;46;2022-05-13;365084
2022-05-12;"Prešovský kraj";38;347;19;366;NA;365584;57;2022-05-12;365038
2022-05-11;"Prešovský kraj";51;347;16;363;NA;365584;67;2022-05-11;364981
2022-05-10;"Prešovský kraj";80;625;43;668;NA;365584;123;2022-05-10;364914
2022-05-09;"Prešovský kraj";28;546;45;591;NA;365584;73;2022-05-09;364791
2022-05-08;"Prešovský kraj";3;95;5;100;NA;365584;8;2022-05-08;364718
2022-05-07;"Prešovský kraj";27;122;8;130;NA;365584;35;2022-05-07;364710
2022-05-06;"Prešovský kraj";52;469;32;501;NA;365584;84;2022-05-06;364675
2022-05-05;"Prešovský kraj";58;395;15;410;NA;365584;73;2022-05-05;364591
2022-05-04;"Prešovský kraj";61;576;48;624;NA;365584;109;2022-05-04;364518
2022-05-03;"Prešovský kraj";96;834;28;862;NA;365584;124;2022-05-03;364409
2022-05-02;"Prešovský kraj";112;839;42;881;NA;365584;154;2022-05-02;364285
2022-05-01;"Prešovský kraj";13;164;12;176;NA;365584;25;2022-05-01;364131
2022-04-30;"Prešovský kraj";117;287;13;300;NA;365584;130;2022-04-30;364106
2022-04-29;"Prešovský kraj";150;841;31;872;NA;365584;181;2022-04-29;363976
2022-04-28;"Prešovský kraj";96;856;34;890;NA;365584;130;2022-04-28;363795
2022-04-27;"Prešovský kraj";177;1061;32;1093;NA;365584;209;2022-04-27;363665
2022-04-26;"Prešovský kraj";197;1106;38;1144;NA;365584;235;2022-04-26;363456
2022-04-25;"Prešovský kraj";229;1343;54;1397;NA;365584;283;2022-04-25;363221
2022-04-24;"Prešovský kraj";56;279;8;287;NA;365584;64;2022-04-24;362938
2022-04-23;"Prešovský kraj";121;277;11;288;NA;365584;132;2022-04-23;362874
2022-04-22;"Prešovský kraj";226;908;41;949;NA;365584;267;2022-04-22;362742
2022-04-21;"Prešovský kraj";193;1340;38;1378;NA;365584;231;2022-04-21;362475
2022-04-20;"Prešovský kraj";305;1236;40;1276;NA;365584;345;2022-04-20;362244
2022-04-19;"Prešovský kraj";332;1489;68;1557;NA;365584;400;2022-04-19;361899
2022-04-18;"Prešovský kraj";74;299;43;342;NA;365584;117;2022-04-18;361499
2022-04-17;"Prešovský kraj";117;172;10;182;NA;365584;127;2022-04-17;361382
2022-04-16;"Prešovský kraj";93;285;30;315;NA;365584;123;2022-04-16;361255
2022-04-15;"Prešovský kraj";125;207;1;208;NA;365584;126;2022-04-15;361132
2022-04-14;"Prešovský kraj";303;934;47;981;NA;365584;350;2022-04-14;361006
2022-04-13;"Prešovský kraj";352;1093;54;1147;NA;365584;406;2022-04-13;360656
2022-04-12;"Prešovský kraj";208;1222;58;1280;NA;365584;266;2022-04-12;360250
2022-04-11;"Prešovský kraj";437;1983;104;2087;NA;365584;541;2022-04-11;359984
2022-04-10;"Prešovský kraj";97;421;40;461;NA;365584;137;2022-04-10;359443
2022-04-09;"Prešovský kraj";234;346;42;388;NA;365584;276;2022-04-09;359306
2022-04-08;"Prešovský kraj";368;1290;86;1376;NA;365584;454;2022-04-08;359030
2022-04-07;"Prešovský kraj";442;1324;82;1406;NA;365584;524;2022-04-07;358576
2022-04-06;"Prešovský kraj";582;1297;96;1393;NA;365584;678;2022-04-06;358052
2022-04-05;"Prešovský kraj";596;1734;99;1833;NA;365584;695;2022-04-05;357374
2022-04-04;"Prešovský kraj";804;2064;169;2233;NA;365584;973;2022-04-04;356679
2022-04-03;"Prešovský kraj";159;579;76;655;NA;365584;235;2022-04-03;355706
2022-04-02;"Prešovský kraj";359;408;41;449;NA;365584;400;2022-04-02;355471
2022-04-01;"Prešovský kraj";621;1407;120;1527;NA;365584;741;2022-04-01;355071
2022-03-31;"Prešovský kraj";717;2187;132;2319;NA;365584;849;2022-03-31;354330
2022-03-30;"Prešovský kraj";973;2061;154;2215;NA;365584;1127;2022-03-30;353481
2022-03-29;"Prešovský kraj";645;2078;164;2242;NA;365584;809;2022-03-29;352354
2022-03-28;"Prešovský kraj";946;3199;256;3455;NA;365584;1202;2022-03-28;351545
2022-03-27;"Prešovský kraj";256;793;101;894;NA;365584;357;2022-03-27;350343
2022-03-26;"Prešovský kraj";719;663;80;743;NA;365584;799;2022-03-26;349986
2022-03-25;"Prešovský kraj";895;1956;227;2183;NA;365584;1122;2022-03-25;349187
2022-03-24;"Prešovský kraj";909;2153;200;2353;NA;365584;1109;2022-03-24;348065
2022-03-23;"Prešovský kraj";1291;2147;209;2356;NA;365584;1500;2022-03-23;346956
2022-03-22;"Prešovský kraj";1398;2251;192;2443;NA;365584;1590;2022-03-22;345456
2022-03-21;"Prešovský kraj";1234;3002;290;3292;NA;365584;1524;2022-03-21;343866
2022-03-20;"Prešovský kraj";262;813;130;943;NA;365584;392;2022-03-20;342342
2022-03-19;"Prešovský kraj";802;902;115;1017;NA;365584;917;2022-03-19;341950
2022-03-18;"Prešovský kraj";1217;2105;225;2330;NA;365584;1442;2022-03-18;341033
2022-03-17;"Prešovský kraj";1118;2446;182;2628;NA;365584;1300;2022-03-17;339591
2022-03-16;"Prešovský kraj";1585;2084;222;2306;NA;365584;1807;2022-03-16;338291
2022-03-15;"Prešovský kraj";1460;2329;217;2546;NA;365584;1677;2022-03-15;336484
2022-03-14;"Prešovský kraj";1438;3310;380;3690;NA;365584;1818;2022-03-14;334807
2022-03-13;"Prešovský kraj";432;1045;190;1235;NA;365584;622;2022-03-13;332989
2022-03-12;"Prešovský kraj";1150;857;117;974;NA;365584;1267;2022-03-12;332367
2022-03-11;"Prešovský kraj";1271;2553;287;2840;NA;365584;1558;2022-03-11;331100
2022-03-10;"Prešovský kraj";1114;2577;278;2855;NA;365584;1392;2022-03-10;329542
2022-03-09;"Prešovský kraj";1477;2815;345;3160;NA;365584;1822;2022-03-09;328150
2022-03-08;"Prešovský kraj";1716;2999;308;3307;NA;365584;2024;2022-03-08;326328
2022-03-07;"Prešovský kraj";1326;4197;509;4706;NA;365584;1835;2022-03-07;324304
2022-03-06;"Prešovský kraj";278;1650;232;1882;NA;365584;510;2022-03-06;322469
2022-03-05;"Prešovský kraj";785;1194;136;1330;NA;365584;921;2022-03-05;321959
2022-03-04;"Prešovský kraj";1263;2812;303;3115;NA;365584;1566;2022-03-04;321038
2022-03-03;"Prešovský kraj";1049;3016;373;3389;NA;365584;1422;2022-03-03;319472
2022-03-02;"Prešovský kraj";1526;2955;335;3290;NA;365584;1861;2022-03-02;318050
2022-03-01;"Prešovský kraj";1612;3302;338;3640;NA;365584;1950;2022-03-01;316189
2022-02-28;"Prešovský kraj";1234;4963;538;5501;NA;365584;1772;2022-02-28;314239
2022-02-27;"Prešovský kraj";523;1467;278;1745;NA;365584;801;2022-02-27;312467
2022-02-26;"Prešovský kraj";867;1317;167;1484;NA;365584;1034;2022-02-26;311666
2022-02-25;"Prešovský kraj";1740;2768;346;3114;NA;365584;2086;2022-02-25;310632
2022-02-24;"Prešovský kraj";1435;3301;399;3700;NA;365584;1834;2022-02-24;308546
2022-02-23;"Prešovský kraj";1837;3516;404;3920;NA;365584;2241;2022-02-23;306712
2022-02-22;"Prešovský kraj";2294;3893;407;4300;NA;365584;2701;2022-02-22;304471
2022-02-21;"Prešovský kraj";1609;5165;618;5783;NA;365584;2227;2022-02-21;301770
2022-02-20;"Prešovský kraj";759;1877;319;2196;NA;365584;1078;2022-02-20;299543
2022-02-19;"Prešovský kraj";1535;1556;247;1803;NA;365584;1782;2022-02-19;298465
2022-02-18;"Prešovský kraj";2332;3580;393;3973;NA;365584;2725;2022-02-18;296683
2022-02-17;"Prešovský kraj";2293;3740;457;4197;NA;365584;2750;2022-02-17;293958
2022-02-16;"Prešovský kraj";2494;4049;484;4533;NA;365584;2978;2022-02-16;291208
2022-02-15;"Prešovský kraj";2992;4583;551;5134;NA;365584;3543;2022-02-15;288230
2022-02-14;"Prešovský kraj";2122;6203;845;7048;NA;365584;2967;2022-02-14;284687
2022-02-13;"Prešovský kraj";1338;2452;434;2886;NA;365584;1772;2022-02-13;281720
2022-02-12;"Prešovský kraj";2333;1867;352;2219;NA;365584;2685;2022-02-12;279948
2022-02-11;"Prešovský kraj";2666;3931;520;4451;NA;365584;3186;2022-02-11;277263
2022-02-10;"Prešovský kraj";2977;4518;599;5117;NA;365584;3576;2022-02-10;274077
2022-02-09;"Prešovský kraj";2644;4502;634;5136;NA;365584;3278;2022-02-09;270501
2022-02-08;"Prešovský kraj";3387;4890;651;5541;NA;365584;4038;2022-02-08;267223
2022-02-07;"Prešovský kraj";2132;6920;941;7861;NA;365584;3073;2022-02-07;263185
2022-02-06;"Prešovský kraj";1360;2884;490;3374;NA;365584;1850;2022-02-06;260112
2022-02-05;"Prešovský kraj";2813;1993;334;2327;NA;365584;3147;2022-02-05;258262
2022-02-04;"Prešovský kraj";2944;4556;573;5129;NA;365584;3517;2022-02-04;255115
2022-02-03;"Prešovský kraj";3375;5205;487;5692;NA;365584;3862;2022-02-03;251598
2022-02-02;"Prešovský kraj";3150;5686;562;6248;NA;365584;3712;2022-02-02;247736
2022-02-01;"Prešovský kraj";2791;5694;631;6325;NA;365584;3422;2022-02-01;244024
2022-01-31;"Prešovský kraj";2444;9142;929;10071;NA;365584;3373;2022-01-31;240602
2022-01-30;"Prešovský kraj";1311;3437;495;3932;NA;365584;1806;2022-01-30;237229
2022-01-29;"Prešovský kraj";2291;1949;282;2231;NA;365584;2573;2022-01-29;235423
2022-01-28;"Prešovský kraj";2473;4784;486;5270;NA;365584;2959;2022-01-28;232850
2022-01-27;"Prešovský kraj";2353;4558;412;4970;NA;365584;2765;2022-01-27;229891
2022-01-26;"Prešovský kraj";2311;5628;405;6033;NA;365584;2716;2022-01-26;227126
2022-01-25;"Prešovský kraj";2127;5284;346;5630;NA;365584;2473;2022-01-25;224410
2022-01-24;"Prešovský kraj";1324;7619;410;8029;NA;365584;1734;2022-01-24;221937
2022-01-23;"Prešovský kraj";262;3584;218;3802;NA;365584;480;2022-01-23;220203
2022-01-22;"Prešovský kraj";1448;1764;157;1921;NA;365584;1605;2022-01-22;219723
2022-01-21;"Prešovský kraj";1128;4312;196;4508;NA;365584;1324;2022-01-21;218118
2022-01-20;"Prešovský kraj";1184;4012;156;4168;NA;365584;1340;2022-01-20;216794
2022-01-19;"Prešovský kraj";822;4781;173;4954;NA;365584;995;2022-01-19;215454
2022-01-18;"Prešovský kraj";1032;4918;163;5081;NA;365584;1195;2022-01-18;214459
2022-01-17;"Prešovský kraj";784;7143;150;7293;NA;365584;934;2022-01-17;213264
2022-01-16;"Prešovský kraj";113;3113;98;3211;NA;365584;211;2022-01-16;212330
2022-01-15;"Prešovský kraj";675;1546;64;1610;NA;365584;739;2022-01-15;212119
2022-01-14;"Prešovský kraj";202;3792;78;3870;NA;365584;280;2022-01-14;211380
2022-01-13;"Prešovský kraj";252;3550;89;3639;NA;365584;341;2022-01-13;211100
2022-01-12;"Prešovský kraj";431;4183;77;4260;NA;365584;508;2022-01-12;210759
2022-01-11;"Prešovský kraj";438;4812;80;4892;NA;365584;518;2022-01-11;210251
2022-01-10;"Prešovský kraj";469;7561;135;7696;NA;365584;604;2022-01-10;209733
2022-01-09;"Prešovský kraj";114;4129;78;4207;NA;365584;192;2022-01-09;209129
2022-01-08;"Prešovský kraj";291;2097;39;2136;NA;365584;330;2022-01-08;208937
2022-01-07;"Prešovský kraj";370;3882;106;3988;NA;365584;476;2022-01-07;208607
2022-01-06;"Prešovský kraj";104;1000;43;1043;NA;365584;147;2022-01-06;208131
2022-01-05;"Prešovský kraj";373;4752;100;4852;NA;365584;473;2022-01-05;207984
2022-01-04;"Prešovský kraj";428;4558;77;4635;NA;365584;505;2022-01-04;207511
2022-01-03;"Prešovský kraj";390;6868;105;6973;NA;365584;495;2022-01-03;207006
2022-01-02;"Prešovský kraj";158;3180;75;3255;NA;365584;233;2022-01-02;206511
2022-01-01;"Prešovský kraj";55;379;8;387;NA;365584;63;2022-01-01;206278
2021-12-31;"Prešovský kraj";220;2217;77;2294;NA;365584;297;2021-12-31;206215
2021-12-30;"Prešovský kraj";230;2985;81;3066;NA;365584;311;2021-12-30;205918
2021-12-29;"Prešovský kraj";298;3924;73;3997;NA;365584;371;2021-12-29;205607
2021-12-28;"Prešovský kraj";365;3625;60;3685;NA;365584;425;2021-12-28;205236
2021-12-27;"Prešovský kraj";593;5336;93;5429;NA;365584;686;2021-12-27;204811
2021-12-26;"Prešovský kraj";112;1584;62;1646;NA;365584;174;2021-12-26;204125
2021-12-25;"Prešovský kraj";12;600;29;629;NA;365584;41;2021-12-25;203951
2021-12-24;"Prešovský kraj";27;463;26;489;NA;365584;53;2021-12-24;203910
2021-12-23;"Prešovský kraj";623;3125;76;3201;NA;365584;699;2021-12-23;203857
2021-12-22;"Prešovský kraj";234;3600;86;3686;NA;365584;320;2021-12-22;203158
2021-12-21;"Prešovský kraj";520;4571;78;4649;NA;365584;598;2021-12-21;202838
2021-12-20;"Prešovský kraj";371;7190;107;7297;NA;365584;478;2021-12-20;202240
2021-12-19;"Prešovský kraj";110;3166;74;3240;NA;365584;184;2021-12-19;201762
2021-12-18;"Prešovský kraj";313;1562;61;1623;NA;365584;374;2021-12-18;201578
2021-12-17;"Prešovský kraj";429;4482;96;4578;NA;365584;525;2021-12-17;201204
2021-12-16;"Prešovský kraj";401;4557;95;4652;NA;365584;496;2021-12-16;200679
2021-12-15;"Prešovský kraj";473;4499;79;4578;NA;365584;552;2021-12-15;200183
2021-12-14;"Prešovský kraj";662;5468;125;5593;NA;365584;787;2021-12-14;199631
2021-12-13;"Prešovský kraj";588;8085;175;8260;NA;365584;763;2021-12-13;198844
2021-12-12;"Prešovský kraj";160;3852;106;3958;NA;365584;266;2021-12-12;198081
2021-12-11;"Prešovský kraj";483;2040;91;2131;NA;365584;574;2021-12-11;197815
2021-12-10;"Prešovský kraj";649;5018;140;5158;NA;365584;789;2021-12-10;197241
2021-12-09;"Prešovský kraj";669;4702;135;4837;NA;365584;804;2021-12-09;196452
2021-12-08;"Prešovský kraj";944;4794;167;4961;NA;365584;1111;2021-12-08;195648
2021-12-07;"Prešovský kraj";1217;5853;188;6041;NA;365584;1405;2021-12-07;194537
2021-12-06;"Prešovský kraj";784;8604;247;8851;NA;365584;1031;2021-12-06;193132
2021-12-05;"Prešovský kraj";145;4439;133;4572;NA;365584;278;2021-12-05;192101
2021-12-04;"Prešovský kraj";1025;2290;127;2417;NA;365584;1152;2021-12-04;191823
2021-12-03;"Prešovský kraj";1040;5268;231;5499;NA;365584;1271;2021-12-03;190671
2021-12-02;"Prešovský kraj";2255;5291;183;5474;NA;365584;2438;2021-12-02;189400
2021-12-01;"Prešovský kraj";826;5267;239;5506;NA;365584;1065;2021-12-01;186962
2021-11-30;"Prešovský kraj";1123;6651;265;6916;NA;365584;1388;2021-11-30;185897
2021-11-29;"Prešovský kraj";583;11478;473;11951;NA;365584;1056;2021-11-29;184509
2021-11-28;"Prešovský kraj";919;5898;234;6132;NA;365584;1153;2021-11-28;183453
2021-11-27;"Prešovský kraj";884;2977;219;3196;NA;365584;1103;2021-11-27;182300
2021-11-26;"Prešovský kraj";1311;5890;328;6218;NA;365584;1639;2021-11-26;181197
2021-11-25;"Prešovský kraj";1285;5051;307;5358;NA;365584;1592;2021-11-25;179558
2021-11-24;"Prešovský kraj";1209;6120;357;6477;NA;365584;1566;2021-11-24;177966
2021-11-23;"Prešovský kraj";1099;6631;314;6945;NA;365584;1413;2021-11-23;176400
2021-11-22;"Prešovský kraj";905;8209;529;8738;NA;365584;1434;2021-11-22;174987
2021-11-21;"Prešovský kraj";950;3766;316;4082;NA;365584;1266;2021-11-21;173553
2021-11-20;"Prešovský kraj";1372;2193;222;2415;NA;365584;1594;2021-11-20;172287
2021-11-19;"Prešovský kraj";1629;5864;452;6316;NA;365584;2081;2021-11-19;170693
2021-11-18;"Prešovský kraj";823;6696;518;7214;NA;365584;1341;2021-11-18;168612
2021-11-17;"Prešovský kraj";1648;1336;148;1484;NA;365584;1796;2021-11-17;167271
2021-11-16;"Prešovský kraj";1346;5511;398;5909;NA;365584;1744;2021-11-16;165475
2021-11-15;"Prešovský kraj";897;7804;577;8381;NA;365584;1474;2021-11-15;163731
2021-11-14;"Prešovský kraj";603;3168;311;3479;NA;365584;914;2021-11-14;162257
2021-11-13;"Prešovský kraj";1255;2068;262;2330;NA;365584;1517;2021-11-13;161343
2021-11-12;"Prešovský kraj";1358;5236;371;5607;NA;365584;1729;2021-11-12;159826
2021-11-11;"Prešovský kraj";1218;5087;438;5525;NA;365584;1656;2021-11-11;158097
2021-11-10;"Prešovský kraj";1278;4966;380;5346;NA;365584;1658;2021-11-10;156441
2021-11-09;"Prešovský kraj";1038;5431;407;5838;NA;365584;1445;2021-11-09;154783
2021-11-08;"Prešovský kraj";1068;6987;574;7561;NA;365584;1642;2021-11-08;153338
2021-11-07;"Prešovský kraj";421;2500;242;2742;NA;365584;663;2021-11-07;151696
2021-11-06;"Prešovský kraj";1389;1899;234;2133;NA;365584;1623;2021-11-06;151033
2021-11-05;"Prešovský kraj";1080;4974;367;5341;NA;365584;1447;2021-11-05;149410
2021-11-04;"Prešovský kraj";1743;5162;322;5484;NA;365584;2065;2021-11-04;147963
2021-11-03;"Prešovský kraj";1326;5337;387;5724;NA;365584;1713;2021-11-03;145898
2021-11-02;"Prešovský kraj";1002;7553;556;8109;NA;365584;1558;2021-11-02;144185
2021-11-01;"Prešovský kraj";347;1402;131;1533;NA;365584;478;2021-11-01;142627
2021-10-31;"Prešovský kraj";447;2045;210;2255;NA;365584;657;2021-10-31;142149
2021-10-30;"Prešovský kraj";1148;1928;183;2111;NA;365584;1331;2021-10-30;141492
2021-10-29;"Prešovský kraj";1360;4460;253;4713;NA;365584;1613;2021-10-29;140161
2021-10-28;"Prešovský kraj";960;4500;300;4800;NA;365584;1260;2021-10-28;138548
2021-10-27;"Prešovský kraj";1444;4325;221;4546;NA;365584;1665;2021-10-27;137288
2021-10-26;"Prešovský kraj";940;5125;217;5342;NA;365584;1157;2021-10-26;135623
2021-10-25;"Prešovský kraj";673;6077;348;6425;NA;365584;1021;2021-10-25;134466
2021-10-24;"Prešovský kraj";110;2180;149;2329;NA;365584;259;2021-10-24;133445
2021-10-23;"Prešovský kraj";1145;1928;141;2069;NA;365584;1286;2021-10-23;133186
2021-10-22;"Prešovský kraj";792;4876;177;5053;NA;365584;969;2021-10-22;131900
2021-10-21;"Prešovský kraj";901;4738;191;4929;NA;365584;1092;2021-10-21;130931
2021-10-20;"Prešovský kraj";833;4199;195;4394;NA;365584;1028;2021-10-20;129839
2021-10-19;"Prešovský kraj";830;4728;175;4903;NA;365584;1005;2021-10-19;128811
2021-10-18;"Prešovský kraj";454;5752;240;5992;NA;365584;694;2021-10-18;127806
2021-10-17;"Prešovský kraj";181;2430;131;2561;NA;365584;312;2021-10-17;127112
2021-10-16;"Prešovský kraj";561;1924;94;2018;NA;365584;655;2021-10-16;126800
2021-10-15;"Prešovský kraj";533;4735;107;4842;NA;365584;640;2021-10-15;126145
2021-10-14;"Prešovský kraj";506;3948;85;4033;NA;365584;591;2021-10-14;125505
2021-10-13;"Prešovský kraj";549;3794;98;3892;NA;365584;647;2021-10-13;124914
2021-10-12;"Prešovský kraj";520;3966;101;4067;NA;365584;621;2021-10-12;124267
2021-10-11;"Prešovský kraj";433;5421;131;5552;NA;365584;564;2021-10-11;123646
2021-10-10;"Prešovský kraj";78;2099;64;2163;NA;365584;142;2021-10-10;123082
2021-10-09;"Prešovský kraj";311;2077;47;2124;NA;365584;358;2021-10-09;122940
2021-10-08;"Prešovský kraj";636;4934;94;5028;NA;365584;730;2021-10-08;122582
2021-10-07;"Prešovský kraj";487;3919;101;4020;NA;365584;588;2021-10-07;121852
2021-10-06;"Prešovský kraj";296;3851;104;3955;NA;365584;400;2021-10-06;121264
2021-10-05;"Prešovský kraj";430;4151;90;4241;NA;365584;520;2021-10-05;120864
2021-10-04;"Prešovský kraj";353;5569;125;5694;NA;365584;478;2021-10-04;120344
2021-10-03;"Prešovský kraj";19;2324;47;2371;NA;365584;66;2021-10-03;119866
2021-10-02;"Prešovský kraj";269;2238;58;2296;NA;365584;327;2021-10-02;119800
2021-10-01;"Prešovský kraj";325;4997;63;5060;NA;365584;388;2021-10-01;119473
2021-09-30;"Prešovský kraj";265;4044;83;4127;NA;365584;348;2021-09-30;119085
2021-09-29;"Prešovský kraj";381;3825;55;3880;NA;365584;436;2021-09-29;118737
2021-09-28;"Prešovský kraj";312;4714;69;4783;NA;365584;381;2021-09-28;118301
2021-09-27;"Prešovský kraj";257;5062;104;5166;NA;365584;361;2021-09-27;117920
2021-09-26;"Prešovský kraj";8;2422;67;2489;NA;365584;75;2021-09-26;117559
2021-09-25;"Prešovský kraj";134;2540;46;2586;NA;365584;180;2021-09-25;117484
2021-09-24;"Prešovský kraj";297;4822;61;4883;NA;365584;358;2021-09-24;117304
2021-09-23;"Prešovský kraj";109;4105;45;4150;NA;365584;154;2021-09-23;116946
2021-09-22;"Prešovský kraj";177;3836;41;3877;NA;365584;218;2021-09-22;116792
2021-09-21;"Prešovský kraj";219;5059;66;5125;NA;365584;285;2021-09-21;116574
2021-09-20;"Prešovský kraj";180;5183;68;5251;NA;365584;248;2021-09-20;116289
2021-09-19;"Prešovský kraj";7;2726;30;2756;NA;365584;37;2021-09-19;116041
2021-09-18;"Prešovský kraj";169;2406;37;2443;NA;365584;206;2021-09-18;116004
2021-09-17;"Prešovský kraj";157;4402;52;4454;NA;365584;209;2021-09-17;115798
2021-09-16;"Prešovský kraj";146;4371;71;4442;NA;365584;217;2021-09-16;115589
2021-09-15;"Prešovský kraj";68;701;19;720;NA;365584;87;2021-09-15;115372
2021-09-14;"Prešovský kraj";133;3369;38;3407;NA;365584;171;2021-09-14;115285
2021-09-13;"Prešovský kraj";105;4225;37;4262;NA;365584;142;2021-09-13;115114
2021-09-12;"Prešovský kraj";4;1776;29;1805;NA;365584;33;2021-09-12;114972
2021-09-11;"Prešovský kraj";65;2012;24;2036;NA;365584;89;2021-09-11;114939
2021-09-10;"Prešovský kraj";105;3241;30;3271;NA;365584;135;2021-09-10;114850
2021-09-09;"Prešovský kraj";29;3090;27;3117;NA;365584;56;2021-09-09;114715
2021-09-08;"Prešovský kraj";73;2444;20;2464;NA;365584;93;2021-09-08;114659
2021-09-07;"Prešovský kraj";82;2449;24;2473;NA;365584;106;2021-09-07;114566
2021-09-06;"Prešovský kraj";61;3282;20;3302;NA;365584;81;2021-09-06;114460
2021-09-05;"Prešovský kraj";5;1338;11;1349;NA;365584;16;2021-09-05;114379
2021-09-04;"Prešovský kraj";27;1864;14;1878;NA;365584;41;2021-09-04;114363
2021-09-03;"Prešovský kraj";39;2976;15;2991;NA;365584;54;2021-09-03;114322
2021-09-02;"Prešovský kraj";39;2558;20;2578;NA;365584;59;2021-09-02;114268
2021-09-01;"Prešovský kraj";14;575;6;581;NA;365584;20;2021-09-01;114209
2021-08-31;"Prešovský kraj";47;2438;13;2451;NA;365584;60;2021-08-31;114189
2021-08-30;"Prešovský kraj";23;2827;19;2846;NA;365584;42;2021-08-30;114129
2021-08-29;"Prešovský kraj";3;781;1;782;NA;365584;4;2021-08-29;114087
2021-08-28;"Prešovský kraj";5;2101;8;2109;NA;365584;13;2021-08-28;114083
2021-08-27;"Prešovský kraj";32;3084;8;3092;NA;365584;40;2021-08-27;114070
2021-08-26;"Prešovský kraj";13;2094;8;2102;NA;365584;21;2021-08-26;114030
2021-08-25;"Prešovský kraj";18;1947;4;1951;NA;365584;22;2021-08-25;114009
2021-08-24;"Prešovský kraj";10;2138;5;2143;NA;365584;15;2021-08-24;113987
2021-08-23;"Prešovský kraj";16;2576;6;2582;NA;365584;22;2021-08-23;113972
2021-08-22;"Prešovský kraj";0;1440;6;1446;NA;365584;6;2021-08-22;113950
2021-08-21;"Prešovský kraj";28;2018;4;2022;NA;365584;32;2021-08-21;113944
2021-08-20;"Prešovský kraj";15;2906;7;2913;NA;365584;22;2021-08-20;113912
2021-08-19;"Prešovský kraj";22;2242;8;2250;NA;365584;30;2021-08-19;113890
2021-08-18;"Prešovský kraj";6;1752;11;1763;NA;365584;17;2021-08-18;113860
2021-08-17;"Prešovský kraj";29;1829;6;1835;NA;365584;35;2021-08-17;113843
2021-08-16;"Prešovský kraj";11;2524;7;2531;NA;365584;18;2021-08-16;113808
2021-08-15;"Prešovský kraj";0;896;2;898;NA;365584;2;2021-08-15;113790
2021-08-14;"Prešovský kraj";14;1662;1;1663;NA;365584;15;2021-08-14;113788
2021-08-13;"Prešovský kraj";24;1646;12;1658;NA;365584;36;2021-08-13;113773
2021-08-12;"Prešovský kraj";9;1752;3;1755;NA;365584;12;2021-08-12;113737
2021-08-11;"Prešovský kraj";15;1193;3;1196;NA;365584;18;2021-08-11;113725
2021-08-10;"Prešovský kraj";10;1102;4;1106;NA;365584;14;2021-08-10;113707
2021-08-09;"Prešovský kraj";13;2156;4;2160;NA;365584;17;2021-08-09;113693
2021-08-08;"Prešovský kraj";2;675;2;677;NA;365584;4;2021-08-08;113676
2021-08-07;"Prešovský kraj";5;1114;3;1117;NA;365584;8;2021-08-07;113672
2021-08-06;"Prešovský kraj";9;1459;4;1463;NA;365584;13;2021-08-06;113664
2021-08-05;"Prešovský kraj";9;1370;2;1372;NA;365584;11;2021-08-05;113651
2021-08-04;"Prešovský kraj";6;1007;1;1008;NA;365584;7;2021-08-04;113640
2021-08-03;"Prešovský kraj";8;976;1;977;NA;365584;9;2021-08-03;113633
2021-08-02;"Prešovský kraj";5;1477;6;1483;NA;365584;11;2021-08-02;113624
2021-08-01;"Prešovský kraj";0;738;2;740;NA;365584;2;2021-08-01;113613
2021-07-31;"Prešovský kraj";20;1080;0;1080;NA;365584;20;2021-07-31;113611
2021-07-30;"Prešovský kraj";2;1518;1;1519;NA;365584;3;2021-07-30;113591
2021-07-29;"Prešovský kraj";6;1302;1;1303;NA;365584;7;2021-07-29;113588
2021-07-28;"Prešovský kraj";6;1106;1;1107;NA;365584;7;2021-07-28;113581
2021-07-27;"Prešovský kraj";5;1140;2;1142;NA;365584;7;2021-07-27;113574
2021-07-26;"Prešovský kraj";12;1583;1;1584;NA;365584;13;2021-07-26;113567
2021-07-25;"Prešovský kraj";0;687;1;688;NA;365584;1;2021-07-25;113554
2021-07-24;"Prešovský kraj";8;1040;0;1040;NA;365584;8;2021-07-24;113553
2021-07-23;"Prešovský kraj";8;1608;1;1609;NA;365584;9;2021-07-23;113545
2021-07-22;"Prešovský kraj";13;1431;10;1441;NA;365584;23;2021-07-22;113536
2021-07-21;"Prešovský kraj";5;1076;1;1077;NA;365584;6;2021-07-21;113513
2021-07-20;"Prešovský kraj";4;1064;0;1064;NA;365584;4;2021-07-20;113507
2021-07-19;"Prešovský kraj";2;1644;4;1648;NA;365584;6;2021-07-19;113503
2021-07-18;"Prešovský kraj";1;647;0;647;NA;365584;1;2021-07-18;113497
2021-07-17;"Prešovský kraj";6;1245;1;1246;NA;365584;7;2021-07-17;113496
2021-07-16;"Prešovský kraj";4;1558;2;1560;NA;365584;6;2021-07-16;113489
2021-07-15;"Prešovský kraj";5;1310;4;1314;NA;365584;9;2021-07-15;113483
2021-07-14;"Prešovský kraj";1;1051;2;1053;NA;365584;3;2021-07-14;113474
2021-07-13;"Prešovský kraj";1;1071;2;1073;NA;365584;3;2021-07-13;113471
2021-07-12;"Prešovský kraj";1;1949;2;1951;NA;365584;3;2021-07-12;113468
2021-07-11;"Prešovský kraj";0;660;1;661;NA;365584;1;2021-07-11;113465
2021-07-10;"Prešovský kraj";4;1229;2;1231;NA;365584;6;2021-07-10;113464
2021-07-09;"Prešovský kraj";6;1957;1;1958;NA;365584;7;2021-07-09;113458
2021-07-08;"Prešovský kraj";5;1192;0;1192;NA;365584;5;2021-07-08;113451
2021-07-07;"Prešovský kraj";7;1468;3;1471;NA;365584;10;2021-07-07;113446
2021-07-06;"Prešovský kraj";5;1423;2;1425;NA;365584;7;2021-07-06;113436
2021-07-05;"Prešovský kraj";2;645;0;645;NA;365584;2;2021-07-05;113429
2021-07-04;"Prešovský kraj";0;788;0;788;NA;365584;0;2021-07-04;113427
2021-07-03;"Prešovský kraj";2;1391;0;1391;NA;365584;2;2021-07-03;113427
2021-07-02;"Prešovský kraj";4;1796;0;1796;NA;365584;4;2021-07-02;113425
2021-07-01;"Prešovský kraj";2;1590;1;1591;NA;365584;3;2021-07-01;113421
2021-06-30;"Prešovský kraj";3;8829;4;8833;NA;365584;7;2021-06-30;113418
2021-06-29;"Prešovský kraj";1;4935;3;4938;NA;365584;4;2021-06-29;113411
2021-06-28;"Prešovský kraj";5;6109;2;6111;NA;365584;7;2021-06-28;113407
2021-06-27;"Prešovský kraj";0;3852;1;3853;NA;365584;1;2021-06-27;113400
2021-06-26;"Prešovský kraj";4;5815;1;5816;NA;365584;5;2021-06-26;113399
2021-06-25;"Prešovský kraj";7;7321;4;7325;NA;365584;11;2021-06-25;113394
2021-06-24;"Prešovský kraj";10;5406;5;5411;NA;365584;15;2021-06-24;113383
2021-06-23;"Prešovský kraj";4;5124;2;5126;NA;365584;6;2021-06-23;113368
2021-06-22;"Prešovský kraj";5;5143;1;5144;NA;365584;6;2021-06-22;113362
2021-06-21;"Prešovský kraj";13;7033;6;7039;NA;365584;19;2021-06-21;113356
2021-06-20;"Prešovský kraj";0;5204;3;5207;NA;365584;3;2021-06-20;113337
2021-06-19;"Prešovský kraj";1;7349;5;7354;NA;365584;6;2021-06-19;113334
2021-06-18;"Prešovský kraj";9;8682;10;8692;NA;365584;19;2021-06-18;113328
2021-06-17;"Prešovský kraj";9;6548;5;6553;NA;365584;14;2021-06-17;113309
2021-06-16;"Prešovský kraj";6;6422;3;6425;NA;365584;9;2021-06-16;113295
2021-06-15;"Prešovský kraj";2;5709;4;5713;NA;365584;6;2021-06-15;113286
2021-06-14;"Prešovský kraj";5;8229;13;8242;NA;365584;18;2021-06-14;113280
2021-06-13;"Prešovský kraj";1;6455;7;6462;NA;365584;8;2021-06-13;113262
2021-06-12;"Prešovský kraj";3;8904;9;8913;NA;365584;12;2021-06-12;113254
2021-06-11;"Prešovský kraj";21;9877;9;9886;NA;365584;30;2021-06-11;113242
2021-06-10;"Prešovský kraj";11;6512;10;6522;NA;365584;21;2021-06-10;113212
2021-06-09;"Prešovský kraj";16;6375;3;6378;NA;365584;19;2021-06-09;113191
2021-06-08;"Prešovský kraj";31;6495;12;6507;NA;365584;43;2021-06-08;113172
2021-06-07;"Prešovský kraj";11;9111;15;9126;NA;365584;26;2021-06-07;113129
2021-06-06;"Prešovský kraj";0;8016;5;8021;NA;365584;5;2021-06-06;113103
2021-06-05;"Prešovský kraj";17;10248;15;10263;NA;365584;32;2021-06-05;113098
2021-06-04;"Prešovský kraj";26;10375;18;10393;NA;365584;44;2021-06-04;113066
2021-06-03;"Prešovský kraj";14;6820;16;6836;NA;365584;30;2021-06-03;113022
2021-06-02;"Prešovský kraj";47;7372;14;7386;NA;365584;61;2021-06-02;112992
2021-06-01;"Prešovský kraj";15;6926;14;6940;NA;365584;29;2021-06-01;112931
2021-05-31;"Prešovský kraj";27;9951;22;9973;NA;365584;49;2021-05-31;112902
2021-05-30;"Prešovský kraj";2;9717;14;9731;NA;365584;16;2021-05-30;112853
2021-05-29;"Prešovský kraj";23;12733;24;12757;NA;365584;47;2021-05-29;112837
2021-05-28;"Prešovský kraj";30;12468;19;12487;NA;365584;49;2021-05-28;112790
2021-05-27;"Prešovský kraj";16;7653;37;7690;NA;365584;53;2021-05-27;112741
2021-05-26;"Prešovský kraj";32;8140;23;8163;NA;365584;55;2021-05-26;112688
2021-05-25;"Prešovský kraj";38;8690;20;8710;NA;365584;58;2021-05-25;112633
2021-05-24;"Prešovský kraj";17;13298;37;13335;NA;365584;54;2021-05-24;112575
2021-05-23;"Prešovský kraj";3;11947;20;11967;NA;365584;23;2021-05-23;112521
2021-05-22;"Prešovský kraj";11;14422;44;14466;NA;365584;55;2021-05-22;112498
2021-05-21;"Prešovský kraj";44;13803;24;13827;NA;365584;68;2021-05-21;112443
2021-05-20;"Prešovský kraj";13;9437;29;9466;NA;365584;42;2021-05-20;112375
2021-05-19;"Prešovský kraj";60;10756;36;10792;NA;365584;96;2021-05-19;112333
2021-05-18;"Prešovský kraj";44;9062;27;9089;NA;365584;71;2021-05-18;112237
2021-05-17;"Prešovský kraj";60;12856;47;12903;NA;365584;107;2021-05-17;112166
2021-05-16;"Prešovský kraj";20;16302;66;16368;NA;365584;86;2021-05-16;112059
2021-05-15;"Prešovský kraj";20;24604;81;24685;NA;365584;101;2021-05-15;111973
2021-05-14;"Prešovský kraj";49;18671;68;18739;NA;365584;117;2021-05-14;111872
2021-05-13;"Prešovský kraj";54;11166;71;11237;NA;365584;125;2021-05-13;111755
2021-05-12;"Prešovský kraj";59;10822;39;10861;NA;365584;98;2021-05-12;111630
2021-05-11;"Prešovský kraj";61;10728;48;10776;NA;365584;109;2021-05-11;111532
2021-05-10;"Prešovský kraj";79;15726;67;15793;NA;365584;146;2021-05-10;111423
2021-05-09;"Prešovský kraj";54;21658;82;21740;NA;365584;136;2021-05-09;111277
2021-05-08;"Prešovský kraj";39;23050;52;23102;NA;365584;91;2021-05-08;111141
2021-05-07;"Prešovský kraj";81;23543;66;23609;NA;365584;147;2021-05-07;111050
2021-05-06;"Prešovský kraj";107;12924;66;12990;NA;365584;173;2021-05-06;110903
2021-05-05;"Prešovský kraj";60;12808;84;12892;NA;365584;144;2021-05-05;110730
2021-05-04;"Prešovský kraj";203;13470;67;13537;NA;365584;270;2021-05-04;110586
2021-05-03;"Prešovský kraj";68;18458;109;18567;NA;365584;177;2021-05-03;110316
2021-05-02;"Prešovský kraj";29;36676;102;36778;NA;365584;131;2021-05-02;110139
2021-05-01;"Prešovský kraj";70;57153;183;57336;NA;365584;253;2021-05-01;110008
2021-04-30;"Prešovský kraj";135;39333;118;39451;NA;365584;253;2021-04-30;109755
2021-04-29;"Prešovský kraj";110;16635;97;16732;NA;365584;207;2021-04-29;109502
2021-04-28;"Prešovský kraj";122;18671;89;18760;NA;365584;211;2021-04-28;109295
2021-04-27;"Prešovský kraj";154;19994;120;20114;NA;365584;274;2021-04-27;109084
2021-04-26;"Prešovský kraj";99;27241;123;27364;NA;365584;222;2021-04-26;108810
2021-04-25;"Prešovský kraj";9;52776;156;52932;NA;365584;165;2021-04-25;108588
2021-04-24;"Prešovský kraj";61;85698;243;85941;NA;365584;304;2021-04-24;108423
2021-04-23;"Prešovský kraj";171;40365;137;40502;NA;365584;308;2021-04-23;108119
2021-04-22;"Prešovský kraj";86;18104;125;18229;NA;365584;211;2021-04-22;107811
2021-04-21;"Prešovský kraj";144;21550;139;21689;NA;365584;283;2021-04-21;107600
2021-04-20;"Prešovský kraj";115;23346;128;23474;NA;365584;243;2021-04-20;107317
2021-04-19;"Prešovský kraj";106;29133;145;29278;NA;365584;251;2021-04-19;107074
2021-04-18;"Prešovský kraj";4;51824;129;51953;NA;365584;133;2021-04-18;106823
2021-04-17;"Prešovský kraj";119;97970;238;98208;NA;365584;357;2021-04-17;106690
2021-04-16;"Prešovský kraj";135;40989;146;41135;NA;365584;281;2021-04-16;106333
2021-04-15;"Prešovský kraj";112;20179;137;20316;NA;365584;249;2021-04-15;106052
2021-04-14;"Prešovský kraj";199;23332;130;23462;NA;365584;329;2021-04-14;105803
2021-04-13;"Prešovský kraj";180;23907;116;24023;NA;365584;296;2021-04-13;105474
2021-04-12;"Prešovský kraj";172;30152;175;30327;NA;365584;347;2021-04-12;105178
2021-04-11;"Prešovský kraj";11;49955;187;50142;NA;365584;198;2021-04-11;104831
2021-04-10;"Prešovský kraj";94;90181;297;90478;NA;365584;391;2021-04-10;104633
2021-04-09;"Prešovský kraj";255;37163;200;37363;NA;365584;455;2021-04-09;104242
2021-04-08;"Prešovský kraj";192;18893;157;19050;NA;365584;349;2021-04-08;103787
2021-04-07;"Prešovský kraj";314;27797;154;27951;NA;365584;468;2021-04-07;103438
2021-04-06;"Prešovský kraj";231;41711;268;41979;NA;365584;499;2021-04-06;102970
2021-04-05;"Prešovský kraj";54;18454;132;18586;NA;365584;186;2021-04-05;102471
2021-04-04;"Prešovský kraj";31;18569;91;18660;NA;365584;122;2021-04-04;102285
2021-04-03;"Prešovský kraj";104;90664;321;90985;NA;365584;425;2021-04-03;102163
2021-04-02;"Prešovský kraj";194;23381;134;23515;NA;365584;328;2021-04-02;101738
2021-04-01;"Prešovský kraj";256;42879;195;43074;NA;365584;451;2021-04-01;101410
2021-03-31;"Prešovský kraj";311;30176;227;30403;NA;365584;538;2021-03-31;100959
2021-03-30;"Prešovský kraj";374;20751;203;20954;NA;365584;577;2021-03-30;100421
2021-03-29;"Prešovský kraj";219;28188;229;28417;NA;365584;448;2021-03-29;99844
2021-03-28;"Prešovský kraj";26;46811;256;47067;NA;365584;282;2021-03-28;99396
2021-03-27;"Prešovský kraj";181;88673;372;89045;NA;365584;553;2021-03-27;99114
2021-03-26;"Prešovský kraj";310;47751;299;48050;NA;365584;609;2021-03-26;98561
2021-03-25;"Prešovský kraj";248;22281;213;22494;NA;365584;461;2021-03-25;97952
2021-03-24;"Prešovský kraj";381;19590;213;19803;NA;365584;594;2021-03-24;97491
2021-03-23;"Prešovský kraj";241;20351;255;20606;NA;365584;496;2021-03-23;96897
2021-03-22;"Prešovský kraj";299;28634;287;28921;NA;365584;586;2021-03-22;96401
2021-03-21;"Prešovský kraj";32;49439;266;49705;NA;365584;298;2021-03-21;95815
2021-03-20;"Prešovský kraj";180;92529;426;92955;NA;365584;606;2021-03-20;95517
2021-03-19;"Prešovský kraj";373;46582;326;46908;NA;365584;699;2021-03-19;94911
2021-03-18;"Prešovský kraj";251;21721;217;21938;NA;365584;468;2021-03-18;94212
2021-03-17;"Prešovský kraj";331;20887;231;21118;NA;365584;562;2021-03-17;93744
2021-03-16;"Prešovský kraj";461;21094;278;21372;NA;365584;739;2021-03-16;93182
2021-03-15;"Prešovský kraj";370;28813;324;29137;NA;365584;694;2021-03-15;92443
2021-03-14;"Prešovský kraj";52;50410;356;50766;NA;365584;408;2021-03-14;91749
2021-03-13;"Prešovský kraj";200;94768;531;95299;NA;365584;731;2021-03-13;91341
2021-03-12;"Prešovský kraj";425;47691;368;48059;NA;365584;793;2021-03-12;90610
2021-03-11;"Prešovský kraj";463;22059;253;22312;NA;365584;716;2021-03-11;89817
2021-03-10;"Prešovský kraj";325;20821;293;21114;NA;365584;618;2021-03-10;89101
2021-03-09;"Prešovský kraj";505;21496;288;21784;NA;365584;793;2021-03-09;88483
2021-03-08;"Prešovský kraj";314;28903;333;29236;NA;365584;647;2021-03-08;87690
2021-03-07;"Prešovský kraj";19;48328;388;48716;NA;365584;407;2021-03-07;87043
2021-03-06;"Prešovský kraj";193;97527;591;98118;NA;365584;784;2021-03-06;86636
2021-03-05;"Prešovský kraj";497;46054;397;46451;NA;365584;894;2021-03-05;85852
2021-03-04;"Prešovský kraj";372;22670;359;23029;NA;365584;731;2021-03-04;84958
2021-03-03;"Prešovský kraj";397;21623;333;21956;NA;365584;730;2021-03-03;84227
2021-03-02;"Prešovský kraj";421;22682;357;23039;NA;365584;778;2021-03-02;83497
2021-03-01;"Prešovský kraj";303;27716;406;28122;NA;365584;709;2021-03-01;82719
2021-02-28;"Prešovský kraj";75;45000;387;45387;NA;365584;462;2021-02-28;82010
2021-02-27;"Prešovský kraj";273;90231;734;90965;NA;365584;1007;2021-02-27;81548
2021-02-26;"Prešovský kraj";455;41340;438;41778;NA;365584;893;2021-02-26;80541
2021-02-25;"Prešovský kraj";270;19496;337;19833;NA;365584;607;2021-02-25;79648
2021-02-24;"Prešovský kraj";328;19026;377;19403;NA;365584;705;2021-02-24;79041
2021-02-23;"Prešovský kraj";430;21277;345;21622;NA;365584;775;2021-02-23;78336
2021-02-22;"Prešovský kraj";351;27180;356;27536;NA;365584;707;2021-02-22;77561
2021-02-21;"Prešovský kraj";66;31453;301;31754;NA;365584;367;2021-02-21;76854
2021-02-20;"Prešovský kraj";129;71413;517;71930;NA;365584;646;2021-02-20;76487
2021-02-19;"Prešovský kraj";381;38995;430;39425;NA;365584;811;2021-02-19;75841
2021-02-18;"Prešovský kraj";268;16960;322;17282;NA;365584;590;2021-02-18;75030
2021-02-17;"Prešovský kraj";293;17392;246;17638;NA;365584;539;2021-02-17;74440
2021-02-16;"Prešovský kraj";422;18862;265;19127;NA;365584;687;2021-02-16;73901
2021-02-15;"Prešovský kraj";211;31366;303;31669;NA;365584;514;2021-02-15;73214
2021-02-14;"Prešovský kraj";27;39387;321;39708;NA;365584;348;2021-02-14;72700
2021-02-13;"Prešovský kraj";157;74747;402;75149;NA;365584;559;2021-02-13;72352
2021-02-12;"Prešovský kraj";308;38758;365;39123;NA;365584;673;2021-02-12;71793
2021-02-11;"Prešovský kraj";218;16218;239;16457;NA;365584;457;2021-02-11;71120
2021-02-10;"Prešovský kraj";220;18542;282;18824;NA;365584;502;2021-02-10;70663
2021-02-09;"Prešovský kraj";323;21497;370;21867;NA;365584;693;2021-02-09;70161
2021-02-08;"Prešovský kraj";161;36924;261;37185;NA;365584;422;2021-02-08;69468
2021-02-07;"Prešovský kraj";21;34227;209;34436;NA;365584;230;2021-02-07;69046
2021-02-06;"Prešovský kraj";176;69164;360;69524;NA;365584;536;2021-02-06;68816
2021-02-05;"Prešovský kraj";177;31271;262;31533;NA;365584;439;2021-02-05;68280
2021-02-04;"Prešovský kraj";176;13080;237;13317;NA;365584;413;2021-02-04;67841
2021-02-03;"Prešovský kraj";251;8421;236;8657;NA;365584;487;2021-02-03;67428
2021-02-02;"Prešovský kraj";249;11769;264;12033;NA;365584;513;2021-02-02;66941
2021-02-01;"Prešovský kraj";220;16059;316;16375;NA;365584;536;2021-02-01;66428
2021-01-31;"Prešovský kraj";42;10587;107;10694;NA;365584;149;2021-01-31;65892
2021-01-30;"Prešovský kraj";142;23939;215;24154;NA;365584;357;2021-01-30;65743
2021-01-29;"Prešovský kraj";185;17924;326;18250;NA;365584;511;2021-01-29;65386
2021-01-28;"Prešovský kraj";311;7348;150;7498;NA;365584;461;2021-01-28;64875
2021-01-27;"Prešovský kraj";153;9730;147;9877;NA;365584;300;2021-01-27;64414
2021-01-26;"Prešovský kraj";252;16653;151;16804;NA;365584;403;2021-01-26;64114
2021-01-25;"Prešovský kraj";196;30092;253;30345;NA;365584;449;2021-01-25;63711
2021-01-24;"Prešovský kraj";12;45706;304;46010;NA;365584;316;2021-01-24;63262
2021-01-23;"Prešovský kraj";189;96883;487;97370;NA;365584;676;2021-01-23;62946
2021-01-22;"Prešovský kraj";187;35383;261;35644;NA;365584;448;2021-01-22;62270
2021-01-21;"Prešovský kraj";187;20434;212;20646;NA;365584;399;2021-01-21;61822
2021-01-20;"Prešovský kraj";253;14782;195;14977;NA;365584;448;2021-01-20;61423
2021-01-19;"Prešovský kraj";281;12329;305;12634;NA;365584;586;2021-01-19;60975
2021-01-18;"Prešovský kraj";203;10422;336;10758;NA;365584;539;2021-01-18;60389
2021-01-17;"Prešovský kraj";107;14391;1008;15399;NA;365584;1115;2021-01-17;59850
2021-01-16;"Prešovský kraj";72;1838;81;1919;NA;365584;153;2021-01-16;58735
2021-01-15;"Prešovský kraj";159;7033;257;7290;NA;365584;416;2021-01-15;58582
2021-01-14;"Prešovský kraj";268;5534;256;5790;NA;365584;524;2021-01-14;58166
2021-01-13;"Prešovský kraj";342;5649;226;5875;NA;365584;568;2021-01-13;57642
2021-01-12;"Prešovský kraj";455;8251;386;8637;NA;365584;841;2021-01-12;57074
2021-01-11;"Prešovský kraj";343;8149;471;8620;NA;365584;814;2021-01-11;56233
2021-01-10;"Prešovský kraj";63;476;23;499;NA;365584;86;2021-01-10;55419
2021-01-09;"Prešovský kraj";439;2248;125;2373;NA;365584;564;2021-01-09;55333
2021-01-08;"Prešovský kraj";430;10416;561;10977;NA;365584;991;2021-01-08;54769
2021-01-07;"Prešovský kraj";268;7432;622;8054;NA;365584;890;2021-01-07;53778
2021-01-06;"Prešovský kraj";315;1484;134;1618;NA;365584;449;2021-01-06;52888
2021-01-05;"Prešovský kraj";655;11275;976;12251;NA;365584;1631;2021-01-05;52439
2021-01-04;"Prešovský kraj";371;16845;1789;18634;NA;365584;2160;2021-01-04;50808
2021-01-03;"Prešovský kraj";89;459;41;500;NA;365584;130;2021-01-03;48648
2021-01-02;"Prešovský kraj";65;1556;160;1716;NA;365584;225;2021-01-02;48518
2021-01-01;"Prešovský kraj";174;956;71;1027;NA;365584;245;2021-01-01;48293
2020-12-31;"Prešovský kraj";640;11959;783;12742;NA;365584;1423;2020-12-31;48048
2020-12-30;"Prešovský kraj";729;8729;769;9498;NA;365584;1498;2020-12-30;46625
2020-12-29;"Prešovský kraj";435;9273;949;10222;NA;365584;1384;2020-12-29;45127
2020-12-28;"Prešovský kraj";393;9046;1079;10125;NA;365584;1472;2020-12-28;43743
2020-12-27;"Prešovský kraj";40;613;45;658;NA;365584;85;2020-12-27;42271
2020-12-26;"Prešovský kraj";64;176;12;188;NA;365584;76;2020-12-26;42186
2020-12-25;"Prešovský kraj";208;274;11;285;NA;365584;219;2020-12-25;42110
2020-12-24;"Prešovský kraj";452;1214;85;1299;NA;365584;537;2020-12-24;41891
2020-12-23;"Prešovský kraj";361;11006;618;11624;NA;365584;979;2020-12-23;41354
2020-12-22;"Prešovský kraj";439;9023;695;9718;NA;365584;1134;2020-12-22;40375
2020-12-21;"Prešovský kraj";432;9577;847;10424;NA;365584;1279;2020-12-21;39241
2020-12-20;"Prešovský kraj";184;396;20;416;NA;365584;204;2020-12-20;37962
2020-12-19;"Prešovský kraj";276;1658;151;1809;NA;365584;427;2020-12-19;37758
2020-12-18;"Prešovský kraj";396;8246;566;8812;NA;365584;962;2020-12-18;37331
2020-12-17;"Prešovský kraj";427;10505;866;11371;NA;365584;1293;2020-12-17;36369
2020-12-16;"Prešovský kraj";466;5613;473;6086;NA;365584;939;2020-12-16;35076
2020-12-15;"Prešovský kraj";411;5406;574;5980;NA;365584;985;2020-12-15;34137
2020-12-14;"Prešovský kraj";334;5538;477;6015;NA;365584;811;2020-12-14;33152
2020-12-13;"Prešovský kraj";89;29;8;37;NA;365584;97;2020-12-13;32341
2020-12-12;"Prešovský kraj";319;2474;166;2640;NA;365584;485;2020-12-12;32244
2020-12-11;"Prešovský kraj";560;5602;402;6004;NA;365584;962;2020-12-11;31759
2020-12-10;"Prešovský kraj";337;5019;423;5442;NA;365584;760;2020-12-10;30797
2020-12-09;"Prešovský kraj";358;4357;314;4671;NA;365584;672;2020-12-09;30037
2020-12-08;"Prešovský kraj";350;6629;651;7280;NA;365584;1001;2020-12-08;29365
2020-12-07;"Prešovský kraj";309;4345;327;4672;NA;365584;636;2020-12-07;28364
2020-12-06;"Prešovský kraj";59;655;26;681;NA;365584;85;2020-12-06;27728
2020-12-05;"Prešovský kraj";218;984;87;1071;NA;365584;305;2020-12-05;27643
2020-12-04;"Prešovský kraj";352;5070;293;5363;NA;365584;645;2020-12-04;27338
2020-12-03;"Prešovský kraj";284;2456;179;2635;NA;365584;463;2020-12-03;26693
2020-12-02;"Prešovský kraj";232;2830;225;3055;NA;365584;457;2020-12-02;26230
2020-12-01;"Prešovský kraj";281;1884;196;2080;NA;365584;477;2020-12-01;25773
2020-11-30;"Prešovský kraj";196;5333;97;5430;NA;365584;293;2020-11-30;25296
2020-11-29;"Prešovský kraj";27;379;42;421;NA;365584;69;2020-11-29;25003
2020-11-28;"Prešovský kraj";199;772;77;849;NA;365584;276;2020-11-28;24934
2020-11-27;"Prešovský kraj";232;2350;130;2480;NA;365584;362;2020-11-27;24658
2020-11-26;"Prešovský kraj";263;3014;329;3343;NA;365584;592;2020-11-26;24296
2020-11-25;"Prešovský kraj";302;2174;103;2277;NA;365584;405;2020-11-25;23704
2020-11-24;"Prešovský kraj";365;1777;156;1933;NA;365584;521;2020-11-24;23299
2020-11-23;"Prešovský kraj";164;1099;60;1159;NA;365584;224;2020-11-23;22778
2020-11-22;"Prešovský kraj";46;44;1;45;NA;365584;47;2020-11-22;22554
2020-11-21;"Prešovský kraj";205;754;62;816;NA;365584;267;2020-11-21;22507
2020-11-20;"Prešovský kraj";363;2258;102;2360;NA;365584;465;2020-11-20;22240
2020-11-19;"Prešovský kraj";359;2096;238;2334;NA;365584;597;2020-11-19;21775
2020-11-18;"Prešovský kraj";270;488;43;531;NA;365584;313;2020-11-18;21178
2020-11-17;"Prešovský kraj";347;205;23;228;NA;365584;370;2020-11-17;20865
2020-11-16;"Prešovský kraj";226;540;58;598;NA;365584;284;2020-11-16;20495
2020-11-15;"Prešovský kraj";186;39;4;43;NA;365584;190;2020-11-15;20211
2020-11-14;"Prešovský kraj";261;54;4;58;NA;365584;265;2020-11-14;20021
2020-11-13;"Prešovský kraj";395;166;8;174;NA;365584;403;2020-11-13;19756
2020-11-12;"Prešovský kraj";397;229;50;279;NA;365584;447;2020-11-12;19353
2020-11-11;"Prešovský kraj";516;161;15;176;NA;365584;531;2020-11-11;18906
2020-11-10;"Prešovský kraj";437;197;9;206;NA;365584;446;2020-11-10;18375
2020-11-09;"Prešovský kraj";190;4110;945;5055;NA;365584;1135;2020-11-09;17929
2020-11-08;"Prešovský kraj";97;2817;32;2849;NA;365584;129;2020-11-08;16794
2020-11-07;"Prešovský kraj";416;8578;81;8659;NA;365584;497;2020-11-07;16665
2020-11-06;"Prešovský kraj";520;4791;76;4867;NA;365584;596;2020-11-06;16168
2020-11-05;"Prešovský kraj";397;180;5;185;NA;365584;402;2020-11-05;15572
2020-11-04;"Prešovský kraj";350;807;8;815;NA;365584;358;2020-11-04;15170
2020-11-03;"Prešovský kraj";565;98;12;110;NA;365584;577;2020-11-03;14812
2020-11-02;"Prešovský kraj";203;4158;1004;5162;NA;365584;1207;2020-11-02;14235
2020-11-01;"Prešovský kraj";386;2906;53;2959;NA;365584;439;2020-11-01;13028
2020-10-31;"Prešovský kraj";315;10497;170;10667;NA;365584;485;2020-10-31;12589
2020-10-30;"Prešovský kraj";552;2949;65;3014;NA;365584;617;2020-10-30;12104
2020-10-29;"Prešovský kraj";594;301;38;339;NA;365584;632;2020-10-29;11487
2020-10-28;"Prešovský kraj";617;291;46;337;NA;365584;663;2020-10-28;10855
2020-10-27;"Prešovský kraj";656;268;34;302;NA;365584;690;2020-10-27;10192
2020-10-26;"Prešovský kraj";137;363;57;420;NA;365584;194;2020-10-26;9502
2020-10-25;"Prešovský kraj";237;346;11;357;NA;365584;248;2020-10-25;9308
2020-10-24;"Prešovský kraj";719;200;12;212;NA;365584;731;2020-10-24;9060
2020-10-23;"Prešovský kraj";750;218;8;226;NA;365584;758;2020-10-23;8329
2020-10-22;"Prešovský kraj";646;396;30;426;NA;365584;676;2020-10-22;7571
2020-10-21;"Prešovský kraj";383;58;8;66;NA;365584;391;2020-10-21;6895
2020-10-20;"Prešovský kraj";493;65;7;72;NA;365584;500;2020-10-20;6504
2020-10-19;"Prešovský kraj";140;235;15;250;NA;365584;155;2020-10-19;6004
2020-10-18;"Prešovský kraj";209;0;0;0;NA;365584;209;2020-10-18;5849
2020-10-17;"Prešovský kraj";342;0;0;0;NA;365584;342;2020-10-17;5640
2020-10-16;"Prešovský kraj";388;57;3;60;NA;365584;391;2020-10-16;5298
2020-10-15;"Prešovský kraj";435;85;18;103;NA;365584;453;2020-10-15;4907
2020-10-14;"Prešovský kraj";451;54;10;64;NA;365584;461;2020-10-14;4454
2020-10-13;"Prešovský kraj";264;50;6;56;NA;365584;270;2020-10-13;3993
2020-10-12;"Prešovský kraj";214;334;35;369;NA;365584;249;2020-10-12;3723
2020-10-11;"Prešovský kraj";127;0;0;0;NA;365584;127;2020-10-11;3474
2020-10-10;"Prešovský kraj";248;0;0;0;NA;365584;248;2020-10-10;3347
2020-10-09;"Prešovský kraj";406;0;0;0;NA;365584;406;2020-10-09;3099
2020-10-08;"Prešovský kraj";245;0;0;0;NA;365584;245;2020-10-08;2693
2020-10-07;"Prešovský kraj";244;0;0;0;NA;365584;244;2020-10-07;2448
2020-10-06;"Prešovský kraj";166;0;0;0;NA;365584;166;2020-10-06;2204
2020-10-05;"Prešovský kraj";84;0;0;0;NA;365584;84;2020-10-05;2038
2020-10-04;"Prešovský kraj";118;0;0;0;NA;365584;118;2020-10-04;1954
2020-10-03;"Prešovský kraj";204;0;0;0;NA;365584;204;2020-10-03;1836
2020-10-02;"Prešovský kraj";149;0;0;0;NA;365584;149;2020-10-02;1632
2020-10-01;"Prešovský kraj";136;0;0;0;NA;365584;136;2020-10-01;1483
2020-09-30;"Prešovský kraj";121;0;0;0;NA;365584;121;2020-09-30;1347
2020-09-29;"Prešovský kraj";156;0;0;0;NA;365584;156;2020-09-29;1226
2020-09-28;"Prešovský kraj";51;0;0;0;NA;365584;51;2020-09-28;1070
2020-09-27;"Prešovský kraj";10;0;0;0;NA;365584;10;2020-09-27;1019
2020-09-26;"Prešovský kraj";72;0;0;0;NA;365584;72;2020-09-26;1009
2020-09-25;"Prešovský kraj";91;0;0;0;NA;365584;91;2020-09-25;937
2020-09-24;"Prešovský kraj";52;0;0;0;NA;365584;52;2020-09-24;846
2020-09-23;"Prešovský kraj";55;0;0;0;NA;365584;55;2020-09-23;794
2020-09-22;"Prešovský kraj";29;0;0;0;NA;365584;29;2020-09-22;739
2020-09-21;"Prešovský kraj";14;0;0;0;NA;365584;14;2020-09-21;710
2020-09-20;"Prešovský kraj";5;0;0;0;NA;365584;5;2020-09-20;696
2020-09-19;"Prešovský kraj";12;0;0;0;NA;365584;12;2020-09-19;691
2020-09-18;"Prešovský kraj";29;0;0;0;NA;365584;29;2020-09-18;679
2020-09-17;"Prešovský kraj";25;0;0;0;NA;365584;25;2020-09-17;650
2020-09-16;"Prešovský kraj";8;0;0;0;NA;365584;8;2020-09-16;625
2020-09-15;"Prešovský kraj";10;0;0;0;NA;365584;10;2020-09-15;617
2020-09-14;"Prešovský kraj";47;0;0;0;NA;365584;47;2020-09-14;607
2020-09-13;"Prešovský kraj";3;0;0;0;NA;365584;3;2020-09-13;560
2020-09-12;"Prešovský kraj";4;0;0;0;NA;365584;4;2020-09-12;557
2020-09-11;"Prešovský kraj";15;0;0;0;NA;365584;15;2020-09-11;553
2020-09-10;"Prešovský kraj";10;0;0;0;NA;365584;10;2020-09-10;538
2020-09-09;"Prešovský kraj";21;0;0;0;NA;365584;21;2020-09-09;528
2020-09-08;"Prešovský kraj";23;0;0;0;NA;365584;23;2020-09-08;507
2020-09-07;"Prešovský kraj";5;0;0;0;NA;365584;5;2020-09-07;484
2020-09-06;"Prešovský kraj";3;0;0;0;NA;365584;3;2020-09-06;479
2020-09-05;"Prešovský kraj";7;0;0;0;NA;365584;7;2020-09-05;476
2020-09-04;"Prešovský kraj";24;0;0;0;NA;365584;24;2020-09-04;469
2020-09-03;"Prešovský kraj";8;0;0;0;NA;365584;8;2020-09-03;445
2020-09-02;"Prešovský kraj";9;0;0;0;NA;365584;9;2020-09-02;437
2020-09-01;"Prešovský kraj";6;0;0;0;NA;365584;6;2020-09-01;428
2020-08-31;"Prešovský kraj";3;0;0;0;NA;365584;3;2020-08-31;422
2020-08-30;"Prešovský kraj";6;0;0;0;NA;365584;6;2020-08-30;419
2020-08-29;"Prešovský kraj";4;0;0;0;NA;365584;4;2020-08-29;413
2020-08-28;"Prešovský kraj";6;0;0;0;NA;365584;6;2020-08-28;409
2020-08-27;"Prešovský kraj";7;0;0;0;NA;365584;7;2020-08-27;403
2020-08-26;"Prešovský kraj";22;0;0;0;NA;365584;22;2020-08-26;396
2020-08-25;"Prešovský kraj";1;0;0;0;NA;365584;1;2020-08-25;374
2020-08-24;"Prešovský kraj";5;0;0;0;NA;365584;5;2020-08-24;373
2020-08-23;"Prešovský kraj";3;0;0;0;NA;365584;3;2020-08-23;368
2020-08-22;"Prešovský kraj";3;0;0;0;NA;365584;3;2020-08-22;365
2020-08-21;"Prešovský kraj";11;0;0;0;NA;365584;11;2020-08-21;362
2020-08-20;"Prešovský kraj";8;0;0;0;NA;365584;8;2020-08-20;351
2020-08-19;"Prešovský kraj";8;0;0;0;NA;365584;8;2020-08-19;343
2020-08-18;"Prešovský kraj";6;0;0;0;NA;365584;6;2020-08-18;335
2020-08-17;"Prešovský kraj";1;0;0;0;NA;365584;1;2020-08-17;329
2020-08-16;"Prešovský kraj";0;0;0;0;NA;365584;0;2020-08-16;328
2020-08-15;"Prešovský kraj";8;0;0;0;NA;365584;8;2020-08-15;328
2020-08-14;"Prešovský kraj";6;0;0;0;NA;365584;6;2020-08-14;320
2020-08-13;"Prešovský kraj";8;0;0;0;NA;365584;8;2020-08-13;314
2020-08-12;"Prešovský kraj";19;0;0;0;NA;365584;19;2020-08-12;306
2020-08-11;"Prešovský kraj";3;0;0;0;NA;365584;3;2020-08-11;287
2020-08-10;"Prešovský kraj";0;0;0;0;NA;365584;0;2020-08-10;284
2020-08-09;"Prešovský kraj";0;0;0;0;NA;365584;0;2020-08-09;284
2020-08-08;"Prešovský kraj";2;0;0;0;NA;365584;2;2020-08-08;284
2020-08-07;"Prešovský kraj";6;0;0;0;NA;365584;6;2020-08-07;282
2020-08-06;"Prešovský kraj";2;0;0;0;NA;365584;2;2020-08-06;276
2020-08-05;"Prešovský kraj";8;0;0;0;NA;365584;8;2020-08-05;274
2020-08-04;"Prešovský kraj";5;0;0;0;NA;365584;5;2020-08-04;266
2020-08-03;"Prešovský kraj";4;0;0;0;NA;365584;4;2020-08-03;261
2020-08-02;"Prešovský kraj";6;0;0;0;NA;365584;6;2020-08-02;257
2020-08-01;"Prešovský kraj";0;0;0;0;NA;365584;0;2020-08-01;251
2020-07-31;"Prešovský kraj";2;0;0;0;NA;365584;2;2020-07-31;251
2020-07-30;"Prešovský kraj";6;0;0;0;NA;365584;6;2020-07-30;249
2020-07-29;"Prešovský kraj";5;0;0;0;NA;365584;5;2020-07-29;243
2020-07-28;"Prešovský kraj";0;0;0;0;NA;365584;0;2020-07-28;238
2020-07-27;"Prešovský kraj";1;0;0;0;NA;365584;1;2020-07-27;238
2020-07-26;"Prešovský kraj";1;0;0;0;NA;365584;1;2020-07-26;237
2020-07-25;"Prešovský kraj";21;0;0;0;NA;365584;21;2020-07-25;236
2020-07-24;"Prešovský kraj";1;0;0;0;NA;365584;1;2020-07-24;215
2020-07-23;"Prešovský kraj";5;0;0;0;NA;365584;5;2020-07-23;214
2020-07-22;"Prešovský kraj";1;0;0;0;NA;365584;1;2020-07-22;209
2020-07-21;"Prešovský kraj";2;0;0;0;NA;365584;2;2020-07-21;208
2020-07-20;"Prešovský kraj";1;0;0;0;NA;365584;1;2020-07-20;206
2020-07-19;"Prešovský kraj";0;0;0;0;NA;365584;0;2020-07-19;205
2020-07-18;"Prešovský kraj";0;0;0;0;NA;365584;0;2020-07-18;205
2020-07-17;"Prešovský kraj";3;0;0;0;NA;365584;3;2020-07-17;205
2020-07-16;"Prešovský kraj";1;0;0;0;NA;365584;1;2020-07-16;202
2020-07-15;"Prešovský kraj";5;0;0;0;NA;365584;5;2020-07-15;201
2020-07-14;"Prešovský kraj";5;0;0;0;NA;365584;5;2020-07-14;196
2020-07-13;"Prešovský kraj";1;0;0;0;NA;365584;1;2020-07-13;191
2020-07-12;"Prešovský kraj";1;0;0;0;NA;365584;1;2020-07-12;190
2020-07-11;"Prešovský kraj";6;0;0;0;NA;365584;6;2020-07-11;189
2020-07-10;"Prešovský kraj";5;0;0;0;NA;365584;5;2020-07-10;183
2020-07-09;"Prešovský kraj";2;0;0;0;NA;365584;2;2020-07-09;178
2020-07-08;"Prešovský kraj";14;0;0;0;NA;365584;14;2020-07-08;176
2020-07-07;"Prešovský kraj";2;0;0;0;NA;365584;2;2020-07-07;162
2020-07-06;"Prešovský kraj";0;0;0;0;NA;365584;0;2020-07-06;160
2020-07-05;"Prešovský kraj";0;0;0;0;NA;365584;0;2020-07-05;160
2020-07-04;"Prešovský kraj";1;0;0;0;NA;365584;1;2020-07-04;160
2020-07-03;"Prešovský kraj";3;0;0;0;NA;365584;3;2020-07-03;159
2020-07-02;"Prešovský kraj";0;0;0;0;NA;365584;0;2020-07-02;156
2020-07-01;"Prešovský kraj";0;0;0;0;NA;365584;0;2020-07-01;156
2020-06-30;"Prešovský kraj";7;0;0;0;NA;365584;7;2020-06-30;156
2020-06-29;"Prešovský kraj";0;0;0;0;NA;365584;0;2020-06-29;149
2020-06-28;"Prešovský kraj";0;0;0;0;NA;365584;0;2020-06-28;149
2020-06-27;"Prešovský kraj";3;0;0;0;NA;365584;3;2020-06-27;149
2020-06-26;"Prešovský kraj";3;0;0;0;NA;365584;3;2020-06-26;146
2020-06-25;"Prešovský kraj";0;0;0;0;NA;365584;0;2020-06-25;143
2020-06-24;"Prešovský kraj";4;0;0;0;NA;365584;4;2020-06-24;143
2020-06-23;"Prešovský kraj";0;0;0;0;NA;365584;0;2020-06-23;139
2020-06-22;"Prešovský kraj";0;0;0;0;NA;365584;0;2020-06-22;139
2020-06-21;"Prešovský kraj";0;0;0;0;NA;365584;0;2020-06-21;139
2020-06-20;"Prešovský kraj";0;0;0;0;NA;365584;0;2020-06-20;139
2020-06-19;"Prešovský kraj";1;0;0;0;NA;365584;1;2020-06-19;139
2020-06-18;"Prešovský kraj";0;0;0;0;NA;365584;0;2020-06-18;138
2020-06-17;"Prešovský kraj";0;0;0;0;NA;365584;0;2020-06-17;138
2020-06-16;"Prešovský kraj";6;0;0;0;NA;365584;6;2020-06-16;138
2020-06-14;"Prešovský kraj";0;0;0;0;NA;365584;0;2020-06-14;132
2020-06-13;"Prešovský kraj";0;0;0;0;NA;365584;0;2020-06-13;132
2020-06-12;"Prešovský kraj";1;0;0;0;NA;365584;1;2020-06-12;132
2020-06-11;"Prešovský kraj";0;0;0;0;NA;365584;0;2020-06-11;131
2020-06-10;"Prešovský kraj";0;0;0;0;NA;365584;0;2020-06-10;131
2020-06-09;"Prešovský kraj";0;0;0;0;NA;365584;0;2020-06-09;131
2020-06-08;"Prešovský kraj";0;0;0;0;NA;365584;0;2020-06-08;131
2020-06-07;"Prešovský kraj";0;0;0;0;NA;365584;0;2020-06-07;131
2020-06-05;"Prešovský kraj";0;0;0;0;NA;365584;0;2020-06-05;131
2020-06-03;"Prešovský kraj";0;0;0;0;NA;365584;0;2020-06-03;131
2020-06-02;"Prešovský kraj";1;0;0;0;NA;365584;1;2020-06-02;131
2020-05-31;"Prešovský kraj";1;0;0;0;NA;365584;1;2020-05-31;130
2020-05-29;"Prešovský kraj";0;0;0;0;NA;365584;0;2020-05-29;129
2020-05-27;"Prešovský kraj";0;0;0;0;NA;365584;0;2020-05-27;129
2020-05-26;"Prešovský kraj";0;0;0;0;NA;365584;0;2020-05-26;129
2020-05-25;"Prešovský kraj";0;0;0;0;NA;365584;0;2020-05-25;129
2020-05-24;"Prešovský kraj";0;0;0;0;NA;365584;0;2020-05-24;129
2020-05-23;"Prešovský kraj";0;0;0;0;NA;365584;0;2020-05-23;129
2020-05-22;"Prešovský kraj";0;0;0;0;NA;365584;0;2020-05-22;129
2020-05-21;"Prešovský kraj";1;0;0;0;NA;365584;1;2020-05-21;129
2020-05-20;"Prešovský kraj";0;0;0;0;NA;365584;0;2020-05-20;128
2020-05-19;"Prešovský kraj";0;0;0;0;NA;365584;0;2020-05-19;128
2020-05-17;"Prešovský kraj";0;0;0;0;NA;365584;0;2020-05-17;128
2020-05-16;"Prešovský kraj";0;0;0;0;NA;365584;0;2020-05-16;128
2020-05-15;"Prešovský kraj";0;0;0;0;NA;365584;0;2020-05-15;128
2020-05-14;"Prešovský kraj";0;0;0;0;NA;365584;0;2020-05-14;128
2020-05-13;"Prešovský kraj";1;0;0;0;NA;365584;1;2020-05-13;128
2020-05-12;"Prešovský kraj";0;0;0;0;NA;365584;0;2020-05-12;127
2020-05-11;"Prešovský kraj";1;0;0;0;NA;365584;1;2020-05-11;127
2020-05-09;"Prešovský kraj";0;0;0;0;NA;365584;0;2020-05-09;126
2020-05-07;"Prešovský kraj";0;0;0;0;NA;365584;0;2020-05-07;126
2020-05-06;"Prešovský kraj";0;0;0;0;NA;365584;0;2020-05-06;126
2020-05-05;"Prešovský kraj";1;0;0;0;NA;365584;1;2020-05-05;126
2020-05-04;"Prešovský kraj";0;0;0;0;NA;365584;0;2020-05-04;125
2020-05-03;"Prešovský kraj";0;0;0;0;NA;365584;0;2020-05-03;125
2020-05-02;"Prešovský kraj";0;0;0;0;NA;365584;0;2020-05-02;125
2020-05-01;"Prešovský kraj";2;0;0;0;NA;365584;2;2020-05-01;125
2020-04-30;"Prešovský kraj";0;0;0;0;NA;365584;0;2020-04-30;123
2020-04-29;"Prešovský kraj";1;0;0;0;NA;365584;1;2020-04-29;123
2020-04-28;"Prešovský kraj";1;0;0;0;NA;365584;1;2020-04-28;122
2020-04-27;"Prešovský kraj";2;0;0;0;NA;365584;2;2020-04-27;121
2020-04-26;"Prešovský kraj";0;0;0;0;NA;365584;0;2020-04-26;119
2020-04-25;"Prešovský kraj";0;0;0;0;NA;365584;0;2020-04-25;119
2020-04-24;"Prešovský kraj";0;0;0;0;NA;365584;0;2020-04-24;119
2020-04-23;"Prešovský kraj";2;0;0;0;NA;365584;2;2020-04-23;119
2020-04-22;"Prešovský kraj";11;0;0;0;NA;365584;11;2020-04-22;117
2020-04-21;"Prešovský kraj";12;0;0;0;NA;365584;12;2020-04-21;106
2020-04-20;"Prešovský kraj";2;0;0;0;NA;365584;2;2020-04-20;94
2020-04-19;"Prešovský kraj";4;0;0;0;NA;365584;4;2020-04-19;92
2020-04-18;"Prešovský kraj";1;0;0;0;NA;365584;1;2020-04-18;88
2020-04-17;"Prešovský kraj";4;0;0;0;NA;365584;4;2020-04-17;87
2020-04-16;"Prešovský kraj";9;0;0;0;NA;365584;9;2020-04-16;83
2020-04-15;"Prešovský kraj";21;0;0;0;NA;365584;21;2020-04-15;74
2020-04-14;"Prešovský kraj";1;0;0;0;NA;365584;1;2020-04-14;53
2020-04-13;"Prešovský kraj";2;0;0;0;NA;365584;2;2020-04-13;52
2020-04-12;"Prešovský kraj";6;0;0;0;NA;365584;6;2020-04-12;50
2020-04-11;"Prešovský kraj";4;0;0;0;NA;365584;4;2020-04-11;44
2020-04-10;"Prešovský kraj";0;0;0;0;NA;365584;0;2020-04-10;40
2020-04-09;"Prešovský kraj";1;0;0;0;NA;365584;1;2020-04-09;40
2020-04-08;"Prešovský kraj";0;0;0;0;NA;365584;0;2020-04-08;39
2020-04-07;"Prešovský kraj";7;0;0;0;NA;365584;7;2020-04-07;39
2020-04-06;"Prešovský kraj";10;0;0;0;NA;365584;10;2020-04-06;32
2020-04-05;"Prešovský kraj";13;0;0;0;NA;365584;13;2020-04-05;22
2020-04-04;"Prešovský kraj";1;0;0;0;NA;365584;1;2020-04-04;9
2020-04-03;"Prešovský kraj";4;0;0;0;NA;365584;4;2020-04-03;8
2020-04-02;"Prešovský kraj";6;0;0;0;NA;365584;6;2020-04-02;4
2020-04-01;"Prešovský kraj";6;0;0;0;NA;365584;6;2020-04-01;-2
2020-03-31;"Prešovský kraj";6;0;0;0;NA;365584;6;2020-03-31;-8
2020-03-30;"Prešovský kraj";2;0;0;0;NA;365584;2;2020-03-30;-14
2020-03-29;"Prešovský kraj";2;0;0;0;NA;365584;2;2020-03-29;-16
2020-03-28;"Prešovský kraj";2;0;0;0;NA;365584;2;2020-03-28;-18
2020-03-27;"Prešovský kraj";1;0;0;0;NA;365584;1;2020-03-27;-20
2020-03-26;"Prešovský kraj";8;0;0;0;NA;365584;8;2020-03-26;-21
2020-03-25;"Prešovský kraj";1;0;0;0;NA;365584;1;2020-03-25;-29
2020-03-24;"Prešovský kraj";4;0;0;0;NA;365584;4;2020-03-24;-30
2020-03-23;"Prešovský kraj";0;0;0;0;NA;365584;0;2020-03-23;-34
2020-03-22;"Prešovský kraj";1;0;0;0;NA;365584;1;2020-03-22;-34
2020-03-21;"Prešovský kraj";2;0;0;0;NA;365584;2;2020-03-21;-35
2020-03-20;"Prešovský kraj";3;0;0;0;NA;365584;3;2020-03-20;-37
2020-03-19;"Prešovský kraj";2;0;0;0;NA;365584;2;2020-03-19;-40
2020-03-18;"Prešovský kraj";1;0;0;0;NA;365584;1;2020-03-18;-42
2020-03-17;"Prešovský kraj";1;0;0;0;NA;365584;1;2020-03-17;-43
2020-03-16;"Prešovský kraj";4;0;0;0;NA;365584;4;2020-03-16;-44
2020-03-15;"Prešovský kraj";0;0;0;0;NA;365584;0;2020-03-15;-48
2020-03-14;"Prešovský kraj";1;0;0;0;NA;365584;1;2020-03-14;-48
2020-03-13;"Prešovský kraj";0;0;0;0;NA;365584;0;2020-03-13;-49
2020-03-12;"Prešovský kraj";0;0;0;0;NA;365584;0;2020-03-12;-49
2020-03-11;"Prešovský kraj";0;0;0;0;NA;365584;0;2020-03-11;-49
2020-03-09;"Prešovský kraj";0;0;0;0;NA;365584;0;2020-03-09;-49
2020-03-08;"Prešovský kraj";0;0;0;0;NA;365584;0;2020-03-08;-49
2020-03-07;"Prešovský kraj";0;0;0;0;NA;365584;0;2020-03-07;-49
2020-03-06;"Prešovský kraj";0;0;0;0;NA;365584;0;2020-03-06;-49
2022-05-26;"Trenčiansky kraj";21;0;0;0;212585;302801;21;2022-05-26;302801
2022-05-25;"Trenčiansky kraj";9;113;9;122;NA;302801;18;2022-05-25;302780
2022-05-24;"Trenčiansky kraj";21;158;4;162;NA;302801;25;2022-05-24;302762
2022-05-23;"Trenčiansky kraj";15;217;11;228;NA;302801;26;2022-05-23;302737
2022-05-22;"Trenčiansky kraj";1;55;3;58;NA;302801;4;2022-05-22;302711
2022-05-21;"Trenčiansky kraj";10;63;5;68;NA;302801;15;2022-05-21;302707
2022-05-20;"Trenčiansky kraj";26;157;12;169;NA;302801;38;2022-05-20;302692
2022-05-19;"Trenčiansky kraj";46;159;9;168;NA;302801;55;2022-05-19;302654
2022-05-18;"Trenčiansky kraj";24;169;9;178;NA;302801;33;2022-05-18;302599
2022-05-17;"Trenčiansky kraj";31;152;8;160;NA;302801;39;2022-05-17;302566
2022-05-16;"Trenčiansky kraj";19;235;20;255;NA;302801;39;2022-05-16;302527
2022-05-15;"Trenčiansky kraj";1;64;0;64;NA;302801;1;2022-05-15;302488
2022-05-14;"Trenčiansky kraj";31;63;4;67;NA;302801;35;2022-05-14;302487
2022-05-13;"Trenčiansky kraj";24;174;12;186;NA;302801;36;2022-05-13;302452
2022-05-12;"Trenčiansky kraj";29;189;13;202;NA;302801;42;2022-05-12;302416
2022-05-11;"Trenčiansky kraj";30;166;14;180;NA;302801;44;2022-05-11;302374
2022-05-10;"Trenčiansky kraj";46;171;19;190;NA;302801;65;2022-05-10;302330
2022-05-09;"Trenčiansky kraj";39;289;21;310;NA;302801;60;2022-05-09;302265
2022-05-08;"Trenčiansky kraj";3;82;7;89;NA;302801;10;2022-05-08;302205
2022-05-07;"Trenčiansky kraj";22;72;5;77;NA;302801;27;2022-05-07;302195
2022-05-06;"Trenčiansky kraj";52;297;17;314;NA;302801;69;2022-05-06;302168
2022-05-05;"Trenčiansky kraj";53;149;8;157;NA;302801;61;2022-05-05;302099
2022-05-04;"Trenčiansky kraj";43;247;12;259;NA;302801;55;2022-05-04;302038
2022-05-03;"Trenčiansky kraj";79;207;15;222;NA;302801;94;2022-05-03;301983
2022-05-02;"Trenčiansky kraj";57;585;19;604;NA;302801;76;2022-05-02;301889
2022-05-01;"Trenčiansky kraj";14;162;5;167;NA;302801;19;2022-05-01;301813
2022-04-30;"Trenčiansky kraj";75;173;4;177;NA;302801;79;2022-04-30;301794
2022-04-29;"Trenčiansky kraj";106;273;16;289;NA;302801;122;2022-04-29;301715
2022-04-28;"Trenčiansky kraj";87;502;12;514;NA;302801;99;2022-04-28;301593
2022-04-27;"Trenčiansky kraj";115;408;34;442;NA;302801;149;2022-04-27;301494
2022-04-26;"Trenčiansky kraj";151;375;10;385;NA;302801;161;2022-04-26;301345
2022-04-25;"Trenčiansky kraj";106;611;29;640;NA;302801;135;2022-04-25;301184
2022-04-24;"Trenčiansky kraj";32;215;13;228;NA;302801;45;2022-04-24;301049
2022-04-23;"Trenčiansky kraj";104;210;11;221;NA;302801;115;2022-04-23;301004
2022-04-22;"Trenčiansky kraj";122;456;32;488;NA;302801;154;2022-04-22;300889
2022-04-21;"Trenčiansky kraj";191;516;18;534;NA;302801;209;2022-04-21;300735
2022-04-20;"Trenčiansky kraj";269;460;23;483;NA;302801;292;2022-04-20;300526
2022-04-19;"Trenčiansky kraj";180;802;39;841;NA;302801;219;2022-04-19;300234
2022-04-18;"Trenčiansky kraj";107;242;15;257;NA;302801;122;2022-04-18;300015
2022-04-17;"Trenčiansky kraj";154;314;14;328;NA;302801;168;2022-04-17;299893
2022-04-16;"Trenčiansky kraj";51;297;10;307;NA;302801;61;2022-04-16;299725
2022-04-15;"Trenčiansky kraj";71;313;12;325;NA;302801;83;2022-04-15;299664
2022-04-14;"Trenčiansky kraj";235;702;36;738;NA;302801;271;2022-04-14;299581
2022-04-13;"Trenčiansky kraj";288;512;39;551;NA;302801;327;2022-04-13;299310
2022-04-12;"Trenčiansky kraj";293;744;52;796;NA;302801;345;2022-04-12;298983
2022-04-11;"Trenčiansky kraj";349;634;61;695;NA;302801;410;2022-04-11;298638
2022-04-10;"Trenčiansky kraj";110;440;28;468;NA;302801;138;2022-04-10;298228
2022-04-09;"Trenčiansky kraj";234;269;24;293;NA;302801;258;2022-04-09;298090
2022-04-08;"Trenčiansky kraj";301;475;27;502;NA;302801;328;2022-04-08;297832
2022-04-07;"Trenčiansky kraj";381;592;68;660;NA;302801;449;2022-04-07;297504
2022-04-06;"Trenčiansky kraj";416;680;78;758;NA;302801;494;2022-04-06;297055
2022-04-05;"Trenčiansky kraj";499;614;65;679;NA;302801;564;2022-04-05;296561
2022-04-04;"Trenčiansky kraj";468;948;95;1043;NA;302801;563;2022-04-04;295997
2022-04-03;"Trenčiansky kraj";127;373;46;419;NA;302801;173;2022-04-03;295434
2022-04-02;"Trenčiansky kraj";368;404;59;463;NA;302801;427;2022-04-02;295261
2022-04-01;"Trenčiansky kraj";510;630;65;695;NA;302801;575;2022-04-01;294834
2022-03-31;"Trenčiansky kraj";520;1013;97;1110;NA;302801;617;2022-03-31;294259
2022-03-30;"Trenčiansky kraj";706;1494;87;1581;NA;302801;793;2022-03-30;293642
2022-03-29;"Trenčiansky kraj";682;1077;97;1174;NA;302801;779;2022-03-29;292849
2022-03-28;"Trenčiansky kraj";673;1727;140;1867;NA;302801;813;2022-03-28;292070
2022-03-27;"Trenčiansky kraj";167;596;86;682;NA;302801;253;2022-03-27;291257
2022-03-26;"Trenčiansky kraj";513;395;43;438;NA;302801;556;2022-03-26;291004
2022-03-25;"Trenčiansky kraj";534;937;93;1030;NA;302801;627;2022-03-25;290448
2022-03-24;"Trenčiansky kraj";712;1266;106;1372;NA;302801;818;2022-03-24;289821
2022-03-23;"Trenčiansky kraj";903;1047;97;1144;NA;302801;1000;2022-03-23;289003
2022-03-22;"Trenčiansky kraj";918;1078;116;1194;NA;302801;1034;2022-03-22;288003
2022-03-21;"Trenčiansky kraj";745;1753;219;1972;NA;302801;964;2022-03-21;286969
2022-03-20;"Trenčiansky kraj";334;826;89;915;NA;302801;423;2022-03-20;286005
2022-03-19;"Trenčiansky kraj";560;510;77;587;NA;302801;637;2022-03-19;285582
2022-03-18;"Trenčiansky kraj";884;972;135;1107;NA;302801;1019;2022-03-18;284945
2022-03-17;"Trenčiansky kraj";863;1156;137;1293;NA;302801;1000;2022-03-17;283926
2022-03-16;"Trenčiansky kraj";1147;1303;129;1432;NA;302801;1276;2022-03-16;282926
2022-03-15;"Trenčiansky kraj";1054;1325;124;1449;NA;302801;1178;2022-03-15;281650
2022-03-14;"Trenčiansky kraj";934;2642;273;2915;NA;302801;1207;2022-03-14;280472
2022-03-13;"Trenčiansky kraj";373;698;97;795;NA;302801;470;2022-03-13;279265
2022-03-12;"Trenčiansky kraj";674;550;94;644;NA;302801;768;2022-03-12;278795
2022-03-11;"Trenčiansky kraj";1131;1379;222;1601;NA;302801;1353;2022-03-11;278027
2022-03-10;"Trenčiansky kraj";1087;1363;226;1589;NA;302801;1313;2022-03-10;276674
2022-03-09;"Trenčiansky kraj";1515;1517;240;1757;NA;302801;1755;2022-03-09;275361
2022-03-08;"Trenčiansky kraj";1059;1755;253;2008;NA;302801;1312;2022-03-08;273606
2022-03-07;"Trenčiansky kraj";1079;2457;360;2817;NA;302801;1439;2022-03-07;272294
2022-03-06;"Trenčiansky kraj";354;832;134;966;NA;302801;488;2022-03-06;270855
2022-03-05;"Trenčiansky kraj";583;700;138;838;NA;302801;721;2022-03-05;270367
2022-03-04;"Trenčiansky kraj";1125;1337;210;1547;NA;302801;1335;2022-03-04;269646
2022-03-03;"Trenčiansky kraj";1346;1710;223;1933;NA;302801;1569;2022-03-03;268311
2022-03-02;"Trenčiansky kraj";1345;1739;245;1984;NA;302801;1590;2022-03-02;266742
2022-03-01;"Trenčiansky kraj";1409;1805;309;2114;NA;302801;1718;2022-03-01;265152
2022-02-28;"Trenčiansky kraj";1390;2932;468;3400;NA;302801;1858;2022-02-28;263434
2022-02-27;"Trenčiansky kraj";573;1043;218;1261;NA;302801;791;2022-02-27;261576
2022-02-26;"Trenčiansky kraj";934;784;147;931;NA;302801;1081;2022-02-26;260785
2022-02-25;"Trenčiansky kraj";1460;1788;341;2129;NA;302801;1801;2022-02-25;259704
2022-02-24;"Trenčiansky kraj";1372;2468;309;2777;NA;302801;1681;2022-02-24;257903
2022-02-23;"Trenčiansky kraj";1677;2084;322;2406;NA;302801;1999;2022-02-23;256222
2022-02-22;"Trenčiansky kraj";2073;2270;451;2721;NA;302801;2524;2022-02-22;254223
2022-02-21;"Trenčiansky kraj";2172;4194;645;4839;NA;302801;2817;2022-02-21;251699
2022-02-20;"Trenčiansky kraj";1079;1436;322;1758;NA;302801;1401;2022-02-20;248882
2022-02-19;"Trenčiansky kraj";1168;1008;244;1252;NA;302801;1412;2022-02-19;247481
2022-02-18;"Trenčiansky kraj";2456;2369;477;2846;NA;302801;2933;2022-02-18;246069
2022-02-17;"Trenčiansky kraj";2090;2733;427;3160;NA;302801;2517;2022-02-17;243136
2022-02-16;"Trenčiansky kraj";2928;2478;512;2990;NA;302801;3440;2022-02-16;240619
2022-02-15;"Trenčiansky kraj";2372;2603;572;3175;NA;302801;2944;2022-02-15;237179
2022-02-14;"Trenčiansky kraj";2401;4489;728;5217;NA;302801;3129;2022-02-14;234235
2022-02-13;"Trenčiansky kraj";1357;1777;454;2231;NA;302801;1811;2022-02-13;231106
2022-02-12;"Trenčiansky kraj";1802;1448;277;1725;NA;302801;2079;2022-02-12;229295
2022-02-11;"Trenčiansky kraj";2863;2567;495;3062;NA;302801;3358;2022-02-11;227216
2022-02-10;"Trenčiansky kraj";2853;2717;504;3221;NA;302801;3357;2022-02-10;223858
2022-02-09;"Trenčiansky kraj";2788;4356;600;4956;NA;302801;3388;2022-02-09;220501
2022-02-08;"Trenčiansky kraj";2592;3182;660;3842;NA;302801;3252;2022-02-08;217113
2022-02-07;"Trenčiansky kraj";2787;5303;981;6284;NA;302801;3768;2022-02-07;213861
2022-02-06;"Trenčiansky kraj";1431;2181;472;2653;NA;302801;1903;2022-02-06;210093
2022-02-05;"Trenčiansky kraj";1458;1689;323;2012;NA;302801;1781;2022-02-05;208190
2022-02-04;"Trenčiansky kraj";2480;3226;524;3750;NA;302801;3004;2022-02-04;206409
2022-02-03;"Trenčiansky kraj";2391;3566;500;4066;NA;302801;2891;2022-02-03;203405
2022-02-02;"Trenčiansky kraj";2486;4591;602;5193;NA;302801;3088;2022-02-02;200514
2022-02-01;"Trenčiansky kraj";2359;3754;552;4306;NA;302801;2911;2022-02-01;197426
2022-01-31;"Trenčiansky kraj";1823;7493;752;8245;NA;302801;2575;2022-01-31;194515
2022-01-30;"Trenčiansky kraj";680;2463;319;2782;NA;302801;999;2022-01-30;191940
2022-01-29;"Trenčiansky kraj";1227;1772;227;1999;NA;302801;1454;2022-01-29;190941
2022-01-28;"Trenčiansky kraj";1709;3747;366;4113;NA;302801;2075;2022-01-28;189487
2022-01-27;"Trenčiansky kraj";1533;3562;368;3930;NA;302801;1901;2022-01-27;187412
2022-01-26;"Trenčiansky kraj";1415;4674;356;5030;NA;302801;1771;2022-01-26;185511
2022-01-25;"Trenčiansky kraj";1553;3307;299;3606;NA;302801;1852;2022-01-25;183740
2022-01-24;"Trenčiansky kraj";755;7090;328;7418;NA;302801;1083;2022-01-24;181888
2022-01-23;"Trenčiansky kraj";337;2409;179;2588;NA;302801;516;2022-01-23;180805
2022-01-22;"Trenčiansky kraj";683;1675;103;1778;NA;302801;786;2022-01-22;180289
2022-01-21;"Trenčiansky kraj";576;3522;174;3696;NA;302801;750;2022-01-21;179503
2022-01-20;"Trenčiansky kraj";710;2713;137;2850;NA;302801;847;2022-01-20;178753
2022-01-19;"Trenčiansky kraj";621;3765;142;3907;NA;302801;763;2022-01-19;177906
2022-01-18;"Trenčiansky kraj";579;3596;135;3731;NA;302801;714;2022-01-18;177143
2022-01-17;"Trenčiansky kraj";380;6550;210;6760;NA;302801;590;2022-01-17;176429
2022-01-16;"Trenčiansky kraj";89;2319;72;2391;NA;302801;161;2022-01-16;175839
2022-01-15;"Trenčiansky kraj";194;1345;40;1385;NA;302801;234;2022-01-15;175678
2022-01-14;"Trenčiansky kraj";189;2890;79;2969;NA;302801;268;2022-01-14;175444
2022-01-13;"Trenčiansky kraj";134;3329;87;3416;NA;302801;221;2022-01-13;175176
2022-01-12;"Trenčiansky kraj";346;3073;82;3155;NA;302801;428;2022-01-12;174955
2022-01-11;"Trenčiansky kraj";300;3028;80;3108;NA;302801;380;2022-01-11;174527
2022-01-10;"Trenčiansky kraj";218;7272;150;7422;NA;302801;368;2022-01-10;174147
2022-01-09;"Trenčiansky kraj";40;2808;52;2860;NA;302801;92;2022-01-09;173779
2022-01-08;"Trenčiansky kraj";267;1601;45;1646;NA;302801;312;2022-01-08;173687
2022-01-07;"Trenčiansky kraj";334;2968;103;3071;NA;302801;437;2022-01-07;173375
2022-01-06;"Trenčiansky kraj";75;1111;45;1156;NA;302801;120;2022-01-06;172938
2022-01-05;"Trenčiansky kraj";496;3004;84;3088;NA;302801;580;2022-01-05;172818
2022-01-04;"Trenčiansky kraj";521;3890;91;3981;NA;302801;612;2022-01-04;172238
2022-01-03;"Trenčiansky kraj";357;5970;144;6114;NA;302801;501;2022-01-03;171626
2022-01-02;"Trenčiansky kraj";179;2403;74;2477;NA;302801;253;2022-01-02;171125
2022-01-01;"Trenčiansky kraj";4;526;28;554;NA;302801;32;2022-01-01;170872
2021-12-31;"Trenčiansky kraj";443;1478;82;1560;NA;302801;525;2021-12-31;170840
2021-12-30;"Trenčiansky kraj";370;2400;129;2529;NA;302801;499;2021-12-30;170315
2021-12-29;"Trenčiansky kraj";429;2483;87;2570;NA;302801;516;2021-12-29;169816
2021-12-28;"Trenčiansky kraj";609;2741;111;2852;NA;302801;720;2021-12-28;169300
2021-12-27;"Trenčiansky kraj";546;3348;115;3463;NA;302801;661;2021-12-27;168580
2021-12-26;"Trenčiansky kraj";147;1098;78;1176;NA;302801;225;2021-12-26;167919
2021-12-25;"Trenčiansky kraj";52;503;27;530;NA;302801;79;2021-12-25;167694
2021-12-24;"Trenčiansky kraj";176;652;37;689;NA;302801;213;2021-12-24;167615
2021-12-23;"Trenčiansky kraj";532;2431;108;2539;NA;302801;640;2021-12-23;167402
2021-12-22;"Trenčiansky kraj";512;2595;119;2714;NA;302801;631;2021-12-22;166762
2021-12-21;"Trenčiansky kraj";694;3266;123;3389;NA;302801;817;2021-12-21;166131
2021-12-20;"Trenčiansky kraj";488;6754;210;6964;NA;302801;698;2021-12-20;165314
2021-12-19;"Trenčiansky kraj";202;2574;118;2692;NA;302801;320;2021-12-19;164616
2021-12-18;"Trenčiansky kraj";438;1752;108;1860;NA;302801;546;2021-12-18;164296
2021-12-17;"Trenčiansky kraj";427;4054;137;4191;NA;302801;564;2021-12-17;163750
2021-12-16;"Trenčiansky kraj";649;3214;180;3394;NA;302801;829;2021-12-16;163186
2021-12-15;"Trenčiansky kraj";791;4645;167;4812;NA;302801;958;2021-12-15;162357
2021-12-14;"Trenčiansky kraj";885;3640;142;3782;NA;302801;1027;2021-12-14;161399
2021-12-13;"Trenčiansky kraj";573;7458;256;7714;NA;302801;829;2021-12-13;160372
2021-12-12;"Trenčiansky kraj";306;3156;156;3312;NA;302801;462;2021-12-12;159543
2021-12-11;"Trenčiansky kraj";706;1876;138;2014;NA;302801;844;2021-12-11;159081
2021-12-10;"Trenčiansky kraj";789;3694;201;3895;NA;302801;990;2021-12-10;158237
2021-12-09;"Trenčiansky kraj";967;3897;203;4100;NA;302801;1170;2021-12-09;157247
2021-12-08;"Trenčiansky kraj";1020;4475;203;4678;NA;302801;1223;2021-12-08;156077
2021-12-07;"Trenčiansky kraj";1241;6281;217;6498;NA;302801;1458;2021-12-07;154854
2021-12-06;"Trenčiansky kraj";751;8923;430;9353;NA;302801;1181;2021-12-06;153396
2021-12-05;"Trenčiansky kraj";510;3610;210;3820;NA;302801;720;2021-12-05;152215
2021-12-04;"Trenčiansky kraj";1058;2043;156;2199;NA;302801;1214;2021-12-04;151495
2021-12-03;"Trenčiansky kraj";1272;4427;306;4733;NA;302801;1578;2021-12-03;150281
2021-12-02;"Trenčiansky kraj";2007;4132;265;4397;NA;302801;2272;2021-12-02;148703
2021-12-01;"Trenčiansky kraj";1000;4977;299;5276;NA;302801;1299;2021-12-01;146431
2021-11-30;"Trenčiansky kraj";1086;4743;332;5075;NA;302801;1418;2021-11-30;145132
2021-11-29;"Trenčiansky kraj";1165;10434;551;10985;NA;302801;1716;2021-11-29;143714
2021-11-28;"Trenčiansky kraj";664;5566;308;5874;NA;302801;972;2021-11-28;141998
2021-11-27;"Trenčiansky kraj";1080;2782;301;3083;NA;302801;1381;2021-11-27;141026
2021-11-26;"Trenčiansky kraj";1238;4529;350;4879;NA;302801;1588;2021-11-26;139645
2021-11-25;"Trenčiansky kraj";1018;3622;348;3970;NA;302801;1366;2021-11-25;138057
2021-11-24;"Trenčiansky kraj";1362;5596;472;6068;NA;302801;1834;2021-11-24;136691
2021-11-23;"Trenčiansky kraj";1140;3755;351;4106;NA;302801;1491;2021-11-23;134857
2021-11-22;"Trenčiansky kraj";920;6562;568;7130;NA;302801;1488;2021-11-22;133366
2021-11-21;"Trenčiansky kraj";413;3233;377;3610;NA;302801;790;2021-11-21;131878
2021-11-20;"Trenčiansky kraj";914;2379;341;2720;NA;302801;1255;2021-11-20;131088
2021-11-19;"Trenčiansky kraj";1261;3817;448;4265;NA;302801;1709;2021-11-19;129833
2021-11-18;"Trenčiansky kraj";810;5085;529;5614;NA;302801;1339;2021-11-18;128124
2021-11-17;"Trenčiansky kraj";796;1852;237;2089;NA;302801;1033;2021-11-17;126785
2021-11-16;"Trenčiansky kraj";859;4095;403;4498;NA;302801;1262;2021-11-16;125752
2021-11-15;"Trenčiansky kraj";720;5206;557;5763;NA;302801;1277;2021-11-15;124490
2021-11-14;"Trenčiansky kraj";447;2462;343;2805;NA;302801;790;2021-11-14;123213
2021-11-13;"Trenčiansky kraj";478;1879;254;2133;NA;302801;732;2021-11-13;122423
2021-11-12;"Trenčiansky kraj";784;3884;341;4225;NA;302801;1125;2021-11-12;121691
2021-11-11;"Trenčiansky kraj";805;3594;347;3941;NA;302801;1152;2021-11-11;120566
2021-11-10;"Trenčiansky kraj";647;3389;282;3671;NA;302801;929;2021-11-10;119414
2021-11-09;"Trenčiansky kraj";752;2915;306;3221;NA;302801;1058;2021-11-09;118485
2021-11-08;"Trenčiansky kraj";489;4724;355;5079;NA;302801;844;2021-11-08;117427
2021-11-07;"Trenčiansky kraj";405;2043;220;2263;NA;302801;625;2021-11-07;116583
2021-11-06;"Trenčiansky kraj";542;1755;176;1931;NA;302801;718;2021-11-06;115958
2021-11-05;"Trenčiansky kraj";677;3108;240;3348;NA;302801;917;2021-11-05;115240
2021-11-04;"Trenčiansky kraj";563;2741;232;2973;NA;302801;795;2021-11-04;114323
2021-11-03;"Trenčiansky kraj";619;2981;225;3206;NA;302801;844;2021-11-03;113528
2021-11-02;"Trenčiansky kraj";663;3884;313;4197;NA;302801;976;2021-11-02;112684
2021-11-01;"Trenčiansky kraj";219;1029;101;1130;NA;302801;320;2021-11-01;111708
2021-10-31;"Trenčiansky kraj";151;1462;152;1614;NA;302801;303;2021-10-31;111388
2021-10-30;"Trenčiansky kraj";345;1770;130;1900;NA;302801;475;2021-10-30;111085
2021-10-29;"Trenčiansky kraj";415;2885;130;3015;NA;302801;545;2021-10-29;110610
2021-10-28;"Trenčiansky kraj";429;2682;159;2841;NA;302801;588;2021-10-28;110065
2021-10-27;"Trenčiansky kraj";463;2640;94;2734;NA;302801;557;2021-10-27;109477
2021-10-26;"Trenčiansky kraj";419;2657;135;2792;NA;302801;554;2021-10-26;108920
2021-10-25;"Trenčiansky kraj";192;3431;134;3565;NA;302801;326;2021-10-25;108366
2021-10-24;"Trenčiansky kraj";121;1643;79;1722;NA;302801;200;2021-10-24;108040
2021-10-23;"Trenčiansky kraj";326;1737;64;1801;NA;302801;390;2021-10-23;107840
2021-10-22;"Trenčiansky kraj";358;2722;80;2802;NA;302801;438;2021-10-22;107450
2021-10-21;"Trenčiansky kraj";247;2369;76;2445;NA;302801;323;2021-10-21;107012
2021-10-20;"Trenčiansky kraj";302;2124;71;2195;NA;302801;373;2021-10-20;106689
2021-10-19;"Trenčiansky kraj";227;2866;61;2927;NA;302801;288;2021-10-19;106316
2021-10-18;"Trenčiansky kraj";143;2522;73;2595;NA;302801;216;2021-10-18;106028
2021-10-17;"Trenčiansky kraj";46;1457;31;1488;NA;302801;77;2021-10-17;105812
2021-10-16;"Trenčiansky kraj";76;1671;35;1706;NA;302801;111;2021-10-16;105735
2021-10-15;"Trenčiansky kraj";126;2970;52;3022;NA;302801;178;2021-10-15;105624
2021-10-14;"Trenčiansky kraj";103;1717;27;1744;NA;302801;130;2021-10-14;105446
2021-10-13;"Trenčiansky kraj";171;2672;28;2700;NA;302801;199;2021-10-13;105316
2021-10-12;"Trenčiansky kraj";114;2364;33;2397;NA;302801;147;2021-10-12;105117
2021-10-11;"Trenčiansky kraj";109;2571;50;2621;NA;302801;159;2021-10-11;104970
2021-10-10;"Trenčiansky kraj";17;1487;23;1510;NA;302801;40;2021-10-10;104811
2021-10-09;"Trenčiansky kraj";157;1809;16;1825;NA;302801;173;2021-10-09;104771
2021-10-08;"Trenčiansky kraj";82;3100;38;3138;NA;302801;120;2021-10-08;104598
2021-10-07;"Trenčiansky kraj";107;2054;32;2086;NA;302801;139;2021-10-07;104478
2021-10-06;"Trenčiansky kraj";193;2300;37;2337;NA;302801;230;2021-10-06;104339
2021-10-05;"Trenčiansky kraj";119;2236;42;2278;NA;302801;161;2021-10-05;104109
2021-10-04;"Trenčiansky kraj";105;2775;53;2828;NA;302801;158;2021-10-04;103948
2021-10-03;"Trenčiansky kraj";30;1558;27;1585;NA;302801;57;2021-10-03;103790
2021-10-02;"Trenčiansky kraj";107;1794;35;1829;NA;302801;142;2021-10-02;103733
2021-10-01;"Trenčiansky kraj";119;2692;37;2729;NA;302801;156;2021-10-01;103591
2021-09-30;"Trenčiansky kraj";74;2329;50;2379;NA;302801;124;2021-09-30;103435
2021-09-29;"Trenčiansky kraj";170;2151;30;2181;NA;302801;200;2021-09-29;103311
2021-09-28;"Trenčiansky kraj";95;2270;31;2301;NA;302801;126;2021-09-28;103111
2021-09-27;"Trenčiansky kraj";56;2819;57;2876;NA;302801;113;2021-09-27;102985
2021-09-26;"Trenčiansky kraj";20;1675;33;1708;NA;302801;53;2021-09-26;102872
2021-09-25;"Trenčiansky kraj";76;1674;21;1695;NA;302801;97;2021-09-25;102819
2021-09-24;"Trenčiansky kraj";104;3222;35;3257;NA;302801;139;2021-09-24;102722
2021-09-23;"Trenčiansky kraj";91;2252;27;2279;NA;302801;118;2021-09-23;102583
2021-09-22;"Trenčiansky kraj";90;2147;24;2171;NA;302801;114;2021-09-22;102465
2021-09-21;"Trenčiansky kraj";79;2309;29;2338;NA;302801;108;2021-09-21;102351
2021-09-20;"Trenčiansky kraj";78;2615;37;2652;NA;302801;115;2021-09-20;102243
2021-09-19;"Trenčiansky kraj";11;1571;20;1591;NA;302801;31;2021-09-19;102128
2021-09-18;"Trenčiansky kraj";53;2099;14;2113;NA;302801;67;2021-09-18;102097
2021-09-17;"Trenčiansky kraj";55;3144;26;3170;NA;302801;81;2021-09-17;102030
2021-09-16;"Trenčiansky kraj";52;2164;20;2184;NA;302801;72;2021-09-16;101949
2021-09-15;"Trenčiansky kraj";63;1043;7;1050;NA;302801;70;2021-09-15;101877
2021-09-14;"Trenčiansky kraj";67;2450;25;2475;NA;302801;92;2021-09-14;101807
2021-09-13;"Trenčiansky kraj";33;2276;35;2311;NA;302801;68;2021-09-13;101715
2021-09-12;"Trenčiansky kraj";3;1411;11;1422;NA;302801;14;2021-09-12;101647
2021-09-11;"Trenčiansky kraj";55;1729;6;1735;NA;302801;61;2021-09-11;101633
2021-09-10;"Trenčiansky kraj";49;2248;15;2263;NA;302801;64;2021-09-10;101572
2021-09-09;"Trenčiansky kraj";24;1685;30;1715;NA;302801;54;2021-09-09;101508
2021-09-08;"Trenčiansky kraj";54;1773;15;1788;NA;302801;69;2021-09-08;101454
2021-09-07;"Trenčiansky kraj";43;1395;18;1413;NA;302801;61;2021-09-07;101385
2021-09-06;"Trenčiansky kraj";47;1401;15;1416;NA;302801;62;2021-09-06;101324
2021-09-05;"Trenčiansky kraj";2;966;23;989;NA;302801;25;2021-09-05;101262
2021-09-04;"Trenčiansky kraj";41;925;4;929;NA;302801;45;2021-09-04;101237
2021-09-03;"Trenčiansky kraj";53;1422;15;1437;NA;302801;68;2021-09-03;101192
2021-09-02;"Trenčiansky kraj";7;1001;14;1015;NA;302801;21;2021-09-02;101124
2021-09-01;"Trenčiansky kraj";27;431;8;439;NA;302801;35;2021-09-01;101103
2021-08-31;"Trenčiansky kraj";21;1146;15;1161;NA;302801;36;2021-08-31;101068
2021-08-30;"Trenčiansky kraj";32;1168;10;1178;NA;302801;42;2021-08-30;101032
2021-08-29;"Trenčiansky kraj";1;482;11;493;NA;302801;12;2021-08-29;100990
2021-08-28;"Trenčiansky kraj";9;976;10;986;NA;302801;19;2021-08-28;100978
2021-08-27;"Trenčiansky kraj";21;1599;1;1600;NA;302801;22;2021-08-27;100959
2021-08-26;"Trenčiansky kraj";8;993;6;999;NA;302801;14;2021-08-26;100937
2021-08-25;"Trenčiansky kraj";40;875;7;882;NA;302801;47;2021-08-25;100923
2021-08-24;"Trenčiansky kraj";4;822;4;826;NA;302801;8;2021-08-24;100876
2021-08-23;"Trenčiansky kraj";6;1165;17;1182;NA;302801;23;2021-08-23;100868
2021-08-22;"Trenčiansky kraj";0;726;10;736;NA;302801;10;2021-08-22;100845
2021-08-21;"Trenčiansky kraj";5;964;7;971;NA;302801;12;2021-08-21;100835
2021-08-20;"Trenčiansky kraj";15;1538;2;1540;NA;302801;17;2021-08-20;100823
2021-08-19;"Trenčiansky kraj";2;986;2;988;NA;302801;4;2021-08-19;100806
2021-08-18;"Trenčiansky kraj";6;816;7;823;NA;302801;13;2021-08-18;100802
2021-08-17;"Trenčiansky kraj";9;634;1;635;NA;302801;10;2021-08-17;100789
2021-08-16;"Trenčiansky kraj";5;929;3;932;NA;302801;8;2021-08-16;100779
2021-08-15;"Trenčiansky kraj";0;558;1;559;NA;302801;1;2021-08-15;100771
2021-08-14;"Trenčiansky kraj";12;574;6;580;NA;302801;18;2021-08-14;100770
2021-08-13;"Trenčiansky kraj";2;934;0;934;NA;302801;2;2021-08-13;100752
2021-08-12;"Trenčiansky kraj";2;566;3;569;NA;302801;5;2021-08-12;100750
2021-08-11;"Trenčiansky kraj";1;683;0;683;NA;302801;1;2021-08-11;100745
2021-08-10;"Trenčiansky kraj";8;532;1;533;NA;302801;9;2021-08-10;100744
2021-08-09;"Trenčiansky kraj";8;698;1;699;NA;302801;9;2021-08-09;100735
2021-08-08;"Trenčiansky kraj";0;468;0;468;NA;302801;0;2021-08-08;100726
2021-08-07;"Trenčiansky kraj";3;464;0;464;NA;302801;3;2021-08-07;100726
2021-08-06;"Trenčiansky kraj";3;956;1;957;NA;302801;4;2021-08-06;100723
2021-08-05;"Trenčiansky kraj";3;582;1;583;NA;302801;4;2021-08-05;100719
2021-08-04;"Trenčiansky kraj";14;549;3;552;NA;302801;17;2021-08-04;100715
2021-08-03;"Trenčiansky kraj";9;510;5;515;NA;302801;14;2021-08-03;100698
2021-08-02;"Trenčiansky kraj";1;811;2;813;NA;302801;3;2021-08-02;100684
2021-08-01;"Trenčiansky kraj";0;514;1;515;NA;302801;1;2021-08-01;100681
2021-07-31;"Trenčiansky kraj";4;525;2;527;NA;302801;6;2021-07-31;100680
2021-07-30;"Trenčiansky kraj";2;1071;0;1071;NA;302801;2;2021-07-30;100674
2021-07-29;"Trenčiansky kraj";5;710;0;710;NA;302801;5;2021-07-29;100672
2021-07-28;"Trenčiansky kraj";3;521;2;523;NA;302801;5;2021-07-28;100667
2021-07-27;"Trenčiansky kraj";6;553;1;554;NA;302801;7;2021-07-27;100662
2021-07-26;"Trenčiansky kraj";7;781;1;782;NA;302801;8;2021-07-26;100655
2021-07-25;"Trenčiansky kraj";0;487;2;489;NA;302801;2;2021-07-25;100647
2021-07-24;"Trenčiansky kraj";3;643;1;644;NA;302801;4;2021-07-24;100645
2021-07-23;"Trenčiansky kraj";3;1154;0;1154;NA;302801;3;2021-07-23;100641
2021-07-22;"Trenčiansky kraj";2;849;2;851;NA;302801;4;2021-07-22;100638
2021-07-21;"Trenčiansky kraj";8;667;2;669;NA;302801;10;2021-07-21;100634
2021-07-20;"Trenčiansky kraj";4;530;1;531;NA;302801;5;2021-07-20;100624
2021-07-19;"Trenčiansky kraj";0;878;4;882;NA;302801;4;2021-07-19;100619
2021-07-18;"Trenčiansky kraj";0;526;0;526;NA;302801;0;2021-07-18;100615
2021-07-17;"Trenčiansky kraj";3;673;0;673;NA;302801;3;2021-07-17;100615
2021-07-16;"Trenčiansky kraj";4;1126;0;1126;NA;302801;4;2021-07-16;100612
2021-07-15;"Trenčiansky kraj";2;830;0;830;NA;302801;2;2021-07-15;100608
2021-07-14;"Trenčiansky kraj";8;665;1;666;NA;302801;9;2021-07-14;100606
2021-07-13;"Trenčiansky kraj";1;528;3;531;NA;302801;4;2021-07-13;100597
2021-07-12;"Trenčiansky kraj";9;827;3;830;NA;302801;12;2021-07-12;100593
2021-07-11;"Trenčiansky kraj";0;611;2;613;NA;302801;2;2021-07-11;100581
2021-07-10;"Trenčiansky kraj";2;535;0;535;NA;302801;2;2021-07-10;100579
2021-07-09;"Trenčiansky kraj";7;1387;2;1389;NA;302801;9;2021-07-09;100577
2021-07-08;"Trenčiansky kraj";2;824;1;825;NA;302801;3;2021-07-08;100568
2021-07-07;"Trenčiansky kraj";2;943;1;944;NA;302801;3;2021-07-07;100565
2021-07-06;"Trenčiansky kraj";4;1046;2;1048;NA;302801;6;2021-07-06;100562
2021-07-05;"Trenčiansky kraj";1;516;0;516;NA;302801;1;2021-07-05;100556
2021-07-04;"Trenčiansky kraj";0;612;1;613;NA;302801;1;2021-07-04;100555
2021-07-03;"Trenčiansky kraj";3;815;1;816;NA;302801;4;2021-07-03;100554
2021-07-02;"Trenčiansky kraj";5;1590;2;1592;NA;302801;7;2021-07-02;100550
2021-07-01;"Trenčiansky kraj";4;1173;1;1174;NA;302801;5;2021-07-01;100543
2021-06-30;"Trenčiansky kraj";2;7021;6;7027;NA;302801;8;2021-06-30;100538
2021-06-29;"Trenčiansky kraj";4;2773;5;2778;NA;302801;9;2021-06-29;100530
2021-06-28;"Trenčiansky kraj";5;3672;9;3681;NA;302801;14;2021-06-28;100521
2021-06-27;"Trenčiansky kraj";0;2861;1;2862;NA;302801;1;2021-06-27;100507
2021-06-26;"Trenčiansky kraj";1;3547;4;3551;NA;302801;5;2021-06-26;100506
2021-06-25;"Trenčiansky kraj";2;4635;2;4637;NA;302801;4;2021-06-25;100501
2021-06-24;"Trenčiansky kraj";3;3320;4;3324;NA;302801;7;2021-06-24;100497
2021-06-23;"Trenčiansky kraj";4;2808;2;2810;NA;302801;6;2021-06-23;100490
2021-06-22;"Trenčiansky kraj";7;3137;4;3141;NA;302801;11;2021-06-22;100484
2021-06-21;"Trenčiansky kraj";10;3891;4;3895;NA;302801;14;2021-06-21;100473
2021-06-20;"Trenčiansky kraj";0;3579;5;3584;NA;302801;5;2021-06-20;100459
2021-06-19;"Trenčiansky kraj";5;4528;1;4529;NA;302801;6;2021-06-19;100454
2021-06-18;"Trenčiansky kraj";7;6725;7;6732;NA;302801;14;2021-06-18;100448
2021-06-17;"Trenčiansky kraj";0;3469;6;3475;NA;302801;6;2021-06-17;100434
2021-06-16;"Trenčiansky kraj";4;3183;3;3186;NA;302801;7;2021-06-16;100428
2021-06-15;"Trenčiansky kraj";10;3697;2;3699;NA;302801;12;2021-06-15;100421
2021-06-14;"Trenčiansky kraj";10;4805;15;4820;NA;302801;25;2021-06-14;100409
2021-06-13;"Trenčiansky kraj";0;4643;4;4647;NA;302801;4;2021-06-13;100384
2021-06-12;"Trenčiansky kraj";4;5260;8;5268;NA;302801;12;2021-06-12;100380
2021-06-11;"Trenčiansky kraj";10;7365;11;7376;NA;302801;21;2021-06-11;100368
2021-06-10;"Trenčiansky kraj";5;4345;7;4352;NA;302801;12;2021-06-10;100347
2021-06-09;"Trenčiansky kraj";7;3693;7;3700;NA;302801;14;2021-06-09;100335
2021-06-08;"Trenčiansky kraj";21;3965;7;3972;NA;302801;28;2021-06-08;100321
2021-06-07;"Trenčiansky kraj";13;5560;10;5570;NA;302801;23;2021-06-07;100293
2021-06-06;"Trenčiansky kraj";0;5500;10;5510;NA;302801;10;2021-06-06;100270
2021-06-05;"Trenčiansky kraj";7;6511;5;6516;NA;302801;12;2021-06-05;100260
2021-06-04;"Trenčiansky kraj";16;7653;3;7656;NA;302801;19;2021-06-04;100248
2021-06-03;"Trenčiansky kraj";9;4485;10;4495;NA;302801;19;2021-06-03;100229
2021-06-02;"Trenčiansky kraj";28;4329;8;4337;NA;302801;36;2021-06-02;100210
2021-06-01;"Trenčiansky kraj";22;5396;18;5414;NA;302801;40;2021-06-01;100174
2021-05-31;"Trenčiansky kraj";30;6117;24;6141;NA;302801;54;2021-05-31;100134
2021-05-30;"Trenčiansky kraj";0;8258;16;8274;NA;302801;16;2021-05-30;100080
2021-05-29;"Trenčiansky kraj";13;7915;14;7929;NA;302801;27;2021-05-29;100064
2021-05-28;"Trenčiansky kraj";22;8995;25;9020;NA;302801;47;2021-05-28;100037
2021-05-27;"Trenčiansky kraj";6;5205;12;5217;NA;302801;18;2021-05-27;99990
2021-05-26;"Trenčiansky kraj";26;5069;15;5084;NA;302801;41;2021-05-26;99972
2021-05-25;"Trenčiansky kraj";18;6168;24;6192;NA;302801;42;2021-05-25;99931
2021-05-24;"Trenčiansky kraj";19;9292;37;9329;NA;302801;56;2021-05-24;99889
2021-05-23;"Trenčiansky kraj";0;9083;26;9109;NA;302801;26;2021-05-23;99833
2021-05-22;"Trenčiansky kraj";11;11314;21;11335;NA;302801;32;2021-05-22;99807
2021-05-21;"Trenčiansky kraj";23;11572;26;11598;NA;302801;49;2021-05-21;99775
2021-05-20;"Trenčiansky kraj";23;6320;25;6345;NA;302801;48;2021-05-20;99726
2021-05-19;"Trenčiansky kraj";16;5694;32;5726;NA;302801;48;2021-05-19;99678
2021-05-18;"Trenčiansky kraj";26;7779;28;7807;NA;302801;54;2021-05-18;99630
2021-05-17;"Trenčiansky kraj";37;7671;43;7714;NA;302801;80;2021-05-17;99576
2021-05-16;"Trenčiansky kraj";25;15615;41;15656;NA;302801;66;2021-05-16;99496
2021-05-15;"Trenčiansky kraj";3;21237;32;21269;NA;302801;35;2021-05-15;99430
2021-05-14;"Trenčiansky kraj";41;18676;42;18718;NA;302801;83;2021-05-14;99395
2021-05-13;"Trenčiansky kraj";41;8195;24;8219;NA;302801;65;2021-05-13;99312
2021-05-12;"Trenčiansky kraj";41;7409;31;7440;NA;302801;72;2021-05-12;99247
2021-05-11;"Trenčiansky kraj";66;10507;32;10539;NA;302801;98;2021-05-11;99175
2021-05-10;"Trenčiansky kraj";48;12989;55;13044;NA;302801;103;2021-05-10;99077
2021-05-09;"Trenčiansky kraj";52;17737;39;17776;NA;302801;91;2021-05-09;98974
2021-05-08;"Trenčiansky kraj";3;23822;33;23855;NA;302801;36;2021-05-08;98883
2021-05-07;"Trenčiansky kraj";45;23549;56;23605;NA;302801;101;2021-05-07;98847
2021-05-06;"Trenčiansky kraj";26;10771;44;10815;NA;302801;70;2021-05-06;98746
2021-05-05;"Trenčiansky kraj";73;9377;41;9418;NA;302801;114;2021-05-05;98676
2021-05-04;"Trenčiansky kraj";55;12733;53;12786;NA;302801;108;2021-05-04;98562
2021-05-03;"Trenčiansky kraj";60;15331;51;15382;NA;302801;111;2021-05-03;98454
2021-05-02;"Trenčiansky kraj";0;31152;65;31217;NA;302801;65;2021-05-02;98343
2021-05-01;"Trenčiansky kraj";71;56982;60;57042;NA;302801;131;2021-05-01;98278
2021-04-30;"Trenčiansky kraj";77;29427;61;29488;NA;302801;138;2021-04-30;98147
2021-04-29;"Trenčiansky kraj";49;13184;59;13243;NA;302801;108;2021-04-29;98009
2021-04-28;"Trenčiansky kraj";79;12537;52;12589;NA;302801;131;2021-04-28;97901
2021-04-27;"Trenčiansky kraj";107;15527;40;15567;NA;302801;147;2021-04-27;97770
2021-04-26;"Trenčiansky kraj";52;21070;63;21133;NA;302801;115;2021-04-26;97623
2021-04-25;"Trenčiansky kraj";0;34560;48;34608;NA;302801;48;2021-04-25;97508
2021-04-24;"Trenčiansky kraj";76;72398;100;72498;NA;302801;176;2021-04-24;97460
2021-04-23;"Trenčiansky kraj";143;29959;79;30038;NA;302801;222;2021-04-23;97284
2021-04-22;"Trenčiansky kraj";71;13847;64;13911;NA;302801;135;2021-04-22;97062
2021-04-21;"Trenčiansky kraj";79;13000;67;13067;NA;302801;146;2021-04-21;96927
2021-04-20;"Trenčiansky kraj";142;17740;80;17820;NA;302801;222;2021-04-20;96781
2021-04-19;"Trenčiansky kraj";102;22631;103;22734;NA;302801;205;2021-04-19;96559
2021-04-18;"Trenčiansky kraj";3;40879;97;40976;NA;302801;100;2021-04-18;96354
2021-04-17;"Trenčiansky kraj";77;81498;136;81634;NA;302801;213;2021-04-17;96254
2021-04-16;"Trenčiansky kraj";100;31961;90;32051;NA;302801;190;2021-04-16;96041
2021-04-15;"Trenčiansky kraj";71;14479;69;14548;NA;302801;140;2021-04-15;95851
2021-04-14;"Trenčiansky kraj";135;15563;72;15635;NA;302801;207;2021-04-14;95711
2021-04-13;"Trenčiansky kraj";189;18721;75;18796;NA;302801;264;2021-04-13;95504
2021-04-12;"Trenčiansky kraj";97;23743;91;23834;NA;302801;188;2021-04-12;95240
2021-04-11;"Trenčiansky kraj";1;34735;75;34810;NA;302801;76;2021-04-11;95052
2021-04-10;"Trenčiansky kraj";81;83093;145;83238;NA;302801;226;2021-04-10;94976
2021-04-09;"Trenčiansky kraj";120;28014;91;28105;NA;302801;211;2021-04-09;94750
2021-04-08;"Trenčiansky kraj";112;13283;85;13368;NA;302801;197;2021-04-08;94539
2021-04-07;"Trenčiansky kraj";204;17688;123;17811;NA;302801;327;2021-04-07;94342
2021-04-06;"Trenčiansky kraj";157;28567;178;28745;NA;302801;335;2021-04-06;94015
2021-04-05;"Trenčiansky kraj";15;9227;64;9291;NA;302801;79;2021-04-05;93680
2021-04-04;"Trenčiansky kraj";2;20291;85;20376;NA;302801;87;2021-04-04;93601
2021-04-03;"Trenčiansky kraj";86;80473;221;80694;NA;302801;307;2021-04-03;93514
2021-04-02;"Trenčiansky kraj";126;21620;81;21701;NA;302801;207;2021-04-02;93207
2021-04-01;"Trenčiansky kraj";159;32376;139;32515;NA;302801;298;2021-04-01;93000
2021-03-31;"Trenčiansky kraj";198;20100;130;20230;NA;302801;328;2021-03-31;92702
2021-03-30;"Trenčiansky kraj";272;17305;136;17441;NA;302801;408;2021-03-30;92374
2021-03-29;"Trenčiansky kraj";142;19479;170;19649;NA;302801;312;2021-03-29;91966
2021-03-28;"Trenčiansky kraj";3;34759;116;34875;NA;302801;119;2021-03-28;91654
2021-03-27;"Trenčiansky kraj";130;77314;293;77607;NA;302801;423;2021-03-27;91535
2021-03-26;"Trenčiansky kraj";211;35095;157;35252;NA;302801;368;2021-03-26;91112
2021-03-25;"Trenčiansky kraj";184;16580;176;16756;NA;302801;360;2021-03-25;90744
2021-03-24;"Trenčiansky kraj";259;13102;171;13273;NA;302801;430;2021-03-24;90384
2021-03-23;"Trenčiansky kraj";349;17589;174;17763;NA;302801;523;2021-03-23;89954
2021-03-22;"Trenčiansky kraj";141;21116;213;21329;NA;302801;354;2021-03-22;89431
2021-03-21;"Trenčiansky kraj";85;32711;164;32875;NA;302801;249;2021-03-21;89077
2021-03-20;"Trenčiansky kraj";128;80035;322;80357;NA;302801;450;2021-03-20;88828
2021-03-19;"Trenčiansky kraj";231;34783;232;35015;NA;302801;463;2021-03-19;88378
2021-03-18;"Trenčiansky kraj";262;16105;178;16283;NA;302801;440;2021-03-18;87915
2021-03-17;"Trenčiansky kraj";366;13435;164;13599;NA;302801;530;2021-03-17;87475
2021-03-16;"Trenčiansky kraj";450;15282;241;15523;NA;302801;691;2021-03-16;86945
2021-03-15;"Trenčiansky kraj";162;21235;261;21496;NA;302801;423;2021-03-15;86254
2021-03-14;"Trenčiansky kraj";42;34416;238;34654;NA;302801;280;2021-03-14;85831
2021-03-13;"Trenčiansky kraj";270;79186;453;79639;NA;302801;723;2021-03-13;85551
2021-03-12;"Trenčiansky kraj";366;34795;307;35102;NA;302801;673;2021-03-12;84828
2021-03-11;"Trenčiansky kraj";302;15558;213;15771;NA;302801;515;2021-03-11;84155
2021-03-10;"Trenčiansky kraj";402;13585;237;13822;NA;302801;639;2021-03-10;83640
2021-03-09;"Trenčiansky kraj";586;17982;285;18267;NA;302801;871;2021-03-09;83001
2021-03-08;"Trenčiansky kraj";174;21704;363;22067;NA;302801;537;2021-03-08;82130
2021-03-07;"Trenčiansky kraj";4;33660;313;33973;NA;302801;317;2021-03-07;81593
2021-03-06;"Trenčiansky kraj";260;79661;529;80190;NA;302801;789;2021-03-06;81276
2021-03-05;"Trenčiansky kraj";326;32969;415;33384;NA;302801;741;2021-03-05;80487
2021-03-04;"Trenčiansky kraj";323;16821;317;17138;NA;302801;640;2021-03-04;79746
2021-03-03;"Trenčiansky kraj";413;13960;347;14307;NA;302801;760;2021-03-03;79106
2021-03-02;"Trenčiansky kraj";612;17794;344;18138;NA;302801;956;2021-03-02;78346
2021-03-01;"Trenčiansky kraj";217;21104;445;21549;NA;302801;662;2021-03-01;77390
2021-02-28;"Trenčiansky kraj";45;30238;376;30614;NA;302801;421;2021-02-28;76728
2021-02-27;"Trenčiansky kraj";277;78735;686;79421;NA;302801;963;2021-02-27;76307
2021-02-26;"Trenčiansky kraj";420;32940;434;33374;NA;302801;854;2021-02-26;75344
2021-02-25;"Trenčiansky kraj";424;14029;328;14357;NA;302801;752;2021-02-25;74490
2021-02-24;"Trenčiansky kraj";427;12014;399;12413;NA;302801;826;2021-02-24;73738
2021-02-23;"Trenčiansky kraj";577;14904;390;15294;NA;302801;967;2021-02-23;72912
2021-02-22;"Trenčiansky kraj";160;19969;468;20437;NA;302801;628;2021-02-22;71945
2021-02-21;"Trenčiansky kraj";64;29478;392;29870;NA;302801;456;2021-02-21;71317
2021-02-20;"Trenčiansky kraj";274;77840;745;78585;NA;302801;1019;2021-02-20;70861
2021-02-19;"Trenčiansky kraj";272;30260;523;30783;NA;302801;795;2021-02-19;69842
2021-02-18;"Trenčiansky kraj";355;14094;403;14497;NA;302801;758;2021-02-18;69047
2021-02-17;"Trenčiansky kraj";363;11412;376;11788;NA;302801;739;2021-02-17;68289
2021-02-16;"Trenčiansky kraj";488;17761;406;18167;NA;302801;894;2021-02-16;67550
2021-02-15;"Trenčiansky kraj";151;21846;463;22309;NA;302801;614;2021-02-15;66656
2021-02-14;"Trenčiansky kraj";2;31255;324;31579;NA;302801;326;2021-02-14;66042
2021-02-13;"Trenčiansky kraj";274;63006;522;63528;NA;302801;796;2021-02-13;65716
2021-02-12;"Trenčiansky kraj";276;27979;412;28391;NA;302801;688;2021-02-12;64920
2021-02-11;"Trenčiansky kraj";291;11567;323;11890;NA;302801;614;2021-02-11;64232
2021-02-10;"Trenčiansky kraj";304;11408;317;11725;NA;302801;621;2021-02-10;63618
2021-02-09;"Trenčiansky kraj";514;18412;360;18772;NA;302801;874;2021-02-09;62997
2021-02-08;"Trenčiansky kraj";182;26832;430;27262;NA;302801;612;2021-02-08;62123
2021-02-07;"Trenčiansky kraj";31;36781;341;37122;NA;302801;372;2021-02-07;61511
2021-02-06;"Trenčiansky kraj";216;63931;560;64491;NA;302801;776;2021-02-06;61139
2021-02-05;"Trenčiansky kraj";202;18164;367;18531;NA;302801;569;2021-02-05;60363
2021-02-04;"Trenčiansky kraj";266;7253;311;7564;NA;302801;577;2021-02-04;59794
2021-02-03;"Trenčiansky kraj";162;6723;320;7043;NA;302801;482;2021-02-03;59217
2021-02-02;"Trenčiansky kraj";347;8074;381;8455;NA;302801;728;2021-02-02;58735
2021-02-01;"Trenčiansky kraj";167;8921;311;9232;NA;302801;478;2021-02-01;58007
2021-01-31;"Trenčiansky kraj";7;19103;159;19262;NA;302801;166;2021-01-31;57529
2021-01-30;"Trenčiansky kraj";228;38167;332;38499;NA;302801;560;2021-01-30;57363
2021-01-29;"Trenčiansky kraj";214;7590;235;7825;NA;302801;449;2021-01-29;56803
2021-01-28;"Trenčiansky kraj";307;5442;158;5600;NA;302801;465;2021-01-28;56354
2021-01-27;"Trenčiansky kraj";166;4842;181;5023;NA;302801;347;2021-01-27;55889
2021-01-26;"Trenčiansky kraj";303;14589;250;14839;NA;302801;553;2021-01-26;55542
2021-01-25;"Trenčiansky kraj";160;24310;207;24517;NA;302801;367;2021-01-25;54989
2021-01-24;"Trenčiansky kraj";51;38369;282;38651;NA;302801;333;2021-01-24;54622
2021-01-23;"Trenčiansky kraj";206;114125;749;114874;NA;302801;955;2021-01-23;54289
2021-01-22;"Trenčiansky kraj";148;21831;241;22072;NA;302801;389;2021-01-22;53334
2021-01-21;"Trenčiansky kraj";143;8586;166;8752;NA;302801;309;2021-01-21;52945
2021-01-20;"Trenčiansky kraj";181;8189;227;8416;NA;302801;408;2021-01-20;52636
2021-01-19;"Trenčiansky kraj";363;6600;262;6862;NA;302801;625;2021-01-19;52228
2021-01-18;"Trenčiansky kraj";72;4970;321;5291;NA;302801;393;2021-01-18;51603
2021-01-17;"Trenčiansky kraj";124;156;11;167;NA;302801;135;2021-01-17;51210
2021-01-16;"Trenčiansky kraj";39;1288;53;1341;NA;302801;92;2021-01-16;51075
2021-01-15;"Trenčiansky kraj";264;4031;214;4245;NA;302801;478;2021-01-15;50983
2021-01-14;"Trenčiansky kraj";275;3193;189;3382;NA;302801;464;2021-01-14;50505
2021-01-13;"Trenčiansky kraj";222;3893;215;4108;NA;302801;437;2021-01-13;50041
2021-01-12;"Trenčiansky kraj";508;4604;261;4865;NA;302801;769;2021-01-12;49604
2021-01-11;"Trenčiansky kraj";142;4367;354;4721;NA;302801;496;2021-01-11;48835
2021-01-10;"Trenčiansky kraj";89;4969;77;5046;NA;302801;166;2021-01-10;48339
2021-01-09;"Trenčiansky kraj";276;8280;128;8408;NA;302801;404;2021-01-09;48173
2021-01-08;"Trenčiansky kraj";489;6435;484;6919;NA;302801;973;2021-01-08;47769
2021-01-07;"Trenčiansky kraj";420;6138;577;6715;NA;302801;997;2021-01-07;46796
2021-01-06;"Trenčiansky kraj";221;1021;64;1085;NA;302801;285;2021-01-06;45799
2021-01-05;"Trenčiansky kraj";669;5753;706;6459;NA;302801;1375;2021-01-05;45514
2021-01-04;"Trenčiansky kraj";337;5248;782;6030;NA;302801;1119;2021-01-04;44139
2021-01-03;"Trenčiansky kraj";38;114;15;129;NA;302801;53;2021-01-03;43020
2021-01-02;"Trenčiansky kraj";129;196;23;219;NA;302801;152;2021-01-02;42967
2021-01-01;"Trenčiansky kraj";329;347;23;370;NA;302801;352;2021-01-01;42815
2020-12-31;"Trenčiansky kraj";597;4943;557;5500;NA;302801;1154;2020-12-31;42463
2020-12-30;"Trenčiansky kraj";836;7012;762;7774;NA;302801;1598;2020-12-30;41309
2020-12-29;"Trenčiansky kraj";459;6121;1009;7130;NA;302801;1468;2020-12-29;39711
2020-12-28;"Trenčiansky kraj";258;4195;777;4972;NA;302801;1035;2020-12-28;38243
2020-12-27;"Trenčiansky kraj";5;208;36;244;NA;302801;41;2020-12-27;37208
2020-12-26;"Trenčiansky kraj";174;74;10;84;NA;302801;184;2020-12-26;37167
2020-12-25;"Trenčiansky kraj";251;325;47;372;NA;302801;298;2020-12-25;36983
2020-12-24;"Trenčiansky kraj";552;2194;256;2450;NA;302801;808;2020-12-24;36685
2020-12-23;"Trenčiansky kraj";421;6552;661;7213;NA;302801;1082;2020-12-23;35877
2020-12-22;"Trenčiansky kraj";673;5760;694;6454;NA;302801;1367;2020-12-22;34795
2020-12-21;"Trenčiansky kraj";248;13395;979;14374;NA;302801;1227;2020-12-21;33428
2020-12-20;"Trenčiansky kraj";238;12504;292;12796;NA;302801;530;2020-12-20;32201
2020-12-19;"Trenčiansky kraj";341;1611;150;1761;NA;302801;491;2020-12-19;31671
2020-12-18;"Trenčiansky kraj";521;5199;615;5814;NA;302801;1136;2020-12-18;31180
2020-12-17;"Trenčiansky kraj";670;3843;524;4367;NA;302801;1194;2020-12-17;30044
2020-12-16;"Trenčiansky kraj";461;4474;648;5122;NA;302801;1109;2020-12-16;28850
2020-12-15;"Trenčiansky kraj";595;3805;670;4475;NA;302801;1265;2020-12-15;27741
2020-12-14;"Trenčiansky kraj";318;2907;552;3459;NA;302801;870;2020-12-14;26476
2020-12-13;"Trenčiansky kraj";77;49;6;55;NA;302801;83;2020-12-13;25606
2020-12-12;"Trenčiansky kraj";314;1191;136;1327;NA;302801;450;2020-12-12;25523
2020-12-11;"Trenčiansky kraj";751;3773;453;4226;NA;302801;1204;2020-12-11;25073
2020-12-10;"Trenčiansky kraj";271;3354;473;3827;NA;302801;744;2020-12-10;23869
2020-12-09;"Trenčiansky kraj";508;3788;466;4254;NA;302801;974;2020-12-09;23125
2020-12-08;"Trenčiansky kraj";546;3440;522;3962;NA;302801;1068;2020-12-08;22151
2020-12-07;"Trenčiansky kraj";258;3832;468;4300;NA;302801;726;2020-12-07;21083
2020-12-06;"Trenčiansky kraj";114;179;10;189;NA;302801;124;2020-12-06;20357
2020-12-05;"Trenčiansky kraj";223;610;56;666;NA;302801;279;2020-12-05;20233
2020-12-04;"Trenčiansky kraj";253;2943;273;3216;NA;302801;526;2020-12-04;19954
2020-12-03;"Trenčiansky kraj";503;1714;178;1892;NA;302801;681;2020-12-03;19428
2020-12-02;"Trenčiansky kraj";418;1844;232;2076;NA;302801;650;2020-12-02;18747
2020-12-01;"Trenčiansky kraj";321;5642;351;5993;NA;302801;672;2020-12-01;18097
2020-11-30;"Trenčiansky kraj";167;11514;520;12034;NA;302801;687;2020-11-30;17425
2020-11-29;"Trenčiansky kraj";29;30;5;35;NA;302801;34;2020-11-29;16738
2020-11-28;"Trenčiansky kraj";202;1051;93;1144;NA;302801;295;2020-11-28;16704
2020-11-27;"Trenčiansky kraj";330;1888;186;2074;NA;302801;516;2020-11-27;16409
2020-11-26;"Trenčiansky kraj";395;1252;122;1374;NA;302801;517;2020-11-26;15893
2020-11-25;"Trenčiansky kraj";322;1444;160;1604;NA;302801;482;2020-11-25;15376
2020-11-24;"Trenčiansky kraj";348;2553;308;2861;NA;302801;656;2020-11-24;14894
2020-11-23;"Trenčiansky kraj";159;1186;122;1308;NA;302801;281;2020-11-23;14238
2020-11-22;"Trenčiansky kraj";26;30;7;37;NA;302801;33;2020-11-22;13957
2020-11-21;"Trenčiansky kraj";255;1376;69;1445;NA;302801;324;2020-11-21;13924
2020-11-20;"Trenčiansky kraj";316;861;93;954;NA;302801;409;2020-11-20;13600
2020-11-19;"Trenčiansky kraj";316;740;113;853;NA;302801;429;2020-11-19;13191
2020-11-18;"Trenčiansky kraj";233;379;66;445;NA;302801;299;2020-11-18;12762
2020-11-17;"Trenčiansky kraj";222;106;15;121;NA;302801;237;2020-11-17;12463
2020-11-16;"Trenčiansky kraj";245;236;45;281;NA;302801;290;2020-11-16;12226
2020-11-15;"Trenčiansky kraj";109;29;6;35;NA;302801;115;2020-11-15;11936
2020-11-14;"Trenčiansky kraj";190;74;11;85;NA;302801;201;2020-11-14;11821
2020-11-13;"Trenčiansky kraj";308;131;13;144;NA;302801;321;2020-11-13;11620
2020-11-12;"Trenčiansky kraj";324;124;5;129;NA;302801;329;2020-11-12;11299
2020-11-11;"Trenčiansky kraj";366;113;10;123;NA;302801;376;2020-11-11;10970
2020-11-10;"Trenčiansky kraj";277;106;6;112;NA;302801;283;2020-11-10;10594
2020-11-09;"Trenčiansky kraj";115;1407;48;1455;NA;302801;163;2020-11-09;10311
2020-11-08;"Trenčiansky kraj";81;1271;8;1279;NA;302801;89;2020-11-08;10148
2020-11-07;"Trenčiansky kraj";319;3662;59;3721;NA;302801;378;2020-11-07;10059
2020-11-06;"Trenčiansky kraj";383;6893;84;6977;NA;302801;467;2020-11-06;9681
2020-11-05;"Trenčiansky kraj";399;98;15;113;NA;302801;414;2020-11-05;9214
2020-11-04;"Trenčiansky kraj";370;91;9;100;NA;302801;379;2020-11-04;8800
2020-11-03;"Trenčiansky kraj";575;97;8;105;NA;302801;583;2020-11-03;8421
2020-11-02;"Trenčiansky kraj";197;1833;68;1901;NA;302801;265;2020-11-02;7838
2020-11-01;"Trenčiansky kraj";257;808;24;832;NA;302801;281;2020-11-01;7573
2020-10-31;"Trenčiansky kraj";332;4719;82;4801;NA;302801;414;2020-10-31;7292
2020-10-30;"Trenčiansky kraj";299;5283;102;5385;NA;302801;401;2020-10-30;6878
2020-10-29;"Trenčiansky kraj";496;764;68;832;NA;302801;564;2020-10-29;6477
2020-10-28;"Trenčiansky kraj";269;192;33;225;NA;302801;302;2020-10-28;5913
2020-10-27;"Trenčiansky kraj";473;127;27;154;NA;302801;500;2020-10-27;5611
2020-10-26;"Trenčiansky kraj";177;107;36;143;NA;302801;213;2020-10-26;5111
2020-10-25;"Trenčiansky kraj";138;9;5;14;NA;302801;143;2020-10-25;4898
2020-10-24;"Trenčiansky kraj";395;128;6;134;NA;302801;401;2020-10-24;4755
2020-10-23;"Trenčiansky kraj";301;154;8;162;NA;302801;309;2020-10-23;4354
2020-10-22;"Trenčiansky kraj";273;82;12;94;NA;302801;285;2020-10-22;4045
2020-10-21;"Trenčiansky kraj";183;53;9;62;NA;302801;192;2020-10-21;3760
2020-10-20;"Trenčiansky kraj";212;47;6;53;NA;302801;218;2020-10-20;3568
2020-10-19;"Trenčiansky kraj";41;83;25;108;NA;302801;66;2020-10-19;3350
2020-10-18;"Trenčiansky kraj";104;0;0;0;NA;302801;104;2020-10-18;3284
2020-10-17;"Trenčiansky kraj";157;0;0;0;NA;302801;157;2020-10-17;3180
2020-10-16;"Trenčiansky kraj";225;42;6;48;NA;302801;231;2020-10-16;3023
2020-10-15;"Trenčiansky kraj";255;39;4;43;NA;302801;259;2020-10-15;2792
2020-10-14;"Trenčiansky kraj";162;42;7;49;NA;302801;169;2020-10-14;2533
2020-10-13;"Trenčiansky kraj";124;105;12;117;NA;302801;136;2020-10-13;2364
2020-10-12;"Trenčiansky kraj";55;0;0;0;NA;302801;55;2020-10-12;2228
2020-10-11;"Trenčiansky kraj";73;0;0;0;NA;302801;73;2020-10-11;2173
2020-10-10;"Trenčiansky kraj";180;0;0;0;NA;302801;180;2020-10-10;2100
2020-10-09;"Trenčiansky kraj";198;0;0;0;NA;302801;198;2020-10-09;1920
2020-10-08;"Trenčiansky kraj";115;0;0;0;NA;302801;115;2020-10-08;1722
2020-10-07;"Trenčiansky kraj";75;0;0;0;NA;302801;75;2020-10-07;1607
2020-10-06;"Trenčiansky kraj";72;0;0;0;NA;302801;72;2020-10-06;1532
2020-10-05;"Trenčiansky kraj";32;0;0;0;NA;302801;32;2020-10-05;1460
2020-10-04;"Trenčiansky kraj";37;0;0;0;NA;302801;37;2020-10-04;1428
2020-10-03;"Trenčiansky kraj";79;0;0;0;NA;302801;79;2020-10-03;1391
2020-10-02;"Trenčiansky kraj";69;0;0;0;NA;302801;69;2020-10-02;1312
2020-10-01;"Trenčiansky kraj";58;0;0;0;NA;302801;58;2020-10-01;1243
2020-09-30;"Trenčiansky kraj";76;0;0;0;NA;302801;76;2020-09-30;1185
2020-09-29;"Trenčiansky kraj";43;0;0;0;NA;302801;43;2020-09-29;1109
2020-09-28;"Trenčiansky kraj";7;0;0;0;NA;302801;7;2020-09-28;1066
2020-09-27;"Trenčiansky kraj";12;0;0;0;NA;302801;12;2020-09-27;1059
2020-09-26;"Trenčiansky kraj";37;0;0;0;NA;302801;37;2020-09-26;1047
2020-09-25;"Trenčiansky kraj";72;0;0;0;NA;302801;72;2020-09-25;1010
2020-09-24;"Trenčiansky kraj";41;0;0;0;NA;302801;41;2020-09-24;938
2020-09-23;"Trenčiansky kraj";32;0;0;0;NA;302801;32;2020-09-23;897
2020-09-22;"Trenčiansky kraj";26;0;0;0;NA;302801;26;2020-09-22;865
2020-09-21;"Trenčiansky kraj";23;0;0;0;NA;302801;23;2020-09-21;839
2020-09-20;"Trenčiansky kraj";21;0;0;0;NA;302801;21;2020-09-20;816
2020-09-19;"Trenčiansky kraj";20;0;0;0;NA;302801;20;2020-09-19;795
2020-09-18;"Trenčiansky kraj";41;0;0;0;NA;302801;41;2020-09-18;775
2020-09-17;"Trenčiansky kraj";20;0;0;0;NA;302801;20;2020-09-17;734
2020-09-16;"Trenčiansky kraj";14;0;0;0;NA;302801;14;2020-09-16;714
2020-09-15;"Trenčiansky kraj";8;0;0;0;NA;302801;8;2020-09-15;700
2020-09-14;"Trenčiansky kraj";5;0;0;0;NA;302801;5;2020-09-14;692
2020-09-13;"Trenčiansky kraj";12;0;0;0;NA;302801;12;2020-09-13;687
2020-09-12;"Trenčiansky kraj";2;0;0;0;NA;302801;2;2020-09-12;675
2020-09-11;"Trenčiansky kraj";27;0;0;0;NA;302801;27;2020-09-11;673
2020-09-10;"Trenčiansky kraj";15;0;0;0;NA;302801;15;2020-09-10;646
2020-09-09;"Trenčiansky kraj";11;0;0;0;NA;302801;11;2020-09-09;631
2020-09-08;"Trenčiansky kraj";12;0;0;0;NA;302801;12;2020-09-08;620
2020-09-07;"Trenčiansky kraj";6;0;0;0;NA;302801;6;2020-09-07;608
2020-09-06;"Trenčiansky kraj";1;0;0;0;NA;302801;1;2020-09-06;602
2020-09-05;"Trenčiansky kraj";3;0;0;0;NA;302801;3;2020-09-05;601
2020-09-04;"Trenčiansky kraj";9;0;0;0;NA;302801;9;2020-09-04;598
2020-09-03;"Trenčiansky kraj";10;0;0;0;NA;302801;10;2020-09-03;589
2020-09-02;"Trenčiansky kraj";5;0;0;0;NA;302801;5;2020-09-02;579
2020-09-01;"Trenčiansky kraj";1;0;0;0;NA;302801;1;2020-09-01;574
2020-08-31;"Trenčiansky kraj";12;0;0;0;NA;302801;12;2020-08-31;573
2020-08-30;"Trenčiansky kraj";0;0;0;0;NA;302801;0;2020-08-30;561
2020-08-29;"Trenčiansky kraj";1;0;0;0;NA;302801;1;2020-08-29;561
2020-08-28;"Trenčiansky kraj";12;0;0;0;NA;302801;12;2020-08-28;560
2020-08-27;"Trenčiansky kraj";10;0;0;0;NA;302801;10;2020-08-27;548
2020-08-26;"Trenčiansky kraj";15;0;0;0;NA;302801;15;2020-08-26;538
2020-08-25;"Trenčiansky kraj";12;0;0;0;NA;302801;12;2020-08-25;523
2020-08-24;"Trenčiansky kraj";4;0;0;0;NA;302801;4;2020-08-24;511
2020-08-23;"Trenčiansky kraj";5;0;0;0;NA;302801;5;2020-08-23;507
2020-08-22;"Trenčiansky kraj";6;0;0;0;NA;302801;6;2020-08-22;502
2020-08-21;"Trenčiansky kraj";6;0;0;0;NA;302801;6;2020-08-21;496
2020-08-20;"Trenčiansky kraj";20;0;0;0;NA;302801;20;2020-08-20;490
2020-08-19;"Trenčiansky kraj";17;0;0;0;NA;302801;17;2020-08-19;470
2020-08-18;"Trenčiansky kraj";9;0;0;0;NA;302801;9;2020-08-18;453
2020-08-17;"Trenčiansky kraj";4;0;0;0;NA;302801;4;2020-08-17;444
2020-08-16;"Trenčiansky kraj";0;0;0;0;NA;302801;0;2020-08-16;440
2020-08-15;"Trenčiansky kraj";9;0;0;0;NA;302801;9;2020-08-15;440
2020-08-14;"Trenčiansky kraj";15;0;0;0;NA;302801;15;2020-08-14;431
2020-08-13;"Trenčiansky kraj";23;0;0;0;NA;302801;23;2020-08-13;416
2020-08-12;"Trenčiansky kraj";6;0;0;0;NA;302801;6;2020-08-12;393
2020-08-11;"Trenčiansky kraj";7;0;0;0;NA;302801;7;2020-08-11;387
2020-08-10;"Trenčiansky kraj";9;0;0;0;NA;302801;9;2020-08-10;380
2020-08-09;"Trenčiansky kraj";1;0;0;0;NA;302801;1;2020-08-09;371
2020-08-08;"Trenčiansky kraj";4;0;0;0;NA;302801;4;2020-08-08;370
2020-08-07;"Trenčiansky kraj";4;0;0;0;NA;302801;4;2020-08-07;366
2020-08-06;"Trenčiansky kraj";13;0;0;0;NA;302801;13;2020-08-06;362
2020-08-05;"Trenčiansky kraj";39;0;0;0;NA;302801;39;2020-08-05;349
2020-08-04;"Trenčiansky kraj";9;0;0;0;NA;302801;9;2020-08-04;310
2020-08-03;"Trenčiansky kraj";0;0;0;0;NA;302801;0;2020-08-03;301
2020-08-02;"Trenčiansky kraj";2;0;0;0;NA;302801;2;2020-08-02;301
2020-08-01;"Trenčiansky kraj";6;0;0;0;NA;302801;6;2020-08-01;299
2020-07-31;"Trenčiansky kraj";16;0;0;0;NA;302801;16;2020-07-31;293
2020-07-30;"Trenčiansky kraj";4;0;0;0;NA;302801;4;2020-07-30;277
2020-07-29;"Trenčiansky kraj";5;0;0;0;NA;302801;5;2020-07-29;273
2020-07-28;"Trenčiansky kraj";11;0;0;0;NA;302801;11;2020-07-28;268
2020-07-27;"Trenčiansky kraj";4;0;0;0;NA;302801;4;2020-07-27;257
2020-07-26;"Trenčiansky kraj";1;0;0;0;NA;302801;1;2020-07-26;253
2020-07-25;"Trenčiansky kraj";7;0;0;0;NA;302801;7;2020-07-25;252
2020-07-24;"Trenčiansky kraj";5;0;0;0;NA;302801;5;2020-07-24;245
2020-07-23;"Trenčiansky kraj";10;0;0;0;NA;302801;10;2020-07-23;240
2020-07-22;"Trenčiansky kraj";11;0;0;0;NA;302801;11;2020-07-22;230
2020-07-21;"Trenčiansky kraj";6;0;0;0;NA;302801;6;2020-07-21;219
2020-07-20;"Trenčiansky kraj";13;0;0;0;NA;302801;13;2020-07-20;213
2020-07-19;"Trenčiansky kraj";0;0;0;0;NA;302801;0;2020-07-19;200
2020-07-18;"Trenčiansky kraj";0;0;0;0;NA;302801;0;2020-07-18;200
2020-07-17;"Trenčiansky kraj";1;0;0;0;NA;302801;1;2020-07-17;200
2020-07-16;"Trenčiansky kraj";0;0;0;0;NA;302801;0;2020-07-16;199
2020-07-15;"Trenčiansky kraj";2;0;0;0;NA;302801;2;2020-07-15;199
2020-07-14;"Trenčiansky kraj";8;0;0;0;NA;302801;8;2020-07-14;197
2020-07-13;"Trenčiansky kraj";1;0;0;0;NA;302801;1;2020-07-13;189
2020-07-12;"Trenčiansky kraj";0;0;0;0;NA;302801;0;2020-07-12;188
2020-07-11;"Trenčiansky kraj";0;0;0;0;NA;302801;0;2020-07-11;188
2020-07-10;"Trenčiansky kraj";3;0;0;0;NA;302801;3;2020-07-10;188
2020-07-09;"Trenčiansky kraj";2;0;0;0;NA;302801;2;2020-07-09;185
2020-07-08;"Trenčiansky kraj";1;0;0;0;NA;302801;1;2020-07-08;183
2020-07-07;"Trenčiansky kraj";9;0;0;0;NA;302801;9;2020-07-07;182
2020-07-06;"Trenčiansky kraj";1;0;0;0;NA;302801;1;2020-07-06;173
2020-07-05;"Trenčiansky kraj";1;0;0;0;NA;302801;1;2020-07-05;172
2020-07-04;"Trenčiansky kraj";0;0;0;0;NA;302801;0;2020-07-04;171
2020-07-03;"Trenčiansky kraj";2;0;0;0;NA;302801;2;2020-07-03;171
2020-07-02;"Trenčiansky kraj";10;0;0;0;NA;302801;10;2020-07-02;169
2020-07-01;"Trenčiansky kraj";1;0;0;0;NA;302801;1;2020-07-01;159
2020-06-30;"Trenčiansky kraj";6;0;0;0;NA;302801;6;2020-06-30;158
2020-06-29;"Trenčiansky kraj";1;0;0;0;NA;302801;1;2020-06-29;152
2020-06-28;"Trenčiansky kraj";0;0;0;0;NA;302801;0;2020-06-28;151
2020-06-27;"Trenčiansky kraj";0;0;0;0;NA;302801;0;2020-06-27;151
2020-06-26;"Trenčiansky kraj";0;0;0;0;NA;302801;0;2020-06-26;151
2020-06-25;"Trenčiansky kraj";2;0;0;0;NA;302801;2;2020-06-25;151
2020-06-24;"Trenčiansky kraj";1;0;0;0;NA;302801;1;2020-06-24;149
2020-06-23;"Trenčiansky kraj";0;0;0;0;NA;302801;0;2020-06-23;148
2020-06-22;"Trenčiansky kraj";0;0;0;0;NA;302801;0;2020-06-22;148
2020-06-21;"Trenčiansky kraj";0;0;0;0;NA;302801;0;2020-06-21;148
2020-06-20;"Trenčiansky kraj";0;0;0;0;NA;302801;0;2020-06-20;148
2020-06-19;"Trenčiansky kraj";0;0;0;0;NA;302801;0;2020-06-19;148
2020-06-18;"Trenčiansky kraj";0;0;0;0;NA;302801;0;2020-06-18;148
2020-06-17;"Trenčiansky kraj";0;0;0;0;NA;302801;0;2020-06-17;148
2020-06-16;"Trenčiansky kraj";0;0;0;0;NA;302801;0;2020-06-16;148
2020-06-14;"Trenčiansky kraj";0;0;0;0;NA;302801;0;2020-06-14;148
2020-06-13;"Trenčiansky kraj";0;0;0;0;NA;302801;0;2020-06-13;148
2020-06-12;"Trenčiansky kraj";0;0;0;0;NA;302801;0;2020-06-12;148
2020-06-11;"Trenčiansky kraj";0;0;0;0;NA;302801;0;2020-06-11;148
2020-06-10;"Trenčiansky kraj";1;0;0;0;NA;302801;1;2020-06-10;148
2020-06-09;"Trenčiansky kraj";0;0;0;0;NA;302801;0;2020-06-09;147
2020-06-08;"Trenčiansky kraj";0;0;0;0;NA;302801;0;2020-06-08;147
2020-06-07;"Trenčiansky kraj";0;0;0;0;NA;302801;0;2020-06-07;147
2020-06-05;"Trenčiansky kraj";0;0;0;0;NA;302801;0;2020-06-05;147
2020-06-03;"Trenčiansky kraj";0;0;0;0;NA;302801;0;2020-06-03;147
2020-06-02;"Trenčiansky kraj";0;0;0;0;NA;302801;0;2020-06-02;147
2020-05-31;"Trenčiansky kraj";0;0;0;0;NA;302801;0;2020-05-31;147
2020-05-29;"Trenčiansky kraj";0;0;0;0;NA;302801;0;2020-05-29;147
2020-05-27;"Trenčiansky kraj";2;0;0;0;NA;302801;2;2020-05-27;147
2020-05-26;"Trenčiansky kraj";0;0;0;0;NA;302801;0;2020-05-26;145
2020-05-25;"Trenčiansky kraj";0;0;0;0;NA;302801;0;2020-05-25;145
2020-05-24;"Trenčiansky kraj";0;0;0;0;NA;302801;0;2020-05-24;145
2020-05-23;"Trenčiansky kraj";0;0;0;0;NA;302801;0;2020-05-23;145
2020-05-22;"Trenčiansky kraj";0;0;0;0;NA;302801;0;2020-05-22;145
2020-05-21;"Trenčiansky kraj";0;0;0;0;NA;302801;0;2020-05-21;145
2020-05-20;"Trenčiansky kraj";0;0;0;0;NA;302801;0;2020-05-20;145
2020-05-19;"Trenčiansky kraj";0;0;0;0;NA;302801;0;2020-05-19;145
2020-05-17;"Trenčiansky kraj";0;0;0;0;NA;302801;0;2020-05-17;145
2020-05-16;"Trenčiansky kraj";0;0;0;0;NA;302801;0;2020-05-16;145
2020-05-15;"Trenčiansky kraj";1;0;0;0;NA;302801;1;2020-05-15;145
2020-05-14;"Trenčiansky kraj";2;0;0;0;NA;302801;2;2020-05-14;144
2020-05-13;"Trenčiansky kraj";1;0;0;0;NA;302801;1;2020-05-13;142
2020-05-12;"Trenčiansky kraj";1;0;0;0;NA;302801;1;2020-05-12;141
2020-05-11;"Trenčiansky kraj";3;0;0;0;NA;302801;3;2020-05-11;140
2020-05-09;"Trenčiansky kraj";2;0;0;0;NA;302801;2;2020-05-09;137
2020-05-07;"Trenčiansky kraj";6;0;0;0;NA;302801;6;2020-05-07;135
2020-05-06;"Trenčiansky kraj";0;0;0;0;NA;302801;0;2020-05-06;129
2020-05-05;"Trenčiansky kraj";2;0;0;0;NA;302801;2;2020-05-05;129
2020-05-04;"Trenčiansky kraj";0;0;0;0;NA;302801;0;2020-05-04;127
2020-05-03;"Trenčiansky kraj";0;0;0;0;NA;302801;0;2020-05-03;127
2020-05-02;"Trenčiansky kraj";0;0;0;0;NA;302801;0;2020-05-02;127
2020-05-01;"Trenčiansky kraj";0;0;0;0;NA;302801;0;2020-05-01;127
2020-04-30;"Trenčiansky kraj";0;0;0;0;NA;302801;0;2020-04-30;127
2020-04-29;"Trenčiansky kraj";2;0;0;0;NA;302801;2;2020-04-29;127
2020-04-28;"Trenčiansky kraj";1;0;0;0;NA;302801;1;2020-04-28;125
2020-04-27;"Trenčiansky kraj";0;0;0;0;NA;302801;0;2020-04-27;124
2020-04-26;"Trenčiansky kraj";1;0;0;0;NA;302801;1;2020-04-26;124
2020-04-25;"Trenčiansky kraj";0;0;0;0;NA;302801;0;2020-04-25;123
2020-04-24;"Trenčiansky kraj";0;0;0;0;NA;302801;0;2020-04-24;123
2020-04-23;"Trenčiansky kraj";11;0;0;0;NA;302801;11;2020-04-23;123
2020-04-22;"Trenčiansky kraj";1;0;0;0;NA;302801;1;2020-04-22;112
2020-04-21;"Trenčiansky kraj";11;0;0;0;NA;302801;11;2020-04-21;111
2020-04-20;"Trenčiansky kraj";15;0;0;0;NA;302801;15;2020-04-20;100
2020-04-19;"Trenčiansky kraj";2;0;0;0;NA;302801;2;2020-04-19;85
2020-04-18;"Trenčiansky kraj";3;0;0;0;NA;302801;3;2020-04-18;83
2020-04-17;"Trenčiansky kraj";4;0;0;0;NA;302801;4;2020-04-17;80
2020-04-16;"Trenčiansky kraj";10;0;0;0;NA;302801;10;2020-04-16;76
2020-04-15;"Trenčiansky kraj";4;0;0;0;NA;302801;4;2020-04-15;66
2020-04-14;"Trenčiansky kraj";0;0;0;0;NA;302801;0;2020-04-14;62
2020-04-13;"Trenčiansky kraj";1;0;0;0;NA;302801;1;2020-04-13;62
2020-04-12;"Trenčiansky kraj";2;0;0;0;NA;302801;2;2020-04-12;61
2020-04-11;"Trenčiansky kraj";3;0;0;0;NA;302801;3;2020-04-11;59
2020-04-10;"Trenčiansky kraj";0;0;0;0;NA;302801;0;2020-04-10;56
2020-04-09;"Trenčiansky kraj";0;0;0;0;NA;302801;0;2020-04-09;56
2020-04-08;"Trenčiansky kraj";2;0;0;0;NA;302801;2;2020-04-08;56
2020-04-07;"Trenčiansky kraj";18;0;0;0;NA;302801;18;2020-04-07;54
2020-04-06;"Trenčiansky kraj";0;0;0;0;NA;302801;0;2020-04-06;36
2020-04-05;"Trenčiansky kraj";3;0;0;0;NA;302801;3;2020-04-05;36
2020-04-04;"Trenčiansky kraj";5;0;0;0;NA;302801;5;2020-04-04;33
2020-04-03;"Trenčiansky kraj";4;0;0;0;NA;302801;4;2020-04-03;28
2020-04-02;"Trenčiansky kraj";1;0;0;0;NA;302801;1;2020-04-02;24
2020-04-01;"Trenčiansky kraj";3;0;0;0;NA;302801;3;2020-04-01;23
2020-03-31;"Trenčiansky kraj";1;0;0;0;NA;302801;1;2020-03-31;20
2020-03-30;"Trenčiansky kraj";3;0;0;0;NA;302801;3;2020-03-30;19
2020-03-29;"Trenčiansky kraj";6;0;0;0;NA;302801;6;2020-03-29;16
2020-03-28;"Trenčiansky kraj";9;0;0;0;NA;302801;9;2020-03-28;10
2020-03-27;"Trenčiansky kraj";2;0;0;0;NA;302801;2;2020-03-27;1
2020-03-26;"Trenčiansky kraj";6;0;0;0;NA;302801;6;2020-03-26;-1
2020-03-25;"Trenčiansky kraj";3;0;0;0;NA;302801;3;2020-03-25;-7
2020-03-24;"Trenčiansky kraj";1;0;0;0;NA;302801;1;2020-03-24;-10
2020-03-23;"Trenčiansky kraj";0;0;0;0;NA;302801;0;2020-03-23;-11
2020-03-22;"Trenčiansky kraj";0;0;0;0;NA;302801;0;2020-03-22;-11
2020-03-21;"Trenčiansky kraj";2;0;0;0;NA;302801;2;2020-03-21;-11
2020-03-20;"Trenčiansky kraj";2;0;0;0;NA;302801;2;2020-03-20;-13
2020-03-19;"Trenčiansky kraj";8;0;0;0;NA;302801;8;2020-03-19;-15
2020-03-18;"Trenčiansky kraj";0;0;0;0;NA;302801;0;2020-03-18;-23
2020-03-17;"Trenčiansky kraj";0;0;0;0;NA;302801;0;2020-03-17;-23
2020-03-16;"Trenčiansky kraj";1;0;0;0;NA;302801;1;2020-03-16;-23
2020-03-15;"Trenčiansky kraj";5;0;0;0;NA;302801;5;2020-03-15;-24
2020-03-14;"Trenčiansky kraj";0;0;0;0;NA;302801;0;2020-03-14;-29
2020-03-13;"Trenčiansky kraj";0;0;0;0;NA;302801;0;2020-03-13;-29
2020-03-12;"Trenčiansky kraj";1;0;0;0;NA;302801;1;2020-03-12;-29
2020-03-11;"Trenčiansky kraj";0;0;0;0;NA;302801;0;2020-03-11;-30
2020-03-09;"Trenčiansky kraj";0;0;0;0;NA;302801;0;2020-03-09;-30
2020-03-08;"Trenčiansky kraj";0;0;0;0;NA;302801;0;2020-03-08;-30
2020-03-07;"Trenčiansky kraj";0;0;0;0;NA;302801;0;2020-03-07;-30
2020-03-06;"Trenčiansky kraj";0;0;0;0;NA;302801;0;2020-03-06;-30
2022-05-26;"Trnavský kraj";9;0;0;0;212585;281953;9;2022-05-26;281953
2022-05-25;"Trnavský kraj";13;90;2;92;NA;281953;15;2022-05-25;281944
2022-05-24;"Trnavský kraj";13;105;1;106;NA;281953;14;2022-05-24;281929
2022-05-23;"Trnavský kraj";17;213;12;225;NA;281953;29;2022-05-23;281915
2022-05-22;"Trnavský kraj";0;45;0;45;NA;281953;0;2022-05-22;281886
2022-05-21;"Trnavský kraj";7;31;1;32;NA;281953;8;2022-05-21;281886
2022-05-20;"Trnavský kraj";12;96;3;99;NA;281953;15;2022-05-20;281878
2022-05-19;"Trnavský kraj";18;124;1;125;NA;281953;19;2022-05-19;281863
2022-05-18;"Trnavský kraj";13;133;6;139;NA;281953;19;2022-05-18;281844
2022-05-17;"Trnavský kraj";16;193;6;199;NA;281953;22;2022-05-17;281825
2022-05-16;"Trnavský kraj";34;201;5;206;NA;281953;39;2022-05-16;281803
2022-05-15;"Trnavský kraj";5;31;2;33;NA;281953;7;2022-05-15;281764
2022-05-14;"Trnavský kraj";16;63;1;64;NA;281953;17;2022-05-14;281757
2022-05-13;"Trnavský kraj";41;196;4;200;NA;281953;45;2022-05-13;281740
2022-05-12;"Trnavský kraj";9;122;6;128;NA;281953;15;2022-05-12;281695
2022-05-11;"Trnavský kraj";41;183;7;190;NA;281953;48;2022-05-11;281680
2022-05-10;"Trnavský kraj";39;179;4;183;NA;281953;43;2022-05-10;281632
2022-05-09;"Trnavský kraj";35;255;15;270;NA;281953;50;2022-05-09;281589
2022-05-08;"Trnavský kraj";4;42;0;42;NA;281953;4;2022-05-08;281539
2022-05-07;"Trnavský kraj";26;39;6;45;NA;281953;32;2022-05-07;281535
2022-05-06;"Trnavský kraj";42;248;10;258;NA;281953;52;2022-05-06;281503
2022-05-05;"Trnavský kraj";49;182;9;191;NA;281953;58;2022-05-05;281451
2022-05-04;"Trnavský kraj";76;179;8;187;NA;281953;84;2022-05-04;281393
2022-05-03;"Trnavský kraj";97;186;4;190;NA;281953;101;2022-05-03;281309
2022-05-02;"Trnavský kraj";104;287;10;297;NA;281953;114;2022-05-02;281208
2022-05-01;"Trnavský kraj";14;60;1;61;NA;281953;15;2022-05-01;281094
2022-04-30;"Trnavský kraj";53;46;3;49;NA;281953;56;2022-04-30;281079
2022-04-29;"Trnavský kraj";84;172;7;179;NA;281953;91;2022-04-29;281023
2022-04-28;"Trnavský kraj";147;326;12;338;NA;281953;159;2022-04-28;280932
2022-04-27;"Trnavský kraj";125;457;24;481;NA;281953;149;2022-04-27;280773
2022-04-26;"Trnavský kraj";135;213;9;222;NA;281953;144;2022-04-26;280624
2022-04-25;"Trnavský kraj";154;354;15;369;NA;281953;169;2022-04-25;280480
2022-04-24;"Trnavský kraj";41;60;6;66;NA;281953;47;2022-04-24;280311
2022-04-23;"Trnavský kraj";130;119;8;127;NA;281953;138;2022-04-23;280264
2022-04-22;"Trnavský kraj";157;393;20;413;NA;281953;177;2022-04-22;280126
2022-04-21;"Trnavský kraj";238;540;16;556;NA;281953;254;2022-04-21;279949
2022-04-20;"Trnavský kraj";164;390;25;415;NA;281953;189;2022-04-20;279695
2022-04-19;"Trnavský kraj";223;536;31;567;NA;281953;254;2022-04-19;279506
2022-04-18;"Trnavský kraj";66;63;9;72;NA;281953;75;2022-04-18;279252
2022-04-17;"Trnavský kraj";116;65;4;69;NA;281953;120;2022-04-17;279177
2022-04-16;"Trnavský kraj";99;103;9;112;NA;281953;108;2022-04-16;279057
2022-04-15;"Trnavský kraj";193;113;2;115;NA;281953;195;2022-04-15;278949
2022-04-14;"Trnavský kraj";237;610;42;652;NA;281953;279;2022-04-14;278754
2022-04-13;"Trnavský kraj";298;385;26;411;NA;281953;324;2022-04-13;278475
2022-04-12;"Trnavský kraj";358;492;39;531;NA;281953;397;2022-04-12;278151
2022-04-11;"Trnavský kraj";265;601;37;638;NA;281953;302;2022-04-11;277754
2022-04-10;"Trnavský kraj";124;128;19;147;NA;281953;143;2022-04-10;277452
2022-04-09;"Trnavský kraj";324;66;5;71;NA;281953;329;2022-04-09;277309
2022-04-08;"Trnavský kraj";380;388;43;431;NA;281953;423;2022-04-08;276980
2022-04-07;"Trnavský kraj";405;363;33;396;NA;281953;438;2022-04-07;276557
2022-04-06;"Trnavský kraj";485;380;35;415;NA;281953;520;2022-04-06;276119
2022-04-05;"Trnavský kraj";549;401;49;450;NA;281953;598;2022-04-05;275599
2022-04-04;"Trnavský kraj";621;707;90;797;NA;281953;711;2022-04-04;275001
2022-04-03;"Trnavský kraj";35;126;22;148;NA;281953;57;2022-04-03;274290
2022-04-02;"Trnavský kraj";478;113;14;127;NA;281953;492;2022-04-02;274233
2022-04-01;"Trnavský kraj";630;643;65;708;NA;281953;695;2022-04-01;273741
2022-03-31;"Trnavský kraj";709;483;69;552;NA;281953;778;2022-03-31;273046
2022-03-30;"Trnavský kraj";885;483;74;557;NA;281953;959;2022-03-30;272268
2022-03-29;"Trnavský kraj";845;667;75;742;NA;281953;920;2022-03-29;271309
2022-03-28;"Trnavský kraj";623;795;117;912;NA;281953;740;2022-03-28;270389
2022-03-27;"Trnavský kraj";340;185;39;224;NA;281953;379;2022-03-27;269649
2022-03-26;"Trnavský kraj";762;214;36;250;NA;281953;798;2022-03-26;269270
2022-03-25;"Trnavský kraj";859;664;69;733;NA;281953;928;2022-03-25;268472
2022-03-24;"Trnavský kraj";920;638;73;711;NA;281953;993;2022-03-24;267544
2022-03-23;"Trnavský kraj";1112;794;96;890;NA;281953;1208;2022-03-23;266551
2022-03-22;"Trnavský kraj";1096;767;70;837;NA;281953;1166;2022-03-22;265343
2022-03-21;"Trnavský kraj";1096;1025;113;1138;NA;281953;1209;2022-03-21;264177
2022-03-20;"Trnavský kraj";229;262;46;308;NA;281953;275;2022-03-20;262968
2022-03-19;"Trnavský kraj";1000;237;57;294;NA;281953;1057;2022-03-19;262693
2022-03-18;"Trnavský kraj";1038;907;107;1014;NA;281953;1145;2022-03-18;261636
2022-03-17;"Trnavský kraj";1148;721;93;814;NA;281953;1241;2022-03-17;260491
2022-03-16;"Trnavský kraj";1344;602;87;689;NA;281953;1431;2022-03-16;259250
2022-03-15;"Trnavský kraj";1179;1037;122;1159;NA;281953;1301;2022-03-15;257819
2022-03-14;"Trnavský kraj";890;1545;177;1722;NA;281953;1067;2022-03-14;256518
2022-03-13;"Trnavský kraj";290;422;57;479;NA;281953;347;2022-03-13;255451
2022-03-12;"Trnavský kraj";958;589;113;702;NA;281953;1071;2022-03-12;255104
2022-03-11;"Trnavský kraj";961;1038;126;1164;NA;281953;1087;2022-03-11;254033
2022-03-10;"Trnavský kraj";1049;1247;150;1397;NA;281953;1199;2022-03-10;252946
2022-03-09;"Trnavský kraj";1271;1159;161;1320;NA;281953;1432;2022-03-09;251747
2022-03-08;"Trnavský kraj";1393;1361;179;1540;NA;281953;1572;2022-03-08;250315
2022-03-07;"Trnavský kraj";1005;2051;263;2314;NA;281953;1268;2022-03-07;248743
2022-03-06;"Trnavský kraj";395;565;118;683;NA;281953;513;2022-03-06;247475
2022-03-05;"Trnavský kraj";806;475;90;565;NA;281953;896;2022-03-05;246962
2022-03-04;"Trnavský kraj";1028;1063;126;1189;NA;281953;1154;2022-03-04;246066
2022-03-03;"Trnavský kraj";1513;1135;168;1303;NA;281953;1681;2022-03-03;244912
2022-03-02;"Trnavský kraj";1330;1513;194;1707;NA;281953;1524;2022-03-02;243231
2022-03-01;"Trnavský kraj";1527;1351;201;1552;NA;281953;1728;2022-03-01;241707
2022-02-28;"Trnavský kraj";1318;2105;264;2369;NA;281953;1582;2022-02-28;239979
2022-02-27;"Trnavský kraj";386;640;106;746;NA;281953;492;2022-02-27;238397
2022-02-26;"Trnavský kraj";1268;526;112;638;NA;281953;1380;2022-02-26;237905
2022-02-25;"Trnavský kraj";1439;1491;211;1702;NA;281953;1650;2022-02-25;236525
2022-02-24;"Trnavský kraj";1397;1421;183;1604;NA;281953;1580;2022-02-24;234875
2022-02-23;"Trnavský kraj";2032;1668;240;1908;NA;281953;2272;2022-02-23;233295
2022-02-22;"Trnavský kraj";2171;1891;271;2162;NA;281953;2442;2022-02-22;231023
2022-02-21;"Trnavský kraj";1983;2849;438;3287;NA;281953;2421;2022-02-21;228581
2022-02-20;"Trnavský kraj";888;830;187;1017;NA;281953;1075;2022-02-20;226160
2022-02-19;"Trnavský kraj";1838;712;149;861;NA;281953;1987;2022-02-19;225085
2022-02-18;"Trnavský kraj";2132;1733;269;2002;NA;281953;2401;2022-02-18;223098
2022-02-17;"Trnavský kraj";1987;1764;269;2033;NA;281953;2256;2022-02-17;220697
2022-02-16;"Trnavský kraj";2047;1809;317;2126;NA;281953;2364;2022-02-16;218441
2022-02-15;"Trnavský kraj";2228;2412;400;2812;NA;281953;2628;2022-02-15;216077
2022-02-14;"Trnavský kraj";2216;3425;492;3917;NA;281953;2708;2022-02-14;213449
2022-02-13;"Trnavský kraj";805;1129;247;1376;NA;281953;1052;2022-02-13;210741
2022-02-12;"Trnavský kraj";2081;966;175;1141;NA;281953;2256;2022-02-12;209689
2022-02-11;"Trnavský kraj";1665;2158;266;2424;NA;281953;1931;2022-02-11;207433
2022-02-10;"Trnavský kraj";2491;1942;256;2198;NA;281953;2747;2022-02-10;205502
2022-02-09;"Trnavský kraj";2205;2474;365;2839;NA;281953;2570;2022-02-09;202755
2022-02-08;"Trnavský kraj";1758;2352;353;2705;NA;281953;2111;2022-02-08;200185
2022-02-07;"Trnavský kraj";2581;3356;459;3815;NA;281953;3040;2022-02-07;198074
2022-02-06;"Trnavský kraj";1194;1309;276;1585;NA;281953;1470;2022-02-06;195034
2022-02-05;"Trnavský kraj";2165;1102;187;1289;NA;281953;2352;2022-02-05;193564
2022-02-04;"Trnavský kraj";2191;2179;253;2432;NA;281953;2444;2022-02-04;191212
2022-02-03;"Trnavský kraj";2124;3295;347;3642;NA;281953;2471;2022-02-03;188768
2022-02-02;"Trnavský kraj";1812;2684;281;2965;NA;281953;2093;2022-02-02;186297
2022-02-01;"Trnavský kraj";2344;2656;318;2974;NA;281953;2662;2022-02-01;184204
2022-01-31;"Trnavský kraj";1931;5001;489;5490;NA;281953;2420;2022-01-31;181542
2022-01-30;"Trnavský kraj";709;1672;176;1848;NA;281953;885;2022-01-30;179122
2022-01-29;"Trnavský kraj";2136;1174;159;1333;NA;281953;2295;2022-01-29;178237
2022-01-28;"Trnavský kraj";1734;2340;216;2556;NA;281953;1950;2022-01-28;175942
2022-01-27;"Trnavský kraj";1989;2333;246;2579;NA;281953;2235;2022-01-27;173992
2022-01-26;"Trnavský kraj";1906;2730;217;2947;NA;281953;2123;2022-01-26;171757
2022-01-25;"Trnavský kraj";1631;2422;195;2617;NA;281953;1826;2022-01-25;169634
2022-01-24;"Trnavský kraj";999;4194;236;4430;NA;281953;1235;2022-01-24;167808
2022-01-23;"Trnavský kraj";299;1897;105;2002;NA;281953;404;2022-01-23;166573
2022-01-22;"Trnavský kraj";1169;1197;81;1278;NA;281953;1250;2022-01-22;166169
2022-01-21;"Trnavský kraj";830;2134;104;2238;NA;281953;934;2022-01-21;164919
2022-01-20;"Trnavský kraj";917;2511;100;2611;NA;281953;1017;2022-01-20;163985
2022-01-19;"Trnavský kraj";832;2122;84;2206;NA;281953;916;2022-01-19;162968
2022-01-18;"Trnavský kraj";704;2051;74;2125;NA;281953;778;2022-01-18;162052
2022-01-17;"Trnavský kraj";366;3885;87;3972;NA;281953;453;2022-01-17;161274
2022-01-16;"Trnavský kraj";84;1696;44;1740;NA;281953;128;2022-01-16;160821
2022-01-15;"Trnavský kraj";421;1015;33;1048;NA;281953;454;2022-01-15;160693
2022-01-14;"Trnavský kraj";349;2040;50;2090;NA;281953;399;2022-01-14;160239
2022-01-13;"Trnavský kraj";234;2057;52;2109;NA;281953;286;2022-01-13;159840
2022-01-12;"Trnavský kraj";400;1927;35;1962;NA;281953;435;2022-01-12;159554
2022-01-11;"Trnavský kraj";384;2261;33;2294;NA;281953;417;2022-01-11;159119
2022-01-10;"Trnavský kraj";258;4357;71;4428;NA;281953;329;2022-01-10;158702
2022-01-09;"Trnavský kraj";35;1921;22;1943;NA;281953;57;2022-01-09;158373
2022-01-08;"Trnavský kraj";364;1005;29;1034;NA;281953;393;2022-01-08;158316
2022-01-07;"Trnavský kraj";332;1984;47;2031;NA;281953;379;2022-01-07;157923
2022-01-06;"Trnavský kraj";234;830;20;850;NA;281953;254;2022-01-06;157544
2022-01-05;"Trnavský kraj";416;1925;37;1962;NA;281953;453;2022-01-05;157290
2022-01-04;"Trnavský kraj";538;2337;37;2374;NA;281953;575;2022-01-04;156837
2022-01-03;"Trnavský kraj";441;3897;65;3962;NA;281953;506;2022-01-03;156262
2022-01-02;"Trnavský kraj";79;1561;21;1582;NA;281953;100;2022-01-02;155756
2022-01-01;"Trnavský kraj";4;190;7;197;NA;281953;11;2022-01-01;155656
2021-12-31;"Trnavský kraj";485;1246;60;1306;NA;281953;545;2021-12-31;155645
2021-12-30;"Trnavský kraj";401;1927;58;1985;NA;281953;459;2021-12-30;155100
2021-12-29;"Trnavský kraj";401;1756;70;1826;NA;281953;471;2021-12-29;154641
2021-12-28;"Trnavský kraj";633;1742;73;1815;NA;281953;706;2021-12-28;154170
2021-12-27;"Trnavský kraj";463;2814;134;2948;NA;281953;597;2021-12-27;153464
2021-12-26;"Trnavský kraj";253;1019;30;1049;NA;281953;283;2021-12-26;152867
2021-12-25;"Trnavský kraj";104;341;41;382;NA;281953;145;2021-12-25;152584
2021-12-24;"Trnavský kraj";216;369;27;396;NA;281953;243;2021-12-24;152439
2021-12-23;"Trnavský kraj";570;1825;102;1927;NA;281953;672;2021-12-23;152196
2021-12-22;"Trnavský kraj";545;1732;81;1813;NA;281953;626;2021-12-22;151524
2021-12-21;"Trnavský kraj";699;2577;89;2666;NA;281953;788;2021-12-21;150898
2021-12-20;"Trnavský kraj";438;3941;103;4044;NA;281953;541;2021-12-20;150110
2021-12-19;"Trnavský kraj";155;1762;63;1825;NA;281953;218;2021-12-19;149569
2021-12-18;"Trnavský kraj";627;1302;77;1379;NA;281953;704;2021-12-18;149351
2021-12-17;"Trnavský kraj";576;2276;109;2385;NA;281953;685;2021-12-17;148647
2021-12-16;"Trnavský kraj";653;2530;123;2653;NA;281953;776;2021-12-16;147962
2021-12-15;"Trnavský kraj";746;2198;120;2318;NA;281953;866;2021-12-15;147186
2021-12-14;"Trnavský kraj";976;2718;134;2852;NA;281953;1110;2021-12-14;146320
2021-12-13;"Trnavský kraj";521;4857;175;5032;NA;281953;696;2021-12-13;145210
2021-12-12;"Trnavský kraj";337;2117;87;2204;NA;281953;424;2021-12-12;144514
2021-12-11;"Trnavský kraj";720;1324;83;1407;NA;281953;803;2021-12-11;144090
2021-12-10;"Trnavský kraj";702;2909;136;3045;NA;281953;838;2021-12-10;143287
2021-12-09;"Trnavský kraj";926;2313;96;2409;NA;281953;1022;2021-12-09;142449
2021-12-08;"Trnavský kraj";1233;2547;137;2684;NA;281953;1370;2021-12-08;141427
2021-12-07;"Trnavský kraj";1159;3637;174;3811;NA;281953;1333;2021-12-07;140057
2021-12-06;"Trnavský kraj";911;3649;208;3857;NA;281953;1119;2021-12-06;138724
2021-12-05;"Trnavský kraj";269;2303;106;2409;NA;281953;375;2021-12-05;137605
2021-12-04;"Trnavský kraj";1225;1623;115;1738;NA;281953;1340;2021-12-04;137230
2021-12-03;"Trnavský kraj";1246;2998;201;3199;NA;281953;1447;2021-12-03;135890
2021-12-02;"Trnavský kraj";1809;2379;188;2567;NA;281953;1997;2021-12-02;134443
2021-12-01;"Trnavský kraj";738;3011;179;3190;NA;281953;917;2021-12-01;132446
2021-11-30;"Trnavský kraj";1166;4217;202;4419;NA;281953;1368;2021-11-30;131529
2021-11-29;"Trnavský kraj";814;5360;299;5659;NA;281953;1113;2021-11-29;130161
2021-11-28;"Trnavský kraj";482;3087;146;3233;NA;281953;628;2021-11-28;129048
2021-11-27;"Trnavský kraj";1186;2240;206;2446;NA;281953;1392;2021-11-27;128420
2021-11-26;"Trnavský kraj";880;2895;202;3097;NA;281953;1082;2021-11-26;127028
2021-11-25;"Trnavský kraj";1002;2680;158;2838;NA;281953;1160;2021-11-25;125946
2021-11-24;"Trnavský kraj";1060;3442;250;3692;NA;281953;1310;2021-11-24;124786
2021-11-23;"Trnavský kraj";1078;3714;273;3987;NA;281953;1351;2021-11-23;123476
2021-11-22;"Trnavský kraj";696;4028;295;4323;NA;281953;991;2021-11-22;122125
2021-11-21;"Trnavský kraj";298;2270;212;2482;NA;281953;510;2021-11-21;121134
2021-11-20;"Trnavský kraj";826;1529;196;1725;NA;281953;1022;2021-11-20;120624
2021-11-19;"Trnavský kraj";901;3369;315;3684;NA;281953;1216;2021-11-19;119602
2021-11-18;"Trnavský kraj";796;2872;240;3112;NA;281953;1036;2021-11-18;118386
2021-11-17;"Trnavský kraj";769;1201;139;1340;NA;281953;908;2021-11-17;117350
2021-11-16;"Trnavský kraj";591;2755;206;2961;NA;281953;797;2021-11-16;116442
2021-11-15;"Trnavský kraj";606;3350;239;3589;NA;281953;845;2021-11-15;115645
2021-11-14;"Trnavský kraj";236;1579;141;1720;NA;281953;377;2021-11-14;114800
2021-11-13;"Trnavský kraj";815;1314;132;1446;NA;281953;947;2021-11-13;114423
2021-11-12;"Trnavský kraj";563;2585;157;2742;NA;281953;720;2021-11-12;113476
2021-11-11;"Trnavský kraj";512;2426;161;2587;NA;281953;673;2021-11-11;112756
2021-11-10;"Trnavský kraj";590;2315;173;2488;NA;281953;763;2021-11-10;112083
2021-11-09;"Trnavský kraj";585;2538;187;2725;NA;281953;772;2021-11-09;111320
2021-11-08;"Trnavský kraj";357;2715;163;2878;NA;281953;520;2021-11-08;110548
2021-11-07;"Trnavský kraj";162;1349;111;1460;NA;281953;273;2021-11-07;110028
2021-11-06;"Trnavský kraj";391;1287;82;1369;NA;281953;473;2021-11-06;109755
2021-11-05;"Trnavský kraj";447;2202;102;2304;NA;281953;549;2021-11-05;109282
2021-11-04;"Trnavský kraj";432;2289;112;2401;NA;281953;544;2021-11-04;108733
2021-11-03;"Trnavský kraj";420;2091;97;2188;NA;281953;517;2021-11-03;108189
2021-11-02;"Trnavský kraj";365;2777;124;2901;NA;281953;489;2021-11-02;107672
2021-11-01;"Trnavský kraj";220;583;27;610;NA;281953;247;2021-11-01;107183
2021-10-31;"Trnavský kraj";61;887;62;949;NA;281953;123;2021-10-31;106936
2021-10-30;"Trnavský kraj";251;1099;50;1149;NA;281953;301;2021-10-30;106813
2021-10-29;"Trnavský kraj";312;2123;53;2176;NA;281953;365;2021-10-29;106512
2021-10-28;"Trnavský kraj";339;2034;65;2099;NA;281953;404;2021-10-28;106147
2021-10-27;"Trnavský kraj";232;1884;58;1942;NA;281953;290;2021-10-27;105743
2021-10-26;"Trnavský kraj";366;1964;54;2018;NA;281953;420;2021-10-26;105453
2021-10-25;"Trnavský kraj";142;2786;72;2858;NA;281953;214;2021-10-25;105033
2021-10-24;"Trnavský kraj";11;990;30;1020;NA;281953;41;2021-10-24;104819
2021-10-23;"Trnavský kraj";228;1126;27;1153;NA;281953;255;2021-10-23;104778
2021-10-22;"Trnavský kraj";204;2269;51;2320;NA;281953;255;2021-10-22;104523
2021-10-21;"Trnavský kraj";188;1671;46;1717;NA;281953;234;2021-10-21;104268
2021-10-20;"Trnavský kraj";212;1634;47;1681;NA;281953;259;2021-10-20;104034
2021-10-19;"Trnavský kraj";240;1848;30;1878;NA;281953;270;2021-10-19;103775
2021-10-18;"Trnavský kraj";95;2316;72;2388;NA;281953;167;2021-10-18;103505
2021-10-17;"Trnavský kraj";5;1218;17;1235;NA;281953;22;2021-10-17;103338
2021-10-16;"Trnavský kraj";129;1233;17;1250;NA;281953;146;2021-10-16;103316
2021-10-15;"Trnavský kraj";122;2121;24;2145;NA;281953;146;2021-10-15;103170
2021-10-14;"Trnavský kraj";131;1663;24;1687;NA;281953;155;2021-10-14;103024
2021-10-13;"Trnavský kraj";128;2072;23;2095;NA;281953;151;2021-10-13;102869
2021-10-12;"Trnavský kraj";189;2788;38;2826;NA;281953;227;2021-10-12;102718
2021-10-11;"Trnavský kraj";115;2621;35;2656;NA;281953;150;2021-10-11;102491
2021-10-10;"Trnavský kraj";2;993;15;1008;NA;281953;17;2021-10-10;102341
2021-10-09;"Trnavský kraj";151;1099;10;1109;NA;281953;161;2021-10-09;102324
2021-10-08;"Trnavský kraj";106;2326;34;2360;NA;281953;140;2021-10-08;102163
2021-10-07;"Trnavský kraj";151;1744;25;1769;NA;281953;176;2021-10-07;102023
2021-10-06;"Trnavský kraj";122;1929;27;1956;NA;281953;149;2021-10-06;101847
2021-10-05;"Trnavský kraj";220;3726;34;3760;NA;281953;254;2021-10-05;101698
2021-10-04;"Trnavský kraj";54;1963;47;2010;NA;281953;101;2021-10-04;101444
2021-10-03;"Trnavský kraj";1;1106;17;1123;NA;281953;18;2021-10-03;101343
2021-10-02;"Trnavský kraj";52;1055;12;1067;NA;281953;64;2021-10-02;101325
2021-10-01;"Trnavský kraj";113;2243;17;2260;NA;281953;130;2021-10-01;101261
2021-09-30;"Trnavský kraj";109;1872;18;1890;NA;281953;127;2021-09-30;101131
2021-09-29;"Trnavský kraj";83;1331;11;1342;NA;281953;94;2021-09-29;101004
2021-09-28;"Trnavský kraj";135;1934;31;1965;NA;281953;166;2021-09-28;100910
2021-09-27;"Trnavský kraj";80;2084;25;2109;NA;281953;105;2021-09-27;100744
2021-09-26;"Trnavský kraj";2;1048;12;1060;NA;281953;14;2021-09-26;100639
2021-09-25;"Trnavský kraj";61;1105;9;1114;NA;281953;70;2021-09-25;100625
2021-09-24;"Trnavský kraj";41;2229;15;2244;NA;281953;56;2021-09-24;100555
2021-09-23;"Trnavský kraj";89;1691;16;1707;NA;281953;105;2021-09-23;100499
2021-09-22;"Trnavský kraj";119;1706;28;1734;NA;281953;147;2021-09-22;100394
2021-09-21;"Trnavský kraj";108;1505;17;1522;NA;281953;125;2021-09-21;100247
2021-09-20;"Trnavský kraj";50;1652;20;1672;NA;281953;70;2021-09-20;100122
2021-09-19;"Trnavský kraj";2;924;8;932;NA;281953;10;2021-09-19;100052
2021-09-18;"Trnavský kraj";100;982;6;988;NA;281953;106;2021-09-18;100042
2021-09-17;"Trnavský kraj";77;1709;20;1729;NA;281953;97;2021-09-17;99936
2021-09-16;"Trnavský kraj";105;1279;32;1311;NA;281953;137;2021-09-16;99839
2021-09-15;"Trnavský kraj";59;841;5;846;NA;281953;64;2021-09-15;99702
2021-09-14;"Trnavský kraj";38;1583;12;1595;NA;281953;50;2021-09-14;99638
2021-09-13;"Trnavský kraj";56;1410;16;1426;NA;281953;72;2021-09-13;99588
2021-09-12;"Trnavský kraj";0;653;1;654;NA;281953;1;2021-09-12;99516
2021-09-11;"Trnavský kraj";37;971;10;981;NA;281953;47;2021-09-11;99515
2021-09-10;"Trnavský kraj";43;1441;9;1450;NA;281953;52;2021-09-10;99468
2021-09-09;"Trnavský kraj";42;954;13;967;NA;281953;55;2021-09-09;99416
2021-09-08;"Trnavský kraj";65;802;15;817;NA;281953;80;2021-09-08;99361
2021-09-07;"Trnavský kraj";29;844;5;849;NA;281953;34;2021-09-07;99281
2021-09-06;"Trnavský kraj";18;1234;14;1248;NA;281953;32;2021-09-06;99247
2021-09-05;"Trnavský kraj";2;580;4;584;NA;281953;6;2021-09-05;99215
2021-09-04;"Trnavský kraj";17;868;6;874;NA;281953;23;2021-09-04;99209
2021-09-03;"Trnavský kraj";14;1060;5;1065;NA;281953;19;2021-09-03;99186
2021-09-02;"Trnavský kraj";30;830;10;840;NA;281953;40;2021-09-02;99167
2021-09-01;"Trnavský kraj";6;409;4;413;NA;281953;10;2021-09-01;99127
2021-08-31;"Trnavský kraj";13;884;3;887;NA;281953;16;2021-08-31;99117
2021-08-30;"Trnavský kraj";7;904;1;905;NA;281953;8;2021-08-30;99101
2021-08-29;"Trnavský kraj";8;427;1;428;NA;281953;9;2021-08-29;99093
2021-08-28;"Trnavský kraj";17;694;2;696;NA;281953;19;2021-08-28;99084
2021-08-27;"Trnavský kraj";1;1186;4;1190;NA;281953;5;2021-08-27;99065
2021-08-26;"Trnavský kraj";8;713;3;716;NA;281953;11;2021-08-26;99060
2021-08-25;"Trnavský kraj";11;683;6;689;NA;281953;17;2021-08-25;99049
2021-08-24;"Trnavský kraj";7;801;1;802;NA;281953;8;2021-08-24;99032
2021-08-23;"Trnavský kraj";4;844;1;845;NA;281953;5;2021-08-23;99024
2021-08-22;"Trnavský kraj";0;474;0;474;NA;281953;0;2021-08-22;99019
2021-08-21;"Trnavský kraj";8;703;0;703;NA;281953;8;2021-08-21;99019
2021-08-20;"Trnavský kraj";4;1095;4;1099;NA;281953;8;2021-08-20;99011
2021-08-19;"Trnavský kraj";10;881;3;884;NA;281953;13;2021-08-19;99003
2021-08-18;"Trnavský kraj";6;789;2;791;NA;281953;8;2021-08-18;98990
2021-08-17;"Trnavský kraj";7;524;4;528;NA;281953;11;2021-08-17;98982
2021-08-16;"Trnavský kraj";9;966;3;969;NA;281953;12;2021-08-16;98971
2021-08-15;"Trnavský kraj";0;556;1;557;NA;281953;1;2021-08-15;98959
2021-08-14;"Trnavský kraj";10;801;3;804;NA;281953;13;2021-08-14;98958
2021-08-13;"Trnavský kraj";5;1077;6;1083;NA;281953;11;2021-08-13;98945
2021-08-12;"Trnavský kraj";3;666;3;669;NA;281953;6;2021-08-12;98934
2021-08-11;"Trnavský kraj";7;576;2;578;NA;281953;9;2021-08-11;98928
2021-08-10;"Trnavský kraj";3;757;3;760;NA;281953;6;2021-08-10;98919
2021-08-09;"Trnavský kraj";12;808;0;808;NA;281953;12;2021-08-09;98913
2021-08-08;"Trnavský kraj";1;545;0;545;NA;281953;1;2021-08-08;98901
2021-08-07;"Trnavský kraj";9;724;0;724;NA;281953;9;2021-08-07;98900
2021-08-06;"Trnavský kraj";3;988;0;988;NA;281953;3;2021-08-06;98891
2021-08-05;"Trnavský kraj";2;662;1;663;NA;281953;3;2021-08-05;98888
2021-08-04;"Trnavský kraj";1;891;1;892;NA;281953;2;2021-08-04;98885
2021-08-03;"Trnavský kraj";13;645;0;645;NA;281953;13;2021-08-03;98883
2021-08-02;"Trnavský kraj";2;725;1;726;NA;281953;3;2021-08-02;98870
2021-08-01;"Trnavský kraj";0;565;2;567;NA;281953;2;2021-08-01;98867
2021-07-31;"Trnavský kraj";3;886;0;886;NA;281953;3;2021-07-31;98865
2021-07-30;"Trnavský kraj";3;1084;3;1087;NA;281953;6;2021-07-30;98862
2021-07-29;"Trnavský kraj";1;775;0;775;NA;281953;1;2021-07-29;98856
2021-07-28;"Trnavský kraj";5;794;1;795;NA;281953;6;2021-07-28;98855
2021-07-27;"Trnavský kraj";7;623;2;625;NA;281953;9;2021-07-27;98849
2021-07-26;"Trnavský kraj";2;857;2;859;NA;281953;4;2021-07-26;98840
2021-07-25;"Trnavský kraj";0;707;0;707;NA;281953;0;2021-07-25;98836
2021-07-24;"Trnavský kraj";4;828;2;830;NA;281953;6;2021-07-24;98836
2021-07-23;"Trnavský kraj";3;1057;0;1057;NA;281953;3;2021-07-23;98830
2021-07-22;"Trnavský kraj";0;671;2;673;NA;281953;2;2021-07-22;98827
2021-07-21;"Trnavský kraj";2;660;2;662;NA;281953;4;2021-07-21;98825
2021-07-20;"Trnavský kraj";2;593;0;593;NA;281953;2;2021-07-20;98821
2021-07-19;"Trnavský kraj";9;886;0;886;NA;281953;9;2021-07-19;98819
2021-07-18;"Trnavský kraj";0;600;2;602;NA;281953;2;2021-07-18;98810
2021-07-17;"Trnavský kraj";8;796;0;796;NA;281953;8;2021-07-17;98808
2021-07-16;"Trnavský kraj";11;963;0;963;NA;281953;11;2021-07-16;98800
2021-07-15;"Trnavský kraj";4;832;1;833;NA;281953;5;2021-07-15;98789
2021-07-14;"Trnavský kraj";1;699;1;700;NA;281953;2;2021-07-14;98784
2021-07-13;"Trnavský kraj";1;693;1;694;NA;281953;2;2021-07-13;98782
2021-07-12;"Trnavský kraj";4;959;0;959;NA;281953;4;2021-07-12;98780
2021-07-11;"Trnavský kraj";0;692;0;692;NA;281953;0;2021-07-11;98776
2021-07-10;"Trnavský kraj";1;803;0;803;NA;281953;1;2021-07-10;98776
2021-07-09;"Trnavský kraj";3;1262;3;1265;NA;281953;6;2021-07-09;98775
2021-07-08;"Trnavský kraj";4;755;0;755;NA;281953;4;2021-07-08;98769
2021-07-07;"Trnavský kraj";9;924;2;926;NA;281953;11;2021-07-07;98765
2021-07-06;"Trnavský kraj";2;1401;1;1402;NA;281953;3;2021-07-06;98754
2021-07-05;"Trnavský kraj";1;503;2;505;NA;281953;3;2021-07-05;98751
2021-07-04;"Trnavský kraj";0;1129;3;1132;NA;281953;3;2021-07-04;98748
2021-07-03;"Trnavský kraj";4;815;0;815;NA;281953;4;2021-07-03;98745
2021-07-02;"Trnavský kraj";2;1137;2;1139;NA;281953;4;2021-07-02;98741
2021-07-01;"Trnavský kraj";4;487;0;487;NA;281953;4;2021-07-01;98737
2021-06-30;"Trnavský kraj";0;5135;1;5136;NA;281953;1;2021-06-30;98733
2021-06-29;"Trnavský kraj";4;2563;1;2564;NA;281953;5;2021-06-29;98732
2021-06-28;"Trnavský kraj";2;2600;1;2601;NA;281953;3;2021-06-28;98727
2021-06-27;"Trnavský kraj";0;3213;0;3213;NA;281953;0;2021-06-27;98724
2021-06-26;"Trnavský kraj";3;3871;1;3872;NA;281953;4;2021-06-26;98724
2021-06-25;"Trnavský kraj";2;4374;3;4377;NA;281953;5;2021-06-25;98720
2021-06-24;"Trnavský kraj";4;2520;3;2523;NA;281953;7;2021-06-24;98715
2021-06-23;"Trnavský kraj";4;2842;2;2844;NA;281953;6;2021-06-23;98708
2021-06-22;"Trnavský kraj";2;2996;1;2997;NA;281953;3;2021-06-22;98702
2021-06-21;"Trnavský kraj";6;3114;5;3119;NA;281953;11;2021-06-21;98699
2021-06-20;"Trnavský kraj";0;3952;1;3953;NA;281953;1;2021-06-20;98688
2021-06-19;"Trnavský kraj";3;4735;2;4737;NA;281953;5;2021-06-19;98687
2021-06-18;"Trnavský kraj";5;6125;4;6129;NA;281953;9;2021-06-18;98682
2021-06-17;"Trnavský kraj";3;3340;0;3340;NA;281953;3;2021-06-17;98673
2021-06-16;"Trnavský kraj";6;2926;3;2929;NA;281953;9;2021-06-16;98670
2021-06-15;"Trnavský kraj";8;3234;3;3237;NA;281953;11;2021-06-15;98661
2021-06-14;"Trnavský kraj";2;3829;1;3830;NA;281953;3;2021-06-14;98650
2021-06-13;"Trnavský kraj";0;5001;8;5009;NA;281953;8;2021-06-13;98647
2021-06-12;"Trnavský kraj";11;5807;2;5809;NA;281953;13;2021-06-12;98639
2021-06-11;"Trnavský kraj";17;5850;4;5854;NA;281953;21;2021-06-11;98626
2021-06-10;"Trnavský kraj";14;3476;1;3477;NA;281953;15;2021-06-10;98605
2021-06-09;"Trnavský kraj";10;3685;1;3686;NA;281953;11;2021-06-09;98590
2021-06-08;"Trnavský kraj";8;3344;4;3348;NA;281953;12;2021-06-08;98579
2021-06-07;"Trnavský kraj";12;4498;8;4506;NA;281953;20;2021-06-07;98567
2021-06-06;"Trnavský kraj";0;5517;2;5519;NA;281953;2;2021-06-06;98547
2021-06-05;"Trnavský kraj";20;6905;8;6913;NA;281953;28;2021-06-05;98545
2021-06-04;"Trnavský kraj";9;6735;10;6745;NA;281953;19;2021-06-04;98517
2021-06-03;"Trnavský kraj";14;4361;11;4372;NA;281953;25;2021-06-03;98498
2021-06-02;"Trnavský kraj";4;4148;11;4159;NA;281953;15;2021-06-02;98473
2021-06-01;"Trnavský kraj";18;3662;5;3667;NA;281953;23;2021-06-01;98458
2021-05-31;"Trnavský kraj";14;5515;16;5531;NA;281953;30;2021-05-31;98435
2021-05-30;"Trnavský kraj";0;6473;7;6480;NA;281953;7;2021-05-30;98405
2021-05-29;"Trnavský kraj";11;8964;4;8968;NA;281953;15;2021-05-29;98398
2021-05-28;"Trnavský kraj";14;7160;11;7171;NA;281953;25;2021-05-28;98383
2021-05-27;"Trnavský kraj";22;4753;8;4761;NA;281953;30;2021-05-27;98358
2021-05-26;"Trnavský kraj";6;4870;8;4878;NA;281953;14;2021-05-26;98328
2021-05-25;"Trnavský kraj";19;5026;27;5053;NA;281953;46;2021-05-25;98314
2021-05-24;"Trnavský kraj";15;6520;22;6542;NA;281953;37;2021-05-24;98268
2021-05-23;"Trnavský kraj";0;7920;8;7928;NA;281953;8;2021-05-23;98231
2021-05-22;"Trnavský kraj";13;13381;21;13402;NA;281953;34;2021-05-22;98223
2021-05-21;"Trnavský kraj";16;8525;19;8544;NA;281953;35;2021-05-21;98189
2021-05-20;"Trnavský kraj";15;5511;11;5522;NA;281953;26;2021-05-20;98154
2021-05-19;"Trnavský kraj";18;5431;13;5444;NA;281953;31;2021-05-19;98128
2021-05-18;"Trnavský kraj";26;5768;15;5783;NA;281953;41;2021-05-18;98097
2021-05-17;"Trnavský kraj";17;6262;24;6286;NA;281953;41;2021-05-17;98056
2021-05-16;"Trnavský kraj";10;9984;8;9992;NA;281953;18;2021-05-16;98015
2021-05-15;"Trnavský kraj";11;18525;14;18539;NA;281953;25;2021-05-15;97997
2021-05-14;"Trnavský kraj";34;10279;21;10300;NA;281953;55;2021-05-14;97972
2021-05-13;"Trnavský kraj";26;6913;12;6925;NA;281953;38;2021-05-13;97917
2021-05-12;"Trnavský kraj";34;6621;26;6647;NA;281953;60;2021-05-12;97879
2021-05-11;"Trnavský kraj";32;6393;13;6406;NA;281953;45;2021-05-11;97819
2021-05-10;"Trnavský kraj";58;9139;24;9163;NA;281953;82;2021-05-10;97774
2021-05-09;"Trnavský kraj";21;12570;12;12582;NA;281953;33;2021-05-09;97692
2021-05-08;"Trnavský kraj";4;23028;22;23050;NA;281953;26;2021-05-08;97659
2021-05-07;"Trnavský kraj";26;15465;30;15495;NA;281953;56;2021-05-07;97633
2021-05-06;"Trnavský kraj";22;8407;22;8429;NA;281953;44;2021-05-06;97577
2021-05-05;"Trnavský kraj";34;6273;22;6295;NA;281953;56;2021-05-05;97533
2021-05-04;"Trnavský kraj";51;8538;17;8555;NA;281953;68;2021-05-04;97477
2021-05-03;"Trnavský kraj";20;8957;22;8979;NA;281953;42;2021-05-03;97409
2021-05-02;"Trnavský kraj";0;25657;29;25686;NA;281953;29;2021-05-02;97367
2021-05-01;"Trnavský kraj";30;81353;64;81417;NA;281953;94;2021-05-01;97338
2021-04-30;"Trnavský kraj";45;26846;35;26881;NA;281953;80;2021-04-30;97244
2021-04-29;"Trnavský kraj";25;20323;28;20351;NA;281953;53;2021-04-29;97164
2021-04-28;"Trnavský kraj";46;8896;28;8924;NA;281953;74;2021-04-28;97111
2021-04-27;"Trnavský kraj";54;8756;37;8793;NA;281953;91;2021-04-27;97037
2021-04-26;"Trnavský kraj";53;16116;42;16158;NA;281953;95;2021-04-26;96946
2021-04-25;"Trnavský kraj";0;30183;24;30207;NA;281953;24;2021-04-25;96851
2021-04-24;"Trnavský kraj";46;126077;84;126161;NA;281953;130;2021-04-24;96827
2021-04-23;"Trnavský kraj";71;25741;53;25794;NA;281953;124;2021-04-23;96697
2021-04-22;"Trnavský kraj";40;10904;25;10929;NA;281953;65;2021-04-22;96573
2021-04-21;"Trnavský kraj";60;10748;45;10793;NA;281953;105;2021-04-21;96508
2021-04-20;"Trnavský kraj";57;13504;28;13532;NA;281953;85;2021-04-20;96403
2021-04-19;"Trnavský kraj";46;14603;18;14621;NA;281953;64;2021-04-19;96318
2021-04-18;"Trnavský kraj";7;40843;43;40886;NA;281953;50;2021-04-18;96254
2021-04-17;"Trnavský kraj";58;118102;89;118191;NA;281953;147;2021-04-17;96204
2021-04-16;"Trnavský kraj";67;25962;48;26010;NA;281953;115;2021-04-16;96057
2021-04-15;"Trnavský kraj";65;11373;36;11409;NA;281953;101;2021-04-15;95942
2021-04-14;"Trnavský kraj";78;18442;53;18495;NA;281953;131;2021-04-14;95841
2021-04-13;"Trnavský kraj";126;9871;44;9915;NA;281953;170;2021-04-13;95710
2021-04-12;"Trnavský kraj";40;15577;40;15617;NA;281953;80;2021-04-12;95540
2021-04-11;"Trnavský kraj";3;44420;44;44464;NA;281953;47;2021-04-11;95460
2021-04-10;"Trnavský kraj";60;123822;107;123929;NA;281953;167;2021-04-10;95413
2021-04-09;"Trnavský kraj";95;26191;34;26225;NA;281953;129;2021-04-09;95246
2021-04-08;"Trnavský kraj";85;10913;54;10967;NA;281953;139;2021-04-08;95117
2021-04-07;"Trnavský kraj";131;15979;81;16060;NA;281953;212;2021-04-07;94978
2021-04-06;"Trnavský kraj";92;20586;90;20676;NA;281953;182;2021-04-06;94766
2021-04-05;"Trnavský kraj";91;7542;17;7559;NA;281953;108;2021-04-05;94584
2021-04-04;"Trnavský kraj";9;28831;49;28880;NA;281953;58;2021-04-04;94476
2021-04-03;"Trnavský kraj";29;144452;186;144638;NA;281953;215;2021-04-03;94418
2021-04-02;"Trnavský kraj";91;17538;33;17571;NA;281953;124;2021-04-02;94203
2021-04-01;"Trnavský kraj";118;22279;71;22350;NA;281953;189;2021-04-01;94079
2021-03-31;"Trnavský kraj";140;15828;82;15910;NA;281953;222;2021-03-31;93890
2021-03-30;"Trnavský kraj";182;10482;79;10561;NA;281953;261;2021-03-30;93668
2021-03-29;"Trnavský kraj";126;19255;122;19377;NA;281953;248;2021-03-29;93407
2021-03-28;"Trnavský kraj";26;50664;134;50798;NA;281953;160;2021-03-28;93159
2021-03-27;"Trnavský kraj";64;130217;246;130463;NA;281953;310;2021-03-27;92999
2021-03-26;"Trnavský kraj";139;30217;130;30347;NA;281953;269;2021-03-26;92689
2021-03-25;"Trnavský kraj";135;14212;80;14292;NA;281953;215;2021-03-25;92420
2021-03-24;"Trnavský kraj";159;10521;89;10610;NA;281953;248;2021-03-24;92205
2021-03-23;"Trnavský kraj";221;12735;104;12839;NA;281953;325;2021-03-23;91957
2021-03-22;"Trnavský kraj";103;17118;110;17228;NA;281953;213;2021-03-22;91632
2021-03-21;"Trnavský kraj";31;49119;150;49269;NA;281953;181;2021-03-21;91419
2021-03-20;"Trnavský kraj";112;136963;317;137280;NA;281953;429;2021-03-20;91238
2021-03-19;"Trnavský kraj";174;29071;137;29208;NA;281953;311;2021-03-19;90809
2021-03-18;"Trnavský kraj";158;12217;136;12353;NA;281953;294;2021-03-18;90498
2021-03-17;"Trnavský kraj";245;10434;103;10537;NA;281953;348;2021-03-17;90204
2021-03-16;"Trnavský kraj";311;12811;135;12946;NA;281953;446;2021-03-16;89856
2021-03-15;"Trnavský kraj";127;18271;146;18417;NA;281953;273;2021-03-15;89410
2021-03-14;"Trnavský kraj";14;47608;164;47772;NA;281953;178;2021-03-14;89137
2021-03-13;"Trnavský kraj";155;139224;409;139633;NA;281953;564;2021-03-13;88959
2021-03-12;"Trnavský kraj";201;28566;181;28747;NA;281953;382;2021-03-12;88395
2021-03-11;"Trnavský kraj";204;13301;140;13441;NA;281953;344;2021-03-11;88013
2021-03-10;"Trnavský kraj";242;10583;135;10718;NA;281953;377;2021-03-10;87669
2021-03-09;"Trnavský kraj";442;12824;155;12979;NA;281953;597;2021-03-09;87292
2021-03-08;"Trnavský kraj";182;21812;166;21978;NA;281953;348;2021-03-08;86695
2021-03-07;"Trnavský kraj";30;45463;227;45690;NA;281953;257;2021-03-07;86347
2021-03-06;"Trnavský kraj";154;135784;531;136315;NA;281953;685;2021-03-06;86090
2021-03-05;"Trnavský kraj";299;27959;239;28198;NA;281953;538;2021-03-05;85405
2021-03-04;"Trnavský kraj";238;14505;176;14681;NA;281953;414;2021-03-04;84867
2021-03-03;"Trnavský kraj";413;11583;246;11829;NA;281953;659;2021-03-03;84453
2021-03-02;"Trnavský kraj";477;12367;191;12558;NA;281953;668;2021-03-02;83794
2021-03-01;"Trnavský kraj";189;18586;234;18820;NA;281953;423;2021-03-01;83126
2021-02-28;"Trnavský kraj";87;47709;321;48030;NA;281953;408;2021-02-28;82703
2021-02-27;"Trnavský kraj";264;140224;800;141024;NA;281953;1064;2021-02-27;82295
2021-02-26;"Trnavský kraj";362;26637;284;26921;NA;281953;646;2021-02-26;81231
2021-02-25;"Trnavský kraj";433;10490;227;10717;NA;281953;660;2021-02-25;80585
2021-02-24;"Trnavský kraj";407;9113;290;9403;NA;281953;697;2021-02-24;79925
2021-02-23;"Trnavský kraj";469;11322;284;11606;NA;281953;753;2021-02-23;79228
2021-02-22;"Trnavský kraj";206;19901;330;20231;NA;281953;536;2021-02-22;78475
2021-02-21;"Trnavský kraj";38;48221;329;48550;NA;281953;367;2021-02-21;77939
2021-02-20;"Trnavský kraj";273;135835;859;136694;NA;281953;1132;2021-02-20;77572
2021-02-19;"Trnavský kraj";335;26382;366;26748;NA;281953;701;2021-02-19;76440
2021-02-18;"Trnavský kraj";344;11264;348;11612;NA;281953;692;2021-02-18;75739
2021-02-17;"Trnavský kraj";431;8783;416;9199;NA;281953;847;2021-02-17;75047
2021-02-16;"Trnavský kraj";426;11236;294;11530;NA;281953;720;2021-02-16;74200
2021-02-15;"Trnavský kraj";146;18276;326;18602;NA;281953;472;2021-02-15;73480
2021-02-14;"Trnavský kraj";51;57642;495;58137;NA;281953;546;2021-02-14;73008
2021-02-13;"Trnavský kraj";218;137051;994;138045;NA;281953;1212;2021-02-13;72462
2021-02-12;"Trnavský kraj";300;24090;352;24442;NA;281953;652;2021-02-12;71250
2021-02-11;"Trnavský kraj";422;9831;349;10180;NA;281953;771;2021-02-11;70598
2021-02-10;"Trnavský kraj";511;9194;342;9536;NA;281953;853;2021-02-10;69827
2021-02-09;"Trnavský kraj";544;12755;369;13124;NA;281953;913;2021-02-09;68974
2021-02-08;"Trnavský kraj";220;33414;497;33911;NA;281953;717;2021-02-08;68061
2021-02-07;"Trnavský kraj";140;69694;628;70322;NA;281953;768;2021-02-07;67344
2021-02-06;"Trnavský kraj";348;112687;1482;114169;NA;281953;1830;2021-02-06;66576
2021-02-05;"Trnavský kraj";377;16063;373;16436;NA;281953;750;2021-02-05;64746
2021-02-04;"Trnavský kraj";456;7317;456;7773;NA;281953;912;2021-02-04;63996
2021-02-03;"Trnavský kraj";472;6583;434;7017;NA;281953;906;2021-02-03;63084
2021-02-02;"Trnavský kraj";446;14243;424;14667;NA;281953;870;2021-02-02;62178
2021-02-01;"Trnavský kraj";198;38882;679;39561;NA;281953;877;2021-02-01;61308
2021-01-31;"Trnavský kraj";19;64707;822;65529;NA;281953;841;2021-01-31;60431
2021-01-30;"Trnavský kraj";323;111483;1288;112771;NA;281953;1611;2021-01-30;59590
2021-01-29;"Trnavský kraj";421;9689;290;9979;NA;281953;711;2021-01-29;57979
2021-01-28;"Trnavský kraj";389;5817;289;6106;NA;281953;678;2021-01-28;57268
2021-01-27;"Trnavský kraj";433;5554;225;5779;NA;281953;658;2021-01-27;56590
2021-01-26;"Trnavský kraj";565;25411;636;26047;NA;281953;1201;2021-01-26;55932
2021-01-25;"Trnavský kraj";210;41805;620;42425;NA;281953;830;2021-01-25;54731
2021-01-24;"Trnavský kraj";91;66399;779;67178;NA;281953;870;2021-01-24;53901
2021-01-23;"Trnavský kraj";372;113375;1319;114694;NA;281953;1691;2021-01-23;53031
2021-01-22;"Trnavský kraj";217;32755;505;33260;NA;281953;722;2021-01-22;51340
2021-01-21;"Trnavský kraj";311;13913;377;14290;NA;281953;688;2021-01-21;50618
2021-01-20;"Trnavský kraj";503;8685;283;8968;NA;281953;786;2021-01-20;49930
2021-01-19;"Trnavský kraj";415;7013;347;7360;NA;281953;762;2021-01-19;49144
2021-01-18;"Trnavský kraj";247;6690;513;7203;NA;281953;760;2021-01-18;48382
2021-01-17;"Trnavský kraj";128;854;215;1069;NA;281953;343;2021-01-17;47622
2021-01-16;"Trnavský kraj";103;898;24;922;NA;281953;127;2021-01-16;47279
2021-01-15;"Trnavský kraj";278;5467;336;5803;NA;281953;614;2021-01-15;47152
2021-01-14;"Trnavský kraj";452;4001;338;4339;NA;281953;790;2021-01-14;46538
2021-01-13;"Trnavský kraj";457;4751;378;5129;NA;281953;835;2021-01-13;45748
2021-01-12;"Trnavský kraj";469;6860;470;7330;NA;281953;939;2021-01-12;44913
2021-01-11;"Trnavský kraj";370;4587;360;4947;NA;281953;730;2021-01-11;43974
2021-01-10;"Trnavský kraj";71;13;0;13;NA;281953;71;2021-01-10;43244
2021-01-09;"Trnavský kraj";417;1775;100;1875;NA;281953;517;2021-01-09;43173
2021-01-08;"Trnavský kraj";381;6016;506;6522;NA;281953;887;2021-01-08;42656
2021-01-07;"Trnavský kraj";501;3545;329;3874;NA;281953;830;2021-01-07;41769
2021-01-06;"Trnavský kraj";179;758;132;890;NA;281953;311;2021-01-06;40939
2021-01-05;"Trnavský kraj";611;5165;561;5726;NA;281953;1172;2021-01-05;40628
2021-01-04;"Trnavský kraj";302;5556;709;6265;NA;281953;1011;2021-01-04;39456
2021-01-03;"Trnavský kraj";60;53;7;60;NA;281953;67;2021-01-03;38445
2021-01-02;"Trnavský kraj";282;417;32;449;NA;281953;314;2021-01-02;38378
2021-01-01;"Trnavský kraj";143;455;76;531;NA;281953;219;2021-01-01;38064
2020-12-31;"Trnavský kraj";498;8325;820;9145;NA;281953;1318;2020-12-31;37845
2020-12-30;"Trnavský kraj";785;5318;612;5930;NA;281953;1397;2020-12-30;36527
2020-12-29;"Trnavský kraj";322;4913;565;5478;NA;281953;887;2020-12-29;35130
2020-12-28;"Trnavský kraj";213;4900;552;5452;NA;281953;765;2020-12-28;34243
2020-12-27;"Trnavský kraj";27;20;4;24;NA;281953;31;2020-12-27;33478
2020-12-26;"Trnavský kraj";148;44;1;45;NA;281953;149;2020-12-26;33447
2020-12-25;"Trnavský kraj";65;49;5;54;NA;281953;70;2020-12-25;33298
2020-12-24;"Trnavský kraj";333;1359;117;1476;NA;281953;450;2020-12-24;33228
2020-12-23;"Trnavský kraj";210;6672;414;7086;NA;281953;624;2020-12-23;32778
2020-12-22;"Trnavský kraj";311;5427;455;5882;NA;281953;766;2020-12-22;32154
2020-12-21;"Trnavský kraj";328;4092;350;4442;NA;281953;678;2020-12-21;31388
2020-12-20;"Trnavský kraj";134;133;12;145;NA;281953;146;2020-12-20;30710
2020-12-19;"Trnavský kraj";201;1407;103;1510;NA;281953;304;2020-12-19;30564
2020-12-18;"Trnavský kraj";341;4432;334;4766;NA;281953;675;2020-12-18;30260
2020-12-17;"Trnavský kraj";375;4880;414;5294;NA;281953;789;2020-12-17;29585
2020-12-16;"Trnavský kraj";312;4945;383;5328;NA;281953;695;2020-12-16;28796
2020-12-15;"Trnavský kraj";492;6240;598;6838;NA;281953;1090;2020-12-15;28101
2020-12-14;"Trnavský kraj";161;3505;292;3797;NA;281953;453;2020-12-14;27011
2020-12-13;"Trnavský kraj";7;7;0;7;NA;281953;7;2020-12-13;26558
2020-12-12;"Trnavský kraj";254;1456;114;1570;NA;281953;368;2020-12-12;26551
2020-12-11;"Trnavský kraj";384;4289;241;4530;NA;281953;625;2020-12-11;26183
2020-12-10;"Trnavský kraj";183;5197;320;5517;NA;281953;503;2020-12-10;25558
2020-12-09;"Trnavský kraj";521;4199;317;4516;NA;281953;838;2020-12-09;25055
2020-12-08;"Trnavský kraj";281;4090;304;4394;NA;281953;585;2020-12-08;24217
2020-12-07;"Trnavský kraj";178;2895;199;3094;NA;281953;377;2020-12-07;23632
2020-12-06;"Trnavský kraj";46;0;0;0;NA;281953;46;2020-12-06;23255
2020-12-05;"Trnavský kraj";129;2218;41;2259;NA;281953;170;2020-12-05;23209
2020-12-04;"Trnavský kraj";242;3948;158;4106;NA;281953;400;2020-12-04;23039
2020-12-03;"Trnavský kraj";248;2770;190;2960;NA;281953;438;2020-12-03;22639
2020-12-02;"Trnavský kraj";284;4516;176;4692;NA;281953;460;2020-12-02;22201
2020-12-01;"Trnavský kraj";253;3190;205;3395;NA;281953;458;2020-12-01;21741
2020-11-30;"Trnavský kraj";200;7360;186;7546;NA;281953;386;2020-11-30;21283
2020-11-29;"Trnavský kraj";17;738;36;774;NA;281953;53;2020-11-29;20897
2020-11-28;"Trnavský kraj";83;1453;77;1530;NA;281953;160;2020-11-28;20844
2020-11-27;"Trnavský kraj";148;1779;85;1864;NA;281953;233;2020-11-27;20684
2020-11-26;"Trnavský kraj";234;1123;68;1191;NA;281953;302;2020-11-26;20451
2020-11-25;"Trnavský kraj";232;1168;74;1242;NA;281953;306;2020-11-25;20149
2020-11-24;"Trnavský kraj";295;1909;96;2005;NA;281953;391;2020-11-24;19843
2020-11-23;"Trnavský kraj";242;7393;129;7522;NA;281953;371;2020-11-23;19452
2020-11-22;"Trnavský kraj";10;82;9;91;NA;281953;19;2020-11-22;19081
2020-11-21;"Trnavský kraj";129;1354;36;1390;NA;281953;165;2020-11-21;19062
2020-11-20;"Trnavský kraj";246;1154;64;1218;NA;281953;310;2020-11-20;18897
2020-11-19;"Trnavský kraj";157;823;64;887;NA;281953;221;2020-11-19;18587
2020-11-18;"Trnavský kraj";235;822;82;904;NA;281953;317;2020-11-18;18366
2020-11-17;"Trnavský kraj";129;705;74;779;NA;281953;203;2020-11-17;18049
2020-11-16;"Trnavský kraj";187;732;32;764;NA;281953;219;2020-11-16;17846
2020-11-15;"Trnavský kraj";23;73;4;77;NA;281953;27;2020-11-15;17627
2020-11-14;"Trnavský kraj";86;397;12;409;NA;281953;98;2020-11-14;17600
2020-11-13;"Trnavský kraj";219;1312;21;1333;NA;281953;240;2020-11-13;17502
2020-11-12;"Trnavský kraj";162;420;18;438;NA;281953;180;2020-11-12;17262
2020-11-11;"Trnavský kraj";257;392;15;407;NA;281953;272;2020-11-11;17082
2020-11-10;"Trnavský kraj";189;889;30;919;NA;281953;219;2020-11-10;16810
2020-11-09;"Trnavský kraj";196;369;23;392;NA;281953;219;2020-11-09;16591
2020-11-08;"Trnavský kraj";55;400;4;404;NA;281953;59;2020-11-08;16372
2020-11-07;"Trnavský kraj";207;6070;74;6144;NA;281953;281;2020-11-07;16313
2020-11-06;"Trnavský kraj";260;1531;19;1550;NA;281953;279;2020-11-06;16032
2020-11-05;"Trnavský kraj";150;220;27;247;NA;281953;177;2020-11-05;15753
2020-11-04;"Trnavský kraj";188;212;10;222;NA;281953;198;2020-11-04;15576
2020-11-03;"Trnavský kraj";317;127;8;135;NA;281953;325;2020-11-03;15378
2020-11-02;"Trnavský kraj";281;1728;31;1759;NA;281953;312;2020-11-02;15053
2020-11-01;"Trnavský kraj";87;494;27;521;NA;281953;114;2020-11-01;14741
2020-10-31;"Trnavský kraj";259;5024;41;5065;NA;281953;300;2020-10-31;14627
2020-10-30;"Trnavský kraj";198;3784;27;3811;NA;281953;225;2020-10-30;14327
2020-10-29;"Trnavský kraj";273;1461;16;1477;NA;281953;289;2020-10-29;14102
2020-10-28;"Trnavský kraj";319;117;16;133;NA;281953;335;2020-10-28;13813
2020-10-27;"Trnavský kraj";199;461;36;497;NA;281953;235;2020-10-27;13478
2020-10-26;"Trnavský kraj";153;29;2;31;NA;281953;155;2020-10-26;13243
2020-10-25;"Trnavský kraj";95;19;1;20;NA;281953;96;2020-10-25;13088
2020-10-24;"Trnavský kraj";158;109;2;111;NA;281953;160;2020-10-24;12992
2020-10-23;"Trnavský kraj";201;89;4;93;NA;281953;205;2020-10-23;12832
2020-10-22;"Trnavský kraj";195;55;2;57;NA;281953;197;2020-10-22;12627
2020-10-21;"Trnavský kraj";134;73;3;76;NA;281953;137;2020-10-21;12430
2020-10-20;"Trnavský kraj";202;82;3;85;NA;281953;205;2020-10-20;12293
2020-10-19;"Trnavský kraj";67;55;0;55;NA;281953;67;2020-10-19;12088
2020-10-18;"Trnavský kraj";84;0;0;0;NA;281953;84;2020-10-18;12021
2020-10-17;"Trnavský kraj";123;0;0;0;NA;281953;123;2020-10-17;11937
2020-10-16;"Trnavský kraj";86;45;2;47;NA;281953;88;2020-10-16;11814
2020-10-15;"Trnavský kraj";155;66;2;68;NA;281953;157;2020-10-15;11726
2020-10-14;"Trnavský kraj";236;468;3;471;NA;281953;239;2020-10-14;11569
2020-10-13;"Trnavský kraj";138;16;2;18;NA;281953;140;2020-10-13;11330
2020-10-12;"Trnavský kraj";33;41;1;42;NA;281953;34;2020-10-12;11190
2020-10-11;"Trnavský kraj";31;0;0;0;NA;281953;31;2020-10-11;11156
2020-10-10;"Trnavský kraj";128;0;0;0;NA;281953;128;2020-10-10;11125
2020-10-09;"Trnavský kraj";156;0;0;0;NA;281953;156;2020-10-09;10997
2020-10-08;"Trnavský kraj";153;0;0;0;NA;281953;153;2020-10-08;10841
2020-10-07;"Trnavský kraj";80;0;0;0;NA;281953;80;2020-10-07;10688
2020-10-06;"Trnavský kraj";112;0;0;0;NA;281953;112;2020-10-06;10608
2020-10-05;"Trnavský kraj";33;0;0;0;NA;281953;33;2020-10-05;10496
2020-10-04;"Trnavský kraj";44;0;0;0;NA;281953;44;2020-10-04;10463
2020-10-03;"Trnavský kraj";60;0;0;0;NA;281953;60;2020-10-03;10419
2020-10-02;"Trnavský kraj";41;0;0;0;NA;281953;41;2020-10-02;10359
2020-10-01;"Trnavský kraj";53;0;0;0;NA;281953;53;2020-10-01;10318
2020-09-30;"Trnavský kraj";91;0;0;0;NA;281953;91;2020-09-30;10265
2020-09-29;"Trnavský kraj";40;0;0;0;NA;281953;40;2020-09-29;10174
2020-09-28;"Trnavský kraj";69;0;0;0;NA;281953;69;2020-09-28;10134
2020-09-27;"Trnavský kraj";30;0;0;0;NA;281953;30;2020-09-27;10065
2020-09-26;"Trnavský kraj";46;0;0;0;NA;281953;46;2020-09-26;10035
2020-09-25;"Trnavský kraj";32;0;0;0;NA;281953;32;2020-09-25;9989
2020-09-24;"Trnavský kraj";42;0;0;0;NA;281953;42;2020-09-24;9957
2020-09-23;"Trnavský kraj";43;0;0;0;NA;281953;43;2020-09-23;9915
2020-09-22;"Trnavský kraj";55;0;0;0;NA;281953;55;2020-09-22;9872
2020-09-21;"Trnavský kraj";41;0;0;0;NA;281953;41;2020-09-21;9817
2020-09-20;"Trnavský kraj";17;0;0;0;NA;281953;17;2020-09-20;9776
2020-09-19;"Trnavský kraj";4;0;0;0;NA;281953;4;2020-09-19;9759
2020-09-18;"Trnavský kraj";33;0;0;0;NA;281953;33;2020-09-18;9755
2020-09-17;"Trnavský kraj";42;0;0;0;NA;281953;42;2020-09-17;9722
2020-09-16;"Trnavský kraj";49;0;0;0;NA;281953;49;2020-09-16;9680
2020-09-15;"Trnavský kraj";5;0;0;0;NA;281953;5;2020-09-15;9631
2020-09-14;"Trnavský kraj";26;0;0;0;NA;281953;26;2020-09-14;9626
2020-09-13;"Trnavský kraj";9;0;0;0;NA;281953;9;2020-09-13;9600
2020-09-12;"Trnavský kraj";12;0;0;0;NA;281953;12;2020-09-12;9591
2020-09-11;"Trnavský kraj";16;0;0;0;NA;281953;16;2020-09-11;9579
2020-09-10;"Trnavský kraj";32;0;0;0;NA;281953;32;2020-09-10;9563
2020-09-09;"Trnavský kraj";14;0;0;0;NA;281953;14;2020-09-09;9531
2020-09-08;"Trnavský kraj";11;0;0;0;NA;281953;11;2020-09-08;9517
2020-09-07;"Trnavský kraj";7;0;0;0;NA;281953;7;2020-09-07;9506
2020-09-06;"Trnavský kraj";5;0;0;0;NA;281953;5;2020-09-06;9499
2020-09-05;"Trnavský kraj";7;0;0;0;NA;281953;7;2020-09-05;9494
2020-09-04;"Trnavský kraj";16;0;0;0;NA;281953;16;2020-09-04;9487
2020-09-03;"Trnavský kraj";8;0;0;0;NA;281953;8;2020-09-03;9471
2020-09-02;"Trnavský kraj";7;0;0;0;NA;281953;7;2020-09-02;9463
2020-09-01;"Trnavský kraj";1;0;0;0;NA;281953;1;2020-09-01;9456
2020-08-31;"Trnavský kraj";6;0;0;0;NA;281953;6;2020-08-31;9455
2020-08-30;"Trnavský kraj";1;0;0;0;NA;281953;1;2020-08-30;9449
2020-08-29;"Trnavský kraj";3;0;0;0;NA;281953;3;2020-08-29;9448
2020-08-28;"Trnavský kraj";14;0;0;0;NA;281953;14;2020-08-28;9445
2020-08-27;"Trnavský kraj";6;0;0;0;NA;281953;6;2020-08-27;9431
2020-08-26;"Trnavský kraj";4;0;0;0;NA;281953;4;2020-08-26;9425
2020-08-25;"Trnavský kraj";7;0;0;0;NA;281953;7;2020-08-25;9421
2020-08-24;"Trnavský kraj";1;0;0;0;NA;281953;1;2020-08-24;9414
2020-08-23;"Trnavský kraj";6;0;0;0;NA;281953;6;2020-08-23;9413
2020-08-22;"Trnavský kraj";3;0;0;0;NA;281953;3;2020-08-22;9407
2020-08-21;"Trnavský kraj";4;0;0;0;NA;281953;4;2020-08-21;9404
2020-08-20;"Trnavský kraj";23;0;0;0;NA;281953;23;2020-08-20;9400
2020-08-19;"Trnavský kraj";13;0;0;0;NA;281953;13;2020-08-19;9377
2020-08-18;"Trnavský kraj";20;0;0;0;NA;281953;20;2020-08-18;9364
2020-08-17;"Trnavský kraj";3;0;0;0;NA;281953;3;2020-08-17;9344
2020-08-16;"Trnavský kraj";0;0;0;0;NA;281953;0;2020-08-16;9341
2020-08-15;"Trnavský kraj";7;0;0;0;NA;281953;7;2020-08-15;9341
2020-08-14;"Trnavský kraj";6;0;0;0;NA;281953;6;2020-08-14;9334
2020-08-13;"Trnavský kraj";10;0;0;0;NA;281953;10;2020-08-13;9328
2020-08-12;"Trnavský kraj";2;0;0;0;NA;281953;2;2020-08-12;9318
2020-08-11;"Trnavský kraj";30;0;0;0;NA;281953;30;2020-08-11;9316
2020-08-10;"Trnavský kraj";0;0;0;0;NA;281953;0;2020-08-10;9286
2020-08-09;"Trnavský kraj";0;0;0;0;NA;281953;0;2020-08-09;9286
2020-08-08;"Trnavský kraj";13;0;0;0;NA;281953;13;2020-08-08;9286
2020-08-07;"Trnavský kraj";4;0;0;0;NA;281953;4;2020-08-07;9273
2020-08-06;"Trnavský kraj";4;0;0;0;NA;281953;4;2020-08-06;9269
2020-08-05;"Trnavský kraj";0;0;0;0;NA;281953;0;2020-08-05;9265
2020-08-04;"Trnavský kraj";1;0;0;0;NA;281953;1;2020-08-04;9265
2020-08-03;"Trnavský kraj";2;0;0;0;NA;281953;2;2020-08-03;9264
2020-08-02;"Trnavský kraj";1;0;0;0;NA;281953;1;2020-08-02;9262
2020-08-01;"Trnavský kraj";0;0;0;0;NA;281953;0;2020-08-01;9261
2020-07-31;"Trnavský kraj";7;0;0;0;NA;281953;7;2020-07-31;9261
2020-07-30;"Trnavský kraj";6;0;0;0;NA;281953;6;2020-07-30;9254
2020-07-29;"Trnavský kraj";0;0;0;0;NA;281953;0;2020-07-29;9248
2020-07-28;"Trnavský kraj";1;0;0;0;NA;281953;1;2020-07-28;9248
2020-07-27;"Trnavský kraj";2;0;0;0;NA;281953;2;2020-07-27;9247
2020-07-26;"Trnavský kraj";0;0;0;0;NA;281953;0;2020-07-26;9245
2020-07-25;"Trnavský kraj";0;0;0;0;NA;281953;0;2020-07-25;9245
2020-07-24;"Trnavský kraj";1;0;0;0;NA;281953;1;2020-07-24;9245
2020-07-23;"Trnavský kraj";2;0;0;0;NA;281953;2;2020-07-23;9244
2020-07-22;"Trnavský kraj";1;0;0;0;NA;281953;1;2020-07-22;9242
2020-07-21;"Trnavský kraj";2;0;0;0;NA;281953;2;2020-07-21;9241
2020-07-20;"Trnavský kraj";0;0;0;0;NA;281953;0;2020-07-20;9239
2020-07-19;"Trnavský kraj";0;0;0;0;NA;281953;0;2020-07-19;9239
2020-07-18;"Trnavský kraj";0;0;0;0;NA;281953;0;2020-07-18;9239
2020-07-17;"Trnavský kraj";0;0;0;0;NA;281953;0;2020-07-17;9239
2020-07-16;"Trnavský kraj";0;0;0;0;NA;281953;0;2020-07-16;9239
2020-07-15;"Trnavský kraj";1;0;0;0;NA;281953;1;2020-07-15;9239
2020-07-14;"Trnavský kraj";0;0;0;0;NA;281953;0;2020-07-14;9238
2020-07-13;"Trnavský kraj";0;0;0;0;NA;281953;0;2020-07-13;9238
2020-07-12;"Trnavský kraj";0;0;0;0;NA;281953;0;2020-07-12;9238
2020-07-11;"Trnavský kraj";0;0;0;0;NA;281953;0;2020-07-11;9238
2020-07-10;"Trnavský kraj";0;0;0;0;NA;281953;0;2020-07-10;9238
2020-07-09;"Trnavský kraj";0;0;0;0;NA;281953;0;2020-07-09;9238
2020-07-08;"Trnavský kraj";3;0;0;0;NA;281953;3;2020-07-08;9238
2020-07-07;"Trnavský kraj";4;0;0;0;NA;281953;4;2020-07-07;9235
2020-07-06;"Trnavský kraj";0;0;0;0;NA;281953;0;2020-07-06;9231
2020-07-05;"Trnavský kraj";0;0;0;0;NA;281953;0;2020-07-05;9231
2020-07-04;"Trnavský kraj";0;0;0;0;NA;281953;0;2020-07-04;9231
2020-07-03;"Trnavský kraj";0;0;0;0;NA;281953;0;2020-07-03;9231
2020-07-02;"Trnavský kraj";3;0;0;0;NA;281953;3;2020-07-02;9231
2020-07-01;"Trnavský kraj";0;0;0;0;NA;281953;0;2020-07-01;9228
2020-06-30;"Trnavský kraj";0;0;0;0;NA;281953;0;2020-06-30;9228
2020-06-29;"Trnavský kraj";0;0;0;0;NA;281953;0;2020-06-29;9228
2020-06-28;"Trnavský kraj";0;0;0;0;NA;281953;0;2020-06-28;9228
2020-06-27;"Trnavský kraj";0;0;0;0;NA;281953;0;2020-06-27;9228
2020-06-26;"Trnavský kraj";0;0;0;0;NA;281953;0;2020-06-26;9228
2020-06-25;"Trnavský kraj";0;0;0;0;NA;281953;0;2020-06-25;9228
2020-06-24;"Trnavský kraj";0;0;0;0;NA;281953;0;2020-06-24;9228
2020-06-23;"Trnavský kraj";0;0;0;0;NA;281953;0;2020-06-23;9228
2020-06-22;"Trnavský kraj";0;0;0;0;NA;281953;0;2020-06-22;9228
2020-06-21;"Trnavský kraj";0;0;0;0;NA;281953;0;2020-06-21;9228
2020-06-20;"Trnavský kraj";0;0;0;0;NA;281953;0;2020-06-20;9228
2020-06-19;"Trnavský kraj";0;0;0;0;NA;281953;0;2020-06-19;9228
2020-06-18;"Trnavský kraj";2;0;0;0;NA;281953;2;2020-06-18;9228
2020-06-17;"Trnavský kraj";0;0;0;0;NA;281953;0;2020-06-17;9226
2020-06-16;"Trnavský kraj";0;0;0;0;NA;281953;0;2020-06-16;9226
2020-06-14;"Trnavský kraj";0;0;0;0;NA;281953;0;2020-06-14;9226
2020-06-13;"Trnavský kraj";0;0;0;0;NA;281953;0;2020-06-13;9226
2020-06-12;"Trnavský kraj";0;0;0;0;NA;281953;0;2020-06-12;9226
2020-06-11;"Trnavský kraj";0;0;0;0;NA;281953;0;2020-06-11;9226
2020-06-10;"Trnavský kraj";0;0;0;0;NA;281953;0;2020-06-10;9226
2020-06-09;"Trnavský kraj";0;0;0;0;NA;281953;0;2020-06-09;9226
2020-06-08;"Trnavský kraj";0;0;0;0;NA;281953;0;2020-06-08;9226
2020-06-07;"Trnavský kraj";0;0;0;0;NA;281953;0;2020-06-07;9226
2020-06-05;"Trnavský kraj";0;0;0;0;NA;281953;0;2020-06-05;9226
2020-06-03;"Trnavský kraj";0;0;0;0;NA;281953;0;2020-06-03;9226
2020-06-02;"Trnavský kraj";0;0;0;0;NA;281953;0;2020-06-02;9226
2020-05-31;"Trnavský kraj";0;0;0;0;NA;281953;0;2020-05-31;9226
2020-05-29;"Trnavský kraj";0;0;0;0;NA;281953;0;2020-05-29;9226
2020-05-27;"Trnavský kraj";0;0;0;0;NA;281953;0;2020-05-27;9226
2020-05-26;"Trnavský kraj";0;0;0;0;NA;281953;0;2020-05-26;9226
2020-05-25;"Trnavský kraj";1;0;0;0;NA;281953;1;2020-05-25;9226
2020-05-24;"Trnavský kraj";0;0;0;0;NA;281953;0;2020-05-24;9225
2020-05-23;"Trnavský kraj";2;0;0;0;NA;281953;2;2020-05-23;9225
2020-05-22;"Trnavský kraj";0;0;0;0;NA;281953;0;2020-05-22;9223
2020-05-21;"Trnavský kraj";0;0;0;0;NA;281953;0;2020-05-21;9223
2020-05-20;"Trnavský kraj";2;0;0;0;NA;281953;2;2020-05-20;9223
2020-05-19;"Trnavský kraj";0;0;0;0;NA;281953;0;2020-05-19;9221
2020-05-17;"Trnavský kraj";0;0;0;0;NA;281953;0;2020-05-17;9221
2020-05-16;"Trnavský kraj";0;0;0;0;NA;281953;0;2020-05-16;9221
2020-05-15;"Trnavský kraj";1;0;0;0;NA;281953;1;2020-05-15;9221
2020-05-14;"Trnavský kraj";0;0;0;0;NA;281953;0;2020-05-14;9220
2020-05-13;"Trnavský kraj";0;0;0;0;NA;281953;0;2020-05-13;9220
2020-05-12;"Trnavský kraj";0;0;0;0;NA;281953;0;2020-05-12;9220
2020-05-11;"Trnavský kraj";2;0;0;0;NA;281953;2;2020-05-11;9220
2020-05-09;"Trnavský kraj";0;0;0;0;NA;281953;0;2020-05-09;9218
2020-05-07;"Trnavský kraj";0;0;0;0;NA;281953;0;2020-05-07;9218
2020-05-06;"Trnavský kraj";0;0;0;0;NA;281953;0;2020-05-06;9218
2020-05-05;"Trnavský kraj";0;0;0;0;NA;281953;0;2020-05-05;9218
2020-05-04;"Trnavský kraj";0;0;0;0;NA;281953;0;2020-05-04;9218
2020-05-03;"Trnavský kraj";0;0;0;0;NA;281953;0;2020-05-03;9218
2020-05-02;"Trnavský kraj";0;0;0;0;NA;281953;0;2020-05-02;9218
2020-05-01;"Trnavský kraj";0;0;0;0;NA;281953;0;2020-05-01;9218
2020-04-30;"Trnavský kraj";0;0;0;0;NA;281953;0;2020-04-30;9218
2020-04-29;"Trnavský kraj";0;0;0;0;NA;281953;0;2020-04-29;9218
2020-04-28;"Trnavský kraj";1;0;0;0;NA;281953;1;2020-04-28;9218
2020-04-27;"Trnavský kraj";0;0;0;0;NA;281953;0;2020-04-27;9217
2020-04-26;"Trnavský kraj";0;0;0;0;NA;281953;0;2020-04-26;9217
2020-04-25;"Trnavský kraj";2;0;0;0;NA;281953;2;2020-04-25;9217
2020-04-24;"Trnavský kraj";4;0;0;0;NA;281953;4;2020-04-24;9215
2020-04-23;"Trnavský kraj";5;0;0;0;NA;281953;5;2020-04-23;9211
2020-04-22;"Trnavský kraj";10;0;0;0;NA;281953;10;2020-04-22;9206
2020-04-21;"Trnavský kraj";5;0;0;0;NA;281953;5;2020-04-21;9196
2020-04-20;"Trnavský kraj";0;0;0;0;NA;281953;0;2020-04-20;9191
2020-04-19;"Trnavský kraj";1;0;0;0;NA;281953;1;2020-04-19;9191
2020-04-18;"Trnavský kraj";4;0;0;0;NA;281953;4;2020-04-18;9190
2020-04-17;"Trnavský kraj";7;0;0;0;NA;281953;7;2020-04-17;9186
2020-04-16;"Trnavský kraj";5;0;0;0;NA;281953;5;2020-04-16;9179
2020-04-15;"Trnavský kraj";5;0;0;0;NA;281953;5;2020-04-15;9174
2020-04-14;"Trnavský kraj";1;0;0;0;NA;281953;1;2020-04-14;9169
2020-04-13;"Trnavský kraj";0;0;0;0;NA;281953;0;2020-04-13;9168
2020-04-12;"Trnavský kraj";0;0;0;0;NA;281953;0;2020-04-12;9168
2020-04-11;"Trnavský kraj";0;0;0;0;NA;281953;0;2020-04-11;9168
2020-04-10;"Trnavský kraj";2;0;0;0;NA;281953;2;2020-04-10;9168
2020-04-09;"Trnavský kraj";3;0;0;0;NA;281953;3;2020-04-09;9166
2020-04-08;"Trnavský kraj";4;0;0;0;NA;281953;4;2020-04-08;9163
2020-04-07;"Trnavský kraj";6;0;0;0;NA;281953;6;2020-04-07;9159
2020-04-06;"Trnavský kraj";6;0;0;0;NA;281953;6;2020-04-06;9153
2020-04-05;"Trnavský kraj";1;0;0;0;NA;281953;1;2020-04-05;9147
2020-04-04;"Trnavský kraj";1;0;0;0;NA;281953;1;2020-04-04;9146
2020-04-03;"Trnavský kraj";3;0;0;0;NA;281953;3;2020-04-03;9145
2020-04-02;"Trnavský kraj";4;0;0;0;NA;281953;4;2020-04-02;9142
2020-04-01;"Trnavský kraj";0;0;0;0;NA;281953;0;2020-04-01;9138
2020-03-31;"Trnavský kraj";3;0;0;0;NA;281953;3;2020-03-31;9138
2020-03-30;"Trnavský kraj";4;0;0;0;NA;281953;4;2020-03-30;9135
2020-03-29;"Trnavský kraj";1;0;0;0;NA;281953;1;2020-03-29;9131
2020-03-28;"Trnavský kraj";3;0;0;0;NA;281953;3;2020-03-28;9130
2020-03-27;"Trnavský kraj";5;0;0;0;NA;281953;5;2020-03-27;9127
2020-03-26;"Trnavský kraj";5;0;0;0;NA;281953;5;2020-03-26;9122
2020-03-25;"Trnavský kraj";1;0;0;0;NA;281953;1;2020-03-25;9117
2020-03-24;"Trnavský kraj";0;0;0;0;NA;281953;0;2020-03-24;9116
2020-03-23;"Trnavský kraj";2;0;0;0;NA;281953;2;2020-03-23;9116
2020-03-22;"Trnavský kraj";1;0;0;0;NA;281953;1;2020-03-22;9114
2020-03-21;"Trnavský kraj";5;0;0;0;NA;281953;5;2020-03-21;9113
2020-03-20;"Trnavský kraj";0;0;0;0;NA;281953;0;2020-03-20;9108
2020-03-19;"Trnavský kraj";0;0;0;0;NA;281953;0;2020-03-19;9108
2020-03-18;"Trnavský kraj";0;0;0;0;NA;281953;0;2020-03-18;9108
2020-03-17;"Trnavský kraj";3;0;0;0;NA;281953;3;2020-03-17;9108
2020-03-16;"Trnavský kraj";1;0;0;0;NA;281953;1;2020-03-16;9105
2020-03-15;"Trnavský kraj";0;0;0;0;NA;281953;0;2020-03-15;9104
2020-03-14;"Trnavský kraj";0;0;0;0;NA;281953;0;2020-03-14;9104
2020-03-13;"Trnavský kraj";1;0;0;0;NA;281953;1;2020-03-13;9104
2020-03-12;"Trnavský kraj";1;0;0;0;NA;281953;1;2020-03-12;9103
2020-03-11;"Trnavský kraj";0;0;0;0;NA;281953;0;2020-03-11;9102
2020-03-09;"Trnavský kraj";0;0;0;0;NA;281953;0;2020-03-09;9102
2020-03-08;"Trnavský kraj";0;0;0;0;NA;281953;0;2020-03-08;9102
2020-03-07;"Trnavský kraj";0;0;0;0;NA;281953;0;2020-03-07;9102
2020-03-06;"Trnavský kraj";0;0;0;0;NA;281953;0;2020-03-06;9102
2022-05-26;"Žilinský kraj";14;0;0;0;254022;350364;14;2022-05-26;350364
2022-05-25;"Žilinský kraj";24;101;3;104;NA;350364;27;2022-05-25;350350
2022-05-24;"Žilinský kraj";20;301;5;306;NA;350364;25;2022-05-24;350323
2022-05-23;"Žilinský kraj";29;364;9;373;NA;350364;38;2022-05-23;350298
2022-05-22;"Žilinský kraj";4;150;6;156;NA;350364;10;2022-05-22;350260
2022-05-21;"Žilinský kraj";13;91;0;91;NA;350364;13;2022-05-21;350250
2022-05-20;"Žilinský kraj";27;227;15;242;NA;350364;42;2022-05-20;350237
2022-05-19;"Žilinský kraj";22;324;7;331;NA;350364;29;2022-05-19;350195
2022-05-18;"Žilinský kraj";28;253;26;279;NA;350364;54;2022-05-18;350166
2022-05-17;"Žilinský kraj";46;288;11;299;NA;350364;57;2022-05-17;350112
2022-05-16;"Žilinský kraj";42;383;21;404;NA;350364;63;2022-05-16;350055
2022-05-15;"Žilinský kraj";1;128;7;135;NA;350364;8;2022-05-15;349992
2022-05-14;"Žilinský kraj";15;284;18;302;NA;350364;33;2022-05-14;349984
2022-05-13;"Žilinský kraj";40;385;26;411;NA;350364;66;2022-05-13;349951
2022-05-12;"Žilinský kraj";28;302;24;326;NA;350364;52;2022-05-12;349885
2022-05-11;"Žilinský kraj";41;501;24;525;NA;350364;65;2022-05-11;349833
2022-05-10;"Žilinský kraj";74;355;26;381;NA;350364;100;2022-05-10;349768
2022-05-09;"Žilinský kraj";52;515;49;564;NA;350364;101;2022-05-09;349668
2022-05-08;"Žilinský kraj";2;131;10;141;NA;350364;12;2022-05-08;349567
2022-05-07;"Žilinský kraj";27;257;27;284;NA;350364;54;2022-05-07;349555
2022-05-06;"Žilinský kraj";83;268;29;297;NA;350364;112;2022-05-06;349501
2022-05-05;"Žilinský kraj";55;527;30;557;NA;350364;85;2022-05-05;349389
2022-05-04;"Žilinský kraj";60;518;69;587;NA;350364;129;2022-05-04;349304
2022-05-03;"Žilinský kraj";108;537;34;571;NA;350364;142;2022-05-03;349175
2022-05-02;"Žilinský kraj";104;711;41;752;NA;350364;145;2022-05-02;349033
2022-05-01;"Žilinský kraj";15;124;9;133;NA;350364;24;2022-05-01;348888
2022-04-30;"Žilinský kraj";113;372;24;396;NA;350364;137;2022-04-30;348864
2022-04-29;"Žilinský kraj";127;842;29;871;NA;350364;156;2022-04-29;348727
2022-04-28;"Žilinský kraj";117;613;47;660;NA;350364;164;2022-04-28;348571
2022-04-27;"Žilinský kraj";125;874;16;890;NA;350364;141;2022-04-27;348407
2022-04-26;"Žilinský kraj";207;725;30;755;NA;350364;237;2022-04-26;348266
2022-04-25;"Žilinský kraj";218;1155;79;1234;NA;350364;297;2022-04-25;348029
2022-04-24;"Žilinský kraj";8;251;20;271;NA;350364;28;2022-04-24;347732
2022-04-23;"Žilinský kraj";212;391;22;413;NA;350364;234;2022-04-23;347704
2022-04-22;"Žilinský kraj";126;548;35;583;NA;350364;161;2022-04-22;347470
2022-04-21;"Žilinský kraj";218;781;63;844;NA;350364;281;2022-04-21;347309
2022-04-20;"Žilinský kraj";366;915;52;967;NA;350364;418;2022-04-20;347028
2022-04-19;"Žilinský kraj";346;1852;79;1931;NA;350364;425;2022-04-19;346610
2022-04-18;"Žilinský kraj";84;368;27;395;NA;350364;111;2022-04-18;346185
2022-04-17;"Žilinský kraj";157;175;13;188;NA;350364;170;2022-04-17;346074
2022-04-16;"Žilinský kraj";111;282;54;336;NA;350364;165;2022-04-16;345904
2022-04-15;"Žilinský kraj";43;223;11;234;NA;350364;54;2022-04-15;345739
2022-04-14;"Žilinský kraj";315;1195;53;1248;NA;350364;368;2022-04-14;345685
2022-04-13;"Žilinský kraj";331;1101;39;1140;NA;350364;370;2022-04-13;345317
2022-04-12;"Žilinský kraj";280;1079;42;1121;NA;350364;322;2022-04-12;344947
2022-04-11;"Žilinský kraj";453;1335;87;1422;NA;350364;540;2022-04-11;344625
2022-04-10;"Žilinský kraj";20;313;26;339;NA;350364;46;2022-04-10;344085
2022-04-09;"Žilinský kraj";233;261;38;299;NA;350364;271;2022-04-09;344039
2022-04-08;"Žilinský kraj";368;762;50;812;NA;350364;418;2022-04-08;343768
2022-04-07;"Žilinský kraj";359;797;54;851;NA;350364;413;2022-04-07;343350
2022-04-06;"Žilinský kraj";541;1030;69;1099;NA;350364;610;2022-04-06;342937
2022-04-05;"Žilinský kraj";699;1038;78;1116;NA;350364;777;2022-04-05;342327
2022-04-04;"Žilinský kraj";605;1340;110;1450;NA;350364;715;2022-04-04;341550
2022-04-03;"Žilinský kraj";82;268;34;302;NA;350364;116;2022-04-03;340835
2022-04-02;"Žilinský kraj";289;224;33;257;NA;350364;322;2022-04-02;340719
2022-04-01;"Žilinský kraj";592;943;60;1003;NA;350364;652;2022-04-01;340397
2022-03-31;"Žilinský kraj";557;863;92;955;NA;350364;649;2022-03-31;339745
2022-03-30;"Žilinský kraj";688;1644;102;1746;NA;350364;790;2022-03-30;339096
2022-03-29;"Žilinský kraj";755;917;103;1020;NA;350364;858;2022-03-29;338306
2022-03-28;"Žilinský kraj";825;1744;141;1885;NA;350364;966;2022-03-28;337448
2022-03-27;"Žilinský kraj";88;414;91;505;NA;350364;179;2022-03-27;336482
2022-03-26;"Žilinský kraj";586;224;53;277;NA;350364;639;2022-03-26;336303
2022-03-25;"Žilinský kraj";601;866;100;966;NA;350364;701;2022-03-25;335664
2022-03-24;"Žilinský kraj";697;1433;100;1533;NA;350364;797;2022-03-24;334963
2022-03-23;"Žilinský kraj";883;940;103;1043;NA;350364;986;2022-03-23;334166
2022-03-22;"Žilinský kraj";1102;2516;136;2652;NA;350364;1238;2022-03-22;333180
2022-03-21;"Žilinský kraj";969;1921;163;2084;NA;350364;1132;2022-03-21;331942
2022-03-20;"Žilinský kraj";157;438;88;526;NA;350364;245;2022-03-20;330810
2022-03-19;"Žilinský kraj";479;340;69;409;NA;350364;548;2022-03-19;330565
2022-03-18;"Žilinský kraj";864;773;119;892;NA;350364;983;2022-03-18;330017
2022-03-17;"Žilinský kraj";733;1120;154;1274;NA;350364;887;2022-03-17;329034
2022-03-16;"Žilinský kraj";995;1371;165;1536;NA;350364;1160;2022-03-16;328147
2022-03-15;"Žilinský kraj";1252;2522;215;2737;NA;350364;1467;2022-03-15;326987
2022-03-14;"Žilinský kraj";1138;1546;209;1755;NA;350364;1347;2022-03-14;325520
2022-03-13;"Žilinský kraj";226;522;112;634;NA;350364;338;2022-03-13;324173
2022-03-12;"Žilinský kraj";650;346;94;440;NA;350364;744;2022-03-12;323835
2022-03-11;"Žilinský kraj";824;1755;197;1952;NA;350364;1021;2022-03-11;323091
2022-03-10;"Žilinský kraj";1249;1519;169;1688;NA;350364;1418;2022-03-10;322070
2022-03-09;"Žilinský kraj";1713;1457;206;1663;NA;350364;1919;2022-03-09;320652
2022-03-08;"Žilinský kraj";699;2333;311;2644;NA;350364;1010;2022-03-08;318733
2022-03-07;"Žilinský kraj";1448;2225;300;2525;NA;350364;1748;2022-03-07;317723
2022-03-06;"Žilinský kraj";323;797;211;1008;NA;350364;534;2022-03-06;315975
2022-03-05;"Žilinský kraj";576;572;129;701;NA;350364;705;2022-03-05;315441
2022-03-04;"Žilinský kraj";1194;1884;264;2148;NA;350364;1458;2022-03-04;314736
2022-03-03;"Žilinský kraj";1240;1852;247;2099;NA;350364;1487;2022-03-03;313278
2022-03-02;"Žilinský kraj";1194;1798;250;2048;NA;350364;1444;2022-03-02;311791
2022-03-01;"Žilinský kraj";1710;2974;347;3321;NA;350364;2057;2022-03-01;310347
2022-02-28;"Žilinský kraj";1700;2980;355;3335;NA;350364;2055;2022-02-28;308290
2022-02-27;"Žilinský kraj";224;940;221;1161;NA;350364;445;2022-02-27;306235
2022-02-26;"Žilinský kraj";1184;816;171;987;NA;350364;1355;2022-02-26;305790
2022-02-25;"Žilinský kraj";1371;2421;320;2741;NA;350364;1691;2022-02-25;304435
2022-02-24;"Žilinský kraj";1504;2589;314;2903;NA;350364;1818;2022-02-24;302744
2022-02-23;"Žilinský kraj";1766;3298;333;3631;NA;350364;2099;2022-02-23;300926
2022-02-22;"Žilinský kraj";2419;3369;406;3775;NA;350364;2825;2022-02-22;298827
2022-02-21;"Žilinský kraj";2227;4183;573;4756;NA;350364;2800;2022-02-21;296002
2022-02-20;"Žilinský kraj";541;1473;304;1777;NA;350364;845;2022-02-20;293202
2022-02-19;"Žilinský kraj";1656;944;273;1217;NA;350364;1929;2022-02-19;292357
2022-02-18;"Žilinský kraj";1994;3339;439;3778;NA;350364;2433;2022-02-18;290428
2022-02-17;"Žilinský kraj";2274;3019;424;3443;NA;350364;2698;2022-02-17;287995
2022-02-16;"Žilinský kraj";2676;3579;496;4075;NA;350364;3172;2022-02-16;285297
2022-02-15;"Žilinský kraj";2939;4226;604;4830;NA;350364;3543;2022-02-15;282125
2022-02-14;"Žilinský kraj";2955;4182;777;4959;NA;350364;3732;2022-02-14;278582
2022-02-13;"Žilinský kraj";751;1842;464;2306;NA;350364;1215;2022-02-13;274850
2022-02-12;"Žilinský kraj";1771;1431;319;1750;NA;350364;2090;2022-02-12;273635
2022-02-11;"Žilinský kraj";2856;3332;570;3902;NA;350364;3426;2022-02-11;271545
2022-02-10;"Žilinský kraj";2861;3472;583;4055;NA;350364;3444;2022-02-10;268119
2022-02-09;"Žilinský kraj";3365;3863;618;4481;NA;350364;3983;2022-02-09;264675
2022-02-08;"Žilinský kraj";3367;4866;780;5646;NA;350364;4147;2022-02-08;260692
2022-02-07;"Žilinský kraj";3242;5569;913;6482;NA;350364;4155;2022-02-07;256545
2022-02-06;"Žilinský kraj";1389;2587;529;3116;NA;350364;1918;2022-02-06;252390
2022-02-05;"Žilinský kraj";2107;1846;425;2271;NA;350364;2532;2022-02-05;250472
2022-02-04;"Žilinský kraj";3099;4389;631;5020;NA;350364;3730;2022-02-04;247940
2022-02-03;"Žilinský kraj";3201;4122;613;4735;NA;350364;3814;2022-02-03;244210
2022-02-02;"Žilinský kraj";3168;4616;666;5282;NA;350364;3834;2022-02-02;240396
2022-02-01;"Žilinský kraj";3593;5240;694;5934;NA;350364;4287;2022-02-01;236562
2022-01-31;"Žilinský kraj";2145;7492;931;8423;NA;350364;3076;2022-01-31;232275
2022-01-30;"Žilinský kraj";1487;2898;431;3329;NA;350364;1918;2022-01-30;229199
2022-01-29;"Žilinský kraj";2055;2033;365;2398;NA;350364;2420;2022-01-29;227281
2022-01-28;"Žilinský kraj";2572;4800;546;5346;NA;350364;3118;2022-01-28;224861
2022-01-27;"Žilinský kraj";2406;4038;537;4575;NA;350364;2943;2022-01-27;221743
2022-01-26;"Žilinský kraj";2693;5009;516;5525;NA;350364;3209;2022-01-26;218800
2022-01-25;"Žilinský kraj";2595;5626;416;6042;NA;350364;3011;2022-01-25;215591
2022-01-24;"Žilinský kraj";1401;7098;522;7620;NA;350364;1923;2022-01-24;212580
2022-01-23;"Žilinský kraj";654;2923;276;3199;NA;350364;930;2022-01-23;210657
2022-01-22;"Žilinský kraj";1256;1706;206;1912;NA;350364;1462;2022-01-22;209727
2022-01-21;"Žilinský kraj";1188;4187;265;4452;NA;350364;1453;2022-01-21;208265
2022-01-20;"Žilinský kraj";1288;3654;205;3859;NA;350364;1493;2022-01-20;206812
2022-01-19;"Žilinský kraj";1215;4086;206;4292;NA;350364;1421;2022-01-19;205319
2022-01-18;"Žilinský kraj";1191;4213;168;4381;NA;350364;1359;2022-01-18;203898
2022-01-17;"Žilinský kraj";675;6886;256;7142;NA;350364;931;2022-01-17;202539
2022-01-16;"Žilinský kraj";175;2418;106;2524;NA;350364;281;2022-01-16;201608
2022-01-15;"Žilinský kraj";398;1410;70;1480;NA;350364;468;2022-01-15;201327
2022-01-14;"Žilinský kraj";446;3716;106;3822;NA;350364;552;2022-01-14;200859
2022-01-13;"Žilinský kraj";295;2912;78;2990;NA;350364;373;2022-01-13;200307
2022-01-12;"Žilinský kraj";422;3168;72;3240;NA;350364;494;2022-01-12;199934
2022-01-11;"Žilinský kraj";622;4216;57;4273;NA;350364;679;2022-01-11;199440
2022-01-10;"Žilinský kraj";436;6344;102;6446;NA;350364;538;2022-01-10;198761
2022-01-09;"Žilinský kraj";95;2934;54;2988;NA;350364;149;2022-01-09;198223
2022-01-08;"Žilinský kraj";345;1650;45;1695;NA;350364;390;2022-01-08;198074
2022-01-07;"Žilinský kraj";525;4566;75;4641;NA;350364;600;2022-01-07;197684
2022-01-06;"Žilinský kraj";167;1214;40;1254;NA;350364;207;2022-01-06;197084
2022-01-05;"Žilinský kraj";471;3492;75;3567;NA;350364;546;2022-01-05;196877
2022-01-04;"Žilinský kraj";606;3762;87;3849;NA;350364;693;2022-01-04;196331
2022-01-03;"Žilinský kraj";601;6083;116;6199;NA;350364;717;2022-01-03;195638
2022-01-02;"Žilinský kraj";288;2596;85;2681;NA;350364;373;2022-01-02;194921
2022-01-01;"Žilinský kraj";14;439;15;454;NA;350364;29;2022-01-01;194548
2021-12-31;"Žilinský kraj";323;1608;70;1678;NA;350364;393;2021-12-31;194519
2021-12-30;"Žilinský kraj";492;2213;95;2308;NA;350364;587;2021-12-30;194126
2021-12-29;"Žilinský kraj";543;6864;83;6947;NA;350364;626;2021-12-29;193539
2021-12-28;"Žilinský kraj";641;3408;106;3514;NA;350364;747;2021-12-28;192913
2021-12-27;"Žilinský kraj";691;3961;145;4106;NA;350364;836;2021-12-27;192166
2021-12-26;"Žilinský kraj";242;1167;58;1225;NA;350364;300;2021-12-26;191330
2021-12-25;"Žilinský kraj";22;442;45;487;NA;350364;67;2021-12-25;191030
2021-12-24;"Žilinský kraj";98;518;21;539;NA;350364;119;2021-12-24;190963
2021-12-23;"Žilinský kraj";731;2678;105;2783;NA;350364;836;2021-12-23;190844
2021-12-22;"Žilinský kraj";510;2428;77;2505;NA;350364;587;2021-12-22;190008
2021-12-21;"Žilinský kraj";755;3641;102;3743;NA;350364;857;2021-12-21;189421
2021-12-20;"Žilinský kraj";563;4545;125;4670;NA;350364;688;2021-12-20;188564
2021-12-19;"Žilinský kraj";133;2215;90;2305;NA;350364;223;2021-12-19;187876
2021-12-18;"Žilinský kraj";417;1321;70;1391;NA;350364;487;2021-12-18;187653
2021-12-17;"Žilinský kraj";604;3895;127;4022;NA;350364;731;2021-12-17;187166
2021-12-16;"Žilinský kraj";660;3931;109;4040;NA;350364;769;2021-12-16;186435
2021-12-15;"Žilinský kraj";802;3491;122;3613;NA;350364;924;2021-12-15;185666
2021-12-14;"Žilinský kraj";798;4587;129;4716;NA;350364;927;2021-12-14;184742
2021-12-13;"Žilinský kraj";759;7755;212;7967;NA;350364;971;2021-12-13;183815
2021-12-12;"Žilinský kraj";340;2836;114;2950;NA;350364;454;2021-12-12;182844
2021-12-11;"Žilinský kraj";761;1849;112;1961;NA;350364;873;2021-12-11;182390
2021-12-10;"Žilinský kraj";638;4041;136;4177;NA;350364;774;2021-12-10;181517
2021-12-09;"Žilinský kraj";870;5842;161;6003;NA;350364;1031;2021-12-09;180743
2021-12-08;"Žilinský kraj";1018;3215;158;3373;NA;350364;1176;2021-12-08;179712
2021-12-07;"Žilinský kraj";1356;5148;160;5308;NA;350364;1516;2021-12-07;178536
2021-12-06;"Žilinský kraj";919;7441;226;7667;NA;350364;1145;2021-12-06;177020
2021-12-05;"Žilinský kraj";505;3306;134;3440;NA;350364;639;2021-12-05;175875
2021-12-04;"Žilinský kraj";704;1892;153;2045;NA;350364;857;2021-12-04;175236
2021-12-03;"Žilinský kraj";1204;4864;215;5079;NA;350364;1419;2021-12-03;174379
2021-12-02;"Žilinský kraj";1847;4131;199;4330;NA;350364;2046;2021-12-02;172960
2021-12-01;"Žilinský kraj";1183;4073;195;4268;NA;350364;1378;2021-12-01;170914
2021-11-30;"Žilinský kraj";1575;5467;252;5719;NA;350364;1827;2021-11-30;169536
2021-11-29;"Žilinský kraj";1395;9069;358;9427;NA;350364;1753;2021-11-29;167709
2021-11-28;"Žilinský kraj";625;4581;235;4816;NA;350364;860;2021-11-28;165956
2021-11-27;"Žilinský kraj";909;2557;192;2749;NA;350364;1101;2021-11-27;165096
2021-11-26;"Žilinský kraj";1195;6599;344;6943;NA;350364;1539;2021-11-26;163995
2021-11-25;"Žilinský kraj";1281;4701;331;5032;NA;350364;1612;2021-11-25;162456
2021-11-24;"Žilinský kraj";1792;4660;324;4984;NA;350364;2116;2021-11-24;160844
2021-11-23;"Žilinský kraj";1630;4654;353;5007;NA;350364;1983;2021-11-23;158728
2021-11-22;"Žilinský kraj";1126;6699;452;7151;NA;350364;1578;2021-11-22;156745
2021-11-21;"Žilinský kraj";443;2865;260;3125;NA;350364;703;2021-11-21;155167
2021-11-20;"Žilinský kraj";963;2104;241;2345;NA;350364;1204;2021-11-20;154464
2021-11-19;"Žilinský kraj";1281;4622;434;5056;NA;350364;1715;2021-11-19;153260
2021-11-18;"Žilinský kraj";1220;4432;376;4808;NA;350364;1596;2021-11-18;151545
2021-11-17;"Žilinský kraj";1001;1434;149;1583;NA;350364;1150;2021-11-17;149949
2021-11-16;"Žilinský kraj";1197;4058;323;4381;NA;350364;1520;2021-11-16;148799
2021-11-15;"Žilinský kraj";977;5050;476;5526;NA;350364;1453;2021-11-15;147279
2021-11-14;"Žilinský kraj";356;2287;262;2549;NA;350364;618;2021-11-14;145826
2021-11-13;"Žilinský kraj";652;1882;220;2102;NA;350364;872;2021-11-13;145208
2021-11-12;"Žilinský kraj";1027;4291;340;4631;NA;350364;1367;2021-11-12;144336
2021-11-11;"Žilinský kraj";924;4192;272;4464;NA;350364;1196;2021-11-11;142969
2021-11-10;"Žilinský kraj";897;4509;305;4814;NA;350364;1202;2021-11-10;141773
2021-11-09;"Žilinský kraj";1440;4619;256;4875;NA;350364;1696;2021-11-09;140571
2021-11-08;"Žilinský kraj";781;4438;425;4863;NA;350364;1206;2021-11-08;138875
2021-11-07;"Žilinský kraj";304;2130;231;2361;NA;350364;535;2021-11-07;137669
2021-11-06;"Žilinský kraj";741;2150;201;2351;NA;350364;942;2021-11-06;137134
2021-11-05;"Žilinský kraj";1064;4067;235;4302;NA;350364;1299;2021-11-05;136192
2021-11-04;"Žilinský kraj";776;3709;232;3941;NA;350364;1008;2021-11-04;134893
2021-11-03;"Žilinský kraj";1106;5550;338;5888;NA;350364;1444;2021-11-03;133885
2021-11-02;"Žilinský kraj";1136;4451;333;4784;NA;350364;1469;2021-11-02;132441
2021-11-01;"Žilinský kraj";399;1456;137;1593;NA;350364;536;2021-11-01;130972
2021-10-31;"Žilinský kraj";344;1387;145;1532;NA;350364;489;2021-10-31;130436
2021-10-30;"Žilinský kraj";571;1944;161;2105;NA;350364;732;2021-10-30;129947
2021-10-29;"Žilinský kraj";733;3339;194;3533;NA;350364;927;2021-10-29;129215
2021-10-28;"Žilinský kraj";639;4953;247;5200;NA;350364;886;2021-10-28;128288
2021-10-27;"Žilinský kraj";739;3446;173;3619;NA;350364;912;2021-10-27;127402
2021-10-26;"Žilinský kraj";945;4748;216;4964;NA;350364;1161;2021-10-26;126490
2021-10-25;"Žilinský kraj";649;5736;271;6007;NA;350364;920;2021-10-25;125329
2021-10-24;"Žilinský kraj";248;1679;107;1786;NA;350364;355;2021-10-24;124409
2021-10-23;"Žilinský kraj";399;2415;149;2564;NA;350364;548;2021-10-23;124054
2021-10-22;"Žilinský kraj";587;3898;151;4049;NA;350364;738;2021-10-22;123506
2021-10-21;"Žilinský kraj";591;3367;162;3529;NA;350364;753;2021-10-21;122768
2021-10-20;"Žilinský kraj";479;3864;154;4018;NA;350364;633;2021-10-20;122015
2021-10-19;"Žilinský kraj";675;3763;161;3924;NA;350364;836;2021-10-19;121382
2021-10-18;"Žilinský kraj";432;5160;271;5431;NA;350364;703;2021-10-18;120546
2021-10-17;"Žilinský kraj";135;1769;101;1870;NA;350364;236;2021-10-17;119843
2021-10-16;"Žilinský kraj";273;2341;100;2441;NA;350364;373;2021-10-16;119607
2021-10-15;"Žilinský kraj";347;3859;146;4005;NA;350364;493;2021-10-15;119234
2021-10-14;"Žilinský kraj";419;3035;110;3145;NA;350364;529;2021-10-14;118741
2021-10-13;"Žilinský kraj";404;3427;112;3539;NA;350364;516;2021-10-13;118212
2021-10-12;"Žilinský kraj";589;4000;141;4141;NA;350364;730;2021-10-12;117696
2021-10-11;"Žilinský kraj";323;4501;154;4655;NA;350364;477;2021-10-11;116966
2021-10-10;"Žilinský kraj";113;1577;77;1654;NA;350364;190;2021-10-10;116489
2021-10-09;"Žilinský kraj";201;1565;57;1622;NA;350364;258;2021-10-09;116299
2021-10-08;"Žilinský kraj";265;4227;99;4326;NA;350364;364;2021-10-08;116041
2021-10-07;"Žilinský kraj";338;3384;113;3497;NA;350364;451;2021-10-07;115677
2021-10-06;"Žilinský kraj";313;3901;89;3990;NA;350364;402;2021-10-06;115226
2021-10-05;"Žilinský kraj";387;4031;122;4153;NA;350364;509;2021-10-05;114824
2021-10-04;"Žilinský kraj";297;4449;121;4570;NA;350364;418;2021-10-04;114315
2021-10-03;"Žilinský kraj";22;1596;63;1659;NA;350364;85;2021-10-03;113897
2021-10-02;"Žilinský kraj";209;1990;45;2035;NA;350364;254;2021-10-02;113812
2021-10-01;"Žilinský kraj";263;4047;104;4151;NA;350364;367;2021-10-01;113558
2021-09-30;"Žilinský kraj";248;3531;71;3602;NA;350364;319;2021-09-30;113191
2021-09-29;"Žilinský kraj";285;3577;82;3659;NA;350364;367;2021-09-29;112872
2021-09-28;"Žilinský kraj";272;3656;73;3729;NA;350364;345;2021-09-28;112505
2021-09-27;"Žilinský kraj";239;4418;152;4570;NA;350364;391;2021-09-27;112160
2021-09-26;"Žilinský kraj";17;1665;42;1707;NA;350364;59;2021-09-26;111769
2021-09-25;"Žilinský kraj";111;1711;50;1761;NA;350364;161;2021-09-25;111710
2021-09-24;"Žilinský kraj";199;6127;98;6225;NA;350364;297;2021-09-24;111549
2021-09-23;"Žilinský kraj";176;2629;74;2703;NA;350364;250;2021-09-23;111252
2021-09-22;"Žilinský kraj";185;2728;77;2805;NA;350364;262;2021-09-22;111002
2021-09-21;"Žilinský kraj";250;3123;78;3201;NA;350364;328;2021-09-21;110740
2021-09-20;"Žilinský kraj";244;3231;95;3326;NA;350364;339;2021-09-20;110412
2021-09-19;"Žilinský kraj";26;1579;37;1616;NA;350364;63;2021-09-19;110073
2021-09-18;"Žilinský kraj";87;1441;45;1486;NA;350364;132;2021-09-18;110010
2021-09-17;"Žilinský kraj";192;3351;56;3407;NA;350364;248;2021-09-17;109878
2021-09-16;"Žilinský kraj";164;2744;87;2831;NA;350364;251;2021-09-16;109630
2021-09-15;"Žilinský kraj";31;555;11;566;NA;350364;42;2021-09-15;109379
2021-09-14;"Žilinský kraj";155;3268;61;3329;NA;350364;216;2021-09-14;109337
2021-09-13;"Žilinský kraj";81;3250;75;3325;NA;350364;156;2021-09-13;109121
2021-09-12;"Žilinský kraj";9;1138;24;1162;NA;350364;33;2021-09-12;108965
2021-09-11;"Žilinský kraj";47;1322;21;1343;NA;350364;68;2021-09-11;108932
2021-09-10;"Žilinský kraj";66;2439;34;2473;NA;350364;100;2021-09-10;108864
2021-09-09;"Žilinský kraj";56;2352;18;2370;NA;350364;74;2021-09-09;108764
2021-09-08;"Žilinský kraj";68;1560;24;1584;NA;350364;92;2021-09-08;108690
2021-09-07;"Žilinský kraj";72;1806;27;1833;NA;350364;99;2021-09-07;108598
2021-09-06;"Žilinský kraj";31;2381;45;2426;NA;350364;76;2021-09-06;108499
2021-09-05;"Žilinský kraj";11;785;8;793;NA;350364;19;2021-09-05;108423
2021-09-04;"Žilinský kraj";24;1080;5;1085;NA;350364;29;2021-09-04;108404
2021-09-03;"Žilinský kraj";52;2047;28;2075;NA;350364;80;2021-09-03;108375
2021-09-02;"Žilinský kraj";30;1432;22;1454;NA;350364;52;2021-09-02;108295
2021-09-01;"Žilinský kraj";5;461;6;467;NA;350364;11;2021-09-01;108243
2021-08-31;"Žilinský kraj";32;1710;15;1725;NA;350364;47;2021-08-31;108232
2021-08-30;"Žilinský kraj";7;1801;4;1805;NA;350364;11;2021-08-30;108185
2021-08-29;"Žilinský kraj";8;631;5;636;NA;350364;13;2021-08-29;108174
2021-08-28;"Žilinský kraj";2;1005;1;1006;NA;350364;3;2021-08-28;108161
2021-08-27;"Žilinský kraj";13;1765;12;1777;NA;350364;25;2021-08-27;108158
2021-08-26;"Žilinský kraj";17;1636;7;1643;NA;350364;24;2021-08-26;108133
2021-08-25;"Žilinský kraj";9;1203;11;1214;NA;350364;20;2021-08-25;108109
2021-08-24;"Žilinský kraj";6;1395;9;1404;NA;350364;15;2021-08-24;108089
2021-08-23;"Žilinský kraj";11;1877;7;1884;NA;350364;18;2021-08-23;108074
2021-08-22;"Žilinský kraj";2;733;3;736;NA;350364;5;2021-08-22;108056
2021-08-21;"Žilinský kraj";6;1183;2;1185;NA;350364;8;2021-08-21;108051
2021-08-20;"Žilinský kraj";7;2284;5;2289;NA;350364;12;2021-08-20;108043
2021-08-19;"Žilinský kraj";6;1281;3;1284;NA;350364;9;2021-08-19;108031
2021-08-18;"Žilinský kraj";4;1331;7;1338;NA;350364;11;2021-08-18;108022
2021-08-17;"Žilinský kraj";9;1219;3;1222;NA;350364;12;2021-08-17;108011
2021-08-16;"Žilinský kraj";14;1696;5;1701;NA;350364;19;2021-08-16;107999
2021-08-15;"Žilinský kraj";1;880;2;882;NA;350364;3;2021-08-15;107980
2021-08-14;"Žilinský kraj";5;1197;0;1197;NA;350364;5;2021-08-14;107977
2021-08-13;"Žilinský kraj";6;1685;0;1685;NA;350364;6;2021-08-13;107972
2021-08-12;"Žilinský kraj";4;1105;1;1106;NA;350364;5;2021-08-12;107966
2021-08-11;"Žilinský kraj";13;1250;3;1253;NA;350364;16;2021-08-11;107961
2021-08-10;"Žilinský kraj";12;1292;3;1295;NA;350364;15;2021-08-10;107945
2021-08-09;"Žilinský kraj";9;1142;1;1143;NA;350364;10;2021-08-09;107930
2021-08-08;"Žilinský kraj";1;748;5;753;NA;350364;6;2021-08-08;107920
2021-08-07;"Žilinský kraj";7;1192;1;1193;NA;350364;8;2021-08-07;107914
2021-08-06;"Žilinský kraj";1;1347;0;1347;NA;350364;1;2021-08-06;107906
2021-08-05;"Žilinský kraj";7;1148;3;1151;NA;350364;10;2021-08-05;107905
2021-08-04;"Žilinský kraj";12;895;0;895;NA;350364;12;2021-08-04;107895
2021-08-03;"Žilinský kraj";11;918;0;918;NA;350364;11;2021-08-03;107883
2021-08-02;"Žilinský kraj";5;1513;1;1514;NA;350364;6;2021-08-02;107872
2021-08-01;"Žilinský kraj";0;679;2;681;NA;350364;2;2021-08-01;107866
2021-07-31;"Žilinský kraj";4;1114;0;1114;NA;350364;4;2021-07-31;107864
2021-07-30;"Žilinský kraj";3;1671;0;1671;NA;350364;3;2021-07-30;107860
2021-07-29;"Žilinský kraj";1;1299;0;1299;NA;350364;1;2021-07-29;107857
2021-07-28;"Žilinský kraj";4;901;0;901;NA;350364;4;2021-07-28;107856
2021-07-27;"Žilinský kraj";11;1378;0;1378;NA;350364;11;2021-07-27;107852
2021-07-26;"Žilinský kraj";1;1301;1;1302;NA;350364;2;2021-07-26;107841
2021-07-25;"Žilinský kraj";2;828;2;830;NA;350364;4;2021-07-25;107839
2021-07-24;"Žilinský kraj";2;1338;2;1340;NA;350364;4;2021-07-24;107835
2021-07-23;"Žilinský kraj";4;1750;0;1750;NA;350364;4;2021-07-23;107831
2021-07-22;"Žilinský kraj";2;1207;0;1207;NA;350364;2;2021-07-22;107827
2021-07-21;"Žilinský kraj";2;1021;0;1021;NA;350364;2;2021-07-21;107825
2021-07-20;"Žilinský kraj";4;1439;0;1439;NA;350364;4;2021-07-20;107823
2021-07-19;"Žilinský kraj";4;1763;1;1764;NA;350364;5;2021-07-19;107819
2021-07-18;"Žilinský kraj";0;854;1;855;NA;350364;1;2021-07-18;107814
2021-07-17;"Žilinský kraj";0;1350;0;1350;NA;350364;0;2021-07-17;107813
2021-07-16;"Žilinský kraj";2;1767;0;1767;NA;350364;2;2021-07-16;107813
2021-07-15;"Žilinský kraj";2;1577;0;1577;NA;350364;2;2021-07-15;107811
2021-07-14;"Žilinský kraj";5;1042;1;1043;NA;350364;6;2021-07-14;107809
2021-07-13;"Žilinský kraj";3;1709;1;1710;NA;350364;4;2021-07-13;107803
2021-07-12;"Žilinský kraj";3;1325;1;1326;NA;350364;4;2021-07-12;107799
2021-07-11;"Žilinský kraj";2;989;0;989;NA;350364;2;2021-07-11;107795
2021-07-10;"Žilinský kraj";1;1511;4;1515;NA;350364;5;2021-07-10;107793
2021-07-09;"Žilinský kraj";1;2208;1;2209;NA;350364;2;2021-07-09;107788
2021-07-08;"Žilinský kraj";6;1776;3;1779;NA;350364;9;2021-07-08;107786
2021-07-07;"Žilinský kraj";1;1585;3;1588;NA;350364;4;2021-07-07;107777
2021-07-06;"Žilinský kraj";4;1956;0;1956;NA;350364;4;2021-07-06;107773
2021-07-05;"Žilinský kraj";2;1031;1;1032;NA;350364;3;2021-07-05;107769
2021-07-04;"Žilinský kraj";0;1003;0;1003;NA;350364;0;2021-07-04;107766
2021-07-03;"Žilinský kraj";1;1696;2;1698;NA;350364;3;2021-07-03;107766
2021-07-02;"Žilinský kraj";0;3356;2;3358;NA;350364;2;2021-07-02;107763
2021-07-01;"Žilinský kraj";1;1118;0;1118;NA;350364;1;2021-07-01;107761
2021-06-30;"Žilinský kraj";1;10464;6;10470;NA;350364;7;2021-06-30;107760
2021-06-29;"Žilinský kraj";10;5946;0;5946;NA;350364;10;2021-06-29;107753
2021-06-28;"Žilinský kraj";4;6245;2;6247;NA;350364;6;2021-06-28;107743
2021-06-27;"Žilinský kraj";3;4702;1;4703;NA;350364;4;2021-06-27;107737
2021-06-26;"Žilinský kraj";4;5919;0;5919;NA;350364;4;2021-06-26;107733
2021-06-25;"Žilinský kraj";8;9756;5;9761;NA;350364;13;2021-06-25;107729
2021-06-24;"Žilinský kraj";6;5657;3;5660;NA;350364;9;2021-06-24;107716
2021-06-23;"Žilinský kraj";7;5955;10;5965;NA;350364;17;2021-06-23;107707
2021-06-22;"Žilinský kraj";6;5214;8;5222;NA;350364;14;2021-06-22;107690
2021-06-21;"Žilinský kraj";6;6287;8;6295;NA;350364;14;2021-06-21;107676
2021-06-20;"Žilinský kraj";1;5531;8;5539;NA;350364;9;2021-06-20;107662
2021-06-19;"Žilinský kraj";9;8353;2;8355;NA;350364;11;2021-06-19;107653
2021-06-18;"Žilinský kraj";11;10624;12;10636;NA;350364;23;2021-06-18;107642
2021-06-17;"Žilinský kraj";10;6092;12;6104;NA;350364;22;2021-06-17;107619
2021-06-16;"Žilinský kraj";17;5786;11;5797;NA;350364;28;2021-06-16;107597
2021-06-15;"Žilinský kraj";13;5996;13;6009;NA;350364;26;2021-06-15;107569
2021-06-14;"Žilinský kraj";10;7596;21;7617;NA;350364;31;2021-06-14;107543
2021-06-13;"Žilinský kraj";2;6682;9;6691;NA;350364;11;2021-06-13;107512
2021-06-12;"Žilinský kraj";9;8634;11;8645;NA;350364;20;2021-06-12;107501
2021-06-11;"Žilinský kraj";11;11566;14;11580;NA;350364;25;2021-06-11;107481
2021-06-10;"Žilinský kraj";14;6788;14;6802;NA;350364;28;2021-06-10;107456
2021-06-09;"Žilinský kraj";23;5925;14;5939;NA;350364;37;2021-06-09;107428
2021-06-08;"Žilinský kraj";18;6615;16;6631;NA;350364;34;2021-06-08;107391
2021-06-07;"Žilinský kraj";25;8534;21;8555;NA;350364;46;2021-06-07;107357
2021-06-06;"Žilinský kraj";10;8056;27;8083;NA;350364;37;2021-06-06;107311
2021-06-05;"Žilinský kraj";8;9175;10;9185;NA;350364;18;2021-06-05;107274
2021-06-04;"Žilinský kraj";19;12260;34;12294;NA;350364;53;2021-06-04;107256
2021-06-03;"Žilinský kraj";12;7033;33;7066;NA;350364;45;2021-06-03;107203
2021-06-02;"Žilinský kraj";17;7103;28;7131;NA;350364;45;2021-06-02;107158
2021-06-01;"Žilinský kraj";38;8285;46;8331;NA;350364;84;2021-06-01;107113
2021-05-31;"Žilinský kraj";31;9616;59;9675;NA;350364;90;2021-05-31;107029
2021-05-30;"Žilinský kraj";21;9025;35;9060;NA;350364;56;2021-05-30;106939
2021-05-29;"Žilinský kraj";13;11195;23;11218;NA;350364;36;2021-05-29;106883
2021-05-28;"Žilinský kraj";28;13277;30;13307;NA;350364;58;2021-05-28;106847
2021-05-27;"Žilinský kraj";17;8267;39;8306;NA;350364;56;2021-05-27;106789
2021-05-26;"Žilinský kraj";20;8329;25;8354;NA;350364;45;2021-05-26;106733
2021-05-25;"Žilinský kraj";21;9624;38;9662;NA;350364;59;2021-05-25;106688
2021-05-24;"Žilinský kraj";36;11487;57;11544;NA;350364;93;2021-05-24;106629
2021-05-23;"Žilinský kraj";4;10923;56;10979;NA;350364;60;2021-05-23;106536
2021-05-22;"Žilinský kraj";21;11893;28;11921;NA;350364;49;2021-05-22;106476
2021-05-21;"Žilinský kraj";28;15654;50;15704;NA;350364;78;2021-05-21;106427
2021-05-20;"Žilinský kraj";30;9616;30;9646;NA;350364;60;2021-05-20;106349
2021-05-19;"Žilinský kraj";46;8693;41;8734;NA;350364;87;2021-05-19;106289
2021-05-18;"Žilinský kraj";52;10609;44;10653;NA;350364;96;2021-05-18;106202
2021-05-17;"Žilinský kraj";51;12676;84;12760;NA;350364;135;2021-05-17;106106
2021-05-16;"Žilinský kraj";13;14114;42;14156;NA;350364;55;2021-05-16;105971
2021-05-15;"Žilinský kraj";30;18404;35;18439;NA;350364;65;2021-05-15;105916
2021-05-14;"Žilinský kraj";34;21205;82;21287;NA;350364;116;2021-05-14;105851
2021-05-13;"Žilinský kraj";64;11865;51;11916;NA;350364;115;2021-05-13;105735
2021-05-12;"Žilinský kraj";57;10337;51;10388;NA;350364;108;2021-05-12;105620
2021-05-11;"Žilinský kraj";70;12174;51;12225;NA;350364;121;2021-05-11;105512
2021-05-10;"Žilinský kraj";69;16182;72;16254;NA;350364;141;2021-05-10;105391
2021-05-09;"Žilinský kraj";58;20385;77;20462;NA;350364;135;2021-05-09;105250
2021-05-08;"Žilinský kraj";0;24133;63;24196;NA;350364;63;2021-05-08;105115
2021-05-07;"Žilinský kraj";65;26522;87;26609;NA;350364;152;2021-05-07;105052
2021-05-06;"Žilinský kraj";67;16615;72;16687;NA;350364;139;2021-05-06;104900
2021-05-05;"Žilinský kraj";71;13096;73;13169;NA;350364;144;2021-05-05;104761
2021-05-04;"Žilinský kraj";81;16749;80;16829;NA;350364;161;2021-05-04;104617
2021-05-03;"Žilinský kraj";97;20391;111;20502;NA;350364;208;2021-05-03;104456
2021-05-02;"Žilinský kraj";8;28886;64;28950;NA;350364;72;2021-05-02;104248
2021-05-01;"Žilinský kraj";65;55053;105;55158;NA;350364;170;2021-05-01;104176
2021-04-30;"Žilinský kraj";84;44000;117;44117;NA;350364;201;2021-04-30;104006
2021-04-29;"Žilinský kraj";77;24566;101;24667;NA;350364;178;2021-04-29;103805
2021-04-28;"Žilinský kraj";76;19214;91;19305;NA;350364;167;2021-04-28;103627
2021-04-27;"Žilinský kraj";97;21805;110;21915;NA;350364;207;2021-04-27;103460
2021-04-26;"Žilinský kraj";114;27412;136;27548;NA;350364;250;2021-04-26;103253
2021-04-25;"Žilinský kraj";38;35750;82;35832;NA;350364;120;2021-04-25;103003
2021-04-24;"Žilinský kraj";93;78854;157;79011;NA;350364;250;2021-04-24;102883
2021-04-23;"Žilinský kraj";144;49440;153;49593;NA;350364;297;2021-04-23;102633
2021-04-22;"Žilinský kraj";110;25247;132;25379;NA;350364;242;2021-04-22;102336
2021-04-21;"Žilinský kraj";118;20616;145;20761;NA;350364;263;2021-04-21;102094
2021-04-20;"Žilinský kraj";128;23873;136;24009;NA;350364;264;2021-04-20;101831
2021-04-19;"Žilinský kraj";164;32773;210;32983;NA;350364;374;2021-04-19;101567
2021-04-18;"Žilinský kraj";18;36767;91;36858;NA;350364;109;2021-04-18;101193
2021-04-17;"Žilinský kraj";108;89377;156;89533;NA;350364;264;2021-04-17;101084
2021-04-16;"Žilinský kraj";185;47847;208;48055;NA;350364;393;2021-04-16;100820
2021-04-15;"Žilinský kraj";108;24830;130;24960;NA;350364;238;2021-04-15;100427
2021-04-14;"Žilinský kraj";135;23145;145;23290;NA;350364;280;2021-04-14;100189
2021-04-13;"Žilinský kraj";171;25050;135;25185;NA;350364;306;2021-04-13;99909
2021-04-12;"Žilinský kraj";266;30794;189;30983;NA;350364;455;2021-04-12;99603
2021-04-11;"Žilinský kraj";19;37126;107;37233;NA;350364;126;2021-04-11;99148
2021-04-10;"Žilinský kraj";111;86284;237;86521;NA;350364;348;2021-04-10;99022
2021-04-09;"Žilinský kraj";195;41973;206;42179;NA;350364;401;2021-04-09;98674
2021-04-08;"Žilinský kraj";179;24434;141;24575;NA;350364;320;2021-04-08;98273
2021-04-07;"Žilinský kraj";309;28651;174;28825;NA;350364;483;2021-04-07;97953
2021-04-06;"Žilinský kraj";308;40107;301;40408;NA;350364;609;2021-04-06;97470
2021-04-05;"Žilinský kraj";17;14747;140;14887;NA;350364;157;2021-04-05;96861
2021-04-04;"Žilinský kraj";17;16284;69;16353;NA;350364;86;2021-04-04;96704
2021-04-03;"Žilinský kraj";180;100699;403;101102;NA;350364;583;2021-04-03;96618
2021-04-02;"Žilinský kraj";73;22411;83;22494;NA;350364;156;2021-04-02;96035
2021-04-01;"Žilinský kraj";334;43264;240;43504;NA;350364;574;2021-04-01;95879
2021-03-31;"Žilinský kraj";170;31635;247;31882;NA;350364;417;2021-03-31;95305
2021-03-30;"Žilinský kraj";406;26323;243;26566;NA;350364;649;2021-03-30;94888
2021-03-29;"Žilinský kraj";297;28029;268;28297;NA;350364;565;2021-03-29;94239
2021-03-28;"Žilinský kraj";21;36206;239;36445;NA;350364;260;2021-03-28;93674
2021-03-27;"Žilinský kraj";151;89107;353;89460;NA;350364;504;2021-03-27;93414
2021-03-26;"Žilinský kraj";312;51757;330;52087;NA;350364;642;2021-03-26;92910
2021-03-25;"Žilinský kraj";281;27619;214;27833;NA;350364;495;2021-03-25;92268
2021-03-24;"Žilinský kraj";280;21268;260;21528;NA;350364;540;2021-03-24;91773
2021-03-23;"Žilinský kraj";418;23193;278;23471;NA;350364;696;2021-03-23;91233
2021-03-22;"Žilinský kraj";293;29289;314;29603;NA;350364;607;2021-03-22;90537
2021-03-21;"Žilinský kraj";32;33705;227;33932;NA;350364;259;2021-03-21;89930
2021-03-20;"Žilinský kraj";165;93015;497;93512;NA;350364;662;2021-03-20;89671
2021-03-19;"Žilinský kraj";357;51988;414;52402;NA;350364;771;2021-03-19;89009
2021-03-18;"Žilinský kraj";329;28459;294;28753;NA;350364;623;2021-03-18;88238
2021-03-17;"Žilinský kraj";395;21919;269;22188;NA;350364;664;2021-03-17;87615
2021-03-16;"Žilinský kraj";514;24341;317;24658;NA;350364;831;2021-03-16;86951
2021-03-15;"Žilinský kraj";341;29613;419;30032;NA;350364;760;2021-03-15;86120
2021-03-14;"Žilinský kraj";87;34121;267;34388;NA;350364;354;2021-03-14;85360
2021-03-13;"Žilinský kraj";113;93386;581;93967;NA;350364;694;2021-03-13;85006
2021-03-12;"Žilinský kraj";520;52329;411;52740;NA;350364;931;2021-03-12;84312
2021-03-11;"Žilinský kraj";399;28189;302;28491;NA;350364;701;2021-03-11;83381
2021-03-10;"Žilinský kraj";368;22414;378;22792;NA;350364;746;2021-03-10;82680
2021-03-09;"Žilinský kraj";537;24857;316;25173;NA;350364;853;2021-03-09;81934
2021-03-08;"Žilinský kraj";387;30873;458;31331;NA;350364;845;2021-03-08;81081
2021-03-07;"Žilinský kraj";48;33469;290;33759;NA;350364;338;2021-03-07;80236
2021-03-06;"Žilinský kraj";173;92410;589;92999;NA;350364;762;2021-03-06;79898
2021-03-05;"Žilinský kraj";369;51987;484;52471;NA;350364;853;2021-03-05;79136
2021-03-04;"Žilinský kraj";467;30037;377;30414;NA;350364;844;2021-03-04;78283
2021-03-03;"Žilinský kraj";448;26261;394;26655;NA;350364;842;2021-03-03;77439
2021-03-02;"Žilinský kraj";551;25913;378;26291;NA;350364;929;2021-03-02;76597
2021-03-01;"Žilinský kraj";375;30498;441;30939;NA;350364;816;2021-03-01;75668
2021-02-28;"Žilinský kraj";61;34802;327;35129;NA;350364;388;2021-02-28;74852
2021-02-27;"Žilinský kraj";159;83781;639;84420;NA;350364;798;2021-02-27;74464
2021-02-26;"Žilinský kraj";459;47500;508;48008;NA;350364;967;2021-02-26;73666
2021-02-25;"Žilinský kraj";347;30879;393;31272;NA;350364;740;2021-02-25;72699
2021-02-24;"Žilinský kraj";339;18760;395;19155;NA;350364;734;2021-02-24;71959
2021-02-23;"Žilinský kraj";437;22172;418;22590;NA;350364;855;2021-02-23;71225
2021-02-22;"Žilinský kraj";345;29270;438;29708;NA;350364;783;2021-02-22;70370
2021-02-21;"Žilinský kraj";36;28686;322;29008;NA;350364;358;2021-02-21;69587
2021-02-20;"Žilinský kraj";152;89944;671;90615;NA;350364;823;2021-02-20;69229
2021-02-19;"Žilinský kraj";337;45541;417;45958;NA;350364;754;2021-02-19;68406
2021-02-18;"Žilinský kraj";263;24662;337;24999;NA;350364;600;2021-02-18;67652
2021-02-17;"Žilinský kraj";269;17932;355;18287;NA;350364;624;2021-02-17;67052
2021-02-16;"Žilinský kraj";321;24298;325;24623;NA;350364;646;2021-02-16;66428
2021-02-15;"Žilinský kraj";230;30420;311;30731;NA;350364;541;2021-02-15;65782
2021-02-14;"Žilinský kraj";30;28723;231;28954;NA;350364;261;2021-02-14;65241
2021-02-13;"Žilinský kraj";91;69638;453;70091;NA;350364;544;2021-02-13;64980
2021-02-12;"Žilinský kraj";242;43338;336;43674;NA;350364;578;2021-02-12;64436
2021-02-11;"Žilinský kraj";228;23521;300;23821;NA;350364;528;2021-02-11;63858
2021-02-10;"Žilinský kraj";259;17894;267;18161;NA;350364;526;2021-02-10;63330
2021-02-09;"Žilinský kraj";377;24784;274;25058;NA;350364;651;2021-02-09;62804
2021-02-08;"Žilinský kraj";160;41375;390;41765;NA;350364;550;2021-02-08;62153
2021-02-07;"Žilinský kraj";24;46446;252;46698;NA;350364;276;2021-02-07;61603
2021-02-06;"Žilinský kraj";71;72880;367;73247;NA;350364;438;2021-02-06;61327
2021-02-05;"Žilinský kraj";248;31869;323;32192;NA;350364;571;2021-02-05;60889
2021-02-04;"Žilinský kraj";238;13240;258;13498;NA;350364;496;2021-02-04;60318
2021-02-03;"Žilinský kraj";194;9186;255;9441;NA;350364;449;2021-02-03;59822
2021-02-02;"Žilinský kraj";216;9280;272;9552;NA;350364;488;2021-02-02;59373
2021-02-01;"Žilinský kraj";220;19690;370;20060;NA;350364;590;2021-02-01;58885
2021-01-31;"Žilinský kraj";11;2652;27;2679;NA;350364;38;2021-01-31;58295
2021-01-30;"Žilinský kraj";85;18447;187;18634;NA;350364;272;2021-01-30;58257
2021-01-29;"Žilinský kraj";209;22891;304;23195;NA;350364;513;2021-01-29;57985
2021-01-28;"Žilinský kraj";240;5533;172;5705;NA;350364;412;2021-01-28;57472
2021-01-27;"Žilinský kraj";256;6725;119;6844;NA;350364;375;2021-01-27;57060
2021-01-26;"Žilinský kraj";245;49781;348;50129;NA;350364;593;2021-01-26;56685
2021-01-25;"Žilinský kraj";159;21245;150;21395;NA;350364;309;2021-01-25;56092
2021-01-24;"Žilinský kraj";22;55835;268;56103;NA;350364;290;2021-01-24;55783
2021-01-23;"Žilinský kraj";91;101730;444;102174;NA;350364;535;2021-01-23;55493
2021-01-22;"Žilinský kraj";163;32160;237;32397;NA;350364;400;2021-01-22;54958
2021-01-21;"Žilinský kraj";116;19828;181;20009;NA;350364;297;2021-01-21;54558
2021-01-20;"Žilinský kraj";236;17126;159;17285;NA;350364;395;2021-01-20;54261
2021-01-19;"Žilinský kraj";245;15730;285;16015;NA;350364;530;2021-01-19;53866
2021-01-18;"Žilinský kraj";236;12685;326;13011;NA;350364;562;2021-01-18;53336
2021-01-17;"Žilinský kraj";95;147;8;155;NA;350364;103;2021-01-17;52774
2021-01-16;"Žilinský kraj";14;516;31;547;NA;350364;45;2021-01-16;52671
2021-01-15;"Žilinský kraj";248;7486;209;7695;NA;350364;457;2021-01-15;52626
2021-01-14;"Žilinský kraj";166;5319;239;5558;NA;350364;405;2021-01-14;52169
2021-01-13;"Žilinský kraj";247;11263;557;11820;NA;350364;804;2021-01-13;51764
2021-01-12;"Žilinský kraj";376;8410;385;8795;NA;350364;761;2021-01-12;50960
2021-01-11;"Žilinský kraj";351;10058;465;10523;NA;350364;816;2021-01-11;50199
2021-01-10;"Žilinský kraj";38;229;6;235;NA;350364;44;2021-01-10;49383
2021-01-09;"Žilinský kraj";192;1282;60;1342;NA;350364;252;2021-01-09;49339
2021-01-08;"Žilinský kraj";413;8721;462;9183;NA;350364;875;2021-01-08;49087
2021-01-07;"Žilinský kraj";438;23407;1872;25279;NA;350364;2310;2021-01-07;48212
2021-01-06;"Žilinský kraj";145;1076;67;1143;NA;350364;212;2021-01-06;45902
2021-01-05;"Žilinský kraj";717;10227;796;11023;NA;350364;1513;2021-01-05;45690
2021-01-04;"Žilinský kraj";479;9313;893;10206;NA;350364;1372;2021-01-04;44177
2021-01-03;"Žilinský kraj";13;1006;107;1113;NA;350364;120;2021-01-03;42805
2021-01-02;"Žilinský kraj";98;789;91;880;NA;350364;189;2021-01-02;42685
2021-01-01;"Žilinský kraj";118;241;13;254;NA;350364;131;2021-01-01;42496
2020-12-31;"Žilinský kraj";395;9626;784;10410;NA;350364;1179;2020-12-31;42365
2020-12-30;"Žilinský kraj";1038;11781;823;12604;NA;350364;1861;2020-12-30;41186
2020-12-29;"Žilinský kraj";256;10159;979;11138;NA;350364;1235;2020-12-29;39325
2020-12-28;"Žilinský kraj";406;10704;976;11680;NA;350364;1382;2020-12-28;38090
2020-12-27;"Žilinský kraj";40;684;94;778;NA;350364;134;2020-12-27;36708
2020-12-26;"Žilinský kraj";135;593;48;641;NA;350364;183;2020-12-26;36574
2020-12-25;"Žilinský kraj";66;83;9;92;NA;350364;75;2020-12-25;36391
2020-12-24;"Žilinský kraj";643;667;55;722;NA;350364;698;2020-12-24;36316
2020-12-23;"Žilinský kraj";228;16229;975;17204;NA;350364;1203;2020-12-23;35618
2020-12-22;"Žilinský kraj";519;13483;988;14471;NA;350364;1507;2020-12-22;34415
2020-12-21;"Žilinský kraj";444;12429;1078;13507;NA;350364;1522;2020-12-21;32908
2020-12-20;"Žilinský kraj";36;598;80;678;NA;350364;116;2020-12-20;31386
2020-12-19;"Žilinský kraj";208;1678;127;1805;NA;350364;335;2020-12-19;31270
2020-12-18;"Žilinský kraj";333;6553;370;6923;NA;350364;703;2020-12-18;30935
2020-12-17;"Žilinský kraj";500;3922;262;4184;NA;350364;762;2020-12-17;30232
2020-12-16;"Žilinský kraj";333;3815;267;4082;NA;350364;600;2020-12-16;29470
2020-12-15;"Žilinský kraj";528;3729;340;4069;NA;350364;868;2020-12-15;28870
2020-12-14;"Žilinský kraj";321;3884;309;4193;NA;350364;630;2020-12-14;28002
2020-12-13;"Žilinský kraj";26;494;66;560;NA;350364;92;2020-12-13;27372
2020-12-12;"Žilinský kraj";95;767;46;813;NA;350364;141;2020-12-12;27280
2020-12-11;"Žilinský kraj";455;3938;227;4165;NA;350364;682;2020-12-11;27139
2020-12-10;"Žilinský kraj";166;9129;838;9967;NA;350364;1004;2020-12-10;26457
2020-12-09;"Žilinský kraj";392;2169;132;2301;NA;350364;524;2020-12-09;25453
2020-12-08;"Žilinský kraj";331;3127;101;3228;NA;350364;432;2020-12-08;24929
2020-12-07;"Žilinský kraj";348;2746;162;2908;NA;350364;510;2020-12-07;24497
2020-12-06;"Žilinský kraj";15;128;6;134;NA;350364;21;2020-12-06;23987
2020-12-05;"Žilinský kraj";98;781;41;822;NA;350364;139;2020-12-05;23966
2020-12-04;"Žilinský kraj";228;3091;107;3198;NA;350364;335;2020-12-04;23827
2020-12-03;"Žilinský kraj";237;1609;115;1724;NA;350364;352;2020-12-03;23492
2020-12-02;"Žilinský kraj";181;1710;94;1804;NA;350364;275;2020-12-02;23140
2020-12-01;"Žilinský kraj";209;6239;284;6523;NA;350364;493;2020-12-01;22865
2020-11-30;"Žilinský kraj";203;5326;305;5631;NA;350364;508;2020-11-30;22372
2020-11-29;"Žilinský kraj";18;81;7;88;NA;350364;25;2020-11-29;21864
2020-11-28;"Žilinský kraj";99;349;15;364;NA;350364;114;2020-11-28;21839
2020-11-27;"Žilinský kraj";218;904;46;950;NA;350364;264;2020-11-27;21725
2020-11-26;"Žilinský kraj";190;1041;54;1095;NA;350364;244;2020-11-26;21461
2020-11-25;"Žilinský kraj";225;1217;49;1266;NA;350364;274;2020-11-25;21217
2020-11-24;"Žilinský kraj";213;2139;67;2206;NA;350364;280;2020-11-24;20943
2020-11-23;"Žilinský kraj";170;759;44;803;NA;350364;214;2020-11-23;20663
2020-11-22;"Žilinský kraj";11;67;2;69;NA;350364;13;2020-11-22;20449
2020-11-21;"Žilinský kraj";61;505;20;525;NA;350364;81;2020-11-21;20436
2020-11-20;"Žilinský kraj";251;1074;45;1119;NA;350364;296;2020-11-20;20355
2020-11-19;"Žilinský kraj";252;752;61;813;NA;350364;313;2020-11-19;20059
2020-11-18;"Žilinský kraj";346;348;15;363;NA;350364;361;2020-11-18;19746
2020-11-17;"Žilinský kraj";123;490;15;505;NA;350364;138;2020-11-17;19385
2020-11-16;"Žilinský kraj";227;247;15;262;NA;350364;242;2020-11-16;19247
2020-11-15;"Žilinský kraj";63;13;0;13;NA;350364;63;2020-11-15;19005
2020-11-14;"Žilinský kraj";189;1038;11;1049;NA;350364;200;2020-11-14;18942
2020-11-13;"Žilinský kraj";181;125;9;134;NA;350364;190;2020-11-13;18742
2020-11-12;"Žilinský kraj";334;79;2;81;NA;350364;336;2020-11-12;18552
2020-11-11;"Žilinský kraj";489;147;10;157;NA;350364;499;2020-11-11;18216
2020-11-10;"Žilinský kraj";374;519;9;528;NA;350364;383;2020-11-10;17717
2020-11-09;"Žilinský kraj";143;2335;30;2365;NA;350364;173;2020-11-09;17334
2020-11-08;"Žilinský kraj";59;2538;37;2575;NA;350364;96;2020-11-08;17161
2020-11-07;"Žilinský kraj";312;8175;88;8263;NA;350364;400;2020-11-07;17065
2020-11-06;"Žilinský kraj";503;4090;38;4128;NA;350364;541;2020-11-06;16665
2020-11-05;"Žilinský kraj";473;64;4;68;NA;350364;477;2020-11-05;16124
2020-11-04;"Žilinský kraj";423;178;10;188;NA;350364;433;2020-11-04;15647
2020-11-03;"Žilinský kraj";688;889;16;905;NA;350364;704;2020-11-03;15214
2020-11-02;"Žilinský kraj";472;1043;39;1082;NA;350364;511;2020-11-02;14510
2020-11-01;"Žilinský kraj";349;5096;130;5226;NA;350364;479;2020-11-01;13999
2020-10-31;"Žilinský kraj";661;7963;203;8166;NA;350364;864;2020-10-31;13520
2020-10-30;"Žilinský kraj";529;2575;61;2636;NA;350364;590;2020-10-30;12656
2020-10-29;"Žilinský kraj";740;503;17;520;NA;350364;757;2020-10-29;12066
2020-10-28;"Žilinský kraj";635;105;11;116;NA;350364;646;2020-10-28;11309
2020-10-27;"Žilinský kraj";355;154;24;178;NA;350364;379;2020-10-27;10663
2020-10-26;"Žilinský kraj";148;117;28;145;NA;350364;176;2020-10-26;10284
2020-10-25;"Žilinský kraj";436;0;0;0;NA;350364;436;2020-10-25;10108
2020-10-24;"Žilinský kraj";803;0;0;0;NA;350364;803;2020-10-24;9672
2020-10-23;"Žilinský kraj";659;102;13;115;NA;350364;672;2020-10-23;8869
2020-10-22;"Žilinský kraj";525;33;3;36;NA;350364;528;2020-10-22;8197
2020-10-21;"Žilinský kraj";478;74;14;88;NA;350364;492;2020-10-21;7669
2020-10-20;"Žilinský kraj";524;127;8;135;NA;350364;532;2020-10-20;7177
2020-10-19;"Žilinský kraj";70;80;12;92;NA;350364;82;2020-10-19;6645
2020-10-18;"Žilinský kraj";159;0;0;0;NA;350364;159;2020-10-18;6563
2020-10-17;"Žilinský kraj";509;0;0;0;NA;350364;509;2020-10-17;6404
2020-10-16;"Žilinský kraj";603;51;9;60;NA;350364;612;2020-10-16;5895
2020-10-15;"Žilinský kraj";679;61;3;64;NA;350364;682;2020-10-15;5283
2020-10-14;"Žilinský kraj";523;269;6;275;NA;350364;529;2020-10-14;4601
2020-10-13;"Žilinský kraj";367;458;40;498;NA;350364;407;2020-10-13;4072
2020-10-12;"Žilinský kraj";62;0;0;0;NA;350364;62;2020-10-12;3665
2020-10-11;"Žilinský kraj";50;0;0;0;NA;350364;50;2020-10-11;3603
2020-10-10;"Žilinský kraj";213;0;0;0;NA;350364;213;2020-10-10;3553
2020-10-09;"Žilinský kraj";543;0;0;0;NA;350364;543;2020-10-09;3340
2020-10-08;"Žilinský kraj";238;0;0;0;NA;350364;238;2020-10-08;2797
2020-10-07;"Žilinský kraj";168;0;0;0;NA;350364;168;2020-10-07;2559
2020-10-06;"Žilinský kraj";233;0;0;0;NA;350364;233;2020-10-06;2391
2020-10-05;"Žilinský kraj";33;0;0;0;NA;350364;33;2020-10-05;2158
2020-10-04;"Žilinský kraj";35;0;0;0;NA;350364;35;2020-10-04;2125
2020-10-03;"Žilinský kraj";155;0;0;0;NA;350364;155;2020-10-03;2090
2020-10-02;"Žilinský kraj";105;0;0;0;NA;350364;105;2020-10-02;1935
2020-10-01;"Žilinský kraj";147;0;0;0;NA;350364;147;2020-10-01;1830
2020-09-30;"Žilinský kraj";163;0;0;0;NA;350364;163;2020-09-30;1683
2020-09-29;"Žilinský kraj";105;0;0;0;NA;350364;105;2020-09-29;1520
2020-09-28;"Žilinský kraj";34;0;0;0;NA;350364;34;2020-09-28;1415
2020-09-27;"Žilinský kraj";108;0;0;0;NA;350364;108;2020-09-27;1381
2020-09-26;"Žilinský kraj";96;0;0;0;NA;350364;96;2020-09-26;1273
2020-09-25;"Žilinský kraj";69;0;0;0;NA;350364;69;2020-09-25;1177
2020-09-24;"Žilinský kraj";100;0;0;0;NA;350364;100;2020-09-24;1108
2020-09-23;"Žilinský kraj";65;0;0;0;NA;350364;65;2020-09-23;1008
2020-09-22;"Žilinský kraj";65;0;0;0;NA;350364;65;2020-09-22;943
2020-09-21;"Žilinský kraj";47;0;0;0;NA;350364;47;2020-09-21;878
2020-09-20;"Žilinský kraj";4;0;0;0;NA;350364;4;2020-09-20;831
2020-09-19;"Žilinský kraj";6;0;0;0;NA;350364;6;2020-09-19;827
2020-09-18;"Žilinský kraj";82;0;0;0;NA;350364;82;2020-09-18;821
2020-09-17;"Žilinský kraj";30;0;0;0;NA;350364;30;2020-09-17;739
2020-09-16;"Žilinský kraj";34;0;0;0;NA;350364;34;2020-09-16;709
2020-09-15;"Žilinský kraj";12;0;0;0;NA;350364;12;2020-09-15;675
2020-09-14;"Žilinský kraj";39;0;0;0;NA;350364;39;2020-09-14;663
2020-09-13;"Žilinský kraj";6;0;0;0;NA;350364;6;2020-09-13;624
2020-09-12;"Žilinský kraj";4;0;0;0;NA;350364;4;2020-09-12;618
2020-09-11;"Žilinský kraj";31;0;0;0;NA;350364;31;2020-09-11;614
2020-09-10;"Žilinský kraj";31;12;0;12;NA;350364;31;2020-09-10;583
2020-09-09;"Žilinský kraj";23;0;0;0;NA;350364;23;2020-09-09;552
2020-09-08;"Žilinský kraj";25;0;0;0;NA;350364;25;2020-09-08;529
2020-09-07;"Žilinský kraj";11;0;0;0;NA;350364;11;2020-09-07;504
2020-09-06;"Žilinský kraj";0;0;0;0;NA;350364;0;2020-09-06;493
2020-09-05;"Žilinský kraj";2;0;0;0;NA;350364;2;2020-09-05;493
2020-09-04;"Žilinský kraj";33;0;0;0;NA;350364;33;2020-09-04;491
2020-09-03;"Žilinský kraj";18;0;0;0;NA;350364;18;2020-09-03;458
2020-09-02;"Žilinský kraj";16;0;0;0;NA;350364;16;2020-09-02;440
2020-09-01;"Žilinský kraj";4;0;0;0;NA;350364;4;2020-09-01;424
2020-08-31;"Žilinský kraj";5;0;0;0;NA;350364;5;2020-08-31;420
2020-08-30;"Žilinský kraj";3;0;0;0;NA;350364;3;2020-08-30;415
2020-08-29;"Žilinský kraj";5;0;0;0;NA;350364;5;2020-08-29;412
2020-08-28;"Žilinský kraj";13;0;0;0;NA;350364;13;2020-08-28;407
2020-08-27;"Žilinský kraj";18;0;0;0;NA;350364;18;2020-08-27;394
2020-08-26;"Žilinský kraj";8;0;0;0;NA;350364;8;2020-08-26;376
2020-08-25;"Žilinský kraj";2;0;0;0;NA;350364;2;2020-08-25;368
2020-08-24;"Žilinský kraj";5;0;0;0;NA;350364;5;2020-08-24;366
2020-08-23;"Žilinský kraj";0;0;0;0;NA;350364;0;2020-08-23;361
2020-08-22;"Žilinský kraj";0;0;0;0;NA;350364;0;2020-08-22;361
2020-08-21;"Žilinský kraj";10;0;0;0;NA;350364;10;2020-08-21;361
2020-08-20;"Žilinský kraj";13;0;0;0;NA;350364;13;2020-08-20;351
2020-08-19;"Žilinský kraj";7;0;0;0;NA;350364;7;2020-08-19;338
2020-08-18;"Žilinský kraj";9;0;0;0;NA;350364;9;2020-08-18;331
2020-08-17;"Žilinský kraj";1;0;0;0;NA;350364;1;2020-08-17;322
2020-08-16;"Žilinský kraj";0;0;0;0;NA;350364;0;2020-08-16;321
2020-08-15;"Žilinský kraj";0;0;0;0;NA;350364;0;2020-08-15;321
2020-08-14;"Žilinský kraj";4;0;0;0;NA;350364;4;2020-08-14;321
2020-08-13;"Žilinský kraj";2;0;0;0;NA;350364;2;2020-08-13;317
2020-08-12;"Žilinský kraj";0;0;0;0;NA;350364;0;2020-08-12;315
2020-08-11;"Žilinský kraj";4;0;0;0;NA;350364;4;2020-08-11;315
2020-08-10;"Žilinský kraj";1;0;0;0;NA;350364;1;2020-08-10;311
2020-08-09;"Žilinský kraj";0;0;0;0;NA;350364;0;2020-08-09;310
2020-08-08;"Žilinský kraj";3;0;0;0;NA;350364;3;2020-08-08;310
2020-08-07;"Žilinský kraj";8;0;0;0;NA;350364;8;2020-08-07;307
2020-08-06;"Žilinský kraj";1;0;0;0;NA;350364;1;2020-08-06;299
2020-08-05;"Žilinský kraj";1;0;0;0;NA;350364;1;2020-08-05;298
2020-08-04;"Žilinský kraj";2;0;0;0;NA;350364;2;2020-08-04;297
2020-08-03;"Žilinský kraj";0;0;0;0;NA;350364;0;2020-08-03;295
2020-08-02;"Žilinský kraj";1;0;0;0;NA;350364;1;2020-08-02;295
2020-08-01;"Žilinský kraj";0;0;0;0;NA;350364;0;2020-08-01;294
2020-07-31;"Žilinský kraj";4;0;0;0;NA;350364;4;2020-07-31;294
2020-07-30;"Žilinský kraj";2;0;0;0;NA;350364;2;2020-07-30;290
2020-07-29;"Žilinský kraj";2;0;0;0;NA;350364;2;2020-07-29;288
2020-07-28;"Žilinský kraj";4;0;0;0;NA;350364;4;2020-07-28;286
2020-07-27;"Žilinský kraj";6;0;0;0;NA;350364;6;2020-07-27;282
2020-07-26;"Žilinský kraj";0;0;0;0;NA;350364;0;2020-07-26;276
2020-07-25;"Žilinský kraj";0;0;0;0;NA;350364;0;2020-07-25;276
2020-07-24;"Žilinský kraj";2;0;0;0;NA;350364;2;2020-07-24;276
2020-07-23;"Žilinský kraj";0;0;0;0;NA;350364;0;2020-07-23;274
2020-07-22;"Žilinský kraj";1;0;0;0;NA;350364;1;2020-07-22;274
2020-07-21;"Žilinský kraj";2;0;0;0;NA;350364;2;2020-07-21;273
2020-07-20;"Žilinský kraj";3;0;0;0;NA;350364;3;2020-07-20;271
2020-07-19;"Žilinský kraj";0;0;0;0;NA;350364;0;2020-07-19;268
2020-07-18;"Žilinský kraj";0;0;0;0;NA;350364;0;2020-07-18;268
2020-07-17;"Žilinský kraj";2;0;0;0;NA;350364;2;2020-07-17;268
2020-07-16;"Žilinský kraj";2;0;0;0;NA;350364;2;2020-07-16;266
2020-07-15;"Žilinský kraj";2;0;0;0;NA;350364;2;2020-07-15;264
2020-07-14;"Žilinský kraj";1;0;0;0;NA;350364;1;2020-07-14;262
2020-07-13;"Žilinský kraj";0;0;0;0;NA;350364;0;2020-07-13;261
2020-07-12;"Žilinský kraj";0;0;0;0;NA;350364;0;2020-07-12;261
2020-07-11;"Žilinský kraj";2;0;0;0;NA;350364;2;2020-07-11;261
2020-07-10;"Žilinský kraj";3;0;0;0;NA;350364;3;2020-07-10;259
2020-07-09;"Žilinský kraj";2;0;0;0;NA;350364;2;2020-07-09;256
2020-07-08;"Žilinský kraj";10;0;0;0;NA;350364;10;2020-07-08;254
2020-07-07;"Žilinský kraj";7;0;0;0;NA;350364;7;2020-07-07;244
2020-07-06;"Žilinský kraj";0;0;0;0;NA;350364;0;2020-07-06;237
2020-07-05;"Žilinský kraj";0;0;0;0;NA;350364;0;2020-07-05;237
2020-07-04;"Žilinský kraj";10;0;0;0;NA;350364;10;2020-07-04;237
2020-07-03;"Žilinský kraj";18;0;0;0;NA;350364;18;2020-07-03;227
2020-07-02;"Žilinský kraj";7;0;0;0;NA;350364;7;2020-07-02;209
2020-07-01;"Žilinský kraj";0;0;0;0;NA;350364;0;2020-07-01;202
2020-06-30;"Žilinský kraj";4;0;0;0;NA;350364;4;2020-06-30;202
2020-06-29;"Žilinský kraj";0;0;0;0;NA;350364;0;2020-06-29;198
2020-06-28;"Žilinský kraj";1;0;0;0;NA;350364;1;2020-06-28;198
2020-06-27;"Žilinský kraj";3;0;0;0;NA;350364;3;2020-06-27;197
2020-06-26;"Žilinský kraj";5;0;0;0;NA;350364;5;2020-06-26;194
2020-06-25;"Žilinský kraj";7;0;0;0;NA;350364;7;2020-06-25;189
2020-06-24;"Žilinský kraj";11;0;0;0;NA;350364;11;2020-06-24;182
2020-06-23;"Žilinský kraj";9;0;0;0;NA;350364;9;2020-06-23;171
2020-06-22;"Žilinský kraj";0;0;0;0;NA;350364;0;2020-06-22;162
2020-06-21;"Žilinský kraj";1;0;0;0;NA;350364;1;2020-06-21;162
2020-06-20;"Žilinský kraj";1;0;0;0;NA;350364;1;2020-06-20;161
2020-06-19;"Žilinský kraj";4;0;0;0;NA;350364;4;2020-06-19;160
2020-06-18;"Žilinský kraj";1;0;0;0;NA;350364;1;2020-06-18;156
2020-06-17;"Žilinský kraj";0;0;0;0;NA;350364;0;2020-06-17;155
2020-06-16;"Žilinský kraj";1;0;0;0;NA;350364;1;2020-06-16;155
2020-06-14;"Žilinský kraj";0;0;0;0;NA;350364;0;2020-06-14;154
2020-06-13;"Žilinský kraj";0;0;0;0;NA;350364;0;2020-06-13;154
2020-06-12;"Žilinský kraj";0;0;0;0;NA;350364;0;2020-06-12;154
2020-06-11;"Žilinský kraj";0;0;0;0;NA;350364;0;2020-06-11;154
2020-06-10;"Žilinský kraj";0;0;0;0;NA;350364;0;2020-06-10;154
2020-06-09;"Žilinský kraj";1;0;0;0;NA;350364;1;2020-06-09;154
2020-06-08;"Žilinský kraj";0;0;0;0;NA;350364;0;2020-06-08;153
2020-06-07;"Žilinský kraj";0;0;0;0;NA;350364;0;2020-06-07;153
2020-06-05;"Žilinský kraj";0;0;0;0;NA;350364;0;2020-06-05;153
2020-06-03;"Žilinský kraj";0;0;0;0;NA;350364;0;2020-06-03;153
2020-06-02;"Žilinský kraj";0;0;0;0;NA;350364;0;2020-06-02;153
2020-05-31;"Žilinský kraj";0;0;0;0;NA;350364;0;2020-05-31;153
2020-05-29;"Žilinský kraj";0;0;0;0;NA;350364;0;2020-05-29;153
2020-05-27;"Žilinský kraj";1;0;0;0;NA;350364;1;2020-05-27;153
2020-05-26;"Žilinský kraj";1;0;0;0;NA;350364;1;2020-05-26;152
2020-05-25;"Žilinský kraj";0;0;0;0;NA;350364;0;2020-05-25;151
2020-05-24;"Žilinský kraj";0;0;0;0;NA;350364;0;2020-05-24;151
2020-05-23;"Žilinský kraj";0;0;0;0;NA;350364;0;2020-05-23;151
2020-05-22;"Žilinský kraj";0;0;0;0;NA;350364;0;2020-05-22;151
2020-05-21;"Žilinský kraj";0;0;0;0;NA;350364;0;2020-05-21;151
2020-05-20;"Žilinský kraj";0;0;0;0;NA;350364;0;2020-05-20;151
2020-05-19;"Žilinský kraj";1;0;0;0;NA;350364;1;2020-05-19;151
2020-05-17;"Žilinský kraj";0;0;0;0;NA;350364;0;2020-05-17;150
2020-05-16;"Žilinský kraj";0;0;0;0;NA;350364;0;2020-05-16;150
2020-05-15;"Žilinský kraj";0;0;0;0;NA;350364;0;2020-05-15;150
2020-05-14;"Žilinský kraj";0;0;0;0;NA;350364;0;2020-05-14;150
2020-05-13;"Žilinský kraj";0;0;0;0;NA;350364;0;2020-05-13;150
2020-05-12;"Žilinský kraj";0;0;0;0;NA;350364;0;2020-05-12;150
2020-05-11;"Žilinský kraj";0;0;0;0;NA;350364;0;2020-05-11;150
2020-05-09;"Žilinský kraj";0;0;0;0;NA;350364;0;2020-05-09;150
2020-05-07;"Žilinský kraj";0;0;0;0;NA;350364;0;2020-05-07;150
2020-05-06;"Žilinský kraj";2;0;0;0;NA;350364;2;2020-05-06;150
2020-05-05;"Žilinský kraj";3;0;0;0;NA;350364;3;2020-05-05;148
2020-05-04;"Žilinský kraj";3;0;0;0;NA;350364;3;2020-05-04;145
2020-05-03;"Žilinský kraj";1;0;0;0;NA;350364;1;2020-05-03;142
2020-05-02;"Žilinský kraj";0;0;0;0;NA;350364;0;2020-05-02;141
2020-05-01;"Žilinský kraj";1;0;0;0;NA;350364;1;2020-05-01;141
2020-04-30;"Žilinský kraj";0;0;0;0;NA;350364;0;2020-04-30;140
2020-04-29;"Žilinský kraj";0;0;0;0;NA;350364;0;2020-04-29;140
2020-04-28;"Žilinský kraj";0;0;0;0;NA;350364;0;2020-04-28;140
2020-04-27;"Žilinský kraj";0;0;0;0;NA;350364;0;2020-04-27;140
2020-04-26;"Žilinský kraj";0;0;0;0;NA;350364;0;2020-04-26;140
2020-04-25;"Žilinský kraj";2;0;0;0;NA;350364;2;2020-04-25;140
2020-04-24;"Žilinský kraj";1;0;0;0;NA;350364;1;2020-04-24;138
2020-04-23;"Žilinský kraj";2;0;0;0;NA;350364;2;2020-04-23;137
2020-04-22;"Žilinský kraj";9;0;0;0;NA;350364;9;2020-04-22;135
2020-04-21;"Žilinský kraj";1;0;0;0;NA;350364;1;2020-04-21;126
2020-04-20;"Žilinský kraj";4;0;0;0;NA;350364;4;2020-04-20;125
2020-04-19;"Žilinský kraj";0;0;0;0;NA;350364;0;2020-04-19;121
2020-04-18;"Žilinský kraj";49;0;0;0;NA;350364;49;2020-04-18;121
2020-04-17;"Žilinský kraj";3;0;0;0;NA;350364;3;2020-04-17;72
2020-04-16;"Žilinský kraj";4;0;0;0;NA;350364;4;2020-04-16;69
2020-04-15;"Žilinský kraj";7;0;0;0;NA;350364;7;2020-04-15;65
2020-04-14;"Žilinský kraj";1;0;0;0;NA;350364;1;2020-04-14;58
2020-04-13;"Žilinský kraj";2;0;0;0;NA;350364;2;2020-04-13;57
2020-04-12;"Žilinský kraj";5;0;0;0;NA;350364;5;2020-04-12;55
2020-04-11;"Žilinský kraj";2;0;0;0;NA;350364;2;2020-04-11;50
2020-04-10;"Žilinský kraj";1;0;0;0;NA;350364;1;2020-04-10;48
2020-04-09;"Žilinský kraj";1;0;0;0;NA;350364;1;2020-04-09;47
2020-04-08;"Žilinský kraj";3;0;0;0;NA;350364;3;2020-04-08;46
2020-04-07;"Žilinský kraj";5;0;0;0;NA;350364;5;2020-04-07;43
2020-04-06;"Žilinský kraj";6;0;0;0;NA;350364;6;2020-04-06;38
2020-04-05;"Žilinský kraj";8;0;0;0;NA;350364;8;2020-04-05;32
2020-04-04;"Žilinský kraj";0;0;0;0;NA;350364;0;2020-04-04;24
2020-04-03;"Žilinský kraj";3;0;0;0;NA;350364;3;2020-04-03;24
2020-04-02;"Žilinský kraj";5;0;0;0;NA;350364;5;2020-04-02;21
2020-04-01;"Žilinský kraj";4;0;0;0;NA;350364;4;2020-04-01;16
2020-03-31;"Žilinský kraj";1;0;0;0;NA;350364;1;2020-03-31;12
2020-03-30;"Žilinský kraj";3;0;0;0;NA;350364;3;2020-03-30;11
2020-03-29;"Žilinský kraj";0;0;0;0;NA;350364;0;2020-03-29;8
2020-03-28;"Žilinský kraj";1;0;0;0;NA;350364;1;2020-03-28;8
2020-03-27;"Žilinský kraj";9;0;0;0;NA;350364;9;2020-03-27;7
2020-03-26;"Žilinský kraj";4;0;0;0;NA;350364;4;2020-03-26;-2
2020-03-25;"Žilinský kraj";1;0;0;0;NA;350364;1;2020-03-25;-6
2020-03-24;"Žilinský kraj";2;0;0;0;NA;350364;2;2020-03-24;-7
2020-03-23;"Žilinský kraj";3;0;0;0;NA;350364;3;2020-03-23;-9
2020-03-22;"Žilinský kraj";1;0;0;0;NA;350364;1;2020-03-22;-12
2020-03-21;"Žilinský kraj";2;0;0;0;NA;350364;2;2020-03-21;-13
2020-03-20;"Žilinský kraj";4;0;0;0;NA;350364;4;2020-03-20;-15
2020-03-19;"Žilinský kraj";2;0;0;0;NA;350364;2;2020-03-19;-19
2020-03-18;"Žilinský kraj";1;0;0;0;NA;350364;1;2020-03-18;-21
2020-03-17;"Žilinský kraj";5;0;0;0;NA;350364;5;2020-03-17;-22
2020-03-16;"Žilinský kraj";1;0;0;0;NA;350364;1;2020-03-16;-27
2020-03-15;"Žilinský kraj";2;0;0;0;NA;350364;2;2020-03-15;-28
2020-03-14;"Žilinský kraj";1;0;0;0;NA;350364;1;2020-03-14;-30
2020-03-13;"Žilinský kraj";5;0;0;0;NA;350364;5;2020-03-13;-31
2020-03-12;"Žilinský kraj";1;0;0;0;NA;350364;1;2020-03-12;-36
2020-03-11;"Žilinský kraj";0;0;0;0;NA;350364;0;2020-03-11;-37
2020-03-09;"Žilinský kraj";1;0;0;0;NA;350364;1;2020-03-09;-37
2020-03-08;"Žilinský kraj";0;0;0;0;NA;350364;0;2020-03-08;-38
2020-03-07;"Žilinský kraj";0;0;0;0;NA;350364;0;2020-03-07;-38
2020-03-06;"Žilinský kraj";0;0;0;0;NA;350364;0;2020-03-06;-38
