"Datum";"Region";"PCR_Pos";"Ag_Neg";"Ag_Pos";"Total";"Pocet.potvrdenych";"Potvrdenych";"newcases";"date";"positive"
2021-07-11;"Banskobystrický kraj";0;261;0;261;38090;83755;0;2021-07-11;83755
2021-07-10;"Banskobystrický kraj";2;253;0;253;NA;83755;2;2021-07-10;83755
2021-07-09;"Banskobystrický kraj";3;1016;0;1016;NA;83755;3;2021-07-09;83753
2021-07-08;"Banskobystrický kraj";0;1005;1;1006;NA;83755;1;2021-07-08;83750
2021-07-07;"Banskobystrický kraj";1;662;0;662;NA;83755;1;2021-07-07;83749
2021-07-06;"Banskobystrický kraj";6;1263;0;1263;NA;83755;6;2021-07-06;83748
2021-07-05;"Banskobystrický kraj";2;365;1;366;NA;83755;3;2021-07-05;83742
2021-07-04;"Banskobystrický kraj";0;259;0;259;NA;83755;0;2021-07-04;83739
2021-07-03;"Banskobystrický kraj";1;349;1;350;NA;83755;2;2021-07-03;83739
2021-07-02;"Banskobystrický kraj";3;935;0;935;NA;83755;3;2021-07-02;83737
2021-07-01;"Banskobystrický kraj";0;678;1;679;NA;83755;1;2021-07-01;83734
2021-06-30;"Banskobystrický kraj";3;7348;1;7349;NA;83755;4;2021-06-30;83733
2021-06-29;"Banskobystrický kraj";2;4642;1;4643;NA;83755;3;2021-06-29;83729
2021-06-28;"Banskobystrický kraj";3;5608;1;5609;NA;83755;4;2021-06-28;83726
2021-06-27;"Banskobystrický kraj";0;4323;5;4328;NA;83755;5;2021-06-27;83722
2021-06-26;"Banskobystrický kraj";0;4222;4;4226;NA;83755;4;2021-06-26;83717
2021-06-25;"Banskobystrický kraj";2;6415;2;6417;NA;83755;4;2021-06-25;83713
2021-06-24;"Banskobystrický kraj";6;4484;2;4486;NA;83755;8;2021-06-24;83709
2021-06-23;"Banskobystrický kraj";4;4786;0;4786;NA;83755;4;2021-06-23;83701
2021-06-22;"Banskobystrický kraj";7;4504;0;4504;NA;83755;7;2021-06-22;83697
2021-06-21;"Banskobystrický kraj";6;5714;8;5722;NA;83755;14;2021-06-21;83690
2021-06-20;"Banskobystrický kraj";0;4845;6;4851;NA;83755;6;2021-06-20;83676
2021-06-19;"Banskobystrický kraj";0;5439;4;5443;NA;83755;4;2021-06-19;83670
2021-06-18;"Banskobystrický kraj";4;7457;1;7458;NA;83755;5;2021-06-18;83666
2021-06-17;"Banskobystrický kraj";2;5067;3;5070;NA;83755;5;2021-06-17;83661
2021-06-16;"Banskobystrický kraj";10;5769;5;5774;NA;83755;15;2021-06-16;83656
2021-06-15;"Banskobystrický kraj";9;5550;6;5556;NA;83755;15;2021-06-15;83641
2021-06-14;"Banskobystrický kraj";8;6805;7;6812;NA;83755;15;2021-06-14;83626
2021-06-13;"Banskobystrický kraj";0;6181;7;6188;NA;83755;7;2021-06-13;83611
2021-06-12;"Banskobystrický kraj";3;6168;5;6173;NA;83755;8;2021-06-12;83604
2021-06-11;"Banskobystrický kraj";5;9399;13;9412;NA;83755;18;2021-06-11;83596
2021-06-10;"Banskobystrický kraj";10;5545;7;5552;NA;83755;17;2021-06-10;83578
2021-06-09;"Banskobystrický kraj";9;5536;2;5538;NA;83755;11;2021-06-09;83561
2021-06-08;"Banskobystrický kraj";15;5594;10;5604;NA;83755;25;2021-06-08;83550
2021-06-07;"Banskobystrický kraj";4;7367;19;7386;NA;83755;23;2021-06-07;83525
2021-06-06;"Banskobystrický kraj";1;7246;11;7257;NA;83755;12;2021-06-06;83502
2021-06-05;"Banskobystrický kraj";15;7290;8;7298;NA;83755;23;2021-06-05;83490
2021-06-04;"Banskobystrický kraj";2;8996;14;9010;NA;83755;16;2021-06-04;83467
2021-06-03;"Banskobystrický kraj";8;6390;24;6414;NA;83755;32;2021-06-03;83451
2021-06-02;"Banskobystrický kraj";7;6597;5;6602;NA;83755;12;2021-06-02;83419
2021-06-01;"Banskobystrický kraj";12;7081;14;7095;NA;83755;26;2021-06-01;83407
2021-05-31;"Banskobystrický kraj";4;9298;28;9326;NA;83755;32;2021-05-31;83381
2021-05-30;"Banskobystrický kraj";3;8698;18;8716;NA;83755;21;2021-05-30;83349
2021-05-29;"Banskobystrický kraj";11;9648;18;9666;NA;83755;29;2021-05-29;83328
2021-05-28;"Banskobystrický kraj";13;11510;23;11533;NA;83755;36;2021-05-28;83299
2021-05-27;"Banskobystrický kraj";7;8760;12;8772;NA;83755;19;2021-05-27;83263
2021-05-26;"Banskobystrický kraj";18;7623;16;7639;NA;83755;34;2021-05-26;83244
2021-05-25;"Banskobystrický kraj";27;8883;30;8913;NA;83755;57;2021-05-25;83210
2021-05-24;"Banskobystrický kraj";9;12469;44;12513;NA;83755;53;2021-05-24;83153
2021-05-23;"Banskobystrický kraj";0;9522;25;9547;NA;83755;25;2021-05-23;83100
2021-05-22;"Banskobystrický kraj";20;9368;26;9394;NA;83755;46;2021-05-22;83075
2021-05-21;"Banskobystrický kraj";22;12364;21;12385;NA;83755;43;2021-05-21;83029
2021-05-20;"Banskobystrický kraj";14;8693;24;8717;NA;83755;38;2021-05-20;82986
2021-05-19;"Banskobystrický kraj";42;8344;18;8362;NA;83755;60;2021-05-19;82948
2021-05-18;"Banskobystrický kraj";27;9341;25;9366;NA;83755;52;2021-05-18;82888
2021-05-17;"Banskobystrický kraj";11;13179;29;13208;NA;83755;40;2021-05-17;82836
2021-05-16;"Banskobystrický kraj";15;13730;24;13754;NA;83755;39;2021-05-16;82796
2021-05-15;"Banskobystrický kraj";11;15020;29;15049;NA;83755;40;2021-05-15;82757
2021-05-14;"Banskobystrický kraj";35;18481;43;18524;NA;83755;78;2021-05-14;82717
2021-05-13;"Banskobystrický kraj";37;10605;40;10645;NA;83755;77;2021-05-13;82639
2021-05-12;"Banskobystrický kraj";31;10839;45;10884;NA;83755;76;2021-05-12;82562
2021-05-11;"Banskobystrický kraj";42;11227;48;11275;NA;83755;90;2021-05-11;82486
2021-05-10;"Banskobystrický kraj";28;17297;63;17360;NA;83755;91;2021-05-10;82396
2021-05-09;"Banskobystrický kraj";25;21333;66;21399;NA;83755;91;2021-05-09;82305
2021-05-08;"Banskobystrický kraj";11;13686;23;13709;NA;83755;34;2021-05-08;82214
2021-05-07;"Banskobystrický kraj";41;21278;74;21352;NA;83755;115;2021-05-07;82180
2021-05-06;"Banskobystrický kraj";36;12251;70;12321;NA;83755;106;2021-05-06;82065
2021-05-05;"Banskobystrický kraj";34;12592;63;12655;NA;83755;97;2021-05-05;81959
2021-05-04;"Banskobystrický kraj";83;13888;47;13935;NA;83755;130;2021-05-04;81862
2021-05-03;"Banskobystrický kraj";30;20872;80;20952;NA;83755;110;2021-05-03;81732
2021-05-02;"Banskobystrický kraj";6;33040;60;33100;NA;83755;66;2021-05-02;81622
2021-05-01;"Banskobystrický kraj";54;36770;67;36837;NA;83755;121;2021-05-01;81556
2021-04-30;"Banskobystrický kraj";38;34957;86;35043;NA;83755;124;2021-04-30;81435
2021-04-29;"Banskobystrický kraj";55;16839;68;16907;NA;83755;123;2021-04-29;81311
2021-04-28;"Banskobystrický kraj";66;17959;67;18026;NA;83755;133;2021-04-28;81188
2021-04-27;"Banskobystrický kraj";70;19152;73;19225;NA;83755;143;2021-04-27;81055
2021-04-26;"Banskobystrický kraj";34;28514;101;28615;NA;83755;135;2021-04-26;80912
2021-04-25;"Banskobystrický kraj";14;40601;106;40707;NA;83755;120;2021-04-25;80777
2021-04-24;"Banskobystrický kraj";40;51625;98;51723;NA;83755;138;2021-04-24;80657
2021-04-23;"Banskobystrický kraj";78;37729;88;37817;NA;83755;166;2021-04-23;80519
2021-04-22;"Banskobystrický kraj";51;17412;57;17469;NA;83755;108;2021-04-22;80353
2021-04-21;"Banskobystrický kraj";76;19192;94;19286;NA;83755;170;2021-04-21;80245
2021-04-20;"Banskobystrický kraj";116;21233;98;21331;NA;83755;214;2021-04-20;80075
2021-04-19;"Banskobystrický kraj";48;31407;105;31512;NA;83755;153;2021-04-19;79861
2021-04-18;"Banskobystrický kraj";16;43376;90;43466;NA;83755;106;2021-04-18;79708
2021-04-17;"Banskobystrický kraj";42;64939;92;65031;NA;83755;134;2021-04-17;79602
2021-04-16;"Banskobystrický kraj";72;37307;100;37407;NA;83755;172;2021-04-16;79468
2021-04-15;"Banskobystrický kraj";67;20117;83;20200;NA;83755;150;2021-04-15;79296
2021-04-14;"Banskobystrický kraj";69;21257;86;21343;NA;83755;155;2021-04-14;79146
2021-04-13;"Banskobystrický kraj";130;23076;77;23153;NA;83755;207;2021-04-13;78991
2021-04-12;"Banskobystrický kraj";60;32248;130;32378;NA;83755;190;2021-04-12;78784
2021-04-11;"Banskobystrický kraj";0;41367;88;41455;NA;83755;88;2021-04-11;78594
2021-04-10;"Banskobystrický kraj";56;64728;141;64869;NA;83755;197;2021-04-10;78506
2021-04-09;"Banskobystrický kraj";106;31570;118;31688;NA;83755;224;2021-04-09;78309
2021-04-08;"Banskobystrický kraj";132;18406;110;18516;NA;83755;242;2021-04-08;78085
2021-04-07;"Banskobystrický kraj";226;25117;94;25211;NA;83755;320;2021-04-07;77843
2021-04-06;"Banskobystrický kraj";93;42487;187;42674;NA;83755;280;2021-04-06;77523
2021-04-05;"Banskobystrický kraj";15;11797;87;11884;NA;83755;102;2021-04-05;77243
2021-04-04;"Banskobystrický kraj";24;19683;79;19762;NA;83755;103;2021-04-04;77141
2021-04-03;"Banskobystrický kraj";5;72553;211;72764;NA;83755;216;2021-04-03;77038
2021-04-02;"Banskobystrický kraj";71;13455;66;13521;NA;83755;137;2021-04-02;76822
2021-04-01;"Banskobystrický kraj";171;38881;200;39081;NA;83755;371;2021-04-01;76685
2021-03-31;"Banskobystrický kraj";147;25543;161;25704;NA;83755;308;2021-03-31;76314
2021-03-30;"Banskobystrický kraj";167;21439;159;21598;NA;83755;326;2021-03-30;76006
2021-03-29;"Banskobystrický kraj";119;29491;218;29709;NA;83755;337;2021-03-29;75680
2021-03-28;"Banskobystrický kraj";25;40610;189;40799;NA;83755;214;2021-03-28;75343
2021-03-27;"Banskobystrický kraj";85;63414;260;63674;NA;83755;345;2021-03-27;75129
2021-03-26;"Banskobystrický kraj";122;43661;240;43901;NA;83755;362;2021-03-26;74784
2021-03-25;"Banskobystrický kraj";120;21589;240;21829;NA;83755;360;2021-03-25;74422
2021-03-24;"Banskobystrický kraj";200;19319;227;19546;NA;83755;427;2021-03-24;74062
2021-03-23;"Banskobystrický kraj";241;21538;257;21795;NA;83755;498;2021-03-23;73635
2021-03-22;"Banskobystrický kraj";65;30478;274;30752;NA;83755;339;2021-03-22;73137
2021-03-21;"Banskobystrický kraj";31;40039;280;40319;NA;83755;311;2021-03-21;72798
2021-03-20;"Banskobystrický kraj";119;67926;383;68309;NA;83755;502;2021-03-20;72487
2021-03-19;"Banskobystrický kraj";240;44038;307;44345;NA;83755;547;2021-03-19;71985
2021-03-18;"Banskobystrický kraj";160;22467;273;22740;NA;83755;433;2021-03-18;71438
2021-03-17;"Banskobystrický kraj";262;21573;245;21818;NA;83755;507;2021-03-17;71005
2021-03-16;"Banskobystrický kraj";340;23349;224;23573;NA;83755;564;2021-03-16;70498
2021-03-15;"Banskobystrický kraj";95;31293;364;31657;NA;83755;459;2021-03-15;69934
2021-03-14;"Banskobystrický kraj";39;39212;218;39430;NA;83755;257;2021-03-14;69475
2021-03-13;"Banskobystrický kraj";209;67167;391;67558;NA;83755;600;2021-03-13;69218
2021-03-12;"Banskobystrický kraj";206;41443;330;41773;NA;83755;536;2021-03-12;68618
2021-03-11;"Banskobystrický kraj";228;21337;272;21609;NA;83755;500;2021-03-11;68082
2021-03-10;"Banskobystrický kraj";260;20381;238;20619;NA;83755;498;2021-03-10;67582
2021-03-09;"Banskobystrický kraj";352;21790;284;22074;NA;83755;636;2021-03-09;67084
2021-03-08;"Banskobystrický kraj";191;31488;427;31915;NA;83755;618;2021-03-08;66448
2021-03-07;"Banskobystrický kraj";60;39083;295;39378;NA;83755;355;2021-03-07;65830
2021-03-06;"Banskobystrický kraj";164;70562;410;70972;NA;83755;574;2021-03-06;65475
2021-03-05;"Banskobystrický kraj";221;42141;388;42529;NA;83755;609;2021-03-05;64901
2021-03-04;"Banskobystrický kraj";226;22007;334;22341;NA;83755;560;2021-03-04;64292
2021-03-03;"Banskobystrický kraj";317;21949;331;22280;NA;83755;648;2021-03-03;63732
2021-03-02;"Banskobystrický kraj";291;23152;354;23506;NA;83755;645;2021-03-02;63084
2021-03-01;"Banskobystrický kraj";151;31773;434;32207;NA;83755;585;2021-03-01;62439
2021-02-28;"Banskobystrický kraj";45;38663;336;38999;NA;83755;381;2021-02-28;61854
2021-02-27;"Banskobystrický kraj";289;66667;529;67196;NA;83755;818;2021-02-27;61473
2021-02-26;"Banskobystrický kraj";326;39493;468;39961;NA;83755;794;2021-02-26;60655
2021-02-25;"Banskobystrický kraj";375;18081;366;18447;NA;83755;741;2021-02-25;59861
2021-02-24;"Banskobystrický kraj";332;16735;373;17108;NA;83755;705;2021-02-24;59120
2021-02-23;"Banskobystrický kraj";462;19930;439;20369;NA;83755;901;2021-02-23;58415
2021-02-22;"Banskobystrický kraj";67;28643;598;29241;NA;83755;665;2021-02-22;57514
2021-02-21;"Banskobystrický kraj";68;37464;437;37901;NA;83755;505;2021-02-21;56849
2021-02-20;"Banskobystrický kraj";280;68851;598;69449;NA;83755;878;2021-02-20;56344
2021-02-19;"Banskobystrický kraj";420;39886;511;40397;NA;83755;931;2021-02-19;55466
2021-02-18;"Banskobystrický kraj";241;18618;396;19014;NA;83755;637;2021-02-18;54535
2021-02-17;"Banskobystrický kraj";415;16737;389;17126;NA;83755;804;2021-02-17;53898
2021-02-16;"Banskobystrický kraj";338;19727;368;20095;NA;83755;706;2021-02-16;53094
2021-02-15;"Banskobystrický kraj";118;35835;591;36426;NA;83755;709;2021-02-15;52388
2021-02-14;"Banskobystrický kraj";60;31894;386;32280;NA;83755;446;2021-02-14;51679
2021-02-13;"Banskobystrický kraj";202;53889;492;54381;NA;83755;694;2021-02-13;51233
2021-02-12;"Banskobystrický kraj";312;37270;533;37803;NA;83755;845;2021-02-12;50539
2021-02-11;"Banskobystrický kraj";305;21200;386;21586;NA;83755;691;2021-02-11;49694
2021-02-10;"Banskobystrický kraj";333;14790;344;15134;NA;83755;677;2021-02-10;49003
2021-02-09;"Banskobystrický kraj";329;18504;362;18866;NA;83755;691;2021-02-09;48326
2021-02-08;"Banskobystrický kraj";103;47046;672;47718;NA;83755;775;2021-02-08;47635
2021-02-07;"Banskobystrický kraj";70;37363;333;37696;NA;83755;403;2021-02-07;46860
2021-02-06;"Banskobystrický kraj";178;69388;570;69958;NA;83755;748;2021-02-06;46457
2021-02-05;"Banskobystrický kraj";282;24577;363;24940;NA;83755;645;2021-02-05;45709
2021-02-04;"Banskobystrický kraj";240;14367;430;14797;NA;83755;670;2021-02-04;45064
2021-02-03;"Banskobystrický kraj";350;9429;255;9684;NA;83755;605;2021-02-03;44394
2021-02-02;"Banskobystrický kraj";277;15740;334;16074;NA;83755;611;2021-02-02;43789
2021-02-01;"Banskobystrický kraj";75;24346;489;24835;NA;83755;564;2021-02-01;43178
2021-01-31;"Banskobystrický kraj";34;19983;201;20184;NA;83755;235;2021-01-31;42614
2021-01-30;"Banskobystrický kraj";163;63896;525;64421;NA;83755;688;2021-01-30;42379
2021-01-29;"Banskobystrický kraj";196;17360;269;17629;NA;83755;465;2021-01-29;41691
2021-01-28;"Banskobystrický kraj";218;14229;372;14601;NA;83755;590;2021-01-28;41226
2021-01-27;"Banskobystrický kraj";191;8128;200;8328;NA;83755;391;2021-01-27;40636
2021-01-26;"Banskobystrický kraj";238;19793;283;20076;NA;83755;521;2021-01-26;40245
2021-01-25;"Banskobystrický kraj";82;33666;412;34078;NA;83755;494;2021-01-25;39724
2021-01-24;"Banskobystrický kraj";38;35587;278;35865;NA;83755;316;2021-01-24;39230
2021-01-23;"Banskobystrický kraj";142;88667;523;89190;NA;83755;665;2021-01-23;38914
2021-01-22;"Banskobystrický kraj";175;25871;355;26226;NA;83755;530;2021-01-22;38249
2021-01-21;"Banskobystrický kraj";194;17063;279;17342;NA;83755;473;2021-01-21;37719
2021-01-20;"Banskobystrický kraj";231;9142;186;9328;NA;83755;417;2021-01-20;37246
2021-01-19;"Banskobystrický kraj";213;10708;311;11019;NA;83755;524;2021-01-19;36829
2021-01-18;"Banskobystrický kraj";94;7402;401;7803;NA;83755;495;2021-01-18;36305
2021-01-17;"Banskobystrický kraj";110;8154;77;8231;NA;83755;187;2021-01-17;35810
2021-01-16;"Banskobystrický kraj";58;2274;57;2331;NA;83755;115;2021-01-16;35623
2021-01-15;"Banskobystrický kraj";164;7673;217;7890;NA;83755;381;2021-01-15;35508
2021-01-14;"Banskobystrický kraj";220;5760;325;6085;NA;83755;545;2021-01-14;35127
2021-01-13;"Banskobystrický kraj";235;5974;217;6191;NA;83755;452;2021-01-13;34582
2021-01-12;"Banskobystrický kraj";194;6600;290;6890;NA;83755;484;2021-01-12;34130
2021-01-11;"Banskobystrický kraj";76;8231;481;8712;NA;83755;557;2021-01-11;33646
2021-01-10;"Banskobystrický kraj";110;433;4;437;NA;83755;114;2021-01-10;33089
2021-01-09;"Banskobystrický kraj";297;2378;81;2459;NA;83755;378;2021-01-09;32975
2021-01-08;"Banskobystrický kraj";435;9802;443;10245;NA;83755;878;2021-01-08;32597
2021-01-07;"Banskobystrický kraj";127;6322;366;6688;NA;83755;493;2021-01-07;31719
2021-01-06;"Banskobystrický kraj";305;3374;185;3559;NA;83755;490;2021-01-06;31226
2021-01-05;"Banskobystrický kraj";372;7349;533;7882;NA;83755;905;2021-01-05;30736
2021-01-04;"Banskobystrický kraj";130;7083;700;7783;NA;83755;830;2021-01-04;29831
2021-01-03;"Banskobystrický kraj";199;320;19;339;NA;83755;218;2021-01-03;29001
2021-01-02;"Banskobystrický kraj";123;702;85;787;NA;83755;208;2021-01-02;28783
2021-01-01;"Banskobystrický kraj";220;1958;132;2090;NA;83755;352;2021-01-01;28575
2020-12-31;"Banskobystrický kraj";499;7679;633;8312;NA;83755;1132;2020-12-31;28223
2020-12-30;"Banskobystrický kraj";593;7392;541;7933;NA;83755;1134;2020-12-30;27091
2020-12-29;"Banskobystrický kraj";240;7876;660;8536;NA;83755;900;2020-12-29;25957
2020-12-28;"Banskobystrický kraj";131;6120;720;6840;NA;83755;851;2020-12-28;25057
2020-12-27;"Banskobystrický kraj";116;541;25;566;NA;83755;141;2020-12-27;24206
2020-12-26;"Banskobystrický kraj";61;295;35;330;NA;83755;96;2020-12-26;24065
2020-12-25;"Banskobystrický kraj";65;888;10;898;NA;83755;75;2020-12-25;23969
2020-12-24;"Banskobystrický kraj";452;3685;135;3820;NA;83755;587;2020-12-24;23894
2020-12-23;"Banskobystrický kraj";368;10126;502;10628;NA;83755;870;2020-12-23;23307
2020-12-22;"Banskobystrický kraj";307;8467;619;9086;NA;83755;926;2020-12-22;22437
2020-12-21;"Banskobystrický kraj";286;4922;455;5377;NA;83755;741;2020-12-21;21511
2020-12-20;"Banskobystrický kraj";155;249;14;263;NA;83755;169;2020-12-20;20770
2020-12-19;"Banskobystrický kraj";170;3084;138;3222;NA;83755;308;2020-12-19;20601
2020-12-18;"Banskobystrický kraj";432;5959;331;6290;NA;83755;763;2020-12-18;20293
2020-12-17;"Banskobystrický kraj";468;8755;653;9408;NA;83755;1121;2020-12-17;19530
2020-12-16;"Banskobystrický kraj";379;10184;567;10751;NA;83755;946;2020-12-16;18409
2020-12-15;"Banskobystrický kraj";336;5281;425;5706;NA;83755;761;2020-12-15;17463
2020-12-14;"Banskobystrický kraj";148;4012;259;4271;NA;83755;407;2020-12-14;16702
2020-12-13;"Banskobystrický kraj";122;142;1;143;NA;83755;123;2020-12-13;16295
2020-12-12;"Banskobystrický kraj";137;2714;138;2852;NA;83755;275;2020-12-12;16172
2020-12-11;"Banskobystrický kraj";468;6633;362;6995;NA;83755;830;2020-12-11;15897
2020-12-10;"Banskobystrický kraj";280;5501;369;5870;NA;83755;649;2020-12-10;15067
2020-12-09;"Banskobystrický kraj";323;3941;205;4146;NA;83755;528;2020-12-09;14418
2020-12-08;"Banskobystrický kraj";256;3782;272;4054;NA;83755;528;2020-12-08;13890
2020-12-07;"Banskobystrický kraj";175;2633;177;2810;NA;83755;352;2020-12-07;13362
2020-12-06;"Banskobystrický kraj";121;507;11;518;NA;83755;132;2020-12-06;13010
2020-12-05;"Banskobystrický kraj";109;1099;34;1133;NA;83755;143;2020-12-05;12878
2020-12-04;"Banskobystrický kraj";339;3828;174;4002;NA;83755;513;2020-12-04;12735
2020-12-03;"Banskobystrický kraj";240;3193;234;3427;NA;83755;474;2020-12-03;12222
2020-12-02;"Banskobystrický kraj";217;4442;186;4628;NA;83755;403;2020-12-02;11748
2020-12-01;"Banskobystrický kraj";215;2702;134;2836;NA;83755;349;2020-12-01;11345
2020-11-30;"Banskobystrický kraj";74;4559;257;4816;NA;83755;331;2020-11-30;10996
2020-11-29;"Banskobystrický kraj";19;208;7;215;NA;83755;26;2020-11-29;10665
2020-11-28;"Banskobystrický kraj";81;1408;55;1463;NA;83755;136;2020-11-28;10639
2020-11-27;"Banskobystrický kraj";219;2266;123;2389;NA;83755;342;2020-11-27;10503
2020-11-26;"Banskobystrický kraj";208;2124;93;2217;NA;83755;301;2020-11-26;10161
2020-11-25;"Banskobystrický kraj";170;1952;86;2038;NA;83755;256;2020-11-25;9860
2020-11-24;"Banskobystrický kraj";166;2566;69;2635;NA;83755;235;2020-11-24;9604
2020-11-23;"Banskobystrický kraj";66;10240;194;10434;NA;83755;260;2020-11-23;9369
2020-11-22;"Banskobystrický kraj";38;104;1;105;NA;83755;39;2020-11-22;9109
2020-11-21;"Banskobystrický kraj";52;904;14;918;NA;83755;66;2020-11-21;9070
2020-11-20;"Banskobystrický kraj";127;2005;107;2112;NA;83755;234;2020-11-20;9004
2020-11-19;"Banskobystrický kraj";170;1218;82;1300;NA;83755;252;2020-11-19;8770
2020-11-18;"Banskobystrický kraj";153;698;65;763;NA;83755;218;2020-11-18;8518
2020-11-17;"Banskobystrický kraj";52;578;35;613;NA;83755;87;2020-11-17;8300
2020-11-16;"Banskobystrický kraj";106;470;25;495;NA;83755;131;2020-11-16;8213
2020-11-15;"Banskobystrický kraj";52;301;4;305;NA;83755;56;2020-11-15;8082
2020-11-14;"Banskobystrický kraj";73;305;2;307;NA;83755;75;2020-11-14;8026
2020-11-13;"Banskobystrický kraj";157;552;11;563;NA;83755;168;2020-11-13;7951
2020-11-12;"Banskobystrický kraj";218;952;44;996;NA;83755;262;2020-11-12;7783
2020-11-11;"Banskobystrický kraj";224;437;9;446;NA;83755;233;2020-11-11;7521
2020-11-10;"Banskobystrický kraj";263;463;18;481;NA;83755;281;2020-11-10;7288
2020-11-09;"Banskobystrický kraj";80;2678;31;2709;NA;83755;111;2020-11-09;7007
2020-11-08;"Banskobystrický kraj";82;981;16;997;NA;83755;98;2020-11-08;6896
2020-11-07;"Banskobystrický kraj";164;8828;94;8922;NA;83755;258;2020-11-07;6798
2020-11-06;"Banskobystrický kraj";227;2496;16;2512;NA;83755;243;2020-11-06;6540
2020-11-05;"Banskobystrický kraj";240;290;33;323;NA;83755;273;2020-11-05;6297
2020-11-04;"Banskobystrický kraj";254;1366;13;1379;NA;83755;267;2020-11-04;6024
2020-11-03;"Banskobystrický kraj";246;1332;4;1336;NA;83755;250;2020-11-03;5757
2020-11-02;"Banskobystrický kraj";90;2909;65;2974;NA;83755;155;2020-11-02;5507
2020-11-01;"Banskobystrický kraj";101;2671;42;2713;NA;83755;143;2020-11-01;5352
2020-10-31;"Banskobystrický kraj";199;13516;116;13632;NA;83755;315;2020-10-31;5209
2020-10-30;"Banskobystrický kraj";254;2829;20;2849;NA;83755;274;2020-10-30;4894
2020-10-29;"Banskobystrický kraj";372;969;42;1011;NA;83755;414;2020-10-29;4620
2020-10-28;"Banskobystrický kraj";285;302;30;332;NA;83755;315;2020-10-28;4206
2020-10-27;"Banskobystrický kraj";266;654;40;694;NA;83755;306;2020-10-27;3891
2020-10-26;"Banskobystrický kraj";38;234;29;263;NA;83755;67;2020-10-26;3585
2020-10-25;"Banskobystrický kraj";50;140;11;151;NA;83755;61;2020-10-25;3518
2020-10-24;"Banskobystrický kraj";315;114;12;126;NA;83755;327;2020-10-24;3457
2020-10-23;"Banskobystrický kraj";231;230;29;259;NA;83755;260;2020-10-23;3130
2020-10-22;"Banskobystrický kraj";264;253;24;277;NA;83755;288;2020-10-22;2870
2020-10-21;"Banskobystrický kraj";209;266;3;269;NA;83755;212;2020-10-21;2582
2020-10-20;"Banskobystrický kraj";210;66;3;69;NA;83755;213;2020-10-20;2370
2020-10-19;"Banskobystrický kraj";27;73;12;85;NA;83755;39;2020-10-19;2157
2020-10-18;"Banskobystrický kraj";49;0;0;0;NA;83755;49;2020-10-18;2118
2020-10-17;"Banskobystrický kraj";91;0;0;0;NA;83755;91;2020-10-17;2069
2020-10-16;"Banskobystrický kraj";224;37;3;40;NA;83755;227;2020-10-16;1978
2020-10-15;"Banskobystrický kraj";133;29;1;30;NA;83755;134;2020-10-15;1751
2020-10-14;"Banskobystrický kraj";139;31;1;32;NA;83755;140;2020-10-14;1617
2020-10-13;"Banskobystrický kraj";151;169;11;180;NA;83755;162;2020-10-13;1477
2020-10-12;"Banskobystrický kraj";11;110;4;114;NA;83755;15;2020-10-12;1315
2020-10-11;"Banskobystrický kraj";14;0;0;0;NA;83755;14;2020-10-11;1300
2020-10-10;"Banskobystrický kraj";53;0;0;0;NA;83755;53;2020-10-10;1286
2020-10-09;"Banskobystrický kraj";128;0;0;0;NA;83755;128;2020-10-09;1233
2020-10-08;"Banskobystrický kraj";99;0;0;0;NA;83755;99;2020-10-08;1105
2020-10-07;"Banskobystrický kraj";124;0;0;0;NA;83755;124;2020-10-07;1006
2020-10-06;"Banskobystrický kraj";68;0;0;0;NA;83755;68;2020-10-06;882
2020-10-05;"Banskobystrický kraj";49;0;0;0;NA;83755;49;2020-10-05;814
2020-10-04;"Banskobystrický kraj";8;0;0;0;NA;83755;8;2020-10-04;765
2020-10-03;"Banskobystrický kraj";37;0;0;0;NA;83755;37;2020-10-03;757
2020-10-02;"Banskobystrický kraj";74;0;0;0;NA;83755;74;2020-10-02;720
2020-10-01;"Banskobystrický kraj";49;0;0;0;NA;83755;49;2020-10-01;646
2020-09-30;"Banskobystrický kraj";60;0;0;0;NA;83755;60;2020-09-30;597
2020-09-29;"Banskobystrický kraj";24;0;0;0;NA;83755;24;2020-09-29;537
2020-09-28;"Banskobystrický kraj";0;0;0;0;NA;83755;0;2020-09-28;513
2020-09-27;"Banskobystrický kraj";20;0;0;0;NA;83755;20;2020-09-27;513
2020-09-26;"Banskobystrický kraj";24;0;0;0;NA;83755;24;2020-09-26;493
2020-09-25;"Banskobystrický kraj";29;0;0;0;NA;83755;29;2020-09-25;469
2020-09-24;"Banskobystrický kraj";25;0;0;0;NA;83755;25;2020-09-24;440
2020-09-23;"Banskobystrický kraj";17;0;0;0;NA;83755;17;2020-09-23;415
2020-09-22;"Banskobystrický kraj";25;0;0;0;NA;83755;25;2020-09-22;398
2020-09-21;"Banskobystrický kraj";3;0;0;0;NA;83755;3;2020-09-21;373
2020-09-20;"Banskobystrický kraj";0;0;0;0;NA;83755;0;2020-09-20;370
2020-09-19;"Banskobystrický kraj";3;0;0;0;NA;83755;3;2020-09-19;370
2020-09-18;"Banskobystrický kraj";24;0;0;0;NA;83755;24;2020-09-18;367
2020-09-17;"Banskobystrický kraj";14;0;0;0;NA;83755;14;2020-09-17;343
2020-09-16;"Banskobystrický kraj";6;0;0;0;NA;83755;6;2020-09-16;329
2020-09-15;"Banskobystrický kraj";2;0;0;0;NA;83755;2;2020-09-15;323
2020-09-14;"Banskobystrický kraj";13;0;0;0;NA;83755;13;2020-09-14;321
2020-09-13;"Banskobystrický kraj";1;0;0;0;NA;83755;1;2020-09-13;308
2020-09-12;"Banskobystrický kraj";5;0;0;0;NA;83755;5;2020-09-12;307
2020-09-11;"Banskobystrický kraj";19;0;0;0;NA;83755;19;2020-09-11;302
2020-09-10;"Banskobystrický kraj";11;0;0;0;NA;83755;11;2020-09-10;283
2020-09-09;"Banskobystrický kraj";13;0;0;0;NA;83755;13;2020-09-09;272
2020-09-08;"Banskobystrický kraj";5;0;0;0;NA;83755;5;2020-09-08;259
2020-09-07;"Banskobystrický kraj";2;0;0;0;NA;83755;2;2020-09-07;254
2020-09-06;"Banskobystrický kraj";0;0;0;0;NA;83755;0;2020-09-06;252
2020-09-05;"Banskobystrický kraj";0;0;0;0;NA;83755;0;2020-09-05;252
2020-09-04;"Banskobystrický kraj";9;0;0;0;NA;83755;9;2020-09-04;252
2020-09-03;"Banskobystrický kraj";5;0;0;0;NA;83755;5;2020-09-03;243
2020-09-02;"Banskobystrický kraj";6;0;0;0;NA;83755;6;2020-09-02;238
2020-09-01;"Banskobystrický kraj";2;0;0;0;NA;83755;2;2020-09-01;232
2020-08-31;"Banskobystrický kraj";6;0;0;0;NA;83755;6;2020-08-31;230
2020-08-30;"Banskobystrický kraj";0;0;0;0;NA;83755;0;2020-08-30;224
2020-08-29;"Banskobystrický kraj";1;0;0;0;NA;83755;1;2020-08-29;224
2020-08-28;"Banskobystrický kraj";3;0;0;0;NA;83755;3;2020-08-28;223
2020-08-27;"Banskobystrický kraj";1;0;0;0;NA;83755;1;2020-08-27;220
2020-08-26;"Banskobystrický kraj";2;0;0;0;NA;83755;2;2020-08-26;219
2020-08-25;"Banskobystrický kraj";2;0;0;0;NA;83755;2;2020-08-25;217
2020-08-24;"Banskobystrický kraj";0;0;0;0;NA;83755;0;2020-08-24;215
2020-08-23;"Banskobystrický kraj";0;0;0;0;NA;83755;0;2020-08-23;215
2020-08-22;"Banskobystrický kraj";0;0;0;0;NA;83755;0;2020-08-22;215
2020-08-21;"Banskobystrický kraj";4;0;0;0;NA;83755;4;2020-08-21;215
2020-08-20;"Banskobystrický kraj";1;0;0;0;NA;83755;1;2020-08-20;211
2020-08-19;"Banskobystrický kraj";4;0;0;0;NA;83755;4;2020-08-19;210
2020-08-18;"Banskobystrický kraj";0;0;0;0;NA;83755;0;2020-08-18;206
2020-08-17;"Banskobystrický kraj";1;0;0;0;NA;83755;1;2020-08-17;206
2020-08-16;"Banskobystrický kraj";0;0;0;0;NA;83755;0;2020-08-16;205
2020-08-15;"Banskobystrický kraj";0;0;0;0;NA;83755;0;2020-08-15;205
2020-08-14;"Banskobystrický kraj";5;0;0;0;NA;83755;5;2020-08-14;205
2020-08-13;"Banskobystrický kraj";0;0;0;0;NA;83755;0;2020-08-13;200
2020-08-12;"Banskobystrický kraj";0;0;0;0;NA;83755;0;2020-08-12;200
2020-08-11;"Banskobystrický kraj";2;0;0;0;NA;83755;2;2020-08-11;200
2020-08-10;"Banskobystrický kraj";3;0;0;0;NA;83755;3;2020-08-10;198
2020-08-09;"Banskobystrický kraj";0;0;0;0;NA;83755;0;2020-08-09;195
2020-08-08;"Banskobystrický kraj";2;0;0;0;NA;83755;2;2020-08-08;195
2020-08-07;"Banskobystrický kraj";1;0;0;0;NA;83755;1;2020-08-07;193
2020-08-06;"Banskobystrický kraj";1;0;0;0;NA;83755;1;2020-08-06;192
2020-08-05;"Banskobystrický kraj";0;0;0;0;NA;83755;0;2020-08-05;191
2020-08-04;"Banskobystrický kraj";3;0;0;0;NA;83755;3;2020-08-04;191
2020-08-03;"Banskobystrický kraj";0;0;0;0;NA;83755;0;2020-08-03;188
2020-08-02;"Banskobystrický kraj";0;0;0;0;NA;83755;0;2020-08-02;188
2020-08-01;"Banskobystrický kraj";1;0;0;0;NA;83755;1;2020-08-01;188
2020-07-31;"Banskobystrický kraj";2;0;0;0;NA;83755;2;2020-07-31;187
2020-07-30;"Banskobystrický kraj";1;0;0;0;NA;83755;1;2020-07-30;185
2020-07-29;"Banskobystrický kraj";0;0;0;0;NA;83755;0;2020-07-29;184
2020-07-28;"Banskobystrický kraj";2;0;0;0;NA;83755;2;2020-07-28;184
2020-07-27;"Banskobystrický kraj";3;0;0;0;NA;83755;3;2020-07-27;182
2020-07-26;"Banskobystrický kraj";0;0;0;0;NA;83755;0;2020-07-26;179
2020-07-25;"Banskobystrický kraj";0;0;0;0;NA;83755;0;2020-07-25;179
2020-07-24;"Banskobystrický kraj";9;0;0;0;NA;83755;9;2020-07-24;179
2020-07-23;"Banskobystrický kraj";0;0;0;0;NA;83755;0;2020-07-23;170
2020-07-22;"Banskobystrický kraj";3;0;0;0;NA;83755;3;2020-07-22;170
2020-07-21;"Banskobystrický kraj";3;0;0;0;NA;83755;3;2020-07-21;167
2020-07-20;"Banskobystrický kraj";1;0;0;0;NA;83755;1;2020-07-20;164
2020-07-19;"Banskobystrický kraj";1;0;0;0;NA;83755;1;2020-07-19;163
2020-07-18;"Banskobystrický kraj";0;0;0;0;NA;83755;0;2020-07-18;162
2020-07-17;"Banskobystrický kraj";2;0;0;0;NA;83755;2;2020-07-17;162
2020-07-16;"Banskobystrický kraj";1;0;0;0;NA;83755;1;2020-07-16;160
2020-07-15;"Banskobystrický kraj";4;0;0;0;NA;83755;4;2020-07-15;159
2020-07-14;"Banskobystrický kraj";2;0;0;0;NA;83755;2;2020-07-14;155
2020-07-13;"Banskobystrický kraj";1;0;0;0;NA;83755;1;2020-07-13;153
2020-07-12;"Banskobystrický kraj";0;0;0;0;NA;83755;0;2020-07-12;152
2020-07-11;"Banskobystrický kraj";0;0;0;0;NA;83755;0;2020-07-11;152
2020-07-10;"Banskobystrický kraj";3;0;0;0;NA;83755;3;2020-07-10;152
2020-07-09;"Banskobystrický kraj";9;0;0;0;NA;83755;9;2020-07-09;149
2020-07-08;"Banskobystrický kraj";0;0;0;0;NA;83755;0;2020-07-08;140
2020-07-07;"Banskobystrický kraj";4;0;0;0;NA;83755;4;2020-07-07;140
2020-07-06;"Banskobystrický kraj";0;0;0;0;NA;83755;0;2020-07-06;136
2020-07-05;"Banskobystrický kraj";0;0;0;0;NA;83755;0;2020-07-05;136
2020-07-04;"Banskobystrický kraj";1;0;0;0;NA;83755;1;2020-07-04;136
2020-07-03;"Banskobystrický kraj";4;0;0;0;NA;83755;4;2020-07-03;135
2020-07-02;"Banskobystrický kraj";0;0;0;0;NA;83755;0;2020-07-02;131
2020-07-01;"Banskobystrický kraj";1;0;0;0;NA;83755;1;2020-07-01;131
2020-06-30;"Banskobystrický kraj";0;0;0;0;NA;83755;0;2020-06-30;130
2020-06-29;"Banskobystrický kraj";0;0;0;0;NA;83755;0;2020-06-29;130
2020-06-28;"Banskobystrický kraj";0;0;0;0;NA;83755;0;2020-06-28;130
2020-06-27;"Banskobystrický kraj";0;0;0;0;NA;83755;0;2020-06-27;130
2020-06-26;"Banskobystrický kraj";0;0;0;0;NA;83755;0;2020-06-26;130
2020-06-25;"Banskobystrický kraj";1;0;0;0;NA;83755;1;2020-06-25;130
2020-06-24;"Banskobystrický kraj";0;0;0;0;NA;83755;0;2020-06-24;129
2020-06-23;"Banskobystrický kraj";6;0;0;0;NA;83755;6;2020-06-23;129
2020-06-22;"Banskobystrický kraj";0;0;0;0;NA;83755;0;2020-06-22;123
2020-06-21;"Banskobystrický kraj";0;0;0;0;NA;83755;0;2020-06-21;123
2020-06-20;"Banskobystrický kraj";0;0;0;0;NA;83755;0;2020-06-20;123
2020-06-19;"Banskobystrický kraj";2;0;0;0;NA;83755;2;2020-06-19;123
2020-06-18;"Banskobystrický kraj";10;0;0;0;NA;83755;10;2020-06-18;121
2020-06-17;"Banskobystrický kraj";1;0;0;0;NA;83755;1;2020-06-17;111
2020-06-16;"Banskobystrický kraj";0;0;0;0;NA;83755;0;2020-06-16;110
2020-06-14;"Banskobystrický kraj";2;0;0;0;NA;83755;2;2020-06-14;110
2020-06-13;"Banskobystrický kraj";2;0;0;0;NA;83755;2;2020-06-13;108
2020-06-12;"Banskobystrický kraj";0;0;0;0;NA;83755;0;2020-06-12;106
2020-06-11;"Banskobystrický kraj";1;0;0;0;NA;83755;1;2020-06-11;106
2020-06-10;"Banskobystrický kraj";0;0;0;0;NA;83755;0;2020-06-10;105
2020-06-09;"Banskobystrický kraj";0;0;0;0;NA;83755;0;2020-06-09;105
2020-06-08;"Banskobystrický kraj";0;0;0;0;NA;83755;0;2020-06-08;105
2020-06-07;"Banskobystrický kraj";0;0;0;0;NA;83755;0;2020-06-07;105
2020-06-05;"Banskobystrický kraj";2;0;0;0;NA;83755;2;2020-06-05;105
2020-06-03;"Banskobystrický kraj";0;0;0;0;NA;83755;0;2020-06-03;103
2020-06-02;"Banskobystrický kraj";0;0;0;0;NA;83755;0;2020-06-02;103
2020-05-31;"Banskobystrický kraj";0;0;0;0;NA;83755;0;2020-05-31;103
2020-05-29;"Banskobystrický kraj";0;0;0;0;NA;83755;0;2020-05-29;103
2020-05-27;"Banskobystrický kraj";1;0;0;0;NA;83755;1;2020-05-27;103
2020-05-26;"Banskobystrický kraj";0;0;0;0;NA;83755;0;2020-05-26;102
2020-05-25;"Banskobystrický kraj";0;0;0;0;NA;83755;0;2020-05-25;102
2020-05-24;"Banskobystrický kraj";0;0;0;0;NA;83755;0;2020-05-24;102
2020-05-23;"Banskobystrický kraj";1;0;0;0;NA;83755;1;2020-05-23;102
2020-05-22;"Banskobystrický kraj";0;0;0;0;NA;83755;0;2020-05-22;101
2020-05-21;"Banskobystrický kraj";0;0;0;0;NA;83755;0;2020-05-21;101
2020-05-20;"Banskobystrický kraj";1;0;0;0;NA;83755;1;2020-05-20;101
2020-05-19;"Banskobystrický kraj";0;0;0;0;NA;83755;0;2020-05-19;100
2020-05-17;"Banskobystrický kraj";0;0;0;0;NA;83755;0;2020-05-17;100
2020-05-16;"Banskobystrický kraj";0;0;0;0;NA;83755;0;2020-05-16;100
2020-05-15;"Banskobystrický kraj";0;0;0;0;NA;83755;0;2020-05-15;100
2020-05-14;"Banskobystrický kraj";0;0;0;0;NA;83755;0;2020-05-14;100
2020-05-13;"Banskobystrický kraj";0;0;0;0;NA;83755;0;2020-05-13;100
2020-05-12;"Banskobystrický kraj";1;0;0;0;NA;83755;1;2020-05-12;100
2020-05-11;"Banskobystrický kraj";0;0;0;0;NA;83755;0;2020-05-11;99
2020-05-09;"Banskobystrický kraj";0;0;0;0;NA;83755;0;2020-05-09;99
2020-05-07;"Banskobystrický kraj";2;0;0;0;NA;83755;2;2020-05-07;99
2020-05-06;"Banskobystrický kraj";1;0;0;0;NA;83755;1;2020-05-06;97
2020-05-05;"Banskobystrický kraj";2;0;0;0;NA;83755;2;2020-05-05;96
2020-05-04;"Banskobystrický kraj";0;0;0;0;NA;83755;0;2020-05-04;94
2020-05-03;"Banskobystrický kraj";0;0;0;0;NA;83755;0;2020-05-03;94
2020-05-02;"Banskobystrický kraj";0;0;0;0;NA;83755;0;2020-05-02;94
2020-05-01;"Banskobystrický kraj";0;0;0;0;NA;83755;0;2020-05-01;94
2020-04-30;"Banskobystrický kraj";1;0;0;0;NA;83755;1;2020-04-30;94
2020-04-29;"Banskobystrický kraj";1;0;0;0;NA;83755;1;2020-04-29;93
2020-04-28;"Banskobystrický kraj";0;0;0;0;NA;83755;0;2020-04-28;92
2020-04-27;"Banskobystrický kraj";0;0;0;0;NA;83755;0;2020-04-27;92
2020-04-26;"Banskobystrický kraj";0;0;0;0;NA;83755;0;2020-04-26;92
2020-04-25;"Banskobystrický kraj";2;0;0;0;NA;83755;2;2020-04-25;92
2020-04-24;"Banskobystrický kraj";3;0;0;0;NA;83755;3;2020-04-24;90
2020-04-23;"Banskobystrický kraj";2;0;0;0;NA;83755;2;2020-04-23;87
2020-04-22;"Banskobystrický kraj";2;0;0;0;NA;83755;2;2020-04-22;85
2020-04-21;"Banskobystrický kraj";2;0;0;0;NA;83755;2;2020-04-21;83
2020-04-20;"Banskobystrický kraj";0;0;0;0;NA;83755;0;2020-04-20;81
2020-04-19;"Banskobystrický kraj";0;0;0;0;NA;83755;0;2020-04-19;81
2020-04-18;"Banskobystrický kraj";8;0;0;0;NA;83755;8;2020-04-18;81
2020-04-17;"Banskobystrický kraj";2;0;0;0;NA;83755;2;2020-04-17;73
2020-04-16;"Banskobystrický kraj";0;0;0;0;NA;83755;0;2020-04-16;71
2020-04-15;"Banskobystrický kraj";10;0;0;0;NA;83755;10;2020-04-15;71
2020-04-14;"Banskobystrický kraj";0;0;0;0;NA;83755;0;2020-04-14;61
2020-04-13;"Banskobystrický kraj";2;0;0;0;NA;83755;2;2020-04-13;61
2020-04-12;"Banskobystrický kraj";4;0;0;0;NA;83755;4;2020-04-12;59
2020-04-11;"Banskobystrický kraj";1;0;0;0;NA;83755;1;2020-04-11;55
2020-04-10;"Banskobystrický kraj";0;0;0;0;NA;83755;0;2020-04-10;54
2020-04-09;"Banskobystrický kraj";2;0;0;0;NA;83755;2;2020-04-09;54
2020-04-08;"Banskobystrický kraj";0;0;0;0;NA;83755;0;2020-04-08;52
2020-04-07;"Banskobystrický kraj";4;0;0;0;NA;83755;4;2020-04-07;52
2020-04-06;"Banskobystrický kraj";10;0;0;0;NA;83755;10;2020-04-06;48
2020-04-05;"Banskobystrický kraj";9;0;0;0;NA;83755;9;2020-04-05;38
2020-04-04;"Banskobystrický kraj";0;0;0;0;NA;83755;0;2020-04-04;29
2020-04-03;"Banskobystrický kraj";2;0;0;0;NA;83755;2;2020-04-03;29
2020-04-02;"Banskobystrický kraj";2;0;0;0;NA;83755;2;2020-04-02;27
2020-04-01;"Banskobystrický kraj";5;0;0;0;NA;83755;5;2020-04-01;25
2020-03-31;"Banskobystrický kraj";3;0;0;0;NA;83755;3;2020-03-31;20
2020-03-30;"Banskobystrický kraj";1;0;0;0;NA;83755;1;2020-03-30;17
2020-03-29;"Banskobystrický kraj";2;0;0;0;NA;83755;2;2020-03-29;16
2020-03-28;"Banskobystrický kraj";1;0;0;0;NA;83755;1;2020-03-28;14
2020-03-27;"Banskobystrický kraj";1;0;0;0;NA;83755;1;2020-03-27;13
2020-03-26;"Banskobystrický kraj";1;0;0;0;NA;83755;1;2020-03-26;12
2020-03-25;"Banskobystrický kraj";0;0;0;0;NA;83755;0;2020-03-25;11
2020-03-24;"Banskobystrický kraj";1;0;0;0;NA;83755;1;2020-03-24;11
2020-03-23;"Banskobystrický kraj";1;0;0;0;NA;83755;1;2020-03-23;10
2020-03-22;"Banskobystrický kraj";0;0;0;0;NA;83755;0;2020-03-22;9
2020-03-21;"Banskobystrický kraj";3;0;0;0;NA;83755;3;2020-03-21;9
2020-03-20;"Banskobystrický kraj";0;0;0;0;NA;83755;0;2020-03-20;6
2020-03-19;"Banskobystrický kraj";2;0;0;0;NA;83755;2;2020-03-19;6
2020-03-18;"Banskobystrický kraj";1;0;0;0;NA;83755;1;2020-03-18;4
2020-03-17;"Banskobystrický kraj";1;0;0;0;NA;83755;1;2020-03-17;3
2020-03-16;"Banskobystrický kraj";0;0;0;0;NA;83755;0;2020-03-16;2
2020-03-15;"Banskobystrický kraj";1;0;0;0;NA;83755;1;2020-03-15;2
2020-03-14;"Banskobystrický kraj";0;0;0;0;NA;83755;0;2020-03-14;1
2020-03-13;"Banskobystrický kraj";1;0;0;0;NA;83755;1;2020-03-13;1
2020-03-12;"Banskobystrický kraj";0;0;0;0;NA;83755;0;2020-03-12;0
2020-03-11;"Banskobystrický kraj";0;0;0;0;NA;83755;0;2020-03-11;0
2020-03-09;"Banskobystrický kraj";0;0;0;0;NA;83755;0;2020-03-09;0
2020-03-08;"Banskobystrický kraj";0;0;0;0;NA;83755;0;2020-03-08;0
2020-03-07;"Banskobystrický kraj";0;0;0;0;NA;83755;0;2020-03-07;0
2020-03-06;"Banskobystrický kraj";0;0;0;0;NA;83755;0;2020-03-06;0
2021-07-11;"Bratislavský kraj";3;1184;1;1185;44462;91203;4;2021-07-11;91203
2021-07-10;"Bratislavský kraj";5;1798;1;1799;NA;91203;6;2021-07-10;91199
2021-07-09;"Bratislavský kraj";13;3019;2;3021;NA;91203;15;2021-07-09;91193
2021-07-08;"Bratislavský kraj";9;2196;3;2199;NA;91203;12;2021-07-08;91178
2021-07-07;"Bratislavský kraj";5;2530;4;2534;NA;91203;9;2021-07-07;91166
2021-07-06;"Bratislavský kraj";19;2448;3;2451;NA;91203;22;2021-07-06;91157
2021-07-05;"Bratislavský kraj";5;2428;4;2432;NA;91203;9;2021-07-05;91135
2021-07-04;"Bratislavský kraj";3;1789;2;1791;NA;91203;5;2021-07-04;91126
2021-07-03;"Bratislavský kraj";8;2153;4;2157;NA;91203;12;2021-07-03;91121
2021-07-02;"Bratislavský kraj";4;2108;4;2112;NA;91203;8;2021-07-02;91109
2021-07-01;"Bratislavský kraj";6;1740;5;1745;NA;91203;11;2021-07-01;91101
2021-06-30;"Bratislavský kraj";2;11745;11;11756;NA;91203;13;2021-06-30;91090
2021-06-29;"Bratislavský kraj";5;5514;6;5520;NA;91203;11;2021-06-29;91077
2021-06-28;"Bratislavský kraj";16;7957;26;7983;NA;91203;42;2021-06-28;91066
2021-06-27;"Bratislavský kraj";4;6821;10;6831;NA;91203;14;2021-06-27;91024
2021-06-26;"Bratislavský kraj";3;7728;5;7733;NA;91203;8;2021-06-26;91010
2021-06-25;"Bratislavský kraj";7;9154;14;9168;NA;91203;21;2021-06-25;91002
2021-06-24;"Bratislavský kraj";3;7351;17;7368;NA;91203;20;2021-06-24;90981
2021-06-23;"Bratislavský kraj";4;7069;12;7081;NA;91203;16;2021-06-23;90961
2021-06-22;"Bratislavský kraj";6;6697;9;6706;NA;91203;15;2021-06-22;90945
2021-06-21;"Bratislavský kraj";5;7120;9;7129;NA;91203;14;2021-06-21;90930
2021-06-20;"Bratislavský kraj";0;7465;6;7471;NA;91203;6;2021-06-20;90916
2021-06-19;"Bratislavský kraj";3;8557;4;8561;NA;91203;7;2021-06-19;90910
2021-06-18;"Bratislavský kraj";5;12454;9;12463;NA;91203;14;2021-06-18;90903
2021-06-17;"Bratislavský kraj";3;8369;13;8382;NA;91203;16;2021-06-17;90889
2021-06-16;"Bratislavský kraj";3;7083;4;7087;NA;91203;7;2021-06-16;90873
2021-06-15;"Bratislavský kraj";7;7281;16;7297;NA;91203;23;2021-06-15;90866
2021-06-14;"Bratislavský kraj";4;8131;9;8140;NA;91203;13;2021-06-14;90843
2021-06-13;"Bratislavský kraj";2;8677;10;8687;NA;91203;12;2021-06-13;90830
2021-06-12;"Bratislavský kraj";4;10744;11;10755;NA;91203;15;2021-06-12;90818
2021-06-11;"Bratislavský kraj";9;13336;21;13357;NA;91203;30;2021-06-11;90803
2021-06-10;"Bratislavský kraj";12;8511;15;8526;NA;91203;27;2021-06-10;90773
2021-06-09;"Bratislavský kraj";12;7521;12;7533;NA;91203;24;2021-06-09;90746
2021-06-08;"Bratislavský kraj";13;7772;29;7801;NA;91203;42;2021-06-08;90722
2021-06-07;"Bratislavský kraj";13;9143;43;9186;NA;91203;56;2021-06-07;90680
2021-06-06;"Bratislavský kraj";3;10213;20;10233;NA;91203;23;2021-06-06;90624
2021-06-05;"Bratislavský kraj";2;12323;15;12338;NA;91203;17;2021-06-05;90601
2021-06-04;"Bratislavský kraj";10;13556;31;13587;NA;91203;41;2021-06-04;90584
2021-06-03;"Bratislavský kraj";12;9561;19;9580;NA;91203;31;2021-06-03;90543
2021-06-02;"Bratislavský kraj";10;8684;17;8701;NA;91203;27;2021-06-02;90512
2021-06-01;"Bratislavský kraj";3;8637;25;8662;NA;91203;28;2021-06-01;90485
2021-05-31;"Bratislavský kraj";18;11120;32;11152;NA;91203;50;2021-05-31;90457
2021-05-30;"Bratislavský kraj";1;11608;16;11624;NA;91203;17;2021-05-30;90407
2021-05-29;"Bratislavský kraj";4;11943;8;11951;NA;91203;12;2021-05-29;90390
2021-05-28;"Bratislavský kraj";14;15585;22;15607;NA;91203;36;2021-05-28;90378
2021-05-27;"Bratislavský kraj";5;11321;18;11339;NA;91203;23;2021-05-27;90342
2021-05-26;"Bratislavský kraj";20;10518;17;10535;NA;91203;37;2021-05-26;90319
2021-05-25;"Bratislavský kraj";19;11630;31;11661;NA;91203;50;2021-05-25;90282
2021-05-24;"Bratislavský kraj";12;12965;23;12988;NA;91203;35;2021-05-24;90232
2021-05-23;"Bratislavský kraj";7;12858;24;12882;NA;91203;31;2021-05-23;90197
2021-05-22;"Bratislavský kraj";6;13686;22;13708;NA;91203;28;2021-05-22;90166
2021-05-21;"Bratislavský kraj";15;18645;22;18667;NA;91203;37;2021-05-21;90138
2021-05-20;"Bratislavský kraj";15;13857;17;13874;NA;91203;32;2021-05-20;90101
2021-05-19;"Bratislavský kraj";21;11760;24;11784;NA;91203;45;2021-05-19;90069
2021-05-18;"Bratislavský kraj";14;12900;32;12932;NA;91203;46;2021-05-18;90024
2021-05-17;"Bratislavský kraj";15;13750;29;13779;NA;91203;44;2021-05-17;89978
2021-05-16;"Bratislavský kraj";12;19549;32;19581;NA;91203;44;2021-05-16;89934
2021-05-15;"Bratislavský kraj";1;17707;30;17737;NA;91203;31;2021-05-15;89890
2021-05-14;"Bratislavský kraj";15;21841;30;21871;NA;91203;45;2021-05-14;89859
2021-05-13;"Bratislavský kraj";9;16210;17;16227;NA;91203;26;2021-05-13;89814
2021-05-12;"Bratislavský kraj";11;14413;28;14441;NA;91203;39;2021-05-12;89788
2021-05-11;"Bratislavský kraj";29;16741;32;16773;NA;91203;61;2021-05-11;89749
2021-05-10;"Bratislavský kraj";27;19747;64;19811;NA;91203;91;2021-05-10;89688
2021-05-09;"Bratislavský kraj";9;29162;32;29194;NA;91203;41;2021-05-09;89597
2021-05-08;"Bratislavský kraj";5;19014;24;19038;NA;91203;29;2021-05-08;89556
2021-05-07;"Bratislavský kraj";32;27516;64;27580;NA;91203;96;2021-05-07;89527
2021-05-06;"Bratislavský kraj";19;20079;52;20131;NA;91203;71;2021-05-06;89431
2021-05-05;"Bratislavský kraj";29;15368;29;15397;NA;91203;58;2021-05-05;89360
2021-05-04;"Bratislavský kraj";46;19142;53;19195;NA;91203;99;2021-05-04;89302
2021-05-03;"Bratislavský kraj";37;22180;64;22244;NA;91203;101;2021-05-03;89203
2021-05-02;"Bratislavský kraj";38;43064;75;43139;NA;91203;113;2021-05-02;89102
2021-05-01;"Bratislavský kraj";11;39905;40;39945;NA;91203;51;2021-05-01;88989
2021-04-30;"Bratislavský kraj";43;47114;82;47196;NA;91203;125;2021-04-30;88938
2021-04-29;"Bratislavský kraj";48;30257;96;30353;NA;91203;144;2021-04-29;88813
2021-04-28;"Bratislavský kraj";40;28637;77;28714;NA;91203;117;2021-04-28;88669
2021-04-27;"Bratislavský kraj";41;30168;52;30220;NA;91203;93;2021-04-27;88552
2021-04-26;"Bratislavský kraj";59;34519;96;34615;NA;91203;155;2021-04-26;88459
2021-04-25;"Bratislavský kraj";8;57615;74;57689;NA;91203;82;2021-04-25;88304
2021-04-24;"Bratislavský kraj";28;74609;66;74675;NA;91203;94;2021-04-24;88222
2021-04-23;"Bratislavský kraj";70;48228;62;48290;NA;91203;132;2021-04-23;88128
2021-04-22;"Bratislavský kraj";39;31002;72;31074;NA;91203;111;2021-04-22;87996
2021-04-21;"Bratislavský kraj";48;30289;62;30351;NA;91203;110;2021-04-21;87885
2021-04-20;"Bratislavský kraj";58;34967;63;35030;NA;91203;121;2021-04-20;87775
2021-04-19;"Bratislavský kraj";48;39305;80;39385;NA;91203;128;2021-04-19;87654
2021-04-18;"Bratislavský kraj";35;62300;76;62376;NA;91203;111;2021-04-18;87526
2021-04-17;"Bratislavský kraj";13;80089;111;80200;NA;91203;124;2021-04-17;87415
2021-04-16;"Bratislavský kraj";62;47054;80;47134;NA;91203;142;2021-04-16;87291
2021-04-15;"Bratislavský kraj";34;31947;74;32021;NA;91203;108;2021-04-15;87149
2021-04-14;"Bratislavský kraj";65;33728;88;33816;NA;91203;153;2021-04-14;87041
2021-04-13;"Bratislavský kraj";82;35342;82;35424;NA;91203;164;2021-04-13;86888
2021-04-12;"Bratislavský kraj";77;42034;115;42149;NA;91203;192;2021-04-12;86724
2021-04-11;"Bratislavský kraj";42;61151;123;61274;NA;91203;165;2021-04-11;86532
2021-04-10;"Bratislavský kraj";14;77598;167;77765;NA;91203;181;2021-04-10;86367
2021-04-09;"Bratislavský kraj";72;41312;97;41409;NA;91203;169;2021-04-09;86186
2021-04-08;"Bratislavský kraj";71;28701;94;28795;NA;91203;165;2021-04-08;86017
2021-04-07;"Bratislavský kraj";96;37800;101;37901;NA;91203;197;2021-04-07;85852
2021-04-06;"Bratislavský kraj";94;55873;177;56050;NA;91203;271;2021-04-06;85655
2021-04-05;"Bratislavský kraj";85;18380;85;18465;NA;91203;170;2021-04-05;85384
2021-04-04;"Bratislavský kraj";37;29225;75;29300;NA;91203;112;2021-04-04;85214
2021-04-03;"Bratislavský kraj";52;79501;220;79721;NA;91203;272;2021-04-03;85102
2021-04-02;"Bratislavský kraj";33;23790;104;23894;NA;91203;137;2021-04-02;84830
2021-04-01;"Bratislavský kraj";119;57070;158;57228;NA;91203;277;2021-04-01;84693
2021-03-31;"Bratislavský kraj";105;45962;149;46111;NA;91203;254;2021-03-31;84416
2021-03-30;"Bratislavský kraj";100;39266;143;39409;NA;91203;243;2021-03-30;84162
2021-03-29;"Bratislavský kraj";153;40124;178;40302;NA;91203;331;2021-03-29;83919
2021-03-28;"Bratislavský kraj";59;53372;137;53509;NA;91203;196;2021-03-28;83588
2021-03-27;"Bratislavský kraj";53;79493;240;79733;NA;91203;293;2021-03-27;83392
2021-03-26;"Bratislavský kraj";114;55835;191;56026;NA;91203;305;2021-03-26;83099
2021-03-25;"Bratislavský kraj";76;36603;171;36774;NA;91203;247;2021-03-25;82794
2021-03-24;"Bratislavský kraj";120;30385;201;30586;NA;91203;321;2021-03-24;82547
2021-03-23;"Bratislavský kraj";138;36247;190;36437;NA;91203;328;2021-03-23;82226
2021-03-22;"Bratislavský kraj";110;42516;218;42734;NA;91203;328;2021-03-22;81898
2021-03-21;"Bratislavský kraj";54;61299;212;61511;NA;91203;266;2021-03-21;81570
2021-03-20;"Bratislavský kraj";59;72954;228;73182;NA;91203;287;2021-03-20;81304
2021-03-19;"Bratislavský kraj";139;54301;257;54558;NA;91203;396;2021-03-19;81017
2021-03-18;"Bratislavský kraj";142;34351;191;34542;NA;91203;333;2021-03-18;80621
2021-03-17;"Bratislavský kraj";177;30321;217;30538;NA;91203;394;2021-03-17;80288
2021-03-16;"Bratislavský kraj";258;36617;284;36901;NA;91203;542;2021-03-16;79894
2021-03-15;"Bratislavský kraj";180;37975;252;38227;NA;91203;432;2021-03-15;79352
2021-03-14;"Bratislavský kraj";75;52609;275;52884;NA;91203;350;2021-03-14;78920
2021-03-13;"Bratislavský kraj";110;80131;331;80462;NA;91203;441;2021-03-13;78570
2021-03-12;"Bratislavský kraj";152;54898;307;55205;NA;91203;459;2021-03-12;78129
2021-03-11;"Bratislavský kraj";178;34483;284;34767;NA;91203;462;2021-03-11;77670
2021-03-10;"Bratislavský kraj";164;30917;276;31193;NA;91203;440;2021-03-10;77208
2021-03-09;"Bratislavský kraj";242;37543;266;37809;NA;91203;508;2021-03-09;76768
2021-03-08;"Bratislavský kraj";255;40737;343;41080;NA;91203;598;2021-03-08;76260
2021-03-07;"Bratislavský kraj";142;52812;301;53113;NA;91203;443;2021-03-07;75662
2021-03-06;"Bratislavský kraj";79;71410;412;71822;NA;91203;491;2021-03-06;75219
2021-03-05;"Bratislavský kraj";238;50484;292;50776;NA;91203;530;2021-03-05;74728
2021-03-04;"Bratislavský kraj";204;34544;344;34888;NA;91203;548;2021-03-04;74198
2021-03-03;"Bratislavský kraj";250;30525;364;30889;NA;91203;614;2021-03-03;73650
2021-03-02;"Bratislavský kraj";267;39735;388;40123;NA;91203;655;2021-03-02;73036
2021-03-01;"Bratislavský kraj";320;38222;432;38654;NA;91203;752;2021-03-01;72381
2021-02-28;"Bratislavský kraj";184;50323;323;50646;NA;91203;507;2021-02-28;71629
2021-02-27;"Bratislavský kraj";151;76580;464;77044;NA;91203;615;2021-02-27;71122
2021-02-26;"Bratislavský kraj";277;47265;400;47665;NA;91203;677;2021-02-26;70507
2021-02-25;"Bratislavský kraj";277;28769;405;29174;NA;91203;682;2021-02-25;69830
2021-02-24;"Bratislavský kraj";217;27095;412;27507;NA;91203;629;2021-02-24;69148
2021-02-23;"Bratislavský kraj";257;31297;395;31692;NA;91203;652;2021-02-23;68519
2021-02-22;"Bratislavský kraj";353;36454;480;36934;NA;91203;833;2021-02-22;67867
2021-02-21;"Bratislavský kraj";185;54150;396;54546;NA;91203;581;2021-02-21;67034
2021-02-20;"Bratislavský kraj";167;74787;550;75337;NA;91203;717;2021-02-20;66453
2021-02-19;"Bratislavský kraj";280;44871;415;45286;NA;91203;695;2021-02-19;65736
2021-02-18;"Bratislavský kraj";263;26377;371;26748;NA;91203;634;2021-02-18;65041
2021-02-17;"Bratislavský kraj";264;22815;316;23131;NA;91203;580;2021-02-17;64407
2021-02-16;"Bratislavský kraj";289;28262;352;28614;NA;91203;641;2021-02-16;63827
2021-02-15;"Bratislavský kraj";248;36893;396;37289;NA;91203;644;2021-02-15;63186
2021-02-14;"Bratislavský kraj";153;47948;323;48271;NA;91203;476;2021-02-14;62542
2021-02-13;"Bratislavský kraj";173;68589;515;69104;NA;91203;688;2021-02-13;62066
2021-02-12;"Bratislavský kraj";282;35729;327;36056;NA;91203;609;2021-02-12;61378
2021-02-11;"Bratislavský kraj";337;24540;285;24825;NA;91203;622;2021-02-11;60769
2021-02-10;"Bratislavský kraj";314;22944;356;23300;NA;91203;670;2021-02-10;60147
2021-02-09;"Bratislavský kraj";288;36565;454;37019;NA;91203;742;2021-02-09;59477
2021-02-08;"Bratislavský kraj";484;31866;397;32263;NA;91203;881;2021-02-08;58735
2021-02-07;"Bratislavský kraj";243;51290;425;51715;NA;91203;668;2021-02-07;57854
2021-02-06;"Bratislavský kraj";116;61682;501;62183;NA;91203;617;2021-02-06;57186
2021-02-05;"Bratislavský kraj";327;27033;375;27408;NA;91203;702;2021-02-05;56569
2021-02-04;"Bratislavský kraj";555;17260;348;17608;NA;91203;903;2021-02-04;55867
2021-02-03;"Bratislavský kraj";161;13007;352;13359;NA;91203;513;2021-02-03;54964
2021-02-02;"Bratislavský kraj";397;25945;480;26425;NA;91203;877;2021-02-02;54451
2021-02-01;"Bratislavský kraj";221;35536;513;36049;NA;91203;734;2021-02-01;53574
2021-01-31;"Bratislavský kraj";180;35693;425;36118;NA;91203;605;2021-01-31;52840
2021-01-30;"Bratislavský kraj";310;49588;521;50109;NA;91203;831;2021-01-30;52235
2021-01-29;"Bratislavský kraj";344;16568;344;16912;NA;91203;688;2021-01-29;51404
2021-01-28;"Bratislavský kraj";307;10710;297;11007;NA;91203;604;2021-01-28;50716
2021-01-27;"Bratislavský kraj";336;22217;345;22562;NA;91203;681;2021-01-27;50112
2021-01-26;"Bratislavský kraj";297;21884;300;22184;NA;91203;597;2021-01-26;49431
2021-01-25;"Bratislavský kraj";356;23280;249;23529;NA;91203;605;2021-01-25;48834
2021-01-24;"Bratislavský kraj";175;37903;404;38307;NA;91203;579;2021-01-24;48229
2021-01-23;"Bratislavský kraj";396;79447;690;80137;NA;91203;1086;2021-01-23;47650
2021-01-22;"Bratislavský kraj";199;42055;365;42420;NA;91203;564;2021-01-22;46564
2021-01-21;"Bratislavský kraj";255;105751;1317;107068;NA;91203;1572;2021-01-21;46000
2021-01-20;"Bratislavský kraj";360;27289;452;27741;NA;91203;812;2021-01-20;44428
2021-01-19;"Bratislavský kraj";375;15318;346;15664;NA;91203;721;2021-01-19;43616
2021-01-18;"Bratislavský kraj";357;12533;707;13240;NA;91203;1064;2021-01-18;42895
2021-01-17;"Bratislavský kraj";244;482;26;508;NA;91203;270;2021-01-17;41831
2021-01-16;"Bratislavský kraj";70;3016;156;3172;NA;91203;226;2021-01-16;41561
2021-01-15;"Bratislavský kraj";251;7896;256;8152;NA;91203;507;2021-01-15;41335
2021-01-14;"Bratislavský kraj";363;8511;273;8784;NA;91203;636;2021-01-14;40828
2021-01-13;"Bratislavský kraj";336;8490;327;8817;NA;91203;663;2021-01-13;40192
2021-01-12;"Bratislavský kraj";450;10728;463;11191;NA;91203;913;2021-01-12;39529
2021-01-11;"Bratislavský kraj";397;20140;381;20521;NA;91203;778;2021-01-11;38616
2021-01-10;"Bratislavský kraj";252;1507;79;1586;NA;91203;331;2021-01-10;37838
2021-01-09;"Bratislavský kraj";351;5005;291;5296;NA;91203;642;2021-01-09;37507
2021-01-08;"Bratislavský kraj";556;10045;436;10481;NA;91203;992;2021-01-08;36865
2021-01-07;"Bratislavský kraj";537;7403;394;7797;NA;91203;931;2021-01-07;35873
2021-01-06;"Bratislavský kraj";271;3329;216;3545;NA;91203;487;2021-01-06;34942
2021-01-05;"Bratislavský kraj";619;10935;841;11776;NA;91203;1460;2021-01-05;34455
2021-01-04;"Bratislavský kraj";601;8540;601;9141;NA;91203;1202;2021-01-04;32995
2021-01-03;"Bratislavský kraj";77;433;41;474;NA;91203;118;2021-01-03;31793
2021-01-02;"Bratislavský kraj";185;462;57;519;NA;91203;242;2021-01-02;31675
2021-01-01;"Bratislavský kraj";235;3277;131;3408;NA;91203;366;2021-01-01;31433
2020-12-31;"Bratislavský kraj";925;14380;545;14925;NA;91203;1470;2020-12-31;31067
2020-12-30;"Bratislavský kraj";650;9823;554;10377;NA;91203;1204;2020-12-30;29597
2020-12-29;"Bratislavský kraj";303;10832;774;11606;NA;91203;1077;2020-12-29;28393
2020-12-28;"Bratislavský kraj";255;8363;555;8918;NA;91203;810;2020-12-28;27316
2020-12-27;"Bratislavský kraj";160;709;76;785;NA;91203;236;2020-12-27;26506
2020-12-26;"Bratislavský kraj";75;480;27;507;NA;91203;102;2020-12-26;26270
2020-12-25;"Bratislavský kraj";114;503;38;541;NA;91203;152;2020-12-25;26168
2020-12-24;"Bratislavský kraj";536;3367;104;3471;NA;91203;640;2020-12-24;26016
2020-12-23;"Bratislavský kraj";416;13471;503;13974;NA;91203;919;2020-12-23;25376
2020-12-22;"Bratislavský kraj";327;15712;767;16479;NA;91203;1094;2020-12-22;24457
2020-12-21;"Bratislavský kraj";392;15685;2007;17692;NA;91203;2399;2020-12-21;23363
2020-12-20;"Bratislavský kraj";180;797;57;854;NA;91203;237;2020-12-20;20964
2020-12-19;"Bratislavský kraj";396;3314;130;3444;NA;91203;526;2020-12-19;20727
2020-12-18;"Bratislavský kraj";306;10644;394;11038;NA;91203;700;2020-12-18;20201
2020-12-17;"Bratislavský kraj";502;10343;419;10762;NA;91203;921;2020-12-17;19501
2020-12-16;"Bratislavský kraj";282;10772;452;11224;NA;91203;734;2020-12-16;18580
2020-12-15;"Bratislavský kraj";423;10916;479;11395;NA;91203;902;2020-12-15;17846
2020-12-14;"Bratislavský kraj";279;7198;293;7491;NA;91203;572;2020-12-14;16944
2020-12-13;"Bratislavský kraj";125;139;10;149;NA;91203;135;2020-12-13;16372
2020-12-12;"Bratislavský kraj";361;3886;157;4043;NA;91203;518;2020-12-12;16237
2020-12-11;"Bratislavský kraj";326;7344;289;7633;NA;91203;615;2020-12-11;15719
2020-12-10;"Bratislavský kraj";286;5823;209;6032;NA;91203;495;2020-12-10;15104
2020-12-09;"Bratislavský kraj";382;4795;178;4973;NA;91203;560;2020-12-09;14609
2020-12-08;"Bratislavský kraj";234;6243;207;6450;NA;91203;441;2020-12-08;14049
2020-12-07;"Bratislavský kraj";272;4639;152;4791;NA;91203;424;2020-12-07;13608
2020-12-06;"Bratislavský kraj";61;1625;52;1677;NA;91203;113;2020-12-06;13184
2020-12-05;"Bratislavský kraj";266;2221;41;2262;NA;91203;307;2020-12-05;13071
2020-12-04;"Bratislavský kraj";200;4954;99;5053;NA;91203;299;2020-12-04;12764
2020-12-03;"Bratislavský kraj";213;5672;95;5767;NA;91203;308;2020-12-03;12465
2020-12-02;"Bratislavský kraj";205;3462;103;3565;NA;91203;308;2020-12-02;12157
2020-12-01;"Bratislavský kraj";255;3889;172;4061;NA;91203;427;2020-12-01;11849
2020-11-30;"Bratislavský kraj";152;2153;121;2274;NA;91203;273;2020-11-30;11422
2020-11-29;"Bratislavský kraj";52;201;24;225;NA;91203;76;2020-11-29;11149
2020-11-28;"Bratislavský kraj";232;2624;33;2657;NA;91203;265;2020-11-28;11073
2020-11-27;"Bratislavský kraj";54;2540;64;2604;NA;91203;118;2020-11-27;10808
2020-11-26;"Bratislavský kraj";129;1976;60;2036;NA;91203;189;2020-11-26;10690
2020-11-25;"Bratislavský kraj";140;1770;47;1817;NA;91203;187;2020-11-25;10501
2020-11-24;"Bratislavský kraj";81;2988;67;3055;NA;91203;148;2020-11-24;10314
2020-11-23;"Bratislavský kraj";67;7083;58;7141;NA;91203;125;2020-11-23;10166
2020-11-22;"Bratislavský kraj";36;81;7;88;NA;91203;43;2020-11-22;10041
2020-11-21;"Bratislavský kraj";109;2126;47;2173;NA;91203;156;2020-11-21;9998
2020-11-20;"Bratislavský kraj";118;2876;48;2924;NA;91203;166;2020-11-20;9842
2020-11-19;"Bratislavský kraj";173;987;29;1016;NA;91203;202;2020-11-19;9676
2020-11-18;"Bratislavský kraj";118;616;75;691;NA;91203;193;2020-11-18;9474
2020-11-17;"Bratislavský kraj";108;928;23;951;NA;91203;131;2020-11-17;9281
2020-11-16;"Bratislavský kraj";82;651;9;660;NA;91203;91;2020-11-16;9150
2020-11-15;"Bratislavský kraj";47;236;0;236;NA;91203;47;2020-11-15;9059
2020-11-14;"Bratislavský kraj";53;1834;15;1849;NA;91203;68;2020-11-14;9012
2020-11-13;"Bratislavský kraj";94;2096;21;2117;NA;91203;115;2020-11-13;8944
2020-11-12;"Bratislavský kraj";141;1727;6;1733;NA;91203;147;2020-11-12;8829
2020-11-11;"Bratislavský kraj";159;1429;12;1441;NA;91203;171;2020-11-11;8682
2020-11-10;"Bratislavský kraj";136;805;14;819;NA;91203;150;2020-11-10;8511
2020-11-09;"Bratislavský kraj";70;616;8;624;NA;91203;78;2020-11-09;8361
2020-11-08;"Bratislavský kraj";82;869;6;875;NA;91203;88;2020-11-08;8283
2020-11-07;"Bratislavský kraj";88;4039;17;4056;NA;91203;105;2020-11-07;8195
2020-11-06;"Bratislavský kraj";281;6441;25;6466;NA;91203;306;2020-11-06;8090
2020-11-05;"Bratislavský kraj";175;476;11;487;NA;91203;186;2020-11-05;7784
2020-11-04;"Bratislavský kraj";65;411;10;421;NA;91203;75;2020-11-04;7598
2020-11-03;"Bratislavský kraj";251;1085;12;1097;NA;91203;263;2020-11-03;7523
2020-11-02;"Bratislavský kraj";202;3365;22;3387;NA;91203;224;2020-11-02;7260
2020-11-01;"Bratislavský kraj";227;8694;39;8733;NA;91203;266;2020-11-01;7036
2020-10-31;"Bratislavský kraj";173;22407;123;22530;NA;91203;296;2020-10-31;6770
2020-10-30;"Bratislavský kraj";158;17350;138;17488;NA;91203;296;2020-10-30;6474
2020-10-29;"Bratislavský kraj";262;116;4;120;NA;91203;266;2020-10-29;6178
2020-10-28;"Bratislavský kraj";220;260;15;275;NA;91203;235;2020-10-28;5912
2020-10-27;"Bratislavský kraj";256;145;4;149;NA;91203;260;2020-10-27;5677
2020-10-26;"Bratislavský kraj";123;229;11;240;NA;91203;134;2020-10-26;5417
2020-10-25;"Bratislavský kraj";152;33;2;35;NA;91203;154;2020-10-25;5283
2020-10-24;"Bratislavský kraj";170;221;6;227;NA;91203;176;2020-10-24;5129
2020-10-23;"Bratislavský kraj";151;144;8;152;NA;91203;159;2020-10-23;4953
2020-10-22;"Bratislavský kraj";192;204;15;219;NA;91203;207;2020-10-22;4794
2020-10-21;"Bratislavský kraj";66;90;6;96;NA;91203;72;2020-10-21;4587
2020-10-20;"Bratislavský kraj";183;97;4;101;NA;91203;187;2020-10-20;4515
2020-10-19;"Bratislavský kraj";148;80;3;83;NA;91203;151;2020-10-19;4328
2020-10-18;"Bratislavský kraj";75;92;0;92;NA;91203;75;2020-10-18;4177
2020-10-17;"Bratislavský kraj";136;0;0;0;NA;91203;136;2020-10-17;4102
2020-10-16;"Bratislavský kraj";103;14;1;15;NA;91203;104;2020-10-16;3966
2020-10-15;"Bratislavský kraj";135;6;1;7;NA;91203;136;2020-10-15;3862
2020-10-14;"Bratislavský kraj";127;4;0;4;NA;91203;127;2020-10-14;3726
2020-10-13;"Bratislavský kraj";86;108;8;116;NA;91203;94;2020-10-13;3599
2020-10-12;"Bratislavský kraj";46;0;0;0;NA;91203;46;2020-10-12;3505
2020-10-11;"Bratislavský kraj";80;0;0;0;NA;91203;80;2020-10-11;3459
2020-10-10;"Bratislavský kraj";55;0;0;0;NA;91203;55;2020-10-10;3379
2020-10-09;"Bratislavský kraj";148;0;0;0;NA;91203;148;2020-10-09;3324
2020-10-08;"Bratislavský kraj";100;0;0;0;NA;91203;100;2020-10-08;3176
2020-10-07;"Bratislavský kraj";107;0;0;0;NA;91203;107;2020-10-07;3076
2020-10-06;"Bratislavský kraj";108;0;0;0;NA;91203;108;2020-10-06;2969
2020-10-05;"Bratislavský kraj";30;0;0;0;NA;91203;30;2020-10-05;2861
2020-10-04;"Bratislavský kraj";49;0;0;0;NA;91203;49;2020-10-04;2831
2020-10-03;"Bratislavský kraj";82;0;0;0;NA;91203;82;2020-10-03;2782
2020-10-02;"Bratislavský kraj";101;0;0;0;NA;91203;101;2020-10-02;2700
2020-10-01;"Bratislavský kraj";72;0;0;0;NA;91203;72;2020-10-01;2599
2020-09-30;"Bratislavský kraj";91;0;0;0;NA;91203;91;2020-09-30;2527
2020-09-29;"Bratislavský kraj";74;0;0;0;NA;91203;74;2020-09-29;2436
2020-09-28;"Bratislavský kraj";29;0;0;0;NA;91203;29;2020-09-28;2362
2020-09-27;"Bratislavský kraj";48;0;0;0;NA;91203;48;2020-09-27;2333
2020-09-26;"Bratislavský kraj";86;0;0;0;NA;91203;86;2020-09-26;2285
2020-09-25;"Bratislavský kraj";97;0;0;0;NA;91203;97;2020-09-25;2199
2020-09-24;"Bratislavský kraj";73;0;0;0;NA;91203;73;2020-09-24;2102
2020-09-23;"Bratislavský kraj";55;0;0;0;NA;91203;55;2020-09-23;2029
2020-09-22;"Bratislavský kraj";81;0;0;0;NA;91203;81;2020-09-22;1974
2020-09-21;"Bratislavský kraj";32;0;0;0;NA;91203;32;2020-09-21;1893
2020-09-20;"Bratislavský kraj";25;0;0;0;NA;91203;25;2020-09-20;1861
2020-09-19;"Bratislavský kraj";59;0;0;0;NA;91203;59;2020-09-19;1836
2020-09-18;"Bratislavský kraj";42;0;0;0;NA;91203;42;2020-09-18;1777
2020-09-17;"Bratislavský kraj";52;0;0;0;NA;91203;52;2020-09-17;1735
2020-09-16;"Bratislavský kraj";32;0;0;0;NA;91203;32;2020-09-16;1683
2020-09-15;"Bratislavský kraj";26;0;0;0;NA;91203;26;2020-09-15;1651
2020-09-14;"Bratislavský kraj";24;0;0;0;NA;91203;24;2020-09-14;1625
2020-09-13;"Bratislavský kraj";11;0;0;0;NA;91203;11;2020-09-13;1601
2020-09-12;"Bratislavský kraj";24;0;0;0;NA;91203;24;2020-09-12;1590
2020-09-11;"Bratislavský kraj";50;0;0;0;NA;91203;50;2020-09-11;1566
2020-09-10;"Bratislavský kraj";47;0;0;0;NA;91203;47;2020-09-10;1516
2020-09-09;"Bratislavský kraj";40;0;0;0;NA;91203;40;2020-09-09;1469
2020-09-08;"Bratislavský kraj";58;0;0;0;NA;91203;58;2020-09-08;1429
2020-09-07;"Bratislavský kraj";39;0;0;0;NA;91203;39;2020-09-07;1371
2020-09-06;"Bratislavský kraj";11;0;0;0;NA;91203;11;2020-09-06;1332
2020-09-05;"Bratislavský kraj";37;0;0;0;NA;91203;37;2020-09-05;1321
2020-09-04;"Bratislavský kraj";87;0;0;0;NA;91203;87;2020-09-04;1284
2020-09-03;"Bratislavský kraj";51;0;0;0;NA;91203;51;2020-09-03;1197
2020-09-02;"Bratislavský kraj";50;0;0;0;NA;91203;50;2020-09-02;1146
2020-09-01;"Bratislavský kraj";16;0;0;0;NA;91203;16;2020-09-01;1096
2020-08-31;"Bratislavský kraj";19;0;0;0;NA;91203;19;2020-08-31;1080
2020-08-30;"Bratislavský kraj";9;0;0;0;NA;91203;9;2020-08-30;1061
2020-08-29;"Bratislavský kraj";12;0;0;0;NA;91203;12;2020-08-29;1052
2020-08-28;"Bratislavský kraj";35;0;0;0;NA;91203;35;2020-08-28;1040
2020-08-27;"Bratislavský kraj";33;0;0;0;NA;91203;33;2020-08-27;1005
2020-08-26;"Bratislavský kraj";27;0;0;0;NA;91203;27;2020-08-26;972
2020-08-25;"Bratislavský kraj";29;0;0;0;NA;91203;29;2020-08-25;945
2020-08-24;"Bratislavský kraj";6;0;0;0;NA;91203;6;2020-08-24;916
2020-08-23;"Bratislavský kraj";45;0;0;0;NA;91203;45;2020-08-23;910
2020-08-22;"Bratislavský kraj";13;0;0;0;NA;91203;13;2020-08-22;865
2020-08-21;"Bratislavský kraj";46;0;0;0;NA;91203;46;2020-08-21;852
2020-08-20;"Bratislavský kraj";41;0;0;0;NA;91203;41;2020-08-20;806
2020-08-19;"Bratislavský kraj";27;0;0;0;NA;91203;27;2020-08-19;765
2020-08-18;"Bratislavský kraj";47;0;0;0;NA;91203;47;2020-08-18;738
2020-08-17;"Bratislavský kraj";2;0;0;0;NA;91203;2;2020-08-17;691
2020-08-16;"Bratislavský kraj";3;0;0;0;NA;91203;3;2020-08-16;689
2020-08-15;"Bratislavský kraj";18;0;0;0;NA;91203;18;2020-08-15;686
2020-08-14;"Bratislavský kraj";16;0;0;0;NA;91203;16;2020-08-14;668
2020-08-13;"Bratislavský kraj";12;0;0;0;NA;91203;12;2020-08-13;652
2020-08-12;"Bratislavský kraj";10;0;0;0;NA;91203;10;2020-08-12;640
2020-08-11;"Bratislavský kraj";23;0;0;0;NA;91203;23;2020-08-11;630
2020-08-10;"Bratislavský kraj";2;0;0;0;NA;91203;2;2020-08-10;607
2020-08-09;"Bratislavský kraj";2;0;0;0;NA;91203;2;2020-08-09;605
2020-08-08;"Bratislavský kraj";1;0;0;0;NA;91203;1;2020-08-08;603
2020-08-07;"Bratislavský kraj";9;0;0;0;NA;91203;9;2020-08-07;602
2020-08-06;"Bratislavský kraj";15;0;0;0;NA;91203;15;2020-08-06;593
2020-08-05;"Bratislavský kraj";11;0;0;0;NA;91203;11;2020-08-05;578
2020-08-04;"Bratislavský kraj";21;0;0;0;NA;91203;21;2020-08-04;567
2020-08-03;"Bratislavský kraj";7;0;0;0;NA;91203;7;2020-08-03;546
2020-08-02;"Bratislavský kraj";0;0;0;0;NA;91203;0;2020-08-02;539
2020-08-01;"Bratislavský kraj";0;0;0;0;NA;91203;0;2020-08-01;539
2020-07-31;"Bratislavský kraj";14;0;0;0;NA;91203;14;2020-07-31;539
2020-07-30;"Bratislavský kraj";6;0;0;0;NA;91203;6;2020-07-30;525
2020-07-29;"Bratislavský kraj";7;0;0;0;NA;91203;7;2020-07-29;519
2020-07-28;"Bratislavský kraj";14;0;0;0;NA;91203;14;2020-07-28;512
2020-07-27;"Bratislavský kraj";3;0;0;0;NA;91203;3;2020-07-27;498
2020-07-26;"Bratislavský kraj";0;0;0;0;NA;91203;0;2020-07-26;495
2020-07-25;"Bratislavský kraj";8;0;0;0;NA;91203;8;2020-07-25;495
2020-07-24;"Bratislavský kraj";2;0;0;0;NA;91203;2;2020-07-24;487
2020-07-23;"Bratislavský kraj";8;0;0;0;NA;91203;8;2020-07-23;485
2020-07-22;"Bratislavský kraj";11;0;0;0;NA;91203;11;2020-07-22;477
2020-07-21;"Bratislavský kraj";8;0;0;0;NA;91203;8;2020-07-21;466
2020-07-20;"Bratislavský kraj";12;0;0;0;NA;91203;12;2020-07-20;458
2020-07-19;"Bratislavský kraj";0;0;0;0;NA;91203;0;2020-07-19;446
2020-07-18;"Bratislavský kraj";2;0;0;0;NA;91203;2;2020-07-18;446
2020-07-17;"Bratislavský kraj";2;0;0;0;NA;91203;2;2020-07-17;444
2020-07-16;"Bratislavský kraj";6;0;0;0;NA;91203;6;2020-07-16;442
2020-07-15;"Bratislavský kraj";3;0;0;0;NA;91203;3;2020-07-15;436
2020-07-14;"Bratislavský kraj";2;0;0;0;NA;91203;2;2020-07-14;433
2020-07-13;"Bratislavský kraj";2;0;0;0;NA;91203;2;2020-07-13;431
2020-07-12;"Bratislavský kraj";0;0;0;0;NA;91203;0;2020-07-12;429
2020-07-11;"Bratislavský kraj";0;0;0;0;NA;91203;0;2020-07-11;429
2020-07-10;"Bratislavský kraj";8;0;0;0;NA;91203;8;2020-07-10;429
2020-07-09;"Bratislavský kraj";2;0;0;0;NA;91203;2;2020-07-09;421
2020-07-08;"Bratislavský kraj";11;0;0;0;NA;91203;11;2020-07-08;419
2020-07-07;"Bratislavský kraj";5;0;0;0;NA;91203;5;2020-07-07;408
2020-07-06;"Bratislavský kraj";1;0;0;0;NA;91203;1;2020-07-06;403
2020-07-05;"Bratislavský kraj";0;0;0;0;NA;91203;0;2020-07-05;402
2020-07-04;"Bratislavský kraj";3;0;0;0;NA;91203;3;2020-07-04;402
2020-07-03;"Bratislavský kraj";1;0;0;0;NA;91203;1;2020-07-03;399
2020-07-02;"Bratislavský kraj";0;0;0;0;NA;91203;0;2020-07-02;398
2020-07-01;"Bratislavský kraj";7;0;0;0;NA;91203;7;2020-07-01;398
2020-06-30;"Bratislavský kraj";3;0;0;0;NA;91203;3;2020-06-30;391
2020-06-29;"Bratislavský kraj";1;0;0;0;NA;91203;1;2020-06-29;388
2020-06-28;"Bratislavský kraj";0;0;0;0;NA;91203;0;2020-06-28;387
2020-06-27;"Bratislavský kraj";1;0;0;0;NA;91203;1;2020-06-27;387
2020-06-26;"Bratislavský kraj";6;0;0;0;NA;91203;6;2020-06-26;386
2020-06-25;"Bratislavský kraj";0;0;0;0;NA;91203;0;2020-06-25;380
2020-06-24;"Bratislavský kraj";3;0;0;0;NA;91203;3;2020-06-24;380
2020-06-23;"Bratislavský kraj";0;0;0;0;NA;91203;0;2020-06-23;377
2020-06-22;"Bratislavský kraj";1;0;0;0;NA;91203;1;2020-06-22;377
2020-06-21;"Bratislavský kraj";0;0;0;0;NA;91203;0;2020-06-21;376
2020-06-20;"Bratislavský kraj";0;0;0;0;NA;91203;0;2020-06-20;376
2020-06-19;"Bratislavský kraj";3;0;0;0;NA;91203;3;2020-06-19;376
2020-06-18;"Bratislavský kraj";0;0;0;0;NA;91203;0;2020-06-18;373
2020-06-17;"Bratislavský kraj";0;0;0;0;NA;91203;0;2020-06-17;373
2020-06-16;"Bratislavský kraj";0;0;0;0;NA;91203;0;2020-06-16;373
2020-06-14;"Bratislavský kraj";2;0;0;0;NA;91203;2;2020-06-14;373
2020-06-13;"Bratislavský kraj";1;0;0;0;NA;91203;1;2020-06-13;371
2020-06-12;"Bratislavský kraj";2;0;0;0;NA;91203;2;2020-06-12;370
2020-06-11;"Bratislavský kraj";0;0;0;0;NA;91203;0;2020-06-11;368
2020-06-10;"Bratislavský kraj";0;0;0;0;NA;91203;0;2020-06-10;368
2020-06-09;"Bratislavský kraj";0;0;0;0;NA;91203;0;2020-06-09;368
2020-06-08;"Bratislavský kraj";1;0;0;0;NA;91203;1;2020-06-08;368
2020-06-07;"Bratislavský kraj";0;0;0;0;NA;91203;0;2020-06-07;367
2020-06-05;"Bratislavský kraj";0;0;0;0;NA;91203;0;2020-06-05;367
2020-06-03;"Bratislavský kraj";1;0;0;0;NA;91203;1;2020-06-03;367
2020-06-02;"Bratislavský kraj";0;0;0;0;NA;91203;0;2020-06-02;366
2020-05-31;"Bratislavský kraj";0;0;0;0;NA;91203;0;2020-05-31;366
2020-05-29;"Bratislavský kraj";0;0;0;0;NA;91203;0;2020-05-29;366
2020-05-27;"Bratislavský kraj";1;0;0;0;NA;91203;1;2020-05-27;366
2020-05-26;"Bratislavský kraj";0;0;0;0;NA;91203;0;2020-05-26;365
2020-05-25;"Bratislavský kraj";0;0;0;0;NA;91203;0;2020-05-25;365
2020-05-24;"Bratislavský kraj";0;0;0;0;NA;91203;0;2020-05-24;365
2020-05-23;"Bratislavský kraj";2;0;0;0;NA;91203;2;2020-05-23;365
2020-05-22;"Bratislavský kraj";0;0;0;0;NA;91203;0;2020-05-22;363
2020-05-21;"Bratislavský kraj";0;0;0;0;NA;91203;0;2020-05-21;363
2020-05-20;"Bratislavský kraj";0;0;0;0;NA;91203;0;2020-05-20;363
2020-05-19;"Bratislavský kraj";0;0;0;0;NA;91203;0;2020-05-19;363
2020-05-17;"Bratislavský kraj";0;0;0;0;NA;91203;0;2020-05-17;363
2020-05-16;"Bratislavský kraj";0;0;0;0;NA;91203;0;2020-05-16;363
2020-05-15;"Bratislavský kraj";0;0;0;0;NA;91203;0;2020-05-15;363
2020-05-14;"Bratislavský kraj";0;0;0;0;NA;91203;0;2020-05-14;363
2020-05-13;"Bratislavský kraj";0;0;0;0;NA;91203;0;2020-05-13;363
2020-05-12;"Bratislavský kraj";2;0;0;0;NA;91203;2;2020-05-12;363
2020-05-11;"Bratislavský kraj";0;0;0;0;NA;91203;0;2020-05-11;361
2020-05-09;"Bratislavský kraj";0;0;0;0;NA;91203;0;2020-05-09;361
2020-05-07;"Bratislavský kraj";1;0;0;0;NA;91203;1;2020-05-07;361
2020-05-06;"Bratislavský kraj";3;0;0;0;NA;91203;3;2020-05-06;360
2020-05-05;"Bratislavský kraj";0;0;0;0;NA;91203;0;2020-05-05;357
2020-05-04;"Bratislavský kraj";0;0;0;0;NA;91203;0;2020-05-04;357
2020-05-03;"Bratislavský kraj";2;0;0;0;NA;91203;2;2020-05-03;357
2020-05-02;"Bratislavský kraj";0;0;0;0;NA;91203;0;2020-05-02;355
2020-05-01;"Bratislavský kraj";0;0;0;0;NA;91203;0;2020-05-01;355
2020-04-30;"Bratislavský kraj";5;0;0;0;NA;91203;5;2020-04-30;355
2020-04-29;"Bratislavský kraj";0;0;0;0;NA;91203;0;2020-04-29;350
2020-04-28;"Bratislavský kraj";2;0;0;0;NA;91203;2;2020-04-28;350
2020-04-27;"Bratislavský kraj";0;0;0;0;NA;91203;0;2020-04-27;348
2020-04-26;"Bratislavský kraj";1;0;0;0;NA;91203;1;2020-04-26;348
2020-04-25;"Bratislavský kraj";0;0;0;0;NA;91203;0;2020-04-25;347
2020-04-24;"Bratislavský kraj";2;0;0;0;NA;91203;2;2020-04-24;347
2020-04-23;"Bratislavský kraj";6;0;0;0;NA;91203;6;2020-04-23;345
2020-04-22;"Bratislavský kraj";11;0;0;0;NA;91203;11;2020-04-22;339
2020-04-21;"Bratislavský kraj";4;0;0;0;NA;91203;4;2020-04-21;328
2020-04-20;"Bratislavský kraj";0;0;0;0;NA;91203;0;2020-04-20;324
2020-04-19;"Bratislavský kraj";4;0;0;0;NA;91203;4;2020-04-19;324
2020-04-18;"Bratislavský kraj";5;0;0;0;NA;91203;5;2020-04-18;320
2020-04-17;"Bratislavský kraj";6;0;0;0;NA;91203;6;2020-04-17;315
2020-04-16;"Bratislavský kraj";15;0;0;0;NA;91203;15;2020-04-16;309
2020-04-15;"Bratislavský kraj";11;0;0;0;NA;91203;11;2020-04-15;294
2020-04-14;"Bratislavský kraj";19;0;0;0;NA;91203;19;2020-04-14;283
2020-04-13;"Bratislavský kraj";53;0;0;0;NA;91203;53;2020-04-13;264
2020-04-12;"Bratislavský kraj";3;0;0;0;NA;91203;3;2020-04-12;211
2020-04-11;"Bratislavský kraj";1;0;0;0;NA;91203;1;2020-04-11;208
2020-04-10;"Bratislavský kraj";8;0;0;0;NA;91203;8;2020-04-10;207
2020-04-09;"Bratislavský kraj";3;0;0;0;NA;91203;3;2020-04-09;199
2020-04-08;"Bratislavský kraj";3;0;0;0;NA;91203;3;2020-04-08;196
2020-04-07;"Bratislavský kraj";24;0;0;0;NA;91203;24;2020-04-07;193
2020-04-06;"Bratislavský kraj";5;0;0;0;NA;91203;5;2020-04-06;169
2020-04-05;"Bratislavský kraj";6;0;0;0;NA;91203;6;2020-04-05;164
2020-04-04;"Bratislavský kraj";2;0;0;0;NA;91203;2;2020-04-04;158
2020-04-03;"Bratislavský kraj";1;0;0;0;NA;91203;1;2020-04-03;156
2020-04-02;"Bratislavský kraj";2;0;0;0;NA;91203;2;2020-04-02;155
2020-04-01;"Bratislavský kraj";5;0;0;0;NA;91203;5;2020-04-01;153
2020-03-31;"Bratislavský kraj";19;0;0;0;NA;91203;19;2020-03-31;148
2020-03-30;"Bratislavský kraj";6;0;0;0;NA;91203;6;2020-03-30;129
2020-03-29;"Bratislavský kraj";8;0;0;0;NA;91203;8;2020-03-29;123
2020-03-28;"Bratislavský kraj";4;0;0;0;NA;91203;4;2020-03-28;115
2020-03-27;"Bratislavský kraj";3;0;0;0;NA;91203;3;2020-03-27;111
2020-03-26;"Bratislavský kraj";15;0;0;0;NA;91203;15;2020-03-26;108
2020-03-25;"Bratislavský kraj";1;0;0;0;NA;91203;1;2020-03-25;93
2020-03-24;"Bratislavský kraj";4;0;0;0;NA;91203;4;2020-03-24;92
2020-03-23;"Bratislavský kraj";9;0;0;0;NA;91203;9;2020-03-23;88
2020-03-22;"Bratislavský kraj";2;0;0;0;NA;91203;2;2020-03-22;79
2020-03-21;"Bratislavský kraj";22;0;0;0;NA;91203;22;2020-03-21;77
2020-03-20;"Bratislavský kraj";3;0;0;0;NA;91203;3;2020-03-20;55
2020-03-19;"Bratislavský kraj";4;0;0;0;NA;91203;4;2020-03-19;52
2020-03-18;"Bratislavský kraj";3;0;0;0;NA;91203;3;2020-03-18;48
2020-03-17;"Bratislavský kraj";13;0;0;0;NA;91203;13;2020-03-17;45
2020-03-16;"Bratislavský kraj";1;0;0;0;NA;91203;1;2020-03-16;32
2020-03-15;"Bratislavský kraj";4;0;0;0;NA;91203;4;2020-03-15;31
2020-03-14;"Bratislavský kraj";9;0;0;0;NA;91203;9;2020-03-14;27
2020-03-13;"Bratislavský kraj";2;0;0;0;NA;91203;2;2020-03-13;18
2020-03-12;"Bratislavský kraj";8;0;0;0;NA;91203;8;2020-03-12;16
2020-03-11;"Bratislavský kraj";3;0;0;0;NA;91203;3;2020-03-11;8
2020-03-09;"Bratislavský kraj";0;0;0;0;NA;91203;0;2020-03-09;5
2020-03-08;"Bratislavský kraj";2;0;0;0;NA;91203;2;2020-03-08;5
2020-03-07;"Bratislavský kraj";2;0;0;0;NA;91203;2;2020-03-07;3
2020-03-06;"Bratislavský kraj";1;0;0;0;NA;91203;1;2020-03-06;1
2021-07-11;"Košický kraj";1;570;2;572;52947;97729;3;2021-07-11;97729
2021-07-10;"Košický kraj";9;948;0;948;NA;97729;9;2021-07-10;97726
2021-07-09;"Košický kraj";5;1534;5;1539;NA;97729;10;2021-07-09;97717
2021-07-08;"Košický kraj";13;1070;2;1072;NA;97729;15;2021-07-08;97707
2021-07-07;"Košický kraj";6;1436;1;1437;NA;97729;7;2021-07-07;97692
2021-07-06;"Košický kraj";4;1704;2;1706;NA;97729;6;2021-07-06;97685
2021-07-05;"Košický kraj";1;516;0;516;NA;97729;1;2021-07-05;97679
2021-07-04;"Košický kraj";0;496;2;498;NA;97729;2;2021-07-04;97678
2021-07-03;"Košický kraj";2;1133;0;1133;NA;97729;2;2021-07-03;97676
2021-07-02;"Košický kraj";2;1723;3;1726;NA;97729;5;2021-07-02;97674
2021-07-01;"Košický kraj";0;1079;2;1081;NA;97729;2;2021-07-01;97669
2021-06-30;"Košický kraj";5;9031;7;9038;NA;97729;12;2021-06-30;97667
2021-06-29;"Košický kraj";6;5622;7;5629;NA;97729;13;2021-06-29;97655
2021-06-28;"Košický kraj";5;6125;2;6127;NA;97729;7;2021-06-28;97642
2021-06-27;"Košický kraj";8;4612;3;4615;NA;97729;11;2021-06-27;97635
2021-06-26;"Košický kraj";4;5869;14;5883;NA;97729;18;2021-06-26;97624
2021-06-25;"Košický kraj";5;6811;2;6813;NA;97729;7;2021-06-25;97606
2021-06-24;"Košický kraj";1;5101;3;5104;NA;97729;4;2021-06-24;97599
2021-06-23;"Košický kraj";8;5454;3;5457;NA;97729;11;2021-06-23;97595
2021-06-22;"Košický kraj";1;5173;3;5176;NA;97729;4;2021-06-22;97584
2021-06-21;"Košický kraj";5;6732;11;6743;NA;97729;16;2021-06-21;97580
2021-06-20;"Košický kraj";0;5014;6;5020;NA;97729;6;2021-06-20;97564
2021-06-19;"Košický kraj";7;6419;1;6420;NA;97729;8;2021-06-19;97558
2021-06-18;"Košický kraj";4;7741;8;7749;NA;97729;12;2021-06-18;97550
2021-06-17;"Košický kraj";6;6076;3;6079;NA;97729;9;2021-06-17;97538
2021-06-16;"Košický kraj";11;6002;7;6009;NA;97729;18;2021-06-16;97529
2021-06-15;"Košický kraj";12;6260;2;6262;NA;97729;14;2021-06-15;97511
2021-06-14;"Košický kraj";10;6984;9;6993;NA;97729;19;2021-06-14;97497
2021-06-13;"Košický kraj";7;6916;8;6924;NA;97729;15;2021-06-13;97478
2021-06-12;"Košický kraj";7;7424;9;7433;NA;97729;16;2021-06-12;97463
2021-06-11;"Košický kraj";15;8819;5;8824;NA;97729;20;2021-06-11;97447
2021-06-10;"Košický kraj";11;6540;16;6556;NA;97729;27;2021-06-10;97427
2021-06-09;"Košický kraj";37;5995;7;6002;NA;97729;44;2021-06-09;97400
2021-06-08;"Košický kraj";33;6954;13;6967;NA;97729;46;2021-06-08;97356
2021-06-07;"Košický kraj";11;7863;22;7885;NA;97729;33;2021-06-07;97310
2021-06-06;"Košický kraj";1;7803;7;7810;NA;97729;8;2021-06-06;97277
2021-06-05;"Košický kraj";21;9221;3;9224;NA;97729;24;2021-06-05;97269
2021-06-04;"Košický kraj";26;11262;20;11282;NA;97729;46;2021-06-04;97245
2021-06-03;"Košický kraj";23;6472;14;6486;NA;97729;37;2021-06-03;97199
2021-06-02;"Košický kraj";15;7114;24;7138;NA;97729;39;2021-06-02;97162
2021-06-01;"Košický kraj";13;7541;10;7551;NA;97729;23;2021-06-01;97123
2021-05-31;"Košický kraj";13;9224;17;9241;NA;97729;30;2021-05-31;97100
2021-05-30;"Košický kraj";3;11154;10;11164;NA;97729;13;2021-05-30;97070
2021-05-29;"Košický kraj";25;10863;21;10884;NA;97729;46;2021-05-29;97057
2021-05-28;"Košický kraj";17;12959;29;12988;NA;97729;46;2021-05-28;97011
2021-05-27;"Košický kraj";19;7810;24;7834;NA;97729;43;2021-05-27;96965
2021-05-26;"Košický kraj";35;8039;26;8065;NA;97729;61;2021-05-26;96922
2021-05-25;"Košický kraj";33;9148;12;9160;NA;97729;45;2021-05-25;96861
2021-05-24;"Košický kraj";10;10855;27;10882;NA;97729;37;2021-05-24;96816
2021-05-23;"Košický kraj";4;12084;15;12099;NA;97729;19;2021-05-23;96779
2021-05-22;"Košický kraj";27;12472;18;12490;NA;97729;45;2021-05-22;96760
2021-05-21;"Košický kraj";24;14753;27;14780;NA;97729;51;2021-05-21;96715
2021-05-20;"Košický kraj";20;9320;27;9347;NA;97729;47;2021-05-20;96664
2021-05-19;"Košický kraj";30;10346;19;10365;NA;97729;49;2021-05-19;96617
2021-05-18;"Košický kraj";34;10254;36;10290;NA;97729;70;2021-05-18;96568
2021-05-17;"Košický kraj";20;12628;38;12666;NA;97729;58;2021-05-17;96498
2021-05-16;"Košický kraj";37;17686;19;17705;NA;97729;56;2021-05-16;96440
2021-05-15;"Košický kraj";22;25399;27;25426;NA;97729;49;2021-05-15;96384
2021-05-14;"Košický kraj";32;21537;42;21579;NA;97729;74;2021-05-14;96335
2021-05-13;"Košický kraj";39;10172;32;10204;NA;97729;71;2021-05-13;96261
2021-05-12;"Košický kraj";85;10868;33;10901;NA;97729;118;2021-05-12;96190
2021-05-11;"Košický kraj";68;11166;32;11198;NA;97729;100;2021-05-11;96072
2021-05-10;"Košický kraj";25;16886;41;16927;NA;97729;66;2021-05-10;95972
2021-05-09;"Košický kraj";84;25262;53;25315;NA;97729;137;2021-05-09;95906
2021-05-08;"Košický kraj";18;22917;21;22938;NA;97729;39;2021-05-08;95769
2021-05-07;"Košický kraj";51;24097;55;24152;NA;97729;106;2021-05-07;95730
2021-05-06;"Košický kraj";55;11847;43;11890;NA;97729;98;2021-05-06;95624
2021-05-05;"Košický kraj";23;12004;35;12039;NA;97729;58;2021-05-05;95526
2021-05-04;"Košický kraj";143;13562;38;13600;NA;97729;181;2021-05-04;95468
2021-05-03;"Košický kraj";37;16944;68;17012;NA;97729;105;2021-05-03;95287
2021-05-02;"Košický kraj";45;36096;56;36152;NA;97729;101;2021-05-02;95182
2021-05-01;"Košický kraj";54;52075;76;52151;NA;97729;130;2021-05-01;95081
2021-04-30;"Košický kraj";59;44602;94;44696;NA;97729;153;2021-04-30;94951
2021-04-29;"Košický kraj";76;16986;53;17039;NA;97729;129;2021-04-29;94798
2021-04-28;"Košický kraj";99;17930;52;17982;NA;97729;151;2021-04-28;94669
2021-04-27;"Košický kraj";108;20670;43;20713;NA;97729;151;2021-04-27;94518
2021-04-26;"Košický kraj";39;25915;96;26011;NA;97729;135;2021-04-26;94367
2021-04-25;"Košický kraj";23;48355;57;48412;NA;97729;80;2021-04-25;94232
2021-04-24;"Košický kraj";68;90124;114;90238;NA;97729;182;2021-04-24;94152
2021-04-23;"Košický kraj";110;41232;72;41304;NA;97729;182;2021-04-23;93970
2021-04-22;"Košický kraj";56;16772;44;16816;NA;97729;100;2021-04-22;93788
2021-04-21;"Košický kraj";114;19519;61;19580;NA;97729;175;2021-04-21;93688
2021-04-20;"Košický kraj";81;25359;63;25422;NA;97729;144;2021-04-20;93513
2021-04-19;"Košický kraj";93;29950;108;30058;NA;97729;201;2021-04-19;93369
2021-04-18;"Košický kraj";10;48913;82;48995;NA;97729;92;2021-04-18;93168
2021-04-17;"Košický kraj";187;83856;103;83959;NA;97729;290;2021-04-17;93076
2021-04-16;"Košický kraj";83;41568;127;41695;NA;97729;210;2021-04-16;92786
2021-04-15;"Košický kraj";104;18522;93;18615;NA;97729;197;2021-04-15;92576
2021-04-14;"Košický kraj";119;20089;64;20153;NA;97729;183;2021-04-14;92379
2021-04-13;"Košický kraj";81;23175;120;23295;NA;97729;201;2021-04-13;92196
2021-04-12;"Košický kraj";129;26573;124;26697;NA;97729;253;2021-04-12;91995
2021-04-11;"Košický kraj";29;46948;79;47027;NA;97729;108;2021-04-11;91742
2021-04-10;"Košický kraj";138;99836;183;100019;NA;97729;321;2021-04-10;91634
2021-04-09;"Košický kraj";168;35206;133;35339;NA;97729;301;2021-04-09;91313
2021-04-08;"Košický kraj";81;18530;90;18620;NA;97729;171;2021-04-08;91012
2021-04-07;"Košický kraj";232;28027;194;28221;NA;97729;426;2021-04-07;90841
2021-04-06;"Košický kraj";121;36495;164;36659;NA;97729;285;2021-04-06;90415
2021-04-05;"Košický kraj";19;14361;66;14427;NA;97729;85;2021-04-05;90130
2021-04-04;"Košický kraj";33;15089;66;15155;NA;97729;99;2021-04-04;90045
2021-04-03;"Košický kraj";138;97664;241;97905;NA;97729;379;2021-04-03;89946
2021-04-02;"Košický kraj";128;24290;76;24366;NA;97729;204;2021-04-02;89567
2021-04-01;"Košický kraj";165;46151;156;46307;NA;97729;321;2021-04-01;89363
2021-03-31;"Košický kraj";160;29659;124;29783;NA;97729;284;2021-03-31;89042
2021-03-30;"Košický kraj";229;24038;163;24201;NA;97729;392;2021-03-30;88758
2021-03-29;"Košický kraj";78;28843;194;29037;NA;97729;272;2021-03-29;88366
2021-03-28;"Košický kraj";39;44263;128;44391;NA;97729;167;2021-03-28;88094
2021-03-27;"Košický kraj";222;96602;265;96867;NA;97729;487;2021-03-27;87927
2021-03-26;"Košický kraj";233;45252;202;45454;NA;97729;435;2021-03-26;87440
2021-03-25;"Košický kraj";133;23804;175;23979;NA;97729;308;2021-03-25;87005
2021-03-24;"Košický kraj";165;20677;155;20832;NA;97729;320;2021-03-24;86697
2021-03-23;"Košický kraj";202;22434;192;22626;NA;97729;394;2021-03-23;86377
2021-03-22;"Košický kraj";169;26890;228;27118;NA;97729;397;2021-03-22;85983
2021-03-21;"Košický kraj";109;46746;167;46913;NA;97729;276;2021-03-21;85586
2021-03-20;"Košický kraj";126;101334;311;101645;NA;97729;437;2021-03-20;85310
2021-03-19;"Košický kraj";205;45632;260;45892;NA;97729;465;2021-03-19;84873
2021-03-18;"Košický kraj";274;23823;212;24035;NA;97729;486;2021-03-18;84408
2021-03-17;"Košický kraj";177;21548;195;21743;NA;97729;372;2021-03-17;83922
2021-03-16;"Košický kraj";386;23431;226;23657;NA;97729;612;2021-03-16;83550
2021-03-15;"Košický kraj";173;27900;297;28197;NA;97729;470;2021-03-15;82938
2021-03-14;"Košický kraj";145;44354;220;44574;NA;97729;365;2021-03-14;82468
2021-03-13;"Košický kraj";146;103790;483;104273;NA;97729;629;2021-03-13;82103
2021-03-12;"Košický kraj";366;47871;321;48192;NA;97729;687;2021-03-12;81474
2021-03-11;"Košický kraj";396;23229;263;23492;NA;97729;659;2021-03-11;80787
2021-03-10;"Košický kraj";121;22191;269;22460;NA;97729;390;2021-03-10;80128
2021-03-09;"Košický kraj";676;24509;300;24809;NA;97729;976;2021-03-09;79738
2021-03-08;"Košický kraj";559;29836;344;30180;NA;97729;903;2021-03-08;78762
2021-03-07;"Košický kraj";45;44230;299;44529;NA;97729;344;2021-03-07;77859
2021-03-06;"Košický kraj";177;105598;532;106130;NA;97729;709;2021-03-06;77515
2021-03-05;"Košický kraj";439;45567;424;45991;NA;97729;863;2021-03-05;76806
2021-03-04;"Košický kraj";417;23862;320;24182;NA;97729;737;2021-03-04;75943
2021-03-03;"Košický kraj";390;23168;298;23466;NA;97729;688;2021-03-03;75206
2021-03-02;"Košický kraj";464;24150;368;24518;NA;97729;832;2021-03-02;74518
2021-03-01;"Košický kraj";389;30013;514;30527;NA;97729;903;2021-03-01;73686
2021-02-28;"Košický kraj";265;43053;334;43387;NA;97729;599;2021-02-28;72783
2021-02-27;"Košický kraj";301;100559;784;101343;NA;97729;1085;2021-02-27;72184
2021-02-26;"Košický kraj";440;45466;492;45958;NA;97729;932;2021-02-26;71099
2021-02-25;"Košický kraj";331;19872;342;20214;NA;97729;673;2021-02-25;70167
2021-02-24;"Košický kraj";263;18751;505;19256;NA;97729;768;2021-02-24;69494
2021-02-23;"Košický kraj";642;21592;341;21933;NA;97729;983;2021-02-23;68726
2021-02-22;"Košický kraj";362;30830;434;31264;NA;97729;796;2021-02-22;67743
2021-02-21;"Košický kraj";170;40464;385;40849;NA;97729;555;2021-02-21;66947
2021-02-20;"Košický kraj";283;92550;770;93320;NA;97729;1053;2021-02-20;66392
2021-02-19;"Košický kraj";507;41579;583;42162;NA;97729;1090;2021-02-19;65339
2021-02-18;"Košický kraj";397;18442;345;18787;NA;97729;742;2021-02-18;64249
2021-02-17;"Košický kraj";322;18080;387;18467;NA;97729;709;2021-02-17;63507
2021-02-16;"Košický kraj";600;22111;463;22574;NA;97729;1063;2021-02-16;62798
2021-02-15;"Košický kraj";216;27633;419;28052;NA;97729;635;2021-02-15;61735
2021-02-14;"Košický kraj";241;56743;524;57267;NA;97729;765;2021-02-14;61100
2021-02-13;"Košický kraj";206;93745;765;94510;NA;97729;971;2021-02-13;60335
2021-02-12;"Košický kraj";448;49924;611;50535;NA;97729;1059;2021-02-12;59364
2021-02-11;"Košický kraj";435;14524;323;14847;NA;97729;758;2021-02-11;58305
2021-02-10;"Košický kraj";360;18475;431;18906;NA;97729;791;2021-02-10;57547
2021-02-09;"Košický kraj";544;24841;463;25304;NA;97729;1007;2021-02-09;56756
2021-02-08;"Košický kraj";237;24836;392;25228;NA;97729;629;2021-02-08;55749
2021-02-07;"Košický kraj";208;56897;612;57509;NA;97729;820;2021-02-07;55120
2021-02-06;"Košický kraj";318;104357;884;105241;NA;97729;1202;2021-02-06;54300
2021-02-05;"Košický kraj";384;43186;494;43680;NA;97729;878;2021-02-05;53098
2021-02-04;"Košický kraj";391;14508;371;14879;NA;97729;762;2021-02-04;52220
2021-02-03;"Košický kraj";296;12599;339;12938;NA;97729;635;2021-02-03;51458
2021-02-02;"Košický kraj";473;43883;1212;45095;NA;97729;1685;2021-02-02;50823
2021-02-01;"Košický kraj";415;21965;362;22327;NA;97729;777;2021-02-01;49138
2021-01-31;"Košický kraj";142;54154;609;54763;NA;97729;751;2021-01-31;48361
2021-01-30;"Košický kraj";320;76722;661;77383;NA;97729;981;2021-01-30;47610
2021-01-29;"Košický kraj";311;37130;466;37596;NA;97729;777;2021-01-29;46629
2021-01-28;"Košický kraj";540;9006;244;9250;NA;97729;784;2021-01-28;45852
2021-01-27;"Košický kraj";265;7575;211;7786;NA;97729;476;2021-01-27;45068
2021-01-26;"Košický kraj";530;14210;245;14455;NA;97729;775;2021-01-26;44592
2021-01-25;"Košický kraj";226;26430;413;26843;NA;97729;639;2021-01-25;43817
2021-01-24;"Košický kraj";150;44419;581;45000;NA;97729;731;2021-01-24;43178
2021-01-23;"Košický kraj";232;82705;857;83562;NA;97729;1089;2021-01-23;42447
2021-01-22;"Košický kraj";316;19997;265;20262;NA;97729;581;2021-01-22;41358
2021-01-21;"Košický kraj";274;14047;158;14205;NA;97729;432;2021-01-21;40777
2021-01-20;"Košický kraj";374;10843;201;11044;NA;97729;575;2021-01-20;40345
2021-01-19;"Košický kraj";248;9717;181;9898;NA;97729;429;2021-01-19;39770
2021-01-18;"Košický kraj";333;7659;262;7921;NA;97729;595;2021-01-18;39341
2021-01-17;"Košický kraj";155;535;14;549;NA;97729;169;2021-01-17;38746
2021-01-16;"Košický kraj";153;1403;47;1450;NA;97729;200;2021-01-16;38577
2021-01-15;"Košický kraj";308;6443;213;6656;NA;97729;521;2021-01-15;38377
2021-01-14;"Košický kraj";358;5471;221;5692;NA;97729;579;2021-01-14;37856
2021-01-13;"Košický kraj";421;4897;226;5123;NA;97729;647;2021-01-13;37277
2021-01-12;"Košický kraj";482;6784;259;7043;NA;97729;741;2021-01-12;36630
2021-01-11;"Košický kraj";309;7945;304;8249;NA;97729;613;2021-01-11;35889
2021-01-10;"Košický kraj";193;136;6;142;NA;97729;199;2021-01-10;35276
2021-01-09;"Košický kraj";469;1134;45;1179;NA;97729;514;2021-01-09;35077
2021-01-08;"Košický kraj";551;8222;388;8610;NA;97729;939;2021-01-08;34563
2021-01-07;"Košický kraj";251;6566;434;7000;NA;97729;685;2021-01-07;33624
2021-01-06;"Košický kraj";442;429;33;462;NA;97729;475;2021-01-06;32939
2021-01-05;"Košický kraj";584;8100;560;8660;NA;97729;1144;2021-01-05;32464
2021-01-04;"Košický kraj";407;7113;737;7850;NA;97729;1144;2021-01-04;31320
2021-01-03;"Košický kraj";118;661;22;683;NA;97729;140;2021-01-03;30176
2021-01-02;"Košický kraj";88;440;52;492;NA;97729;140;2021-01-02;30036
2021-01-01;"Košický kraj";398;725;49;774;NA;97729;447;2021-01-01;29896
2020-12-31;"Košický kraj";625;7877;461;8338;NA;97729;1086;2020-12-31;29449
2020-12-30;"Košický kraj";590;6477;412;6889;NA;97729;1002;2020-12-30;28363
2020-12-29;"Košický kraj";419;7573;605;8178;NA;97729;1024;2020-12-29;27361
2020-12-28;"Košický kraj";356;8296;804;9100;NA;97729;1160;2020-12-28;26337
2020-12-27;"Košický kraj";159;147;16;163;NA;97729;175;2020-12-27;25177
2020-12-26;"Košický kraj";163;274;23;297;NA;97729;186;2020-12-26;25002
2020-12-25;"Košický kraj";237;140;10;150;NA;97729;247;2020-12-25;24816
2020-12-24;"Košický kraj";564;1470;90;1560;NA;97729;654;2020-12-24;24569
2020-12-23;"Košický kraj";304;7942;354;8296;NA;97729;658;2020-12-23;23915
2020-12-22;"Košický kraj";438;7920;459;8379;NA;97729;897;2020-12-22;23257
2020-12-21;"Košický kraj";405;6984;509;7493;NA;97729;914;2020-12-21;22360
2020-12-20;"Košický kraj";215;73;11;84;NA;97729;226;2020-12-20;21446
2020-12-19;"Košický kraj";207;1309;63;1372;NA;97729;270;2020-12-19;21220
2020-12-18;"Košický kraj";310;8484;326;8810;NA;97729;636;2020-12-18;20950
2020-12-17;"Košický kraj";463;5292;255;5547;NA;97729;718;2020-12-17;20314
2020-12-16;"Košický kraj";455;5898;316;6214;NA;97729;771;2020-12-16;19596
2020-12-15;"Košický kraj";319;5086;338;5424;NA;97729;657;2020-12-15;18825
2020-12-14;"Košický kraj";256;3401;264;3665;NA;97729;520;2020-12-14;18168
2020-12-13;"Košický kraj";47;181;2;183;NA;97729;49;2020-12-13;17648
2020-12-12;"Košický kraj";369;1587;118;1705;NA;97729;487;2020-12-12;17599
2020-12-11;"Košický kraj";354;5461;258;5719;NA;97729;612;2020-12-11;17112
2020-12-10;"Košický kraj";283;4064;176;4240;NA;97729;459;2020-12-10;16500
2020-12-09;"Košický kraj";279;3786;166;3952;NA;97729;445;2020-12-09;16041
2020-12-08;"Košický kraj";226;4105;355;4460;NA;97729;581;2020-12-08;15596
2020-12-07;"Košický kraj";270;2383;106;2489;NA;97729;376;2020-12-07;15015
2020-12-06;"Košický kraj";121;97;20;117;NA;97729;141;2020-12-06;14639
2020-12-05;"Košický kraj";90;1096;48;1144;NA;97729;138;2020-12-05;14498
2020-12-04;"Košický kraj";224;2680;82;2762;NA;97729;306;2020-12-04;14360
2020-12-03;"Košický kraj";211;7717;173;7890;NA;97729;384;2020-12-03;14054
2020-12-02;"Košický kraj";193;8132;496;8628;NA;97729;689;2020-12-02;13670
2020-12-01;"Košický kraj";178;2237;124;2361;NA;97729;302;2020-12-01;12981
2020-11-30;"Košický kraj";171;3754;62;3816;NA;97729;233;2020-11-30;12679
2020-11-29;"Košický kraj";31;325;17;342;NA;97729;48;2020-11-29;12446
2020-11-28;"Košický kraj";69;721;52;773;NA;97729;121;2020-11-28;12398
2020-11-27;"Košický kraj";149;2921;78;2999;NA;97729;227;2020-11-27;12277
2020-11-26;"Košický kraj";239;1234;60;1294;NA;97729;299;2020-11-26;12050
2020-11-25;"Košický kraj";237;1785;123;1908;NA;97729;360;2020-11-25;11751
2020-11-24;"Košický kraj";196;1976;67;2043;NA;97729;263;2020-11-24;11391
2020-11-23;"Košický kraj";51;4115;63;4178;NA;97729;114;2020-11-23;11128
2020-11-22;"Košický kraj";57;57;5;62;NA;97729;62;2020-11-22;11014
2020-11-21;"Košický kraj";87;858;36;894;NA;97729;123;2020-11-21;10952
2020-11-20;"Košický kraj";176;3084;49;3133;NA;97729;225;2020-11-20;10829
2020-11-19;"Košický kraj";206;1736;48;1784;NA;97729;254;2020-11-19;10604
2020-11-18;"Košický kraj";122;532;17;549;NA;97729;139;2020-11-18;10350
2020-11-17;"Košický kraj";152;82;9;91;NA;97729;161;2020-11-17;10211
2020-11-16;"Košický kraj";114;596;27;623;NA;97729;141;2020-11-16;10050
2020-11-15;"Košický kraj";15;338;7;345;NA;97729;22;2020-11-15;9909
2020-11-14;"Košický kraj";234;520;12;532;NA;97729;246;2020-11-14;9887
2020-11-13;"Košický kraj";207;664;29;693;NA;97729;236;2020-11-13;9641
2020-11-12;"Košický kraj";192;736;13;749;NA;97729;205;2020-11-12;9405
2020-11-11;"Košický kraj";301;593;7;600;NA;97729;308;2020-11-11;9200
2020-11-10;"Košický kraj";190;541;11;552;NA;97729;201;2020-11-10;8892
2020-11-09;"Košický kraj";129;380;17;397;NA;97729;146;2020-11-09;8691
2020-11-08;"Košický kraj";78;1306;8;1314;NA;97729;86;2020-11-08;8545
2020-11-07;"Košický kraj";192;3909;22;3931;NA;97729;214;2020-11-07;8459
2020-11-06;"Košický kraj";195;5310;34;5344;NA;97729;229;2020-11-06;8245
2020-11-05;"Košický kraj";342;330;31;361;NA;97729;373;2020-11-05;8016
2020-11-04;"Košický kraj";101;154;6;160;NA;97729;107;2020-11-04;7643
2020-11-03;"Košický kraj";358;1122;13;1135;NA;97729;371;2020-11-03;7536
2020-11-02;"Košický kraj";111;6125;56;6181;NA;97729;167;2020-11-02;7165
2020-11-01;"Košický kraj";346;6522;34;6556;NA;97729;380;2020-11-01;6998
2020-10-31;"Košický kraj";82;14035;106;14141;NA;97729;188;2020-10-31;6618
2020-10-30;"Košický kraj";379;2835;27;2862;NA;97729;406;2020-10-30;6430
2020-10-29;"Košický kraj";333;983;13;996;NA;97729;346;2020-10-29;6024
2020-10-28;"Košický kraj";224;305;13;318;NA;97729;237;2020-10-28;5678
2020-10-27;"Košický kraj";386;439;21;460;NA;97729;407;2020-10-27;5441
2020-10-26;"Košický kraj";56;212;12;224;NA;97729;68;2020-10-26;5034
2020-10-25;"Košický kraj";154;79;2;81;NA;97729;156;2020-10-25;4966
2020-10-24;"Košický kraj";313;118;16;134;NA;97729;329;2020-10-24;4810
2020-10-23;"Košický kraj";315;331;8;339;NA;97729;323;2020-10-23;4481
2020-10-22;"Košický kraj";349;530;16;546;NA;97729;365;2020-10-22;4158
2020-10-21;"Košický kraj";129;84;2;86;NA;97729;131;2020-10-21;3793
2020-10-20;"Košický kraj";181;14;1;15;NA;97729;182;2020-10-20;3662
2020-10-19;"Košický kraj";64;38;1;39;NA;97729;65;2020-10-19;3480
2020-10-18;"Košický kraj";158;0;0;0;NA;97729;158;2020-10-18;3415
2020-10-17;"Košický kraj";142;0;0;0;NA;97729;142;2020-10-17;3257
2020-10-16;"Košický kraj";206;19;0;19;NA;97729;206;2020-10-16;3115
2020-10-15;"Košický kraj";177;19;5;24;NA;97729;182;2020-10-15;2909
2020-10-14;"Košický kraj";211;8;0;8;NA;97729;211;2020-10-14;2727
2020-10-13;"Košický kraj";179;80;3;83;NA;97729;182;2020-10-13;2516
2020-10-12;"Košický kraj";74;0;0;0;NA;97729;74;2020-10-12;2334
2020-10-11;"Košický kraj";121;0;0;0;NA;97729;121;2020-10-11;2260
2020-10-10;"Košický kraj";70;0;0;0;NA;97729;70;2020-10-10;2139
2020-10-09;"Košický kraj";188;0;0;0;NA;97729;188;2020-10-09;2069
2020-10-08;"Košický kraj";102;0;0;0;NA;97729;102;2020-10-08;1881
2020-10-07;"Košický kraj";158;0;0;0;NA;97729;158;2020-10-07;1779
2020-10-06;"Košický kraj";70;0;0;0;NA;97729;70;2020-10-06;1621
2020-10-05;"Košický kraj";39;0;0;0;NA;97729;39;2020-10-05;1551
2020-10-04;"Košický kraj";45;0;0;0;NA;97729;45;2020-10-04;1512
2020-10-03;"Košický kraj";105;0;0;0;NA;97729;105;2020-10-03;1467
2020-10-02;"Košický kraj";57;0;0;0;NA;97729;57;2020-10-02;1362
2020-10-01;"Košický kraj";69;0;0;0;NA;97729;69;2020-10-01;1305
2020-09-30;"Košický kraj";95;0;0;0;NA;97729;95;2020-09-30;1236
2020-09-29;"Košický kraj";75;0;0;0;NA;97729;75;2020-09-29;1141
2020-09-28;"Košický kraj";19;0;0;0;NA;97729;19;2020-09-28;1066
2020-09-27;"Košický kraj";21;0;0;0;NA;97729;21;2020-09-27;1047
2020-09-26;"Košický kraj";53;0;0;0;NA;97729;53;2020-09-26;1026
2020-09-25;"Košický kraj";72;0;0;0;NA;97729;72;2020-09-25;973
2020-09-24;"Košický kraj";35;0;0;0;NA;97729;35;2020-09-24;901
2020-09-23;"Košický kraj";23;0;0;0;NA;97729;23;2020-09-23;866
2020-09-22;"Košický kraj";39;0;0;0;NA;97729;39;2020-09-22;843
2020-09-21;"Košický kraj";5;0;0;0;NA;97729;5;2020-09-21;804
2020-09-20;"Košický kraj";3;0;0;0;NA;97729;3;2020-09-20;799
2020-09-19;"Košický kraj";13;0;0;0;NA;97729;13;2020-09-19;796
2020-09-18;"Košický kraj";20;0;0;0;NA;97729;20;2020-09-18;783
2020-09-17;"Košický kraj";22;0;0;0;NA;97729;22;2020-09-17;763
2020-09-16;"Košický kraj";12;0;0;0;NA;97729;12;2020-09-16;741
2020-09-15;"Košický kraj";10;0;0;0;NA;97729;10;2020-09-15;729
2020-09-14;"Košický kraj";6;0;0;0;NA;97729;6;2020-09-14;719
2020-09-13;"Košický kraj";3;0;0;0;NA;97729;3;2020-09-13;713
2020-09-12;"Košický kraj";16;0;0;0;NA;97729;16;2020-09-12;710
2020-09-11;"Košický kraj";20;0;0;0;NA;97729;20;2020-09-11;694
2020-09-10;"Košický kraj";11;0;0;0;NA;97729;11;2020-09-10;674
2020-09-09;"Košický kraj";37;0;0;0;NA;97729;37;2020-09-09;663
2020-09-08;"Košický kraj";10;0;0;0;NA;97729;10;2020-09-08;626
2020-09-07;"Košický kraj";4;0;0;0;NA;97729;4;2020-09-07;616
2020-09-06;"Košický kraj";2;0;0;0;NA;97729;2;2020-09-06;612
2020-09-05;"Košický kraj";10;0;0;0;NA;97729;10;2020-09-05;610
2020-09-04;"Košický kraj";14;0;0;0;NA;97729;14;2020-09-04;600
2020-09-03;"Košický kraj";22;0;0;0;NA;97729;22;2020-09-03;586
2020-09-02;"Košický kraj";13;0;0;0;NA;97729;13;2020-09-02;564
2020-09-01;"Košický kraj";21;0;0;0;NA;97729;21;2020-09-01;551
2020-08-31;"Košický kraj";9;0;0;0;NA;97729;9;2020-08-31;530
2020-08-30;"Košický kraj";21;0;0;0;NA;97729;21;2020-08-30;521
2020-08-29;"Košický kraj";1;0;0;0;NA;97729;1;2020-08-29;500
2020-08-28;"Košický kraj";19;0;0;0;NA;97729;19;2020-08-28;499
2020-08-27;"Košický kraj";15;0;0;0;NA;97729;15;2020-08-27;480
2020-08-26;"Košický kraj";8;0;0;0;NA;97729;8;2020-08-26;465
2020-08-25;"Košický kraj";23;0;0;0;NA;97729;23;2020-08-25;457
2020-08-24;"Košický kraj";6;0;0;0;NA;97729;6;2020-08-24;434
2020-08-23;"Košický kraj";8;0;0;0;NA;97729;8;2020-08-23;428
2020-08-22;"Košický kraj";13;0;0;0;NA;97729;13;2020-08-22;420
2020-08-21;"Košický kraj";10;0;0;0;NA;97729;10;2020-08-21;407
2020-08-20;"Košický kraj";10;0;0;0;NA;97729;10;2020-08-20;397
2020-08-19;"Košický kraj";3;0;0;0;NA;97729;3;2020-08-19;387
2020-08-18;"Košický kraj";7;0;0;0;NA;97729;7;2020-08-18;384
2020-08-17;"Košický kraj";2;0;0;0;NA;97729;2;2020-08-17;377
2020-08-16;"Košický kraj";2;0;0;0;NA;97729;2;2020-08-16;375
2020-08-15;"Košický kraj";3;0;0;0;NA;97729;3;2020-08-15;373
2020-08-14;"Košický kraj";1;0;0;0;NA;97729;1;2020-08-14;370
2020-08-13;"Košický kraj";3;0;0;0;NA;97729;3;2020-08-13;369
2020-08-12;"Košický kraj";12;0;0;0;NA;97729;12;2020-08-12;366
2020-08-11;"Košický kraj";5;0;0;0;NA;97729;5;2020-08-11;354
2020-08-10;"Košický kraj";1;0;0;0;NA;97729;1;2020-08-10;349
2020-08-09;"Košický kraj";0;0;0;0;NA;97729;0;2020-08-09;348
2020-08-08;"Košický kraj";5;0;0;0;NA;97729;5;2020-08-08;348
2020-08-07;"Košický kraj";7;0;0;0;NA;97729;7;2020-08-07;343
2020-08-06;"Košický kraj";3;0;0;0;NA;97729;3;2020-08-06;336
2020-08-05;"Košický kraj";4;0;0;0;NA;97729;4;2020-08-05;333
2020-08-04;"Košický kraj";1;0;0;0;NA;97729;1;2020-08-04;329
2020-08-03;"Košický kraj";1;0;0;0;NA;97729;1;2020-08-03;328
2020-08-02;"Košický kraj";0;0;0;0;NA;97729;0;2020-08-02;327
2020-08-01;"Košický kraj";0;0;0;0;NA;97729;0;2020-08-01;327
2020-07-31;"Košický kraj";0;0;0;0;NA;97729;0;2020-07-31;327
2020-07-30;"Košický kraj";2;0;0;0;NA;97729;2;2020-07-30;327
2020-07-29;"Košický kraj";1;0;0;0;NA;97729;1;2020-07-29;325
2020-07-28;"Košický kraj";9;0;0;0;NA;97729;9;2020-07-28;324
2020-07-27;"Košický kraj";4;0;0;0;NA;97729;4;2020-07-27;315
2020-07-26;"Košický kraj";0;0;0;0;NA;97729;0;2020-07-26;311
2020-07-25;"Košický kraj";2;0;0;0;NA;97729;2;2020-07-25;311
2020-07-24;"Košický kraj";2;0;0;0;NA;97729;2;2020-07-24;309
2020-07-23;"Košický kraj";1;0;0;0;NA;97729;1;2020-07-23;307
2020-07-22;"Košický kraj";1;0;0;0;NA;97729;1;2020-07-22;306
2020-07-21;"Košický kraj";0;0;0;0;NA;97729;0;2020-07-21;305
2020-07-20;"Košický kraj";0;0;0;0;NA;97729;0;2020-07-20;305
2020-07-19;"Košický kraj";0;0;0;0;NA;97729;0;2020-07-19;305
2020-07-18;"Košický kraj";1;0;0;0;NA;97729;1;2020-07-18;305
2020-07-17;"Košický kraj";1;0;0;0;NA;97729;1;2020-07-17;304
2020-07-16;"Košický kraj";0;0;0;0;NA;97729;0;2020-07-16;303
2020-07-15;"Košický kraj";2;0;0;0;NA;97729;2;2020-07-15;303
2020-07-14;"Košický kraj";1;0;0;0;NA;97729;1;2020-07-14;301
2020-07-13;"Košický kraj";1;0;0;0;NA;97729;1;2020-07-13;300
2020-07-12;"Košický kraj";0;0;0;0;NA;97729;0;2020-07-12;299
2020-07-11;"Košický kraj";0;0;0;0;NA;97729;0;2020-07-11;299
2020-07-10;"Košický kraj";1;0;0;0;NA;97729;1;2020-07-10;299
2020-07-09;"Košický kraj";1;0;0;0;NA;97729;1;2020-07-09;298
2020-07-08;"Košický kraj";12;0;0;0;NA;97729;12;2020-07-08;297
2020-07-07;"Košický kraj";0;0;0;0;NA;97729;0;2020-07-07;285
2020-07-06;"Košický kraj";0;0;0;0;NA;97729;0;2020-07-06;285
2020-07-05;"Košický kraj";0;0;0;0;NA;97729;0;2020-07-05;285
2020-07-04;"Košický kraj";0;0;0;0;NA;97729;0;2020-07-04;285
2020-07-03;"Košický kraj";1;0;0;0;NA;97729;1;2020-07-03;285
2020-07-02;"Košický kraj";0;0;0;0;NA;97729;0;2020-07-02;284
2020-07-01;"Košický kraj";1;0;0;0;NA;97729;1;2020-07-01;284
2020-06-30;"Košický kraj";0;0;0;0;NA;97729;0;2020-06-30;283
2020-06-29;"Košický kraj";0;0;0;0;NA;97729;0;2020-06-29;283
2020-06-28;"Košický kraj";0;0;0;0;NA;97729;0;2020-06-28;283
2020-06-27;"Košický kraj";0;0;0;0;NA;97729;0;2020-06-27;283
2020-06-26;"Košický kraj";0;0;0;0;NA;97729;0;2020-06-26;283
2020-06-25;"Košický kraj";3;0;0;0;NA;97729;3;2020-06-25;283
2020-06-24;"Košický kraj";3;0;0;0;NA;97729;3;2020-06-24;280
2020-06-23;"Košický kraj";3;0;0;0;NA;97729;3;2020-06-23;277
2020-06-22;"Košický kraj";0;0;0;0;NA;97729;0;2020-06-22;274
2020-06-21;"Košický kraj";0;0;0;0;NA;97729;0;2020-06-21;274
2020-06-20;"Košický kraj";0;0;0;0;NA;97729;0;2020-06-20;274
2020-06-19;"Košický kraj";0;0;0;0;NA;97729;0;2020-06-19;274
2020-06-18;"Košický kraj";1;0;0;0;NA;97729;1;2020-06-18;274
2020-06-17;"Košický kraj";0;0;0;0;NA;97729;0;2020-06-17;273
2020-06-16;"Košický kraj";2;0;0;0;NA;97729;2;2020-06-16;273
2020-06-14;"Košický kraj";0;0;0;0;NA;97729;0;2020-06-14;271
2020-06-13;"Košický kraj";0;0;0;0;NA;97729;0;2020-06-13;271
2020-06-12;"Košický kraj";0;0;0;0;NA;97729;0;2020-06-12;271
2020-06-11;"Košický kraj";0;0;0;0;NA;97729;0;2020-06-11;271
2020-06-10;"Košický kraj";6;0;0;0;NA;97729;6;2020-06-10;271
2020-06-09;"Košický kraj";0;0;0;0;NA;97729;0;2020-06-09;265
2020-06-08;"Košický kraj";0;0;0;0;NA;97729;0;2020-06-08;265
2020-06-07;"Košický kraj";2;0;0;0;NA;97729;2;2020-06-07;265
2020-06-05;"Košický kraj";0;0;0;0;NA;97729;0;2020-06-05;263
2020-06-03;"Košický kraj";0;0;0;0;NA;97729;0;2020-06-03;263
2020-06-02;"Košický kraj";1;0;0;0;NA;97729;1;2020-06-02;263
2020-05-31;"Košický kraj";0;0;0;0;NA;97729;0;2020-05-31;262
2020-05-29;"Košický kraj";1;0;0;0;NA;97729;1;2020-05-29;262
2020-05-27;"Košický kraj";0;0;0;0;NA;97729;0;2020-05-27;261
2020-05-26;"Košický kraj";1;0;0;0;NA;97729;1;2020-05-26;261
2020-05-25;"Košický kraj";1;0;0;0;NA;97729;1;2020-05-25;260
2020-05-24;"Košický kraj";0;0;0;0;NA;97729;0;2020-05-24;259
2020-05-23;"Košický kraj";0;0;0;0;NA;97729;0;2020-05-23;259
2020-05-22;"Košický kraj";0;0;0;0;NA;97729;0;2020-05-22;259
2020-05-21;"Košický kraj";0;0;0;0;NA;97729;0;2020-05-21;259
2020-05-20;"Košický kraj";3;0;0;0;NA;97729;3;2020-05-20;259
2020-05-19;"Košický kraj";0;0;0;0;NA;97729;0;2020-05-19;256
2020-05-17;"Košický kraj";1;0;0;0;NA;97729;1;2020-05-17;256
2020-05-16;"Košický kraj";1;0;0;0;NA;97729;1;2020-05-16;255
2020-05-15;"Košický kraj";10;0;0;0;NA;97729;10;2020-05-15;254
2020-05-14;"Košický kraj";1;0;0;0;NA;97729;1;2020-05-14;244
2020-05-13;"Košický kraj";6;0;0;0;NA;97729;6;2020-05-13;243
2020-05-12;"Košický kraj";0;0;0;0;NA;97729;0;2020-05-12;237
2020-05-11;"Košický kraj";0;0;0;0;NA;97729;0;2020-05-11;237
2020-05-09;"Košický kraj";0;0;0;0;NA;97729;0;2020-05-09;237
2020-05-07;"Košický kraj";0;0;0;0;NA;97729;0;2020-05-07;237
2020-05-06;"Košický kraj";1;0;0;0;NA;97729;1;2020-05-06;237
2020-05-05;"Košický kraj";0;0;0;0;NA;97729;0;2020-05-05;236
2020-05-04;"Košický kraj";0;0;0;0;NA;97729;0;2020-05-04;236
2020-05-03;"Košický kraj";0;0;0;0;NA;97729;0;2020-05-03;236
2020-05-02;"Košický kraj";1;0;0;0;NA;97729;1;2020-05-02;236
2020-05-01;"Košický kraj";0;0;0;0;NA;97729;0;2020-05-01;235
2020-04-30;"Košický kraj";1;0;0;0;NA;97729;1;2020-04-30;235
2020-04-29;"Košický kraj";1;0;0;0;NA;97729;1;2020-04-29;234
2020-04-28;"Košický kraj";1;0;0;0;NA;97729;1;2020-04-28;233
2020-04-27;"Košický kraj";1;0;0;0;NA;97729;1;2020-04-27;232
2020-04-26;"Košický kraj";0;0;0;0;NA;97729;0;2020-04-26;231
2020-04-25;"Košický kraj";0;0;0;0;NA;97729;0;2020-04-25;231
2020-04-24;"Košický kraj";3;0;0;0;NA;97729;3;2020-04-24;231
2020-04-23;"Košický kraj";4;0;0;0;NA;97729;4;2020-04-23;228
2020-04-22;"Košický kraj";21;0;0;0;NA;97729;21;2020-04-22;224
2020-04-21;"Košický kraj";4;0;0;0;NA;97729;4;2020-04-21;203
2020-04-20;"Košický kraj";0;0;0;0;NA;97729;0;2020-04-20;199
2020-04-19;"Košický kraj";1;0;0;0;NA;97729;1;2020-04-19;199
2020-04-18;"Košický kraj";2;0;0;0;NA;97729;2;2020-04-18;198
2020-04-17;"Košický kraj";7;0;0;0;NA;97729;7;2020-04-17;196
2020-04-16;"Košický kraj";29;0;0;0;NA;97729;29;2020-04-16;189
2020-04-15;"Košický kraj";50;0;0;0;NA;97729;50;2020-04-15;160
2020-04-14;"Košický kraj";4;0;0;0;NA;97729;4;2020-04-14;110
2020-04-13;"Košický kraj";5;0;0;0;NA;97729;5;2020-04-13;106
2020-04-12;"Košický kraj";4;0;0;0;NA;97729;4;2020-04-12;101
2020-04-11;"Košický kraj";2;0;0;0;NA;97729;2;2020-04-11;97
2020-04-10;"Košický kraj";1;0;0;0;NA;97729;1;2020-04-10;95
2020-04-09;"Košický kraj";4;0;0;0;NA;97729;4;2020-04-09;94
2020-04-08;"Košický kraj";5;0;0;0;NA;97729;5;2020-04-08;90
2020-04-07;"Košický kraj";34;0;0;0;NA;97729;34;2020-04-07;85
2020-04-06;"Košický kraj";6;0;0;0;NA;97729;6;2020-04-06;51
2020-04-05;"Košický kraj";4;0;0;0;NA;97729;4;2020-04-05;45
2020-04-04;"Košický kraj";5;0;0;0;NA;97729;5;2020-04-04;41
2020-04-03;"Košický kraj";4;0;0;0;NA;97729;4;2020-04-03;36
2020-04-02;"Košický kraj";3;0;0;0;NA;97729;3;2020-04-02;32
2020-04-01;"Košický kraj";3;0;0;0;NA;97729;3;2020-04-01;29
2020-03-31;"Košický kraj";1;0;0;0;NA;97729;1;2020-03-31;26
2020-03-30;"Košický kraj";5;0;0;0;NA;97729;5;2020-03-30;25
2020-03-29;"Košický kraj";0;0;0;0;NA;97729;0;2020-03-29;20
2020-03-28;"Košický kraj";1;0;0;0;NA;97729;1;2020-03-28;20
2020-03-27;"Košický kraj";1;0;0;0;NA;97729;1;2020-03-27;19
2020-03-26;"Košický kraj";3;0;0;0;NA;97729;3;2020-03-26;18
2020-03-25;"Košický kraj";2;0;0;0;NA;97729;2;2020-03-25;15
2020-03-24;"Košický kraj";0;0;0;0;NA;97729;0;2020-03-24;13
2020-03-23;"Košický kraj";2;0;0;0;NA;97729;2;2020-03-23;13
2020-03-22;"Košický kraj";0;0;0;0;NA;97729;0;2020-03-22;11
2020-03-21;"Košický kraj";3;0;0;0;NA;97729;3;2020-03-21;11
2020-03-20;"Košický kraj";1;0;0;0;NA;97729;1;2020-03-20;8
2020-03-19;"Košický kraj";0;0;0;0;NA;97729;0;2020-03-19;7
2020-03-18;"Košický kraj";0;0;0;0;NA;97729;0;2020-03-18;7
2020-03-17;"Košický kraj";0;0;0;0;NA;97729;0;2020-03-17;7
2020-03-16;"Košický kraj";3;0;0;0;NA;97729;3;2020-03-16;7
2020-03-15;"Košický kraj";1;0;0;0;NA;97729;1;2020-03-15;4
2020-03-14;"Košický kraj";0;0;0;0;NA;97729;0;2020-03-14;3
2020-03-13;"Košický kraj";2;0;0;0;NA;97729;2;2020-03-13;3
2020-03-12;"Košický kraj";0;0;0;0;NA;97729;0;2020-03-12;1
2020-03-11;"Košický kraj";0;0;0;0;NA;97729;0;2020-03-11;1
2020-03-09;"Košický kraj";1;0;0;0;NA;97729;1;2020-03-09;1
2020-03-08;"Košický kraj";0;0;0;0;NA;97729;0;2020-03-08;0
2020-03-07;"Košický kraj";0;0;0;0;NA;97729;0;2020-03-07;0
2020-03-06;"Košický kraj";0;0;0;0;NA;97729;0;2020-03-06;0
2021-07-11;"Nitriansky kraj";1;454;0;454;39266;92665;1;2021-07-11;92665
2021-07-10;"Nitriansky kraj";1;552;0;552;NA;92665;1;2021-07-10;92664
2021-07-09;"Nitriansky kraj";3;848;0;848;NA;92665;3;2021-07-09;92663
2021-07-08;"Nitriansky kraj";0;599;0;599;NA;92665;0;2021-07-08;92660
2021-07-07;"Nitriansky kraj";2;874;2;876;NA;92665;4;2021-07-07;92660
2021-07-06;"Nitriansky kraj";1;891;1;892;NA;92665;2;2021-07-06;92656
2021-07-05;"Nitriansky kraj";1;452;0;452;NA;92665;1;2021-07-05;92654
2021-07-04;"Nitriansky kraj";0;745;1;746;NA;92665;1;2021-07-04;92653
2021-07-03;"Nitriansky kraj";0;611;0;611;NA;92665;0;2021-07-03;92652
2021-07-02;"Nitriansky kraj";0;1061;0;1061;NA;92665;0;2021-07-02;92652
2021-07-01;"Nitriansky kraj";0;316;1;317;NA;92665;1;2021-07-01;92652
2021-06-30;"Nitriansky kraj";1;6528;2;6530;NA;92665;3;2021-06-30;92651
2021-06-29;"Nitriansky kraj";1;3255;0;3255;NA;92665;1;2021-06-29;92648
2021-06-28;"Nitriansky kraj";3;4393;0;4393;NA;92665;3;2021-06-28;92647
2021-06-27;"Nitriansky kraj";0;3263;0;3263;NA;92665;0;2021-06-27;92644
2021-06-26;"Nitriansky kraj";1;4845;2;4847;NA;92665;3;2021-06-26;92644
2021-06-25;"Nitriansky kraj";8;5145;1;5146;NA;92665;9;2021-06-25;92641
2021-06-24;"Nitriansky kraj";1;3383;0;3383;NA;92665;1;2021-06-24;92632
2021-06-23;"Nitriansky kraj";1;3023;0;3023;NA;92665;1;2021-06-23;92631
2021-06-22;"Nitriansky kraj";1;3240;3;3243;NA;92665;4;2021-06-22;92630
2021-06-21;"Nitriansky kraj";8;5059;8;5067;NA;92665;16;2021-06-21;92626
2021-06-20;"Nitriansky kraj";0;4437;6;4443;NA;92665;6;2021-06-20;92610
2021-06-19;"Nitriansky kraj";0;5750;4;5754;NA;92665;4;2021-06-19;92604
2021-06-18;"Nitriansky kraj";4;6453;3;6456;NA;92665;7;2021-06-18;92600
2021-06-17;"Nitriansky kraj";5;4030;1;4031;NA;92665;6;2021-06-17;92593
2021-06-16;"Nitriansky kraj";4;3694;3;3697;NA;92665;7;2021-06-16;92587
2021-06-15;"Nitriansky kraj";1;3849;0;3849;NA;92665;1;2021-06-15;92580
2021-06-14;"Nitriansky kraj";0;5590;3;5593;NA;92665;3;2021-06-14;92579
2021-06-13;"Nitriansky kraj";0;6184;3;6187;NA;92665;3;2021-06-13;92576
2021-06-12;"Nitriansky kraj";1;7723;1;7724;NA;92665;2;2021-06-12;92573
2021-06-11;"Nitriansky kraj";3;6558;4;6562;NA;92665;7;2021-06-11;92571
2021-06-10;"Nitriansky kraj";7;4539;1;4540;NA;92665;8;2021-06-10;92564
2021-06-09;"Nitriansky kraj";2;4656;5;4661;NA;92665;7;2021-06-09;92556
2021-06-08;"Nitriansky kraj";8;4239;3;4242;NA;92665;11;2021-06-08;92549
2021-06-07;"Nitriansky kraj";6;5648;8;5656;NA;92665;14;2021-06-07;92538
2021-06-06;"Nitriansky kraj";0;6981;4;6985;NA;92665;4;2021-06-06;92524
2021-06-05;"Nitriansky kraj";6;8417;9;8426;NA;92665;15;2021-06-05;92520
2021-06-04;"Nitriansky kraj";9;7462;5;7467;NA;92665;14;2021-06-04;92505
2021-06-03;"Nitriansky kraj";2;5062;6;5068;NA;92665;8;2021-06-03;92491
2021-06-02;"Nitriansky kraj";11;4902;11;4913;NA;92665;22;2021-06-02;92483
2021-06-01;"Nitriansky kraj";3;4698;2;4700;NA;92665;5;2021-06-01;92461
2021-05-31;"Nitriansky kraj";8;8708;8;8716;NA;92665;16;2021-05-31;92456
2021-05-30;"Nitriansky kraj";1;9067;8;9075;NA;92665;9;2021-05-30;92440
2021-05-29;"Nitriansky kraj";2;12799;7;12806;NA;92665;9;2021-05-29;92431
2021-05-28;"Nitriansky kraj";10;8575;6;8581;NA;92665;16;2021-05-28;92422
2021-05-27;"Nitriansky kraj";4;6015;5;6020;NA;92665;9;2021-05-27;92406
2021-05-26;"Nitriansky kraj";11;8266;8;8274;NA;92665;19;2021-05-26;92397
2021-05-25;"Nitriansky kraj";15;7228;8;7236;NA;92665;23;2021-05-25;92378
2021-05-24;"Nitriansky kraj";14;9599;17;9616;NA;92665;31;2021-05-24;92355
2021-05-23;"Nitriansky kraj";1;9456;13;9469;NA;92665;14;2021-05-23;92324
2021-05-22;"Nitriansky kraj";7;16774;11;16785;NA;92665;18;2021-05-22;92310
2021-05-21;"Nitriansky kraj";18;10473;15;10488;NA;92665;33;2021-05-21;92292
2021-05-20;"Nitriansky kraj";8;7059;7;7066;NA;92665;15;2021-05-20;92259
2021-05-19;"Nitriansky kraj";20;6640;14;6654;NA;92665;34;2021-05-19;92244
2021-05-18;"Nitriansky kraj";23;7577;18;7595;NA;92665;41;2021-05-18;92210
2021-05-17;"Nitriansky kraj";22;9575;20;9595;NA;92665;42;2021-05-17;92169
2021-05-16;"Nitriansky kraj";4;13830;15;13845;NA;92665;19;2021-05-16;92127
2021-05-15;"Nitriansky kraj";5;25389;23;25412;NA;92665;28;2021-05-15;92108
2021-05-14;"Nitriansky kraj";18;13273;23;13296;NA;92665;41;2021-05-14;92080
2021-05-13;"Nitriansky kraj";24;8049;19;8068;NA;92665;43;2021-05-13;92039
2021-05-12;"Nitriansky kraj";10;7466;26;7492;NA;92665;36;2021-05-12;91996
2021-05-11;"Nitriansky kraj";36;7978;13;7991;NA;92665;49;2021-05-11;91960
2021-05-10;"Nitriansky kraj";16;13590;33;13623;NA;92665;49;2021-05-10;91911
2021-05-09;"Nitriansky kraj";8;21879;35;21914;NA;92665;43;2021-05-09;91862
2021-05-08;"Nitriansky kraj";0;24318;29;24347;NA;92665;29;2021-05-08;91819
2021-05-07;"Nitriansky kraj";32;14657;20;14677;NA;92665;52;2021-05-07;91790
2021-05-06;"Nitriansky kraj";30;9275;20;9295;NA;92665;50;2021-05-06;91738
2021-05-05;"Nitriansky kraj";19;8518;23;8541;NA;92665;42;2021-05-05;91688
2021-05-04;"Nitriansky kraj";46;8954;27;8981;NA;92665;73;2021-05-04;91646
2021-05-03;"Nitriansky kraj";32;14490;44;14534;NA;92665;76;2021-05-03;91573
2021-05-02;"Nitriansky kraj";4;31751;46;31797;NA;92665;50;2021-05-02;91497
2021-05-01;"Nitriansky kraj";23;60318;43;60361;NA;92665;66;2021-05-01;91447
2021-04-30;"Nitriansky kraj";28;31803;53;31856;NA;92665;81;2021-04-30;91381
2021-04-29;"Nitriansky kraj";27;13995;32;14027;NA;92665;59;2021-04-29;91300
2021-04-28;"Nitriansky kraj";36;14678;45;14723;NA;92665;81;2021-04-28;91241
2021-04-27;"Nitriansky kraj";51;13154;35;13189;NA;92665;86;2021-04-27;91160
2021-04-26;"Nitriansky kraj";38;21029;44;21073;NA;92665;82;2021-04-26;91074
2021-04-25;"Nitriansky kraj";7;43494;43;43537;NA;92665;50;2021-04-25;90992
2021-04-24;"Nitriansky kraj";23;92745;71;92816;NA;92665;94;2021-04-24;90942
2021-04-23;"Nitriansky kraj";54;35143;51;35194;NA;92665;105;2021-04-23;90848
2021-04-22;"Nitriansky kraj";32;15435;44;15479;NA;92665;76;2021-04-22;90743
2021-04-21;"Nitriansky kraj";38;14222;45;14267;NA;92665;83;2021-04-21;90667
2021-04-20;"Nitriansky kraj";67;16058;51;16109;NA;92665;118;2021-04-20;90584
2021-04-19;"Nitriansky kraj";35;24816;59;24875;NA;92665;94;2021-04-19;90466
2021-04-18;"Nitriansky kraj";0;39569;27;39596;NA;92665;27;2021-04-18;90372
2021-04-17;"Nitriansky kraj";34;92102;82;92184;NA;92665;116;2021-04-17;90345
2021-04-16;"Nitriansky kraj";46;32348;37;32385;NA;92665;83;2021-04-16;90229
2021-04-15;"Nitriansky kraj";75;16215;52;16267;NA;92665;127;2021-04-15;90146
2021-04-14;"Nitriansky kraj";43;15303;42;15345;NA;92665;85;2021-04-14;90019
2021-04-13;"Nitriansky kraj";110;14947;44;14991;NA;92665;154;2021-04-13;89934
2021-04-12;"Nitriansky kraj";29;22162;50;22212;NA;92665;79;2021-04-12;89780
2021-04-11;"Nitriansky kraj";1;37537;31;37568;NA;92665;32;2021-04-11;89701
2021-04-10;"Nitriansky kraj";35;95524;115;95639;NA;92665;150;2021-04-10;89669
2021-04-09;"Nitriansky kraj";69;30669;58;30727;NA;92665;127;2021-04-09;89519
2021-04-08;"Nitriansky kraj";71;15369;36;15405;NA;92665;107;2021-04-08;89392
2021-04-07;"Nitriansky kraj";64;18541;47;18588;NA;92665;111;2021-04-07;89285
2021-04-06;"Nitriansky kraj";65;33218;112;33330;NA;92665;177;2021-04-06;89174
2021-04-05;"Nitriansky kraj";37;12673;48;12721;NA;92665;85;2021-04-05;88997
2021-04-04;"Nitriansky kraj";5;17887;35;17922;NA;92665;40;2021-04-04;88912
2021-04-03;"Nitriansky kraj";26;85465;153;85618;NA;92665;179;2021-04-03;88872
2021-04-02;"Nitriansky kraj";32;18667;46;18713;NA;92665;78;2021-04-02;88693
2021-04-01;"Nitriansky kraj";63;24610;83;24693;NA;92665;146;2021-04-01;88615
2021-03-31;"Nitriansky kraj";73;21752;94;21846;NA;92665;167;2021-03-31;88469
2021-03-30;"Nitriansky kraj";125;17044;83;17127;NA;92665;208;2021-03-30;88302
2021-03-29;"Nitriansky kraj";81;25139;100;25239;NA;92665;181;2021-03-29;88094
2021-03-28;"Nitriansky kraj";6;45581;106;45687;NA;92665;112;2021-03-28;87913
2021-03-27;"Nitriansky kraj";39;103659;174;103833;NA;92665;213;2021-03-27;87801
2021-03-26;"Nitriansky kraj";90;40444;115;40559;NA;92665;205;2021-03-26;87588
2021-03-25;"Nitriansky kraj";95;19149;94;19243;NA;92665;189;2021-03-25;87383
2021-03-24;"Nitriansky kraj";90;14784;91;14875;NA;92665;181;2021-03-24;87194
2021-03-23;"Nitriansky kraj";167;16753;66;16819;NA;92665;233;2021-03-23;87013
2021-03-22;"Nitriansky kraj";101;23699;124;23823;NA;92665;225;2021-03-22;86780
2021-03-21;"Nitriansky kraj";27;42169;99;42268;NA;92665;126;2021-03-21;86555
2021-03-20;"Nitriansky kraj";36;99816;207;100023;NA;92665;243;2021-03-20;86429
2021-03-19;"Nitriansky kraj";76;37115;101;37216;NA;92665;177;2021-03-19;86186
2021-03-18;"Nitriansky kraj";103;20051;113;20164;NA;92665;216;2021-03-18;86009
2021-03-17;"Nitriansky kraj";87;15832;127;15959;NA;92665;214;2021-03-17;85793
2021-03-16;"Nitriansky kraj";172;18085;121;18206;NA;92665;293;2021-03-16;85579
2021-03-15;"Nitriansky kraj";130;24491;165;24656;NA;92665;295;2021-03-15;85286
2021-03-14;"Nitriansky kraj";3;45758;107;45865;NA;92665;110;2021-03-14;84991
2021-03-13;"Nitriansky kraj";65;112081;241;112322;NA;92665;306;2021-03-13;84881
2021-03-12;"Nitriansky kraj";127;40776;159;40935;NA;92665;286;2021-03-12;84575
2021-03-11;"Nitriansky kraj";131;18685;130;18815;NA;92665;261;2021-03-11;84289
2021-03-10;"Nitriansky kraj";96;17422;143;17565;NA;92665;239;2021-03-10;84028
2021-03-09;"Nitriansky kraj";260;17635;149;17784;NA;92665;409;2021-03-09;83789
2021-03-08;"Nitriansky kraj";145;27214;172;27386;NA;92665;317;2021-03-08;83380
2021-03-07;"Nitriansky kraj";48;46867;185;47052;NA;92665;233;2021-03-07;83063
2021-03-06;"Nitriansky kraj";86;110858;326;111184;NA;92665;412;2021-03-06;82830
2021-03-05;"Nitriansky kraj";133;39068;200;39268;NA;92665;333;2021-03-05;82418
2021-03-04;"Nitriansky kraj";176;18206;173;18379;NA;92665;349;2021-03-04;82085
2021-03-03;"Nitriansky kraj";172;17210;177;17387;NA;92665;349;2021-03-03;81736
2021-03-02;"Nitriansky kraj";274;20999;366;21365;NA;92665;640;2021-03-02;81387
2021-03-01;"Nitriansky kraj";133;27881;279;28160;NA;92665;412;2021-03-01;80747
2021-02-28;"Nitriansky kraj";80;40866;218;41084;NA;92665;298;2021-02-28;80335
2021-02-27;"Nitriansky kraj";101;106352;496;106848;NA;92665;597;2021-02-27;80037
2021-02-26;"Nitriansky kraj";109;36722;306;37028;NA;92665;415;2021-02-26;79440
2021-02-25;"Nitriansky kraj";188;15235;212;15447;NA;92665;400;2021-02-25;79025
2021-02-24;"Nitriansky kraj";125;13833;260;14093;NA;92665;385;2021-02-24;78625
2021-02-23;"Nitriansky kraj";273;15402;273;15675;NA;92665;546;2021-02-23;78240
2021-02-22;"Nitriansky kraj";154;26466;330;26796;NA;92665;484;2021-02-22;77694
2021-02-21;"Nitriansky kraj";22;43657;320;43977;NA;92665;342;2021-02-21;77210
2021-02-20;"Nitriansky kraj";128;108304;584;108888;NA;92665;712;2021-02-20;76868
2021-02-19;"Nitriansky kraj";173;36849;328;37177;NA;92665;501;2021-02-19;76156
2021-02-18;"Nitriansky kraj";202;17046;275;17321;NA;92665;477;2021-02-18;75655
2021-02-17;"Nitriansky kraj";198;12080;310;12390;NA;92665;508;2021-02-17;75178
2021-02-16;"Nitriansky kraj";284;14477;282;14759;NA;92665;566;2021-02-16;74670
2021-02-15;"Nitriansky kraj";122;27620;471;28091;NA;92665;593;2021-02-15;74104
2021-02-14;"Nitriansky kraj";8;50408;318;50726;NA;92665;326;2021-02-14;73511
2021-02-13;"Nitriansky kraj";127;110035;689;110724;NA;92665;816;2021-02-13;73185
2021-02-12;"Nitriansky kraj";162;33400;407;33807;NA;92665;569;2021-02-12;72369
2021-02-11;"Nitriansky kraj";195;12406;270;12676;NA;92665;465;2021-02-11;71800
2021-02-10;"Nitriansky kraj";186;17632;644;18276;NA;92665;830;2021-02-10;71335
2021-02-09;"Nitriansky kraj";260;18523;385;18908;NA;92665;645;2021-02-09;70505
2021-02-08;"Nitriansky kraj";177;37530;569;38099;NA;92665;746;2021-02-08;69860
2021-02-07;"Nitriansky kraj";20;52307;513;52820;NA;92665;533;2021-02-07;69114
2021-02-06;"Nitriansky kraj";129;101439;764;102203;NA;92665;893;2021-02-06;68581
2021-02-05;"Nitriansky kraj";244;26137;491;26628;NA;92665;735;2021-02-05;67688
2021-02-04;"Nitriansky kraj";308;15681;512;16193;NA;92665;820;2021-02-04;66953
2021-02-03;"Nitriansky kraj";191;13459;382;13841;NA;92665;573;2021-02-03;66133
2021-02-02;"Nitriansky kraj";327;17878;382;18260;NA;92665;709;2021-02-02;65560
2021-02-01;"Nitriansky kraj";221;24002;460;24462;NA;92665;681;2021-02-01;64851
2021-01-31;"Nitriansky kraj";9;45339;496;45835;NA;92665;505;2021-01-31;64170
2021-01-30;"Nitriansky kraj";152;97976;1072;99048;NA;92665;1224;2021-01-30;63665
2021-01-29;"Nitriansky kraj";302;22461;477;22938;NA;92665;779;2021-01-29;62441
2021-01-28;"Nitriansky kraj";269;11370;398;11768;NA;92665;667;2021-01-28;61662
2021-01-27;"Nitriansky kraj";235;6758;299;7057;NA;92665;534;2021-01-27;60995
2021-01-26;"Nitriansky kraj";345;16025;454;16479;NA;92665;799;2021-01-26;60461
2021-01-25;"Nitriansky kraj";201;21729;429;22158;NA;92665;630;2021-01-25;59662
2021-01-24;"Nitriansky kraj";12;78775;889;79664;NA;92665;901;2021-01-24;59032
2021-01-23;"Nitriansky kraj";277;97416;1434;98850;NA;92665;1711;2021-01-23;58131
2021-01-22;"Nitriansky kraj";139;35924;619;36543;NA;92665;758;2021-01-22;56420
2021-01-21;"Nitriansky kraj";305;14649;412;15061;NA;92665;717;2021-01-21;55662
2021-01-20;"Nitriansky kraj";326;11991;625;12616;NA;92665;951;2021-01-20;54945
2021-01-19;"Nitriansky kraj";344;11022;633;11655;NA;92665;977;2021-01-19;53994
2021-01-18;"Nitriansky kraj";367;8901;519;9420;NA;92665;886;2021-01-18;53017
2021-01-17;"Nitriansky kraj";97;15061;275;15336;NA;92665;372;2021-01-17;52131
2021-01-16;"Nitriansky kraj";64;36838;679;37517;NA;92665;743;2021-01-16;51759
2021-01-15;"Nitriansky kraj";373;15940;474;16414;NA;92665;847;2021-01-15;51016
2021-01-14;"Nitriansky kraj";627;10577;452;11029;NA;92665;1079;2021-01-14;50169
2021-01-13;"Nitriansky kraj";663;9234;484;9718;NA;92665;1147;2021-01-13;49090
2021-01-12;"Nitriansky kraj";642;9014;557;9571;NA;92665;1199;2021-01-12;47943
2021-01-11;"Nitriansky kraj";422;8625;556;9181;NA;92665;978;2021-01-11;46744
2021-01-10;"Nitriansky kraj";44;19841;730;20571;NA;92665;774;2021-01-10;45766
2021-01-09;"Nitriansky kraj";532;36823;1071;37894;NA;92665;1603;2021-01-09;44992
2021-01-08;"Nitriansky kraj";817;14297;711;15008;NA;92665;1528;2021-01-08;43389
2021-01-07;"Nitriansky kraj";438;10406;822;11228;NA;92665;1260;2021-01-07;41861
2021-01-06;"Nitriansky kraj";259;3192;197;3389;NA;92665;456;2021-01-06;40601
2021-01-05;"Nitriansky kraj";732;8918;1208;10126;NA;92665;1940;2021-01-05;40145
2021-01-04;"Nitriansky kraj";362;8692;1329;10021;NA;92665;1691;2021-01-04;38205
2021-01-03;"Nitriansky kraj";42;84;20;104;NA;92665;62;2021-01-03;36514
2021-01-02;"Nitriansky kraj";249;1090;26;1116;NA;92665;275;2021-01-02;36452
2021-01-01;"Nitriansky kraj";119;781;95;876;NA;92665;214;2021-01-01;36177
2020-12-31;"Nitriansky kraj";786;7646;962;8608;NA;92665;1748;2020-12-31;35963
2020-12-30;"Nitriansky kraj";1094;9619;1165;10784;NA;92665;2259;2020-12-30;34215
2020-12-29;"Nitriansky kraj";607;8277;1286;9563;NA;92665;1893;2020-12-29;31956
2020-12-28;"Nitriansky kraj";83;6981;1271;8252;NA;92665;1354;2020-12-28;30063
2020-12-27;"Nitriansky kraj";22;60;8;68;NA;92665;30;2020-12-27;28709
2020-12-26;"Nitriansky kraj";54;297;56;353;NA;92665;110;2020-12-26;28679
2020-12-25;"Nitriansky kraj";35;60;11;71;NA;92665;46;2020-12-25;28569
2020-12-24;"Nitriansky kraj";514;1861;176;2037;NA;92665;690;2020-12-24;28523
2020-12-23;"Nitriansky kraj";349;15295;843;16138;NA;92665;1192;2020-12-23;27833
2020-12-22;"Nitriansky kraj";673;10989;994;11983;NA;92665;1667;2020-12-22;26641
2020-12-21;"Nitriansky kraj";128;7953;976;8929;NA;92665;1104;2020-12-21;24974
2020-12-20;"Nitriansky kraj";77;50;10;60;NA;92665;87;2020-12-20;23870
2020-12-19;"Nitriansky kraj";262;2259;159;2418;NA;92665;421;2020-12-19;23783
2020-12-18;"Nitriansky kraj";512;8437;551;8988;NA;92665;1063;2020-12-18;23362
2020-12-17;"Nitriansky kraj";586;6894;514;7408;NA;92665;1100;2020-12-17;22299
2020-12-16;"Nitriansky kraj";357;8613;535;9148;NA;92665;892;2020-12-16;21199
2020-12-15;"Nitriansky kraj";461;9365;769;10134;NA;92665;1230;2020-12-15;20307
2020-12-14;"Nitriansky kraj";217;8089;827;8916;NA;92665;1044;2020-12-14;19077
2020-12-13;"Nitriansky kraj";12;69;6;75;NA;92665;18;2020-12-13;18033
2020-12-12;"Nitriansky kraj";341;1832;125;1957;NA;92665;466;2020-12-12;18015
2020-12-11;"Nitriansky kraj";409;5430;416;5846;NA;92665;825;2020-12-11;17549
2020-12-10;"Nitriansky kraj";360;5473;351;5824;NA;92665;711;2020-12-10;16724
2020-12-09;"Nitriansky kraj";362;5506;529;6035;NA;92665;891;2020-12-09;16013
2020-12-08;"Nitriansky kraj";340;8168;548;8716;NA;92665;888;2020-12-08;15122
2020-12-07;"Nitriansky kraj";139;6243;573;6816;NA;92665;712;2020-12-07;14234
2020-12-06;"Nitriansky kraj";15;89;4;93;NA;92665;19;2020-12-06;13522
2020-12-05;"Nitriansky kraj";136;1388;19;1407;NA;92665;155;2020-12-05;13503
2020-12-04;"Nitriansky kraj";232;2884;74;2958;NA;92665;306;2020-12-04;13348
2020-12-03;"Nitriansky kraj";248;2471;110;2581;NA;92665;358;2020-12-03;13042
2020-12-02;"Nitriansky kraj";252;3733;163;3896;NA;92665;415;2020-12-02;12684
2020-12-01;"Nitriansky kraj";331;2891;131;3022;NA;92665;462;2020-12-01;12269
2020-11-30;"Nitriansky kraj";91;4228;188;4416;NA;92665;279;2020-11-30;11807
2020-11-29;"Nitriansky kraj";3;634;42;676;NA;92665;45;2020-11-29;11528
2020-11-28;"Nitriansky kraj";135;892;31;923;NA;92665;166;2020-11-28;11483
2020-11-27;"Nitriansky kraj";177;2069;73;2142;NA;92665;250;2020-11-27;11317
2020-11-26;"Nitriansky kraj";191;2813;80;2893;NA;92665;271;2020-11-26;11067
2020-11-25;"Nitriansky kraj";325;2478;91;2569;NA;92665;416;2020-11-25;10796
2020-11-24;"Nitriansky kraj";147;1641;64;1705;NA;92665;211;2020-11-24;10380
2020-11-23;"Nitriansky kraj";102;9891;212;10103;NA;92665;314;2020-11-23;10169
2020-11-22;"Nitriansky kraj";7;1176;25;1201;NA;92665;32;2020-11-22;9855
2020-11-21;"Nitriansky kraj";86;1083;38;1121;NA;92665;124;2020-11-21;9823
2020-11-20;"Nitriansky kraj";264;4180;103;4283;NA;92665;367;2020-11-20;9699
2020-11-19;"Nitriansky kraj";185;3065;134;3199;NA;92665;319;2020-11-19;9332
2020-11-18;"Nitriansky kraj";188;2214;79;2293;NA;92665;267;2020-11-18;9013
2020-11-17;"Nitriansky kraj";178;596;29;625;NA;92665;207;2020-11-17;8746
2020-11-16;"Nitriansky kraj";139;1877;75;1952;NA;92665;214;2020-11-16;8539
2020-11-15;"Nitriansky kraj";14;180;5;185;NA;92665;19;2020-11-15;8325
2020-11-14;"Nitriansky kraj";114;1131;32;1163;NA;92665;146;2020-11-14;8306
2020-11-13;"Nitriansky kraj";210;936;46;982;NA;92665;256;2020-11-13;8160
2020-11-12;"Nitriansky kraj";256;1195;35;1230;NA;92665;291;2020-11-12;7904
2020-11-11;"Nitriansky kraj";279;1247;22;1269;NA;92665;301;2020-11-11;7613
2020-11-10;"Nitriansky kraj";192;2623;39;2662;NA;92665;231;2020-11-10;7312
2020-11-09;"Nitriansky kraj";128;3136;43;3179;NA;92665;171;2020-11-09;7081
2020-11-08;"Nitriansky kraj";43;1462;32;1494;NA;92665;75;2020-11-08;6910
2020-11-07;"Nitriansky kraj";130;1046;4;1050;NA;92665;134;2020-11-07;6835
2020-11-06;"Nitriansky kraj";210;2264;32;2296;NA;92665;242;2020-11-06;6701
2020-11-05;"Nitriansky kraj";178;313;14;327;NA;92665;192;2020-11-05;6459
2020-11-04;"Nitriansky kraj";211;297;16;313;NA;92665;227;2020-11-04;6267
2020-11-03;"Nitriansky kraj";216;435;25;460;NA;92665;241;2020-11-03;6040
2020-11-02;"Nitriansky kraj";171;4208;46;4254;NA;92665;217;2020-11-02;5799
2020-11-01;"Nitriansky kraj";130;2546;27;2573;NA;92665;157;2020-11-01;5582
2020-10-31;"Nitriansky kraj";261;10466;134;10600;NA;92665;395;2020-10-31;5425
2020-10-30;"Nitriansky kraj";204;2593;42;2635;NA;92665;246;2020-10-30;5030
2020-10-29;"Nitriansky kraj";293;841;39;880;NA;92665;332;2020-10-29;4784
2020-10-28;"Nitriansky kraj";216;608;59;667;NA;92665;275;2020-10-28;4452
2020-10-27;"Nitriansky kraj";296;550;47;597;NA;92665;343;2020-10-27;4177
2020-10-26;"Nitriansky kraj";69;633;56;689;NA;92665;125;2020-10-26;3834
2020-10-25;"Nitriansky kraj";50;62;8;70;NA;92665;58;2020-10-25;3709
2020-10-24;"Nitriansky kraj";169;237;11;248;NA;92665;180;2020-10-24;3651
2020-10-23;"Nitriansky kraj";282;762;41;803;NA;92665;323;2020-10-23;3471
2020-10-22;"Nitriansky kraj";137;444;39;483;NA;92665;176;2020-10-22;3148
2020-10-21;"Nitriansky kraj";146;208;3;211;NA;92665;149;2020-10-21;2972
2020-10-20;"Nitriansky kraj";197;78;6;84;NA;92665;203;2020-10-20;2823
2020-10-19;"Nitriansky kraj";148;79;1;80;NA;92665;149;2020-10-19;2620
2020-10-18;"Nitriansky kraj";22;0;0;0;NA;92665;22;2020-10-18;2471
2020-10-17;"Nitriansky kraj";67;0;0;0;NA;92665;67;2020-10-17;2449
2020-10-16;"Nitriansky kraj";133;28;3;31;NA;92665;136;2020-10-16;2382
2020-10-15;"Nitriansky kraj";106;31;2;33;NA;92665;108;2020-10-15;2246
2020-10-14;"Nitriansky kraj";80;22;4;26;NA;92665;84;2020-10-14;2138
2020-10-13;"Nitriansky kraj";101;82;2;84;NA;92665;103;2020-10-13;2054
2020-10-12;"Nitriansky kraj";36;0;0;0;NA;92665;36;2020-10-12;1951
2020-10-11;"Nitriansky kraj";8;0;0;0;NA;92665;8;2020-10-11;1915
2020-10-10;"Nitriansky kraj";107;0;0;0;NA;92665;107;2020-10-10;1907
2020-10-09;"Nitriansky kraj";120;0;0;0;NA;92665;120;2020-10-09;1800
2020-10-08;"Nitriansky kraj";132;0;0;0;NA;92665;132;2020-10-08;1680
2020-10-07;"Nitriansky kraj";81;0;0;0;NA;92665;81;2020-10-07;1548
2020-10-06;"Nitriansky kraj";48;0;0;0;NA;92665;48;2020-10-06;1467
2020-10-05;"Nitriansky kraj";20;0;0;0;NA;92665;20;2020-10-05;1419
2020-10-04;"Nitriansky kraj";17;0;0;0;NA;92665;17;2020-10-04;1399
2020-10-03;"Nitriansky kraj";96;0;0;0;NA;92665;96;2020-10-03;1382
2020-10-02;"Nitriansky kraj";108;0;0;0;NA;92665;108;2020-10-02;1286
2020-10-01;"Nitriansky kraj";95;0;0;0;NA;92665;95;2020-10-01;1178
2020-09-30;"Nitriansky kraj";100;0;0;0;NA;92665;100;2020-09-30;1083
2020-09-29;"Nitriansky kraj";50;0;0;0;NA;92665;50;2020-09-29;983
2020-09-28;"Nitriansky kraj";22;0;0;0;NA;92665;22;2020-09-28;933
2020-09-27;"Nitriansky kraj";16;0;0;0;NA;92665;16;2020-09-27;911
2020-09-26;"Nitriansky kraj";64;0;0;0;NA;92665;64;2020-09-26;895
2020-09-25;"Nitriansky kraj";90;0;0;0;NA;92665;90;2020-09-25;831
2020-09-24;"Nitriansky kraj";51;0;0;0;NA;92665;51;2020-09-24;741
2020-09-23;"Nitriansky kraj";70;0;0;0;NA;92665;70;2020-09-23;690
2020-09-22;"Nitriansky kraj";18;0;0;0;NA;92665;18;2020-09-22;620
2020-09-21;"Nitriansky kraj";10;0;0;0;NA;92665;10;2020-09-21;602
2020-09-20;"Nitriansky kraj";4;0;0;0;NA;92665;4;2020-09-20;592
2020-09-19;"Nitriansky kraj";14;0;0;0;NA;92665;14;2020-09-19;588
2020-09-18;"Nitriansky kraj";19;0;0;0;NA;92665;19;2020-09-18;574
2020-09-17;"Nitriansky kraj";30;0;0;0;NA;92665;30;2020-09-17;555
2020-09-16;"Nitriansky kraj";6;0;0;0;NA;92665;6;2020-09-16;525
2020-09-15;"Nitriansky kraj";19;0;0;0;NA;92665;19;2020-09-15;519
2020-09-14;"Nitriansky kraj";28;0;0;0;NA;92665;28;2020-09-14;500
2020-09-13;"Nitriansky kraj";3;0;0;0;NA;92665;3;2020-09-13;472
2020-09-12;"Nitriansky kraj";12;0;0;0;NA;92665;12;2020-09-12;469
2020-09-11;"Nitriansky kraj";23;0;0;0;NA;92665;23;2020-09-11;457
2020-09-10;"Nitriansky kraj";29;0;0;0;NA;92665;29;2020-09-10;434
2020-09-09;"Nitriansky kraj";19;0;0;0;NA;92665;19;2020-09-09;405
2020-09-08;"Nitriansky kraj";17;0;0;0;NA;92665;17;2020-09-08;386
2020-09-07;"Nitriansky kraj";17;0;0;0;NA;92665;17;2020-09-07;369
2020-09-06;"Nitriansky kraj";0;0;0;0;NA;92665;0;2020-09-06;352
2020-09-05;"Nitriansky kraj";22;0;0;0;NA;92665;22;2020-09-05;352
2020-09-04;"Nitriansky kraj";34;0;0;0;NA;92665;34;2020-09-04;330
2020-09-03;"Nitriansky kraj";15;0;0;0;NA;92665;15;2020-09-03;296
2020-09-02;"Nitriansky kraj";15;0;0;0;NA;92665;15;2020-09-02;281
2020-09-01;"Nitriansky kraj";2;0;0;0;NA;92665;2;2020-09-01;266
2020-08-31;"Nitriansky kraj";12;0;0;0;NA;92665;12;2020-08-31;264
2020-08-30;"Nitriansky kraj";1;0;0;0;NA;92665;1;2020-08-30;252
2020-08-29;"Nitriansky kraj";7;0;0;0;NA;92665;7;2020-08-29;251
2020-08-28;"Nitriansky kraj";12;0;0;0;NA;92665;12;2020-08-28;244
2020-08-27;"Nitriansky kraj";12;0;0;0;NA;92665;12;2020-08-27;232
2020-08-26;"Nitriansky kraj";4;0;0;0;NA;92665;4;2020-08-26;220
2020-08-25;"Nitriansky kraj";8;0;0;0;NA;92665;8;2020-08-25;216
2020-08-24;"Nitriansky kraj";1;0;0;0;NA;92665;1;2020-08-24;208
2020-08-23;"Nitriansky kraj";1;0;0;0;NA;92665;1;2020-08-23;207
2020-08-22;"Nitriansky kraj";2;0;0;0;NA;92665;2;2020-08-22;206
2020-08-21;"Nitriansky kraj";0;0;0;0;NA;92665;0;2020-08-21;204
2020-08-20;"Nitriansky kraj";7;0;0;0;NA;92665;7;2020-08-20;204
2020-08-19;"Nitriansky kraj";1;0;0;0;NA;92665;1;2020-08-19;197
2020-08-18;"Nitriansky kraj";2;0;0;0;NA;92665;2;2020-08-18;196
2020-08-17;"Nitriansky kraj";1;0;0;0;NA;92665;1;2020-08-17;194
2020-08-16;"Nitriansky kraj";0;0;0;0;NA;92665;0;2020-08-16;193
2020-08-15;"Nitriansky kraj";2;0;0;0;NA;92665;2;2020-08-15;193
2020-08-14;"Nitriansky kraj";1;0;0;0;NA;92665;1;2020-08-14;191
2020-08-13;"Nitriansky kraj";4;0;0;0;NA;92665;4;2020-08-13;190
2020-08-12;"Nitriansky kraj";0;0;0;0;NA;92665;0;2020-08-12;186
2020-08-11;"Nitriansky kraj";1;0;0;0;NA;92665;1;2020-08-11;186
2020-08-10;"Nitriansky kraj";0;0;0;0;NA;92665;0;2020-08-10;185
2020-08-09;"Nitriansky kraj";0;0;0;0;NA;92665;0;2020-08-09;185
2020-08-08;"Nitriansky kraj";0;0;0;0;NA;92665;0;2020-08-08;185
2020-08-07;"Nitriansky kraj";4;0;0;0;NA;92665;4;2020-08-07;185
2020-08-06;"Nitriansky kraj";4;0;0;0;NA;92665;4;2020-08-06;181
2020-08-05;"Nitriansky kraj";0;0;0;0;NA;92665;0;2020-08-05;177
2020-08-04;"Nitriansky kraj";7;0;0;0;NA;92665;7;2020-08-04;177
2020-08-03;"Nitriansky kraj";0;0;0;0;NA;92665;0;2020-08-03;170
2020-08-02;"Nitriansky kraj";0;0;0;0;NA;92665;0;2020-08-02;170
2020-08-01;"Nitriansky kraj";0;0;0;0;NA;92665;0;2020-08-01;170
2020-07-31;"Nitriansky kraj";0;0;0;0;NA;92665;0;2020-07-31;170
2020-07-30;"Nitriansky kraj";0;0;0;0;NA;92665;0;2020-07-30;170
2020-07-29;"Nitriansky kraj";0;0;0;0;NA;92665;0;2020-07-29;170
2020-07-28;"Nitriansky kraj";0;0;0;0;NA;92665;0;2020-07-28;170
2020-07-27;"Nitriansky kraj";0;0;0;0;NA;92665;0;2020-07-27;170
2020-07-26;"Nitriansky kraj";0;0;0;0;NA;92665;0;2020-07-26;170
2020-07-25;"Nitriansky kraj";0;0;0;0;NA;92665;0;2020-07-25;170
2020-07-24;"Nitriansky kraj";1;0;0;0;NA;92665;1;2020-07-24;170
2020-07-23;"Nitriansky kraj";3;0;0;0;NA;92665;3;2020-07-23;169
2020-07-22;"Nitriansky kraj";2;0;0;0;NA;92665;2;2020-07-22;166
2020-07-21;"Nitriansky kraj";14;0;0;0;NA;92665;14;2020-07-21;164
2020-07-20;"Nitriansky kraj";11;0;0;0;NA;92665;11;2020-07-20;150
2020-07-19;"Nitriansky kraj";0;0;0;0;NA;92665;0;2020-07-19;139
2020-07-18;"Nitriansky kraj";0;0;0;0;NA;92665;0;2020-07-18;139
2020-07-17;"Nitriansky kraj";0;0;0;0;NA;92665;0;2020-07-17;139
2020-07-16;"Nitriansky kraj";4;0;0;0;NA;92665;4;2020-07-16;139
2020-07-15;"Nitriansky kraj";5;0;0;0;NA;92665;5;2020-07-15;135
2020-07-14;"Nitriansky kraj";0;0;0;0;NA;92665;0;2020-07-14;130
2020-07-13;"Nitriansky kraj";0;0;0;0;NA;92665;0;2020-07-13;130
2020-07-12;"Nitriansky kraj";0;0;0;0;NA;92665;0;2020-07-12;130
2020-07-11;"Nitriansky kraj";0;0;0;0;NA;92665;0;2020-07-11;130
2020-07-10;"Nitriansky kraj";0;0;0;0;NA;92665;0;2020-07-10;130
2020-07-09;"Nitriansky kraj";1;0;0;0;NA;92665;1;2020-07-09;130
2020-07-08;"Nitriansky kraj";2;0;0;0;NA;92665;2;2020-07-08;129
2020-07-07;"Nitriansky kraj";0;0;0;0;NA;92665;0;2020-07-07;127
2020-07-06;"Nitriansky kraj";0;0;0;0;NA;92665;0;2020-07-06;127
2020-07-05;"Nitriansky kraj";0;0;0;0;NA;92665;0;2020-07-05;127
2020-07-04;"Nitriansky kraj";0;0;0;0;NA;92665;0;2020-07-04;127
2020-07-03;"Nitriansky kraj";0;0;0;0;NA;92665;0;2020-07-03;127
2020-07-02;"Nitriansky kraj";0;0;0;0;NA;92665;0;2020-07-02;127
2020-07-01;"Nitriansky kraj";3;0;0;0;NA;92665;3;2020-07-01;127
2020-06-30;"Nitriansky kraj";0;0;0;0;NA;92665;0;2020-06-30;124
2020-06-29;"Nitriansky kraj";0;0;0;0;NA;92665;0;2020-06-29;124
2020-06-28;"Nitriansky kraj";0;0;0;0;NA;92665;0;2020-06-28;124
2020-06-27;"Nitriansky kraj";0;0;0;0;NA;92665;0;2020-06-27;124
2020-06-26;"Nitriansky kraj";0;0;0;0;NA;92665;0;2020-06-26;124
2020-06-25;"Nitriansky kraj";0;0;0;0;NA;92665;0;2020-06-25;124
2020-06-24;"Nitriansky kraj";1;0;0;0;NA;92665;1;2020-06-24;124
2020-06-23;"Nitriansky kraj";0;0;0;0;NA;92665;0;2020-06-23;123
2020-06-22;"Nitriansky kraj";0;0;0;0;NA;92665;0;2020-06-22;123
2020-06-21;"Nitriansky kraj";0;0;0;0;NA;92665;0;2020-06-21;123
2020-06-20;"Nitriansky kraj";0;0;0;0;NA;92665;0;2020-06-20;123
2020-06-19;"Nitriansky kraj";0;0;0;0;NA;92665;0;2020-06-19;123
2020-06-18;"Nitriansky kraj";0;0;0;0;NA;92665;0;2020-06-18;123
2020-06-17;"Nitriansky kraj";0;0;0;0;NA;92665;0;2020-06-17;123
2020-06-16;"Nitriansky kraj";0;0;0;0;NA;92665;0;2020-06-16;123
2020-06-14;"Nitriansky kraj";0;0;0;0;NA;92665;0;2020-06-14;123
2020-06-13;"Nitriansky kraj";0;0;0;0;NA;92665;0;2020-06-13;123
2020-06-12;"Nitriansky kraj";0;0;0;0;NA;92665;0;2020-06-12;123
2020-06-11;"Nitriansky kraj";0;0;0;0;NA;92665;0;2020-06-11;123
2020-06-10;"Nitriansky kraj";1;0;0;0;NA;92665;1;2020-06-10;123
2020-06-09;"Nitriansky kraj";1;0;0;0;NA;92665;1;2020-06-09;122
2020-06-08;"Nitriansky kraj";0;0;0;0;NA;92665;0;2020-06-08;121
2020-06-07;"Nitriansky kraj";0;0;0;0;NA;92665;0;2020-06-07;121
2020-06-05;"Nitriansky kraj";0;0;0;0;NA;92665;0;2020-06-05;121
2020-06-03;"Nitriansky kraj";0;0;0;0;NA;92665;0;2020-06-03;121
2020-06-02;"Nitriansky kraj";1;0;0;0;NA;92665;1;2020-06-02;121
2020-05-31;"Nitriansky kraj";0;0;0;0;NA;92665;0;2020-05-31;120
2020-05-29;"Nitriansky kraj";0;0;0;0;NA;92665;0;2020-05-29;120
2020-05-27;"Nitriansky kraj";0;0;0;0;NA;92665;0;2020-05-27;120
2020-05-26;"Nitriansky kraj";0;0;0;0;NA;92665;0;2020-05-26;120
2020-05-25;"Nitriansky kraj";0;0;0;0;NA;92665;0;2020-05-25;120
2020-05-24;"Nitriansky kraj";2;0;0;0;NA;92665;2;2020-05-24;120
2020-05-23;"Nitriansky kraj";0;0;0;0;NA;92665;0;2020-05-23;118
2020-05-22;"Nitriansky kraj";1;0;0;0;NA;92665;1;2020-05-22;118
2020-05-21;"Nitriansky kraj";0;0;0;0;NA;92665;0;2020-05-21;117
2020-05-20;"Nitriansky kraj";0;0;0;0;NA;92665;0;2020-05-20;117
2020-05-19;"Nitriansky kraj";0;0;0;0;NA;92665;0;2020-05-19;117
2020-05-17;"Nitriansky kraj";0;0;0;0;NA;92665;0;2020-05-17;117
2020-05-16;"Nitriansky kraj";0;0;0;0;NA;92665;0;2020-05-16;117
2020-05-15;"Nitriansky kraj";1;0;0;0;NA;92665;1;2020-05-15;117
2020-05-14;"Nitriansky kraj";0;0;0;0;NA;92665;0;2020-05-14;116
2020-05-13;"Nitriansky kraj";0;0;0;0;NA;92665;0;2020-05-13;116
2020-05-12;"Nitriansky kraj";0;0;0;0;NA;92665;0;2020-05-12;116
2020-05-11;"Nitriansky kraj";2;0;0;0;NA;92665;2;2020-05-11;116
2020-05-09;"Nitriansky kraj";0;0;0;0;NA;92665;0;2020-05-09;114
2020-05-07;"Nitriansky kraj";1;0;0;0;NA;92665;1;2020-05-07;114
2020-05-06;"Nitriansky kraj";9;0;0;0;NA;92665;9;2020-05-06;113
2020-05-05;"Nitriansky kraj";0;0;0;0;NA;92665;0;2020-05-05;104
2020-05-04;"Nitriansky kraj";5;0;0;0;NA;92665;5;2020-05-04;104
2020-05-03;"Nitriansky kraj";2;0;0;0;NA;92665;2;2020-05-03;99
2020-05-02;"Nitriansky kraj";0;0;0;0;NA;92665;0;2020-05-02;97
2020-05-01;"Nitriansky kraj";1;0;0;0;NA;92665;1;2020-05-01;97
2020-04-30;"Nitriansky kraj";0;0;0;0;NA;92665;0;2020-04-30;96
2020-04-29;"Nitriansky kraj";0;0;0;0;NA;92665;0;2020-04-29;96
2020-04-28;"Nitriansky kraj";1;0;0;0;NA;92665;1;2020-04-28;96
2020-04-27;"Nitriansky kraj";0;0;0;0;NA;92665;0;2020-04-27;95
2020-04-26;"Nitriansky kraj";0;0;0;0;NA;92665;0;2020-04-26;95
2020-04-25;"Nitriansky kraj";0;0;0;0;NA;92665;0;2020-04-25;95
2020-04-24;"Nitriansky kraj";0;0;0;0;NA;92665;0;2020-04-24;95
2020-04-23;"Nitriansky kraj";3;0;0;0;NA;92665;3;2020-04-23;95
2020-04-22;"Nitriansky kraj";16;0;0;0;NA;92665;16;2020-04-22;92
2020-04-21;"Nitriansky kraj";6;0;0;0;NA;92665;6;2020-04-21;76
2020-04-20;"Nitriansky kraj";5;0;0;0;NA;92665;5;2020-04-20;70
2020-04-19;"Nitriansky kraj";0;0;0;0;NA;92665;0;2020-04-19;65
2020-04-18;"Nitriansky kraj";0;0;0;0;NA;92665;0;2020-04-18;65
2020-04-17;"Nitriansky kraj";7;0;0;0;NA;92665;7;2020-04-17;65
2020-04-16;"Nitriansky kraj";0;0;0;0;NA;92665;0;2020-04-16;58
2020-04-15;"Nitriansky kraj";6;0;0;0;NA;92665;6;2020-04-15;58
2020-04-14;"Nitriansky kraj";2;0;0;0;NA;92665;2;2020-04-14;52
2020-04-13;"Nitriansky kraj";1;0;0;0;NA;92665;1;2020-04-13;50
2020-04-12;"Nitriansky kraj";3;0;0;0;NA;92665;3;2020-04-12;49
2020-04-11;"Nitriansky kraj";1;0;0;0;NA;92665;1;2020-04-11;46
2020-04-10;"Nitriansky kraj";1;0;0;0;NA;92665;1;2020-04-10;45
2020-04-09;"Nitriansky kraj";0;0;0;0;NA;92665;0;2020-04-09;44
2020-04-08;"Nitriansky kraj";2;0;0;0;NA;92665;2;2020-04-08;44
2020-04-07;"Nitriansky kraj";3;0;0;0;NA;92665;3;2020-04-07;42
2020-04-06;"Nitriansky kraj";4;0;0;0;NA;92665;4;2020-04-06;39
2020-04-05;"Nitriansky kraj";5;0;0;0;NA;92665;5;2020-04-05;35
2020-04-04;"Nitriansky kraj";0;0;0;0;NA;92665;0;2020-04-04;30
2020-04-03;"Nitriansky kraj";0;0;0;0;NA;92665;0;2020-04-03;30
2020-04-02;"Nitriansky kraj";1;0;0;0;NA;92665;1;2020-04-02;30
2020-04-01;"Nitriansky kraj";0;0;0;0;NA;92665;0;2020-04-01;29
2020-03-31;"Nitriansky kraj";3;0;0;0;NA;92665;3;2020-03-31;29
2020-03-30;"Nitriansky kraj";3;0;0;0;NA;92665;3;2020-03-30;26
2020-03-29;"Nitriansky kraj";3;0;0;0;NA;92665;3;2020-03-29;23
2020-03-28;"Nitriansky kraj";1;0;0;0;NA;92665;1;2020-03-28;20
2020-03-27;"Nitriansky kraj";1;0;0;0;NA;92665;1;2020-03-27;19
2020-03-26;"Nitriansky kraj";1;0;0;0;NA;92665;1;2020-03-26;18
2020-03-25;"Nitriansky kraj";1;0;0;0;NA;92665;1;2020-03-25;17
2020-03-24;"Nitriansky kraj";0;0;0;0;NA;92665;0;2020-03-24;16
2020-03-23;"Nitriansky kraj";2;0;0;0;NA;92665;2;2020-03-23;16
2020-03-22;"Nitriansky kraj";2;0;0;0;NA;92665;2;2020-03-22;14
2020-03-21;"Nitriansky kraj";2;0;0;0;NA;92665;2;2020-03-21;12
2020-03-20;"Nitriansky kraj";1;0;0;0;NA;92665;1;2020-03-20;10
2020-03-19;"Nitriansky kraj";1;0;0;0;NA;92665;1;2020-03-19;9
2020-03-18;"Nitriansky kraj";2;0;0;0;NA;92665;2;2020-03-18;8
2020-03-17;"Nitriansky kraj";1;0;0;0;NA;92665;1;2020-03-17;6
2020-03-16;"Nitriansky kraj";0;0;0;0;NA;92665;0;2020-03-16;5
2020-03-15;"Nitriansky kraj";4;0;0;0;NA;92665;4;2020-03-15;5
2020-03-14;"Nitriansky kraj";1;0;0;0;NA;92665;1;2020-03-14;1
2020-03-13;"Nitriansky kraj";0;0;0;0;NA;92665;0;2020-03-13;0
2020-03-12;"Nitriansky kraj";0;0;0;0;NA;92665;0;2020-03-12;0
2020-03-11;"Nitriansky kraj";0;0;0;0;NA;92665;0;2020-03-11;0
2020-03-09;"Nitriansky kraj";0;0;0;0;NA;92665;0;2020-03-09;0
2020-03-08;"Nitriansky kraj";0;0;0;0;NA;92665;0;2020-03-08;0
2020-03-07;"Nitriansky kraj";0;0;0;0;NA;92665;0;2020-03-07;0
2020-03-06;"Nitriansky kraj";0;0;0;0;NA;92665;0;2020-03-06;0
2021-07-11;"Prešovský kraj";0;302;0;302;60074;113819;0;2021-07-11;113819
2021-07-10;"Prešovský kraj";4;747;1;748;NA;113819;5;2021-07-10;113819
2021-07-09;"Prešovský kraj";6;1344;1;1345;NA;113819;7;2021-07-09;113814
2021-07-08;"Prešovský kraj";5;1077;0;1077;NA;113819;5;2021-07-08;113807
2021-07-07;"Prešovský kraj";7;1322;3;1325;NA;113819;10;2021-07-07;113802
2021-07-06;"Prešovský kraj";5;1364;2;1366;NA;113819;7;2021-07-06;113792
2021-07-05;"Prešovský kraj";2;573;0;573;NA;113819;2;2021-07-05;113785
2021-07-04;"Prešovský kraj";0;744;0;744;NA;113819;0;2021-07-04;113783
2021-07-03;"Prešovský kraj";2;1298;0;1298;NA;113819;2;2021-07-03;113783
2021-07-02;"Prešovský kraj";4;1704;0;1704;NA;113819;4;2021-07-02;113781
2021-07-01;"Prešovský kraj";2;1584;1;1585;NA;113819;3;2021-07-01;113777
2021-06-30;"Prešovský kraj";3;9010;2;9012;NA;113819;5;2021-06-30;113774
2021-06-29;"Prešovský kraj";1;4524;3;4527;NA;113819;4;2021-06-29;113769
2021-06-28;"Prešovský kraj";5;7522;2;7524;NA;113819;7;2021-06-28;113765
2021-06-27;"Prešovský kraj";0;3597;1;3598;NA;113819;1;2021-06-27;113758
2021-06-26;"Prešovský kraj";4;5097;1;5098;NA;113819;5;2021-06-26;113757
2021-06-25;"Prešovský kraj";7;6464;4;6468;NA;113819;11;2021-06-25;113752
2021-06-24;"Prešovský kraj";10;6092;4;6096;NA;113819;14;2021-06-24;113741
2021-06-23;"Prešovský kraj";4;4632;2;4634;NA;113819;6;2021-06-23;113727
2021-06-22;"Prešovský kraj";5;4449;1;4450;NA;113819;6;2021-06-22;113721
2021-06-21;"Prešovský kraj";13;7357;6;7363;NA;113819;19;2021-06-21;113715
2021-06-20;"Prešovský kraj";0;4880;3;4883;NA;113819;3;2021-06-20;113696
2021-06-19;"Prešovský kraj";1;6555;4;6559;NA;113819;5;2021-06-19;113693
2021-06-18;"Prešovský kraj";9;7903;8;7911;NA;113819;17;2021-06-18;113688
2021-06-17;"Prešovský kraj";9;6391;5;6396;NA;113819;14;2021-06-17;113671
2021-06-16;"Prešovský kraj";6;6087;3;6090;NA;113819;9;2021-06-16;113657
2021-06-15;"Prešovský kraj";2;5577;4;5581;NA;113819;6;2021-06-15;113648
2021-06-14;"Prešovský kraj";5;8182;13;8195;NA;113819;18;2021-06-14;113642
2021-06-13;"Prešovský kraj";1;6462;7;6469;NA;113819;8;2021-06-13;113624
2021-06-12;"Prešovský kraj";3;8646;9;8655;NA;113819;12;2021-06-12;113616
2021-06-11;"Prešovský kraj";21;9487;9;9496;NA;113819;30;2021-06-11;113604
2021-06-10;"Prešovský kraj";11;6375;10;6385;NA;113819;21;2021-06-10;113574
2021-06-09;"Prešovský kraj";16;6161;3;6164;NA;113819;19;2021-06-09;113553
2021-06-08;"Prešovský kraj";31;6291;12;6303;NA;113819;43;2021-06-08;113534
2021-06-07;"Prešovský kraj";11;8891;15;8906;NA;113819;26;2021-06-07;113491
2021-06-06;"Prešovský kraj";0;7702;4;7706;NA;113819;4;2021-06-06;113465
2021-06-05;"Prešovský kraj";17;9970;14;9984;NA;113819;31;2021-06-05;113461
2021-06-04;"Prešovský kraj";26;10021;18;10039;NA;113819;44;2021-06-04;113430
2021-06-03;"Prešovský kraj";14;6449;15;6464;NA;113819;29;2021-06-03;113386
2021-06-02;"Prešovský kraj";47;7372;14;7386;NA;113819;61;2021-06-02;113357
2021-06-01;"Prešovský kraj";15;6781;14;6795;NA;113819;29;2021-06-01;113296
2021-05-31;"Prešovský kraj";27;9620;22;9642;NA;113819;49;2021-05-31;113267
2021-05-30;"Prešovský kraj";2;9429;13;9442;NA;113819;15;2021-05-30;113218
2021-05-29;"Prešovský kraj";23;12398;24;12422;NA;113819;47;2021-05-29;113203
2021-05-28;"Prešovský kraj";30;11974;19;11993;NA;113819;49;2021-05-28;113156
2021-05-27;"Prešovský kraj";16;7609;37;7646;NA;113819;53;2021-05-27;113107
2021-05-26;"Prešovský kraj";32;7979;23;8002;NA;113819;55;2021-05-26;113054
2021-05-25;"Prešovský kraj";38;8409;20;8429;NA;113819;58;2021-05-25;112999
2021-05-24;"Prešovský kraj";17;13297;37;13334;NA;113819;54;2021-05-24;112941
2021-05-23;"Prešovský kraj";3;11593;20;11613;NA;113819;23;2021-05-23;112887
2021-05-22;"Prešovský kraj";11;14263;44;14307;NA;113819;55;2021-05-22;112864
2021-05-21;"Prešovský kraj";44;13281;24;13305;NA;113819;68;2021-05-21;112809
2021-05-20;"Prešovský kraj";13;9076;29;9105;NA;113819;42;2021-05-20;112741
2021-05-19;"Prešovský kraj";60;10398;33;10431;NA;113819;93;2021-05-19;112699
2021-05-18;"Prešovský kraj";44;9060;27;9087;NA;113819;71;2021-05-18;112606
2021-05-17;"Prešovský kraj";60;12596;46;12642;NA;113819;106;2021-05-17;112535
2021-05-16;"Prešovský kraj";20;15945;66;16011;NA;113819;86;2021-05-16;112429
2021-05-15;"Prešovský kraj";20;24280;80;24360;NA;113819;100;2021-05-15;112343
2021-05-14;"Prešovský kraj";49;18020;62;18082;NA;113819;111;2021-05-14;112243
2021-05-13;"Prešovský kraj";54;11166;71;11237;NA;113819;125;2021-05-13;112132
2021-05-12;"Prešovský kraj";59;10822;39;10861;NA;113819;98;2021-05-12;112007
2021-05-11;"Prešovský kraj";61;10728;48;10776;NA;113819;109;2021-05-11;111909
2021-05-10;"Prešovský kraj";79;15450;67;15517;NA;113819;146;2021-05-10;111800
2021-05-09;"Prešovský kraj";54;21448;79;21527;NA;113819;133;2021-05-09;111654
2021-05-08;"Prešovský kraj";39;23012;52;23064;NA;113819;91;2021-05-08;111521
2021-05-07;"Prešovský kraj";81;23356;66;23422;NA;113819;147;2021-05-07;111430
2021-05-06;"Prešovský kraj";107;12833;66;12899;NA;113819;173;2021-05-06;111283
2021-05-05;"Prešovský kraj";60;12808;84;12892;NA;113819;144;2021-05-05;111110
2021-05-04;"Prešovský kraj";203;13463;66;13529;NA;113819;269;2021-05-04;110966
2021-05-03;"Prešovský kraj";68;18435;109;18544;NA;113819;177;2021-05-03;110697
2021-05-02;"Prešovský kraj";29;36175;102;36277;NA;113819;131;2021-05-02;110520
2021-05-01;"Prešovský kraj";70;57153;183;57336;NA;113819;253;2021-05-01;110389
2021-04-30;"Prešovský kraj";135;39333;118;39451;NA;113819;253;2021-04-30;110136
2021-04-29;"Prešovský kraj";110;16585;97;16682;NA;113819;207;2021-04-29;109883
2021-04-28;"Prešovský kraj";122;18671;89;18760;NA;113819;211;2021-04-28;109676
2021-04-27;"Prešovský kraj";154;19984;120;20104;NA;113819;274;2021-04-27;109465
2021-04-26;"Prešovský kraj";99;27120;123;27243;NA;113819;222;2021-04-26;109191
2021-04-25;"Prešovský kraj";9;52257;155;52412;NA;113819;164;2021-04-25;108969
2021-04-24;"Prešovský kraj";61;85301;243;85544;NA;113819;304;2021-04-24;108805
2021-04-23;"Prešovský kraj";171;40362;137;40499;NA;113819;308;2021-04-23;108501
2021-04-22;"Prešovský kraj";86;18104;125;18229;NA;113819;211;2021-04-22;108193
2021-04-21;"Prešovský kraj";144;21549;139;21688;NA;113819;283;2021-04-21;107982
2021-04-20;"Prešovský kraj";115;23345;128;23473;NA;113819;243;2021-04-20;107699
2021-04-19;"Prešovský kraj";106;29131;145;29276;NA;113819;251;2021-04-19;107456
2021-04-18;"Prešovský kraj";4;51540;129;51669;NA;113819;133;2021-04-18;107205
2021-04-17;"Prešovský kraj";119;97970;238;98208;NA;113819;357;2021-04-17;107072
2021-04-16;"Prešovský kraj";135;40983;146;41129;NA;113819;281;2021-04-16;106715
2021-04-15;"Prešovský kraj";112;20179;137;20316;NA;113819;249;2021-04-15;106434
2021-04-14;"Prešovský kraj";199;23331;130;23461;NA;113819;329;2021-04-14;106185
2021-04-13;"Prešovský kraj";180;23907;116;24023;NA;113819;296;2021-04-13;105856
2021-04-12;"Prešovský kraj";172;30152;175;30327;NA;113819;347;2021-04-12;105560
2021-04-11;"Prešovský kraj";11;49807;187;49994;NA;113819;198;2021-04-11;105213
2021-04-10;"Prešovský kraj";94;90181;297;90478;NA;113819;391;2021-04-10;105015
2021-04-09;"Prešovský kraj";255;37163;200;37363;NA;113819;455;2021-04-09;104624
2021-04-08;"Prešovský kraj";192;18891;157;19048;NA;113819;349;2021-04-08;104169
2021-04-07;"Prešovský kraj";314;27797;154;27951;NA;113819;468;2021-04-07;103820
2021-04-06;"Prešovský kraj";231;41702;268;41970;NA;113819;499;2021-04-06;103352
2021-04-05;"Prešovský kraj";54;18454;132;18586;NA;113819;186;2021-04-05;102853
2021-04-04;"Prešovský kraj";31;18569;91;18660;NA;113819;122;2021-04-04;102667
2021-04-03;"Prešovský kraj";104;90608;317;90925;NA;113819;421;2021-04-03;102545
2021-04-02;"Prešovský kraj";194;23381;134;23515;NA;113819;328;2021-04-02;102124
2021-04-01;"Prešovský kraj";256;42854;195;43049;NA;113819;451;2021-04-01;101796
2021-03-31;"Prešovský kraj";311;30160;227;30387;NA;113819;538;2021-03-31;101345
2021-03-30;"Prešovský kraj";374;20747;203;20950;NA;113819;577;2021-03-30;100807
2021-03-29;"Prešovský kraj";219;28188;229;28417;NA;113819;448;2021-03-29;100230
2021-03-28;"Prešovský kraj";26;46811;256;47067;NA;113819;282;2021-03-28;99782
2021-03-27;"Prešovský kraj";181;88413;372;88785;NA;113819;553;2021-03-27;99500
2021-03-26;"Prešovský kraj";310;47751;299;48050;NA;113819;609;2021-03-26;98947
2021-03-25;"Prešovský kraj";248;22279;213;22492;NA;113819;461;2021-03-25;98338
2021-03-24;"Prešovský kraj";381;19588;213;19801;NA;113819;594;2021-03-24;97877
2021-03-23;"Prešovský kraj";241;20329;255;20584;NA;113819;496;2021-03-23;97283
2021-03-22;"Prešovský kraj";299;28479;286;28765;NA;113819;585;2021-03-22;96787
2021-03-21;"Prešovský kraj";32;49439;266;49705;NA;113819;298;2021-03-21;96202
2021-03-20;"Prešovský kraj";180;92531;427;92958;NA;113819;607;2021-03-20;95904
2021-03-19;"Prešovský kraj";373;46196;320;46516;NA;113819;693;2021-03-19;95297
2021-03-18;"Prešovský kraj";251;21721;217;21938;NA;113819;468;2021-03-18;94604
2021-03-17;"Prešovský kraj";331;20887;231;21118;NA;113819;562;2021-03-17;94136
2021-03-16;"Prešovský kraj";461;21094;278;21372;NA;113819;739;2021-03-16;93574
2021-03-15;"Prešovský kraj";370;28789;324;29113;NA;113819;694;2021-03-15;92835
2021-03-14;"Prešovský kraj";52;50410;356;50766;NA;113819;408;2021-03-14;92141
2021-03-13;"Prešovský kraj";200;94768;531;95299;NA;113819;731;2021-03-13;91733
2021-03-12;"Prešovský kraj";425;47691;368;48059;NA;113819;793;2021-03-12;91002
2021-03-11;"Prešovský kraj";463;22059;253;22312;NA;113819;716;2021-03-11;90209
2021-03-10;"Prešovský kraj";325;20821;293;21114;NA;113819;618;2021-03-10;89493
2021-03-09;"Prešovský kraj";505;21489;288;21777;NA;113819;793;2021-03-09;88875
2021-03-08;"Prešovský kraj";314;28903;333;29236;NA;113819;647;2021-03-08;88082
2021-03-07;"Prešovský kraj";19;48024;385;48409;NA;113819;404;2021-03-07;87435
2021-03-06;"Prešovský kraj";193;96985;591;97576;NA;113819;784;2021-03-06;87031
2021-03-05;"Prešovský kraj";497;46044;397;46441;NA;113819;894;2021-03-05;86247
2021-03-04;"Prešovský kraj";372;22670;359;23029;NA;113819;731;2021-03-04;85353
2021-03-03;"Prešovský kraj";397;21621;333;21954;NA;113819;730;2021-03-03;84622
2021-03-02;"Prešovský kraj";421;22679;357;23036;NA;113819;778;2021-03-02;83892
2021-03-01;"Prešovský kraj";303;27716;406;28122;NA;113819;709;2021-03-01;83114
2021-02-28;"Prešovský kraj";75;45000;387;45387;NA;113819;462;2021-02-28;82405
2021-02-27;"Prešovský kraj";273;90231;734;90965;NA;113819;1007;2021-02-27;81943
2021-02-26;"Prešovský kraj";455;41340;438;41778;NA;113819;893;2021-02-26;80936
2021-02-25;"Prešovský kraj";270;19496;337;19833;NA;113819;607;2021-02-25;80043
2021-02-24;"Prešovský kraj";328;19026;377;19403;NA;113819;705;2021-02-24;79436
2021-02-23;"Prešovský kraj";430;21273;345;21618;NA;113819;775;2021-02-23;78731
2021-02-22;"Prešovský kraj";351;27175;356;27531;NA;113819;707;2021-02-22;77956
2021-02-21;"Prešovský kraj";66;31802;302;32104;NA;113819;368;2021-02-21;77249
2021-02-20;"Prešovský kraj";129;71413;517;71930;NA;113819;646;2021-02-20;76881
2021-02-19;"Prešovský kraj";381;38597;425;39022;NA;113819;806;2021-02-19;76235
2021-02-18;"Prešovský kraj";268;16960;322;17282;NA;113819;590;2021-02-18;75429
2021-02-17;"Prešovský kraj";293;17392;246;17638;NA;113819;539;2021-02-17;74839
2021-02-16;"Prešovský kraj";422;18862;265;19127;NA;113819;687;2021-02-16;74300
2021-02-15;"Prešovský kraj";211;31360;303;31663;NA;113819;514;2021-02-15;73613
2021-02-14;"Prešovský kraj";27;39271;318;39589;NA;113819;345;2021-02-14;73099
2021-02-13;"Prešovský kraj";157;74009;392;74401;NA;113819;549;2021-02-13;72754
2021-02-12;"Prešovský kraj";308;38757;362;39119;NA;113819;670;2021-02-12;72205
2021-02-11;"Prešovský kraj";218;16207;238;16445;NA;113819;456;2021-02-11;71535
2021-02-10;"Prešovský kraj";220;18541;282;18823;NA;113819;502;2021-02-10;71079
2021-02-09;"Prešovský kraj";323;21495;370;21865;NA;113819;693;2021-02-09;70577
2021-02-08;"Prešovský kraj";161;36924;261;37185;NA;113819;422;2021-02-08;69884
2021-02-07;"Prešovský kraj";21;34227;209;34436;NA;113819;230;2021-02-07;69462
2021-02-06;"Prešovský kraj";176;69164;360;69524;NA;113819;536;2021-02-06;69232
2021-02-05;"Prešovský kraj";177;31247;261;31508;NA;113819;438;2021-02-05;68696
2021-02-04;"Prešovský kraj";176;13071;237;13308;NA;113819;413;2021-02-04;68258
2021-02-03;"Prešovský kraj";251;8421;236;8657;NA;113819;487;2021-02-03;67845
2021-02-02;"Prešovský kraj";249;11769;264;12033;NA;113819;513;2021-02-02;67358
2021-02-01;"Prešovský kraj";220;16059;316;16375;NA;113819;536;2021-02-01;66845
2021-01-31;"Prešovský kraj";42;10587;107;10694;NA;113819;149;2021-01-31;66309
2021-01-30;"Prešovský kraj";142;23939;215;24154;NA;113819;357;2021-01-30;66160
2021-01-29;"Prešovský kraj";185;17924;326;18250;NA;113819;511;2021-01-29;65803
2021-01-28;"Prešovský kraj";311;7338;150;7488;NA;113819;461;2021-01-28;65292
2021-01-27;"Prešovský kraj";153;9730;147;9877;NA;113819;300;2021-01-27;64831
2021-01-26;"Prešovský kraj";252;16653;151;16804;NA;113819;403;2021-01-26;64531
2021-01-25;"Prešovský kraj";196;29730;253;29983;NA;113819;449;2021-01-25;64128
2021-01-24;"Prešovský kraj";12;45706;304;46010;NA;113819;316;2021-01-24;63679
2021-01-23;"Prešovský kraj";189;96722;487;97209;NA;113819;676;2021-01-23;63363
2021-01-22;"Prešovský kraj";187;35377;261;35638;NA;113819;448;2021-01-22;62687
2021-01-21;"Prešovský kraj";187;20434;212;20646;NA;113819;399;2021-01-21;62239
2021-01-20;"Prešovský kraj";253;14771;195;14966;NA;113819;448;2021-01-20;61840
2021-01-19;"Prešovský kraj";281;12329;305;12634;NA;113819;586;2021-01-19;61392
2021-01-18;"Prešovský kraj";203;10422;336;10758;NA;113819;539;2021-01-18;60806
2021-01-17;"Prešovský kraj";107;14391;1008;15399;NA;113819;1115;2021-01-17;60267
2021-01-16;"Prešovský kraj";72;1838;81;1919;NA;113819;153;2021-01-16;59152
2021-01-15;"Prešovský kraj";159;7033;257;7290;NA;113819;416;2021-01-15;58999
2021-01-14;"Prešovský kraj";268;5534;256;5790;NA;113819;524;2021-01-14;58583
2021-01-13;"Prešovský kraj";342;5649;226;5875;NA;113819;568;2021-01-13;58059
2021-01-12;"Prešovský kraj";455;8487;409;8896;NA;113819;864;2021-01-12;57491
2021-01-11;"Prešovský kraj";343;8507;481;8988;NA;113819;824;2021-01-11;56627
2021-01-10;"Prešovský kraj";63;476;23;499;NA;113819;86;2021-01-10;55803
2021-01-09;"Prešovský kraj";439;2248;125;2373;NA;113819;564;2021-01-09;55717
2021-01-08;"Prešovský kraj";430;10855;572;11427;NA;113819;1002;2021-01-08;55153
2021-01-07;"Prešovský kraj";268;7789;648;8437;NA;113819;916;2021-01-07;54151
2021-01-06;"Prešovský kraj";315;1484;134;1618;NA;113819;449;2021-01-06;53235
2021-01-05;"Prešovský kraj";655;11591;1003;12594;NA;113819;1658;2021-01-05;52786
2021-01-04;"Prešovský kraj";371;17192;1812;19004;NA;113819;2183;2021-01-04;51128
2021-01-03;"Prešovský kraj";89;459;41;500;NA;113819;130;2021-01-03;48945
2021-01-02;"Prešovský kraj";65;1556;160;1716;NA;113819;225;2021-01-02;48815
2021-01-01;"Prešovský kraj";174;956;71;1027;NA;113819;245;2021-01-01;48590
2020-12-31;"Prešovský kraj";640;11959;783;12742;NA;113819;1423;2020-12-31;48345
2020-12-30;"Prešovský kraj";729;9062;802;9864;NA;113819;1531;2020-12-30;46922
2020-12-29;"Prešovský kraj";435;9273;949;10222;NA;113819;1384;2020-12-29;45391
2020-12-28;"Prešovský kraj";393;9046;1079;10125;NA;113819;1472;2020-12-28;44007
2020-12-27;"Prešovský kraj";40;613;45;658;NA;113819;85;2020-12-27;42535
2020-12-26;"Prešovský kraj";64;176;12;188;NA;113819;76;2020-12-26;42450
2020-12-25;"Prešovský kraj";208;274;11;285;NA;113819;219;2020-12-25;42374
2020-12-24;"Prešovský kraj";452;1214;85;1299;NA;113819;537;2020-12-24;42155
2020-12-23;"Prešovský kraj";361;11369;635;12004;NA;113819;996;2020-12-23;41618
2020-12-22;"Prešovský kraj";439;9371;710;10081;NA;113819;1149;2020-12-22;40622
2020-12-21;"Prešovský kraj";432;9923;880;10803;NA;113819;1312;2020-12-21;39473
2020-12-20;"Prešovský kraj";184;396;20;416;NA;113819;204;2020-12-20;38161
2020-12-19;"Prešovský kraj";276;1658;151;1809;NA;113819;427;2020-12-19;37957
2020-12-18;"Prešovský kraj";396;8845;595;9440;NA;113819;991;2020-12-18;37530
2020-12-17;"Prešovský kraj";427;10826;891;11717;NA;113819;1318;2020-12-17;36539
2020-12-16;"Prešovský kraj";466;6017;508;6525;NA;113819;974;2020-12-16;35221
2020-12-15;"Prešovský kraj";411;5685;584;6269;NA;113819;995;2020-12-15;34247
2020-12-14;"Prešovský kraj";334;5767;508;6275;NA;113819;842;2020-12-14;33252
2020-12-13;"Prešovský kraj";89;29;8;37;NA;113819;97;2020-12-13;32410
2020-12-12;"Prešovský kraj";319;2474;166;2640;NA;113819;485;2020-12-12;32313
2020-12-11;"Prešovský kraj";560;5602;402;6004;NA;113819;962;2020-12-11;31828
2020-12-10;"Prešovský kraj";337;5202;443;5645;NA;113819;780;2020-12-10;30866
2020-12-09;"Prešovský kraj";358;4357;314;4671;NA;113819;672;2020-12-09;30086
2020-12-08;"Prešovský kraj";350;6629;651;7280;NA;113819;1001;2020-12-08;29414
2020-12-07;"Prešovský kraj";309;4345;327;4672;NA;113819;636;2020-12-07;28413
2020-12-06;"Prešovský kraj";59;655;26;681;NA;113819;85;2020-12-06;27777
2020-12-05;"Prešovský kraj";218;984;87;1071;NA;113819;305;2020-12-05;27692
2020-12-04;"Prešovský kraj";352;5070;293;5363;NA;113819;645;2020-12-04;27387
2020-12-03;"Prešovský kraj";284;2456;179;2635;NA;113819;463;2020-12-03;26742
2020-12-02;"Prešovský kraj";232;2830;225;3055;NA;113819;457;2020-12-02;26279
2020-12-01;"Prešovský kraj";281;1884;196;2080;NA;113819;477;2020-12-01;25822
2020-11-30;"Prešovský kraj";196;5333;97;5430;NA;113819;293;2020-11-30;25345
2020-11-29;"Prešovský kraj";27;379;42;421;NA;113819;69;2020-11-29;25052
2020-11-28;"Prešovský kraj";199;772;77;849;NA;113819;276;2020-11-28;24983
2020-11-27;"Prešovský kraj";232;2350;130;2480;NA;113819;362;2020-11-27;24707
2020-11-26;"Prešovský kraj";263;3014;329;3343;NA;113819;592;2020-11-26;24345
2020-11-25;"Prešovský kraj";302;2174;103;2277;NA;113819;405;2020-11-25;23753
2020-11-24;"Prešovský kraj";365;1777;156;1933;NA;113819;521;2020-11-24;23348
2020-11-23;"Prešovský kraj";164;1099;60;1159;NA;113819;224;2020-11-23;22827
2020-11-22;"Prešovský kraj";46;44;1;45;NA;113819;47;2020-11-22;22603
2020-11-21;"Prešovský kraj";205;754;62;816;NA;113819;267;2020-11-21;22556
2020-11-20;"Prešovský kraj";363;2258;102;2360;NA;113819;465;2020-11-20;22289
2020-11-19;"Prešovský kraj";359;2096;238;2334;NA;113819;597;2020-11-19;21824
2020-11-18;"Prešovský kraj";270;488;43;531;NA;113819;313;2020-11-18;21227
2020-11-17;"Prešovský kraj";347;205;23;228;NA;113819;370;2020-11-17;20914
2020-11-16;"Prešovský kraj";226;540;58;598;NA;113819;284;2020-11-16;20544
2020-11-15;"Prešovský kraj";186;39;4;43;NA;113819;190;2020-11-15;20260
2020-11-14;"Prešovský kraj";261;54;4;58;NA;113819;265;2020-11-14;20070
2020-11-13;"Prešovský kraj";395;166;8;174;NA;113819;403;2020-11-13;19805
2020-11-12;"Prešovský kraj";397;229;50;279;NA;113819;447;2020-11-12;19402
2020-11-11;"Prešovský kraj";516;161;15;176;NA;113819;531;2020-11-11;18955
2020-11-10;"Prešovský kraj";437;197;9;206;NA;113819;446;2020-11-10;18424
2020-11-09;"Prešovský kraj";190;4110;945;5055;NA;113819;1135;2020-11-09;17978
2020-11-08;"Prešovský kraj";97;2817;32;2849;NA;113819;129;2020-11-08;16843
2020-11-07;"Prešovský kraj";416;8578;81;8659;NA;113819;497;2020-11-07;16714
2020-11-06;"Prešovský kraj";520;4791;76;4867;NA;113819;596;2020-11-06;16217
2020-11-05;"Prešovský kraj";397;180;5;185;NA;113819;402;2020-11-05;15621
2020-11-04;"Prešovský kraj";350;807;8;815;NA;113819;358;2020-11-04;15219
2020-11-03;"Prešovský kraj";565;98;12;110;NA;113819;577;2020-11-03;14861
2020-11-02;"Prešovský kraj";203;4158;1004;5162;NA;113819;1207;2020-11-02;14284
2020-11-01;"Prešovský kraj";386;2906;53;2959;NA;113819;439;2020-11-01;13077
2020-10-31;"Prešovský kraj";315;10497;170;10667;NA;113819;485;2020-10-31;12638
2020-10-30;"Prešovský kraj";552;2949;65;3014;NA;113819;617;2020-10-30;12153
2020-10-29;"Prešovský kraj";594;301;38;339;NA;113819;632;2020-10-29;11536
2020-10-28;"Prešovský kraj";617;291;46;337;NA;113819;663;2020-10-28;10904
2020-10-27;"Prešovský kraj";656;268;34;302;NA;113819;690;2020-10-27;10241
2020-10-26;"Prešovský kraj";137;363;57;420;NA;113819;194;2020-10-26;9551
2020-10-25;"Prešovský kraj";237;346;11;357;NA;113819;248;2020-10-25;9357
2020-10-24;"Prešovský kraj";719;200;12;212;NA;113819;731;2020-10-24;9109
2020-10-23;"Prešovský kraj";750;218;8;226;NA;113819;758;2020-10-23;8378
2020-10-22;"Prešovský kraj";646;396;30;426;NA;113819;676;2020-10-22;7620
2020-10-21;"Prešovský kraj";383;58;8;66;NA;113819;391;2020-10-21;6944
2020-10-20;"Prešovský kraj";493;65;7;72;NA;113819;500;2020-10-20;6553
2020-10-19;"Prešovský kraj";140;235;15;250;NA;113819;155;2020-10-19;6053
2020-10-18;"Prešovský kraj";209;0;0;0;NA;113819;209;2020-10-18;5898
2020-10-17;"Prešovský kraj";342;0;0;0;NA;113819;342;2020-10-17;5689
2020-10-16;"Prešovský kraj";388;57;3;60;NA;113819;391;2020-10-16;5347
2020-10-15;"Prešovský kraj";435;85;18;103;NA;113819;453;2020-10-15;4956
2020-10-14;"Prešovský kraj";451;54;10;64;NA;113819;461;2020-10-14;4503
2020-10-13;"Prešovský kraj";264;50;6;56;NA;113819;270;2020-10-13;4042
2020-10-12;"Prešovský kraj";214;334;35;369;NA;113819;249;2020-10-12;3772
2020-10-11;"Prešovský kraj";127;0;0;0;NA;113819;127;2020-10-11;3523
2020-10-10;"Prešovský kraj";248;0;0;0;NA;113819;248;2020-10-10;3396
2020-10-09;"Prešovský kraj";406;0;0;0;NA;113819;406;2020-10-09;3148
2020-10-08;"Prešovský kraj";245;0;0;0;NA;113819;245;2020-10-08;2742
2020-10-07;"Prešovský kraj";244;0;0;0;NA;113819;244;2020-10-07;2497
2020-10-06;"Prešovský kraj";166;0;0;0;NA;113819;166;2020-10-06;2253
2020-10-05;"Prešovský kraj";84;0;0;0;NA;113819;84;2020-10-05;2087
2020-10-04;"Prešovský kraj";118;0;0;0;NA;113819;118;2020-10-04;2003
2020-10-03;"Prešovský kraj";204;0;0;0;NA;113819;204;2020-10-03;1885
2020-10-02;"Prešovský kraj";149;0;0;0;NA;113819;149;2020-10-02;1681
2020-10-01;"Prešovský kraj";136;0;0;0;NA;113819;136;2020-10-01;1532
2020-09-30;"Prešovský kraj";121;0;0;0;NA;113819;121;2020-09-30;1396
2020-09-29;"Prešovský kraj";156;0;0;0;NA;113819;156;2020-09-29;1275
2020-09-28;"Prešovský kraj";51;0;0;0;NA;113819;51;2020-09-28;1119
2020-09-27;"Prešovský kraj";10;0;0;0;NA;113819;10;2020-09-27;1068
2020-09-26;"Prešovský kraj";72;0;0;0;NA;113819;72;2020-09-26;1058
2020-09-25;"Prešovský kraj";91;0;0;0;NA;113819;91;2020-09-25;986
2020-09-24;"Prešovský kraj";52;0;0;0;NA;113819;52;2020-09-24;895
2020-09-23;"Prešovský kraj";55;0;0;0;NA;113819;55;2020-09-23;843
2020-09-22;"Prešovský kraj";29;0;0;0;NA;113819;29;2020-09-22;788
2020-09-21;"Prešovský kraj";14;0;0;0;NA;113819;14;2020-09-21;759
2020-09-20;"Prešovský kraj";5;0;0;0;NA;113819;5;2020-09-20;745
2020-09-19;"Prešovský kraj";12;0;0;0;NA;113819;12;2020-09-19;740
2020-09-18;"Prešovský kraj";29;0;0;0;NA;113819;29;2020-09-18;728
2020-09-17;"Prešovský kraj";25;0;0;0;NA;113819;25;2020-09-17;699
2020-09-16;"Prešovský kraj";8;0;0;0;NA;113819;8;2020-09-16;674
2020-09-15;"Prešovský kraj";10;0;0;0;NA;113819;10;2020-09-15;666
2020-09-14;"Prešovský kraj";47;0;0;0;NA;113819;47;2020-09-14;656
2020-09-13;"Prešovský kraj";3;0;0;0;NA;113819;3;2020-09-13;609
2020-09-12;"Prešovský kraj";4;0;0;0;NA;113819;4;2020-09-12;606
2020-09-11;"Prešovský kraj";15;0;0;0;NA;113819;15;2020-09-11;602
2020-09-10;"Prešovský kraj";10;0;0;0;NA;113819;10;2020-09-10;587
2020-09-09;"Prešovský kraj";21;0;0;0;NA;113819;21;2020-09-09;577
2020-09-08;"Prešovský kraj";23;0;0;0;NA;113819;23;2020-09-08;556
2020-09-07;"Prešovský kraj";5;0;0;0;NA;113819;5;2020-09-07;533
2020-09-06;"Prešovský kraj";3;0;0;0;NA;113819;3;2020-09-06;528
2020-09-05;"Prešovský kraj";7;0;0;0;NA;113819;7;2020-09-05;525
2020-09-04;"Prešovský kraj";24;0;0;0;NA;113819;24;2020-09-04;518
2020-09-03;"Prešovský kraj";8;0;0;0;NA;113819;8;2020-09-03;494
2020-09-02;"Prešovský kraj";9;0;0;0;NA;113819;9;2020-09-02;486
2020-09-01;"Prešovský kraj";6;0;0;0;NA;113819;6;2020-09-01;477
2020-08-31;"Prešovský kraj";3;0;0;0;NA;113819;3;2020-08-31;471
2020-08-30;"Prešovský kraj";6;0;0;0;NA;113819;6;2020-08-30;468
2020-08-29;"Prešovský kraj";4;0;0;0;NA;113819;4;2020-08-29;462
2020-08-28;"Prešovský kraj";6;0;0;0;NA;113819;6;2020-08-28;458
2020-08-27;"Prešovský kraj";7;0;0;0;NA;113819;7;2020-08-27;452
2020-08-26;"Prešovský kraj";22;0;0;0;NA;113819;22;2020-08-26;445
2020-08-25;"Prešovský kraj";1;0;0;0;NA;113819;1;2020-08-25;423
2020-08-24;"Prešovský kraj";5;0;0;0;NA;113819;5;2020-08-24;422
2020-08-23;"Prešovský kraj";3;0;0;0;NA;113819;3;2020-08-23;417
2020-08-22;"Prešovský kraj";3;0;0;0;NA;113819;3;2020-08-22;414
2020-08-21;"Prešovský kraj";11;0;0;0;NA;113819;11;2020-08-21;411
2020-08-20;"Prešovský kraj";8;0;0;0;NA;113819;8;2020-08-20;400
2020-08-19;"Prešovský kraj";8;0;0;0;NA;113819;8;2020-08-19;392
2020-08-18;"Prešovský kraj";6;0;0;0;NA;113819;6;2020-08-18;384
2020-08-17;"Prešovský kraj";1;0;0;0;NA;113819;1;2020-08-17;378
2020-08-16;"Prešovský kraj";0;0;0;0;NA;113819;0;2020-08-16;377
2020-08-15;"Prešovský kraj";8;0;0;0;NA;113819;8;2020-08-15;377
2020-08-14;"Prešovský kraj";6;0;0;0;NA;113819;6;2020-08-14;369
2020-08-13;"Prešovský kraj";8;0;0;0;NA;113819;8;2020-08-13;363
2020-08-12;"Prešovský kraj";19;0;0;0;NA;113819;19;2020-08-12;355
2020-08-11;"Prešovský kraj";3;0;0;0;NA;113819;3;2020-08-11;336
2020-08-10;"Prešovský kraj";0;0;0;0;NA;113819;0;2020-08-10;333
2020-08-09;"Prešovský kraj";0;0;0;0;NA;113819;0;2020-08-09;333
2020-08-08;"Prešovský kraj";2;0;0;0;NA;113819;2;2020-08-08;333
2020-08-07;"Prešovský kraj";6;0;0;0;NA;113819;6;2020-08-07;331
2020-08-06;"Prešovský kraj";2;0;0;0;NA;113819;2;2020-08-06;325
2020-08-05;"Prešovský kraj";8;0;0;0;NA;113819;8;2020-08-05;323
2020-08-04;"Prešovský kraj";5;0;0;0;NA;113819;5;2020-08-04;315
2020-08-03;"Prešovský kraj";4;0;0;0;NA;113819;4;2020-08-03;310
2020-08-02;"Prešovský kraj";6;0;0;0;NA;113819;6;2020-08-02;306
2020-08-01;"Prešovský kraj";0;0;0;0;NA;113819;0;2020-08-01;300
2020-07-31;"Prešovský kraj";2;0;0;0;NA;113819;2;2020-07-31;300
2020-07-30;"Prešovský kraj";6;0;0;0;NA;113819;6;2020-07-30;298
2020-07-29;"Prešovský kraj";5;0;0;0;NA;113819;5;2020-07-29;292
2020-07-28;"Prešovský kraj";0;0;0;0;NA;113819;0;2020-07-28;287
2020-07-27;"Prešovský kraj";1;0;0;0;NA;113819;1;2020-07-27;287
2020-07-26;"Prešovský kraj";1;0;0;0;NA;113819;1;2020-07-26;286
2020-07-25;"Prešovský kraj";21;0;0;0;NA;113819;21;2020-07-25;285
2020-07-24;"Prešovský kraj";1;0;0;0;NA;113819;1;2020-07-24;264
2020-07-23;"Prešovský kraj";5;0;0;0;NA;113819;5;2020-07-23;263
2020-07-22;"Prešovský kraj";1;0;0;0;NA;113819;1;2020-07-22;258
2020-07-21;"Prešovský kraj";2;0;0;0;NA;113819;2;2020-07-21;257
2020-07-20;"Prešovský kraj";1;0;0;0;NA;113819;1;2020-07-20;255
2020-07-19;"Prešovský kraj";0;0;0;0;NA;113819;0;2020-07-19;254
2020-07-18;"Prešovský kraj";0;0;0;0;NA;113819;0;2020-07-18;254
2020-07-17;"Prešovský kraj";3;0;0;0;NA;113819;3;2020-07-17;254
2020-07-16;"Prešovský kraj";1;0;0;0;NA;113819;1;2020-07-16;251
2020-07-15;"Prešovský kraj";5;0;0;0;NA;113819;5;2020-07-15;250
2020-07-14;"Prešovský kraj";5;0;0;0;NA;113819;5;2020-07-14;245
2020-07-13;"Prešovský kraj";1;0;0;0;NA;113819;1;2020-07-13;240
2020-07-12;"Prešovský kraj";1;0;0;0;NA;113819;1;2020-07-12;239
2020-07-11;"Prešovský kraj";6;0;0;0;NA;113819;6;2020-07-11;238
2020-07-10;"Prešovský kraj";5;0;0;0;NA;113819;5;2020-07-10;232
2020-07-09;"Prešovský kraj";2;0;0;0;NA;113819;2;2020-07-09;227
2020-07-08;"Prešovský kraj";14;0;0;0;NA;113819;14;2020-07-08;225
2020-07-07;"Prešovský kraj";2;0;0;0;NA;113819;2;2020-07-07;211
2020-07-06;"Prešovský kraj";0;0;0;0;NA;113819;0;2020-07-06;209
2020-07-05;"Prešovský kraj";0;0;0;0;NA;113819;0;2020-07-05;209
2020-07-04;"Prešovský kraj";1;0;0;0;NA;113819;1;2020-07-04;209
2020-07-03;"Prešovský kraj";3;0;0;0;NA;113819;3;2020-07-03;208
2020-07-02;"Prešovský kraj";0;0;0;0;NA;113819;0;2020-07-02;205
2020-07-01;"Prešovský kraj";0;0;0;0;NA;113819;0;2020-07-01;205
2020-06-30;"Prešovský kraj";7;0;0;0;NA;113819;7;2020-06-30;205
2020-06-29;"Prešovský kraj";0;0;0;0;NA;113819;0;2020-06-29;198
2020-06-28;"Prešovský kraj";0;0;0;0;NA;113819;0;2020-06-28;198
2020-06-27;"Prešovský kraj";3;0;0;0;NA;113819;3;2020-06-27;198
2020-06-26;"Prešovský kraj";3;0;0;0;NA;113819;3;2020-06-26;195
2020-06-25;"Prešovský kraj";0;0;0;0;NA;113819;0;2020-06-25;192
2020-06-24;"Prešovský kraj";4;0;0;0;NA;113819;4;2020-06-24;192
2020-06-23;"Prešovský kraj";0;0;0;0;NA;113819;0;2020-06-23;188
2020-06-22;"Prešovský kraj";0;0;0;0;NA;113819;0;2020-06-22;188
2020-06-21;"Prešovský kraj";0;0;0;0;NA;113819;0;2020-06-21;188
2020-06-20;"Prešovský kraj";0;0;0;0;NA;113819;0;2020-06-20;188
2020-06-19;"Prešovský kraj";1;0;0;0;NA;113819;1;2020-06-19;188
2020-06-18;"Prešovský kraj";0;0;0;0;NA;113819;0;2020-06-18;187
2020-06-17;"Prešovský kraj";0;0;0;0;NA;113819;0;2020-06-17;187
2020-06-16;"Prešovský kraj";6;0;0;0;NA;113819;6;2020-06-16;187
2020-06-14;"Prešovský kraj";0;0;0;0;NA;113819;0;2020-06-14;181
2020-06-13;"Prešovský kraj";0;0;0;0;NA;113819;0;2020-06-13;181
2020-06-12;"Prešovský kraj";1;0;0;0;NA;113819;1;2020-06-12;181
2020-06-11;"Prešovský kraj";0;0;0;0;NA;113819;0;2020-06-11;180
2020-06-10;"Prešovský kraj";0;0;0;0;NA;113819;0;2020-06-10;180
2020-06-09;"Prešovský kraj";0;0;0;0;NA;113819;0;2020-06-09;180
2020-06-08;"Prešovský kraj";0;0;0;0;NA;113819;0;2020-06-08;180
2020-06-07;"Prešovský kraj";0;0;0;0;NA;113819;0;2020-06-07;180
2020-06-05;"Prešovský kraj";0;0;0;0;NA;113819;0;2020-06-05;180
2020-06-03;"Prešovský kraj";0;0;0;0;NA;113819;0;2020-06-03;180
2020-06-02;"Prešovský kraj";1;0;0;0;NA;113819;1;2020-06-02;180
2020-05-31;"Prešovský kraj";1;0;0;0;NA;113819;1;2020-05-31;179
2020-05-29;"Prešovský kraj";0;0;0;0;NA;113819;0;2020-05-29;178
2020-05-27;"Prešovský kraj";0;0;0;0;NA;113819;0;2020-05-27;178
2020-05-26;"Prešovský kraj";0;0;0;0;NA;113819;0;2020-05-26;178
2020-05-25;"Prešovský kraj";0;0;0;0;NA;113819;0;2020-05-25;178
2020-05-24;"Prešovský kraj";0;0;0;0;NA;113819;0;2020-05-24;178
2020-05-23;"Prešovský kraj";0;0;0;0;NA;113819;0;2020-05-23;178
2020-05-22;"Prešovský kraj";0;0;0;0;NA;113819;0;2020-05-22;178
2020-05-21;"Prešovský kraj";1;0;0;0;NA;113819;1;2020-05-21;178
2020-05-20;"Prešovský kraj";0;0;0;0;NA;113819;0;2020-05-20;177
2020-05-19;"Prešovský kraj";0;0;0;0;NA;113819;0;2020-05-19;177
2020-05-17;"Prešovský kraj";0;0;0;0;NA;113819;0;2020-05-17;177
2020-05-16;"Prešovský kraj";0;0;0;0;NA;113819;0;2020-05-16;177
2020-05-15;"Prešovský kraj";0;0;0;0;NA;113819;0;2020-05-15;177
2020-05-14;"Prešovský kraj";0;0;0;0;NA;113819;0;2020-05-14;177
2020-05-13;"Prešovský kraj";1;0;0;0;NA;113819;1;2020-05-13;177
2020-05-12;"Prešovský kraj";0;0;0;0;NA;113819;0;2020-05-12;176
2020-05-11;"Prešovský kraj";1;0;0;0;NA;113819;1;2020-05-11;176
2020-05-09;"Prešovský kraj";0;0;0;0;NA;113819;0;2020-05-09;175
2020-05-07;"Prešovský kraj";0;0;0;0;NA;113819;0;2020-05-07;175
2020-05-06;"Prešovský kraj";0;0;0;0;NA;113819;0;2020-05-06;175
2020-05-05;"Prešovský kraj";1;0;0;0;NA;113819;1;2020-05-05;175
2020-05-04;"Prešovský kraj";0;0;0;0;NA;113819;0;2020-05-04;174
2020-05-03;"Prešovský kraj";0;0;0;0;NA;113819;0;2020-05-03;174
2020-05-02;"Prešovský kraj";0;0;0;0;NA;113819;0;2020-05-02;174
2020-05-01;"Prešovský kraj";2;0;0;0;NA;113819;2;2020-05-01;174
2020-04-30;"Prešovský kraj";0;0;0;0;NA;113819;0;2020-04-30;172
2020-04-29;"Prešovský kraj";1;0;0;0;NA;113819;1;2020-04-29;172
2020-04-28;"Prešovský kraj";1;0;0;0;NA;113819;1;2020-04-28;171
2020-04-27;"Prešovský kraj";2;0;0;0;NA;113819;2;2020-04-27;170
2020-04-26;"Prešovský kraj";0;0;0;0;NA;113819;0;2020-04-26;168
2020-04-25;"Prešovský kraj";0;0;0;0;NA;113819;0;2020-04-25;168
2020-04-24;"Prešovský kraj";0;0;0;0;NA;113819;0;2020-04-24;168
2020-04-23;"Prešovský kraj";2;0;0;0;NA;113819;2;2020-04-23;168
2020-04-22;"Prešovský kraj";11;0;0;0;NA;113819;11;2020-04-22;166
2020-04-21;"Prešovský kraj";12;0;0;0;NA;113819;12;2020-04-21;155
2020-04-20;"Prešovský kraj";2;0;0;0;NA;113819;2;2020-04-20;143
2020-04-19;"Prešovský kraj";4;0;0;0;NA;113819;4;2020-04-19;141
2020-04-18;"Prešovský kraj";1;0;0;0;NA;113819;1;2020-04-18;137
2020-04-17;"Prešovský kraj";4;0;0;0;NA;113819;4;2020-04-17;136
2020-04-16;"Prešovský kraj";9;0;0;0;NA;113819;9;2020-04-16;132
2020-04-15;"Prešovský kraj";21;0;0;0;NA;113819;21;2020-04-15;123
2020-04-14;"Prešovský kraj";1;0;0;0;NA;113819;1;2020-04-14;102
2020-04-13;"Prešovský kraj";2;0;0;0;NA;113819;2;2020-04-13;101
2020-04-12;"Prešovský kraj";6;0;0;0;NA;113819;6;2020-04-12;99
2020-04-11;"Prešovský kraj";4;0;0;0;NA;113819;4;2020-04-11;93
2020-04-10;"Prešovský kraj";0;0;0;0;NA;113819;0;2020-04-10;89
2020-04-09;"Prešovský kraj";1;0;0;0;NA;113819;1;2020-04-09;89
2020-04-08;"Prešovský kraj";0;0;0;0;NA;113819;0;2020-04-08;88
2020-04-07;"Prešovský kraj";7;0;0;0;NA;113819;7;2020-04-07;88
2020-04-06;"Prešovský kraj";10;0;0;0;NA;113819;10;2020-04-06;81
2020-04-05;"Prešovský kraj";13;0;0;0;NA;113819;13;2020-04-05;71
2020-04-04;"Prešovský kraj";1;0;0;0;NA;113819;1;2020-04-04;58
2020-04-03;"Prešovský kraj";4;0;0;0;NA;113819;4;2020-04-03;57
2020-04-02;"Prešovský kraj";6;0;0;0;NA;113819;6;2020-04-02;53
2020-04-01;"Prešovský kraj";6;0;0;0;NA;113819;6;2020-04-01;47
2020-03-31;"Prešovský kraj";6;0;0;0;NA;113819;6;2020-03-31;41
2020-03-30;"Prešovský kraj";2;0;0;0;NA;113819;2;2020-03-30;35
2020-03-29;"Prešovský kraj";2;0;0;0;NA;113819;2;2020-03-29;33
2020-03-28;"Prešovský kraj";2;0;0;0;NA;113819;2;2020-03-28;31
2020-03-27;"Prešovský kraj";1;0;0;0;NA;113819;1;2020-03-27;29
2020-03-26;"Prešovský kraj";8;0;0;0;NA;113819;8;2020-03-26;28
2020-03-25;"Prešovský kraj";1;0;0;0;NA;113819;1;2020-03-25;20
2020-03-24;"Prešovský kraj";4;0;0;0;NA;113819;4;2020-03-24;19
2020-03-23;"Prešovský kraj";0;0;0;0;NA;113819;0;2020-03-23;15
2020-03-22;"Prešovský kraj";1;0;0;0;NA;113819;1;2020-03-22;15
2020-03-21;"Prešovský kraj";2;0;0;0;NA;113819;2;2020-03-21;14
2020-03-20;"Prešovský kraj";3;0;0;0;NA;113819;3;2020-03-20;12
2020-03-19;"Prešovský kraj";2;0;0;0;NA;113819;2;2020-03-19;9
2020-03-18;"Prešovský kraj";1;0;0;0;NA;113819;1;2020-03-18;7
2020-03-17;"Prešovský kraj";1;0;0;0;NA;113819;1;2020-03-17;6
2020-03-16;"Prešovský kraj";4;0;0;0;NA;113819;4;2020-03-16;5
2020-03-15;"Prešovský kraj";0;0;0;0;NA;113819;0;2020-03-15;1
2020-03-14;"Prešovský kraj";1;0;0;0;NA;113819;1;2020-03-14;1
2020-03-13;"Prešovský kraj";0;0;0;0;NA;113819;0;2020-03-13;0
2020-03-12;"Prešovský kraj";0;0;0;0;NA;113819;0;2020-03-12;0
2020-03-11;"Prešovský kraj";0;0;0;0;NA;113819;0;2020-03-11;0
2020-03-09;"Prešovský kraj";0;0;0;0;NA;113819;0;2020-03-09;0
2020-03-08;"Prešovský kraj";0;0;0;0;NA;113819;0;2020-03-08;0
2020-03-07;"Prešovský kraj";0;0;0;0;NA;113819;0;2020-03-07;0
2020-03-06;"Prešovský kraj";0;0;0;0;NA;113819;0;2020-03-06;0
2021-07-11;"Trenčiansky kraj";0;238;0;238;53283;100559;0;2021-07-11;100559
2021-07-10;"Trenčiansky kraj";2;412;0;412;NA;100559;2;2021-07-10;100559
2021-07-09;"Trenčiansky kraj";7;1065;0;1065;NA;100559;7;2021-07-09;100557
2021-07-08;"Trenčiansky kraj";2;701;1;702;NA;100559;3;2021-07-08;100550
2021-07-07;"Trenčiansky kraj";2;837;0;837;NA;100559;2;2021-07-07;100547
2021-07-06;"Trenčiansky kraj";4;950;1;951;NA;100559;5;2021-07-06;100545
2021-07-05;"Trenčiansky kraj";1;448;0;448;NA;100559;1;2021-07-05;100540
2021-07-04;"Trenčiansky kraj";0;606;1;607;NA;100559;1;2021-07-04;100539
2021-07-03;"Trenčiansky kraj";3;737;1;738;NA;100559;4;2021-07-03;100538
2021-07-02;"Trenčiansky kraj";5;1493;2;1495;NA;100559;7;2021-07-02;100534
2021-07-01;"Trenčiansky kraj";4;1143;1;1144;NA;100559;5;2021-07-01;100527
2021-06-30;"Trenčiansky kraj";2;6466;6;6472;NA;100559;8;2021-06-30;100522
2021-06-29;"Trenčiansky kraj";4;2721;5;2726;NA;100559;9;2021-06-29;100514
2021-06-28;"Trenčiansky kraj";5;3468;4;3472;NA;100559;9;2021-06-28;100505
2021-06-27;"Trenčiansky kraj";0;2594;1;2595;NA;100559;1;2021-06-27;100496
2021-06-26;"Trenčiansky kraj";1;3296;4;3300;NA;100559;5;2021-06-26;100495
2021-06-25;"Trenčiansky kraj";2;4165;1;4166;NA;100559;3;2021-06-25;100490
2021-06-24;"Trenčiansky kraj";3;2795;4;2799;NA;100559;7;2021-06-24;100487
2021-06-23;"Trenčiansky kraj";4;2337;2;2339;NA;100559;6;2021-06-23;100480
2021-06-22;"Trenčiansky kraj";7;2847;3;2850;NA;100559;10;2021-06-22;100474
2021-06-21;"Trenčiansky kraj";10;3540;3;3543;NA;100559;13;2021-06-21;100464
2021-06-20;"Trenčiansky kraj";0;2915;5;2920;NA;100559;5;2021-06-20;100451
2021-06-19;"Trenčiansky kraj";5;3925;0;3925;NA;100559;5;2021-06-19;100446
2021-06-18;"Trenčiansky kraj";7;5899;6;5905;NA;100559;13;2021-06-18;100441
2021-06-17;"Trenčiansky kraj";0;3068;5;3073;NA;100559;5;2021-06-17;100428
2021-06-16;"Trenčiansky kraj";4;2782;2;2784;NA;100559;6;2021-06-16;100423
2021-06-15;"Trenčiansky kraj";10;3490;2;3492;NA;100559;12;2021-06-15;100417
2021-06-14;"Trenčiansky kraj";10;4358;15;4373;NA;100559;25;2021-06-14;100405
2021-06-13;"Trenčiansky kraj";0;3950;4;3954;NA;100559;4;2021-06-13;100380
2021-06-12;"Trenčiansky kraj";4;4616;6;4622;NA;100559;10;2021-06-12;100376
2021-06-11;"Trenčiansky kraj";10;6227;11;6238;NA;100559;21;2021-06-11;100366
2021-06-10;"Trenčiansky kraj";5;3779;7;3786;NA;100559;12;2021-06-10;100345
2021-06-09;"Trenčiansky kraj";7;3254;6;3260;NA;100559;13;2021-06-09;100333
2021-06-08;"Trenčiansky kraj";21;3628;7;3635;NA;100559;28;2021-06-08;100320
2021-06-07;"Trenčiansky kraj";13;4944;10;4954;NA;100559;23;2021-06-07;100292
2021-06-06;"Trenčiansky kraj";0;4659;9;4668;NA;100559;9;2021-06-06;100269
2021-06-05;"Trenčiansky kraj";7;5712;4;5716;NA;100559;11;2021-06-05;100260
2021-06-04;"Trenčiansky kraj";16;6800;3;6803;NA;100559;19;2021-06-04;100249
2021-06-03;"Trenčiansky kraj";9;3886;9;3895;NA;100559;18;2021-06-03;100230
2021-06-02;"Trenčiansky kraj";28;4201;8;4209;NA;100559;36;2021-06-02;100212
2021-06-01;"Trenčiansky kraj";22;4975;17;4992;NA;100559;39;2021-06-01;100176
2021-05-31;"Trenčiansky kraj";30;5495;24;5519;NA;100559;54;2021-05-31;100137
2021-05-30;"Trenčiansky kraj";0;7365;15;7380;NA;100559;15;2021-05-30;100083
2021-05-29;"Trenčiansky kraj";13;6900;13;6913;NA;100559;26;2021-05-29;100068
2021-05-28;"Trenčiansky kraj";22;7934;25;7959;NA;100559;47;2021-05-28;100042
2021-05-27;"Trenčiansky kraj";6;5163;12;5175;NA;100559;18;2021-05-27;99995
2021-05-26;"Trenčiansky kraj";26;4413;13;4426;NA;100559;39;2021-05-26;99977
2021-05-25;"Trenčiansky kraj";18;5674;20;5694;NA;100559;38;2021-05-25;99938
2021-05-24;"Trenčiansky kraj";19;9191;37;9228;NA;100559;56;2021-05-24;99900
2021-05-23;"Trenčiansky kraj";0;8161;22;8183;NA;100559;22;2021-05-23;99844
2021-05-22;"Trenčiansky kraj";11;10114;12;10126;NA;100559;23;2021-05-22;99822
2021-05-21;"Trenčiansky kraj";23;10606;24;10630;NA;100559;47;2021-05-21;99799
2021-05-20;"Trenčiansky kraj";23;5487;23;5510;NA;100559;46;2021-05-20;99752
2021-05-19;"Trenčiansky kraj";16;4959;31;4990;NA;100559;47;2021-05-19;99706
2021-05-18;"Trenčiansky kraj";26;7610;26;7636;NA;100559;52;2021-05-18;99659
2021-05-17;"Trenčiansky kraj";37;6771;38;6809;NA;100559;75;2021-05-17;99607
2021-05-16;"Trenčiansky kraj";25;14270;30;14300;NA;100559;55;2021-05-16;99532
2021-05-15;"Trenčiansky kraj";3;19573;26;19599;NA;100559;29;2021-05-15;99477
2021-05-14;"Trenčiansky kraj";41;17047;39;17086;NA;100559;80;2021-05-14;99448
2021-05-13;"Trenčiansky kraj";41;8149;24;8173;NA;100559;65;2021-05-13;99368
2021-05-12;"Trenčiansky kraj";41;7408;31;7439;NA;100559;72;2021-05-12;99303
2021-05-11;"Trenčiansky kraj";66;10205;31;10236;NA;100559;97;2021-05-11;99231
2021-05-10;"Trenčiansky kraj";48;11688;52;11740;NA;100559;100;2021-05-10;99134
2021-05-09;"Trenčiansky kraj";52;15597;32;15629;NA;100559;84;2021-05-09;99034
2021-05-08;"Trenčiansky kraj";3;21544;29;21573;NA;100559;32;2021-05-08;98950
2021-05-07;"Trenčiansky kraj";45;21204;44;21248;NA;100559;89;2021-05-07;98918
2021-05-06;"Trenčiansky kraj";26;10679;44;10723;NA;100559;70;2021-05-06;98829
2021-05-05;"Trenčiansky kraj";73;9092;41;9133;NA;100559;114;2021-05-05;98759
2021-05-04;"Trenčiansky kraj";55;12732;53;12785;NA;100559;108;2021-05-04;98645
2021-05-03;"Trenčiansky kraj";60;15330;51;15381;NA;100559;111;2021-05-03;98537
2021-05-02;"Trenčiansky kraj";0;30768;61;30829;NA;100559;61;2021-05-02;98426
2021-05-01;"Trenčiansky kraj";71;56982;60;57042;NA;100559;131;2021-05-01;98365
2021-04-30;"Trenčiansky kraj";77;29420;61;29481;NA;100559;138;2021-04-30;98234
2021-04-29;"Trenčiansky kraj";49;13183;59;13242;NA;100559;108;2021-04-29;98096
2021-04-28;"Trenčiansky kraj";79;12536;52;12588;NA;100559;131;2021-04-28;97988
2021-04-27;"Trenčiansky kraj";107;15526;40;15566;NA;100559;147;2021-04-27;97857
2021-04-26;"Trenčiansky kraj";52;21066;63;21129;NA;100559;115;2021-04-26;97710
2021-04-25;"Trenčiansky kraj";0;34560;48;34608;NA;100559;48;2021-04-25;97595
2021-04-24;"Trenčiansky kraj";76;72398;100;72498;NA;100559;176;2021-04-24;97547
2021-04-23;"Trenčiansky kraj";143;29958;79;30037;NA;100559;222;2021-04-23;97371
2021-04-22;"Trenčiansky kraj";71;13847;64;13911;NA;100559;135;2021-04-22;97149
2021-04-21;"Trenčiansky kraj";79;12996;67;13063;NA;100559;146;2021-04-21;97014
2021-04-20;"Trenčiansky kraj";142;17739;80;17819;NA;100559;222;2021-04-20;96868
2021-04-19;"Trenčiansky kraj";102;22630;103;22733;NA;100559;205;2021-04-19;96646
2021-04-18;"Trenčiansky kraj";3;40879;97;40976;NA;100559;100;2021-04-18;96441
2021-04-17;"Trenčiansky kraj";77;81498;136;81634;NA;100559;213;2021-04-17;96341
2021-04-16;"Trenčiansky kraj";100;31954;90;32044;NA;100559;190;2021-04-16;96128
2021-04-15;"Trenčiansky kraj";71;14477;69;14546;NA;100559;140;2021-04-15;95938
2021-04-14;"Trenčiansky kraj";135;15549;72;15621;NA;100559;207;2021-04-14;95798
2021-04-13;"Trenčiansky kraj";189;18713;75;18788;NA;100559;264;2021-04-13;95591
2021-04-12;"Trenčiansky kraj";97;23743;91;23834;NA;100559;188;2021-04-12;95327
2021-04-11;"Trenčiansky kraj";1;34735;75;34810;NA;100559;76;2021-04-11;95139
2021-04-10;"Trenčiansky kraj";81;83093;145;83238;NA;100559;226;2021-04-10;95063
2021-04-09;"Trenčiansky kraj";120;28008;91;28099;NA;100559;211;2021-04-09;94837
2021-04-08;"Trenčiansky kraj";112;13282;85;13367;NA;100559;197;2021-04-08;94626
2021-04-07;"Trenčiansky kraj";204;17689;122;17811;NA;100559;326;2021-04-07;94429
2021-04-06;"Trenčiansky kraj";157;28532;178;28710;NA;100559;335;2021-04-06;94103
2021-04-05;"Trenčiansky kraj";15;9227;64;9291;NA;100559;79;2021-04-05;93768
2021-04-04;"Trenčiansky kraj";2;20291;85;20376;NA;100559;87;2021-04-04;93689
2021-04-03;"Trenčiansky kraj";86;80473;221;80694;NA;100559;307;2021-04-03;93602
2021-04-02;"Trenčiansky kraj";126;21620;81;21701;NA;100559;207;2021-04-02;93295
2021-04-01;"Trenčiansky kraj";159;32370;139;32509;NA;100559;298;2021-04-01;93088
2021-03-31;"Trenčiansky kraj";198;20100;130;20230;NA;100559;328;2021-03-31;92790
2021-03-30;"Trenčiansky kraj";272;17304;136;17440;NA;100559;408;2021-03-30;92462
2021-03-29;"Trenčiansky kraj";142;19479;170;19649;NA;100559;312;2021-03-29;92054
2021-03-28;"Trenčiansky kraj";3;34759;116;34875;NA;100559;119;2021-03-28;91742
2021-03-27;"Trenčiansky kraj";130;77314;293;77607;NA;100559;423;2021-03-27;91623
2021-03-26;"Trenčiansky kraj";211;35092;157;35249;NA;100559;368;2021-03-26;91200
2021-03-25;"Trenčiansky kraj";184;16579;176;16755;NA;100559;360;2021-03-25;90832
2021-03-24;"Trenčiansky kraj";259;13101;171;13272;NA;100559;430;2021-03-24;90472
2021-03-23;"Trenčiansky kraj";349;17588;174;17762;NA;100559;523;2021-03-23;90042
2021-03-22;"Trenčiansky kraj";141;21118;213;21331;NA;100559;354;2021-03-22;89519
2021-03-21;"Trenčiansky kraj";85;32711;164;32875;NA;100559;249;2021-03-21;89165
2021-03-20;"Trenčiansky kraj";128;80035;322;80357;NA;100559;450;2021-03-20;88916
2021-03-19;"Trenčiansky kraj";231;34784;232;35016;NA;100559;463;2021-03-19;88466
2021-03-18;"Trenčiansky kraj";262;16105;178;16283;NA;100559;440;2021-03-18;88003
2021-03-17;"Trenčiansky kraj";366;13435;163;13598;NA;100559;529;2021-03-17;87563
2021-03-16;"Trenčiansky kraj";450;15281;241;15522;NA;100559;691;2021-03-16;87034
2021-03-15;"Trenčiansky kraj";162;21235;261;21496;NA;100559;423;2021-03-15;86343
2021-03-14;"Trenčiansky kraj";42;33892;233;34125;NA;100559;275;2021-03-14;85920
2021-03-13;"Trenčiansky kraj";270;79186;453;79639;NA;100559;723;2021-03-13;85645
2021-03-12;"Trenčiansky kraj";366;34787;307;35094;NA;100559;673;2021-03-12;84922
2021-03-11;"Trenčiansky kraj";302;15557;213;15770;NA;100559;515;2021-03-11;84249
2021-03-10;"Trenčiansky kraj";402;13585;237;13822;NA;100559;639;2021-03-10;83734
2021-03-09;"Trenčiansky kraj";586;17982;285;18267;NA;100559;871;2021-03-09;83095
2021-03-08;"Trenčiansky kraj";174;21704;363;22067;NA;100559;537;2021-03-08;82224
2021-03-07;"Trenčiansky kraj";4;33647;313;33960;NA;100559;317;2021-03-07;81687
2021-03-06;"Trenčiansky kraj";260;79661;529;80190;NA;100559;789;2021-03-06;81370
2021-03-05;"Trenčiansky kraj";326;32946;416;33362;NA;100559;742;2021-03-05;80581
2021-03-04;"Trenčiansky kraj";323;16820;315;17135;NA;100559;638;2021-03-04;79839
2021-03-03;"Trenčiansky kraj";413;13953;346;14299;NA;100559;759;2021-03-03;79201
2021-03-02;"Trenčiansky kraj";612;17794;344;18138;NA;100559;956;2021-03-02;78442
2021-03-01;"Trenčiansky kraj";217;21104;445;21549;NA;100559;662;2021-03-01;77486
2021-02-28;"Trenčiansky kraj";45;30238;376;30614;NA;100559;421;2021-02-28;76824
2021-02-27;"Trenčiansky kraj";277;78735;686;79421;NA;100559;963;2021-02-27;76403
2021-02-26;"Trenčiansky kraj";420;32932;435;33367;NA;100559;855;2021-02-26;75440
2021-02-25;"Trenčiansky kraj";424;14029;328;14357;NA;100559;752;2021-02-25;74585
2021-02-24;"Trenčiansky kraj";427;11997;398;12395;NA;100559;825;2021-02-24;73833
2021-02-23;"Trenčiansky kraj";577;14904;390;15294;NA;100559;967;2021-02-23;73008
2021-02-22;"Trenčiansky kraj";160;19969;468;20437;NA;100559;628;2021-02-22;72041
2021-02-21;"Trenčiansky kraj";64;29478;392;29870;NA;100559;456;2021-02-21;71413
2021-02-20;"Trenčiansky kraj";274;77840;745;78585;NA;100559;1019;2021-02-20;70957
2021-02-19;"Trenčiansky kraj";272;30245;520;30765;NA;100559;792;2021-02-19;69938
2021-02-18;"Trenčiansky kraj";355;14094;403;14497;NA;100559;758;2021-02-18;69146
2021-02-17;"Trenčiansky kraj";363;11413;376;11789;NA;100559;739;2021-02-17;68388
2021-02-16;"Trenčiansky kraj";488;17761;406;18167;NA;100559;894;2021-02-16;67649
2021-02-15;"Trenčiansky kraj";151;21846;463;22309;NA;100559;614;2021-02-15;66755
2021-02-14;"Trenčiansky kraj";2;31255;324;31579;NA;100559;326;2021-02-14;66141
2021-02-13;"Trenčiansky kraj";274;63006;522;63528;NA;100559;796;2021-02-13;65815
2021-02-12;"Trenčiansky kraj";276;27966;412;28378;NA;100559;688;2021-02-12;65019
2021-02-11;"Trenčiansky kraj";291;11566;323;11889;NA;100559;614;2021-02-11;64331
2021-02-10;"Trenčiansky kraj";304;11401;317;11718;NA;100559;621;2021-02-10;63717
2021-02-09;"Trenčiansky kraj";514;18401;360;18761;NA;100559;874;2021-02-09;63096
2021-02-08;"Trenčiansky kraj";182;26830;430;27260;NA;100559;612;2021-02-08;62222
2021-02-07;"Trenčiansky kraj";31;36772;341;37113;NA;100559;372;2021-02-07;61610
2021-02-06;"Trenčiansky kraj";216;63931;560;64491;NA;100559;776;2021-02-06;61238
2021-02-05;"Trenčiansky kraj";202;18154;367;18521;NA;100559;569;2021-02-05;60462
2021-02-04;"Trenčiansky kraj";266;7248;311;7559;NA;100559;577;2021-02-04;59893
2021-02-03;"Trenčiansky kraj";162;6718;320;7038;NA;100559;482;2021-02-03;59316
2021-02-02;"Trenčiansky kraj";347;8058;380;8438;NA;100559;727;2021-02-02;58834
2021-02-01;"Trenčiansky kraj";167;8917;311;9228;NA;100559;478;2021-02-01;58107
2021-01-31;"Trenčiansky kraj";7;19103;159;19262;NA;100559;166;2021-01-31;57629
2021-01-30;"Trenčiansky kraj";228;38167;332;38499;NA;100559;560;2021-01-30;57463
2021-01-29;"Trenčiansky kraj";214;7586;235;7821;NA;100559;449;2021-01-29;56903
2021-01-28;"Trenčiansky kraj";307;5442;158;5600;NA;100559;465;2021-01-28;56454
2021-01-27;"Trenčiansky kraj";166;4842;181;5023;NA;100559;347;2021-01-27;55989
2021-01-26;"Trenčiansky kraj";303;14585;250;14835;NA;100559;553;2021-01-26;55642
2021-01-25;"Trenčiansky kraj";160;24302;207;24509;NA;100559;367;2021-01-25;55089
2021-01-24;"Trenčiansky kraj";51;38369;282;38651;NA;100559;333;2021-01-24;54722
2021-01-23;"Trenčiansky kraj";206;114125;749;114874;NA;100559;955;2021-01-23;54389
2021-01-22;"Trenčiansky kraj";148;21831;241;22072;NA;100559;389;2021-01-22;53434
2021-01-21;"Trenčiansky kraj";143;8582;166;8748;NA;100559;309;2021-01-21;53045
2021-01-20;"Trenčiansky kraj";181;8186;227;8413;NA;100559;408;2021-01-20;52736
2021-01-19;"Trenčiansky kraj";363;6600;262;6862;NA;100559;625;2021-01-19;52328
2021-01-18;"Trenčiansky kraj";72;4970;321;5291;NA;100559;393;2021-01-18;51703
2021-01-17;"Trenčiansky kraj";124;156;11;167;NA;100559;135;2021-01-17;51310
2021-01-16;"Trenčiansky kraj";39;1288;53;1341;NA;100559;92;2021-01-16;51175
2021-01-15;"Trenčiansky kraj";264;4029;218;4247;NA;100559;482;2021-01-15;51083
2021-01-14;"Trenčiansky kraj";275;3193;189;3382;NA;100559;464;2021-01-14;50601
2021-01-13;"Trenčiansky kraj";222;3893;215;4108;NA;100559;437;2021-01-13;50137
2021-01-12;"Trenčiansky kraj";508;4604;261;4865;NA;100559;769;2021-01-12;49700
2021-01-11;"Trenčiansky kraj";142;4367;354;4721;NA;100559;496;2021-01-11;48931
2021-01-10;"Trenčiansky kraj";89;4969;77;5046;NA;100559;166;2021-01-10;48435
2021-01-09;"Trenčiansky kraj";276;8280;128;8408;NA;100559;404;2021-01-09;48269
2021-01-08;"Trenčiansky kraj";489;6434;484;6918;NA;100559;973;2021-01-08;47865
2021-01-07;"Trenčiansky kraj";420;6138;577;6715;NA;100559;997;2021-01-07;46892
2021-01-06;"Trenčiansky kraj";221;1021;64;1085;NA;100559;285;2021-01-06;45895
2021-01-05;"Trenčiansky kraj";669;5753;706;6459;NA;100559;1375;2021-01-05;45610
2021-01-04;"Trenčiansky kraj";337;5248;782;6030;NA;100559;1119;2021-01-04;44235
2021-01-03;"Trenčiansky kraj";38;114;15;129;NA;100559;53;2021-01-03;43116
2021-01-02;"Trenčiansky kraj";129;196;23;219;NA;100559;152;2021-01-02;43063
2021-01-01;"Trenčiansky kraj";329;347;23;370;NA;100559;352;2021-01-01;42911
2020-12-31;"Trenčiansky kraj";597;4943;557;5500;NA;100559;1154;2020-12-31;42559
2020-12-30;"Trenčiansky kraj";836;7012;762;7774;NA;100559;1598;2020-12-30;41405
2020-12-29;"Trenčiansky kraj";459;6122;1009;7131;NA;100559;1468;2020-12-29;39807
2020-12-28;"Trenčiansky kraj";258;4195;777;4972;NA;100559;1035;2020-12-28;38339
2020-12-27;"Trenčiansky kraj";5;208;36;244;NA;100559;41;2020-12-27;37304
2020-12-26;"Trenčiansky kraj";174;74;10;84;NA;100559;184;2020-12-26;37263
2020-12-25;"Trenčiansky kraj";251;325;47;372;NA;100559;298;2020-12-25;37079
2020-12-24;"Trenčiansky kraj";552;2194;256;2450;NA;100559;808;2020-12-24;36781
2020-12-23;"Trenčiansky kraj";421;6552;661;7213;NA;100559;1082;2020-12-23;35973
2020-12-22;"Trenčiansky kraj";673;5760;694;6454;NA;100559;1367;2020-12-22;34891
2020-12-21;"Trenčiansky kraj";248;13321;956;14277;NA;100559;1204;2020-12-21;33524
2020-12-20;"Trenčiansky kraj";238;12504;292;12796;NA;100559;530;2020-12-20;32320
2020-12-19;"Trenčiansky kraj";341;1611;150;1761;NA;100559;491;2020-12-19;31790
2020-12-18;"Trenčiansky kraj";521;5199;615;5814;NA;100559;1136;2020-12-18;31299
2020-12-17;"Trenčiansky kraj";670;3843;524;4367;NA;100559;1194;2020-12-17;30163
2020-12-16;"Trenčiansky kraj";461;4464;647;5111;NA;100559;1108;2020-12-16;28969
2020-12-15;"Trenčiansky kraj";595;3805;670;4475;NA;100559;1265;2020-12-15;27861
2020-12-14;"Trenčiansky kraj";318;3194;613;3807;NA;100559;931;2020-12-14;26596
2020-12-13;"Trenčiansky kraj";77;49;6;55;NA;100559;83;2020-12-13;25665
2020-12-12;"Trenčiansky kraj";314;1191;132;1323;NA;100559;446;2020-12-12;25582
2020-12-11;"Trenčiansky kraj";751;4066;479;4545;NA;100559;1230;2020-12-11;25136
2020-12-10;"Trenčiansky kraj";271;3354;473;3827;NA;100559;744;2020-12-10;23906
2020-12-09;"Trenčiansky kraj";508;3788;466;4254;NA;100559;974;2020-12-09;23162
2020-12-08;"Trenčiansky kraj";546;3440;522;3962;NA;100559;1068;2020-12-08;22188
2020-12-07;"Trenčiansky kraj";258;3832;468;4300;NA;100559;726;2020-12-07;21120
2020-12-06;"Trenčiansky kraj";114;179;10;189;NA;100559;124;2020-12-06;20394
2020-12-05;"Trenčiansky kraj";223;610;56;666;NA;100559;279;2020-12-05;20270
2020-12-04;"Trenčiansky kraj";253;2943;273;3216;NA;100559;526;2020-12-04;19991
2020-12-03;"Trenčiansky kraj";503;1714;178;1892;NA;100559;681;2020-12-03;19465
2020-12-02;"Trenčiansky kraj";418;1844;232;2076;NA;100559;650;2020-12-02;18784
2020-12-01;"Trenčiansky kraj";321;5741;358;6099;NA;100559;679;2020-12-01;18134
2020-11-30;"Trenčiansky kraj";167;11514;520;12034;NA;100559;687;2020-11-30;17455
2020-11-29;"Trenčiansky kraj";29;30;5;35;NA;100559;34;2020-11-29;16768
2020-11-28;"Trenčiansky kraj";202;1051;93;1144;NA;100559;295;2020-11-28;16734
2020-11-27;"Trenčiansky kraj";330;1888;186;2074;NA;100559;516;2020-11-27;16439
2020-11-26;"Trenčiansky kraj";395;1252;122;1374;NA;100559;517;2020-11-26;15923
2020-11-25;"Trenčiansky kraj";322;1444;160;1604;NA;100559;482;2020-11-25;15406
2020-11-24;"Trenčiansky kraj";348;2553;308;2861;NA;100559;656;2020-11-24;14924
2020-11-23;"Trenčiansky kraj";159;1186;122;1308;NA;100559;281;2020-11-23;14268
2020-11-22;"Trenčiansky kraj";26;30;7;37;NA;100559;33;2020-11-22;13987
2020-11-21;"Trenčiansky kraj";255;1376;69;1445;NA;100559;324;2020-11-21;13954
2020-11-20;"Trenčiansky kraj";316;861;93;954;NA;100559;409;2020-11-20;13630
2020-11-19;"Trenčiansky kraj";316;740;113;853;NA;100559;429;2020-11-19;13221
2020-11-18;"Trenčiansky kraj";233;379;66;445;NA;100559;299;2020-11-18;12792
2020-11-17;"Trenčiansky kraj";222;106;15;121;NA;100559;237;2020-11-17;12493
2020-11-16;"Trenčiansky kraj";245;236;45;281;NA;100559;290;2020-11-16;12256
2020-11-15;"Trenčiansky kraj";109;29;6;35;NA;100559;115;2020-11-15;11966
2020-11-14;"Trenčiansky kraj";190;74;11;85;NA;100559;201;2020-11-14;11851
2020-11-13;"Trenčiansky kraj";308;131;13;144;NA;100559;321;2020-11-13;11650
2020-11-12;"Trenčiansky kraj";324;124;5;129;NA;100559;329;2020-11-12;11329
2020-11-11;"Trenčiansky kraj";366;113;10;123;NA;100559;376;2020-11-11;11000
2020-11-10;"Trenčiansky kraj";277;106;6;112;NA;100559;283;2020-11-10;10624
2020-11-09;"Trenčiansky kraj";115;1407;48;1455;NA;100559;163;2020-11-09;10341
2020-11-08;"Trenčiansky kraj";81;1271;8;1279;NA;100559;89;2020-11-08;10178
2020-11-07;"Trenčiansky kraj";319;3662;59;3721;NA;100559;378;2020-11-07;10089
2020-11-06;"Trenčiansky kraj";383;6893;84;6977;NA;100559;467;2020-11-06;9711
2020-11-05;"Trenčiansky kraj";399;98;15;113;NA;100559;414;2020-11-05;9244
2020-11-04;"Trenčiansky kraj";370;91;9;100;NA;100559;379;2020-11-04;8830
2020-11-03;"Trenčiansky kraj";575;97;8;105;NA;100559;583;2020-11-03;8451
2020-11-02;"Trenčiansky kraj";197;1833;68;1901;NA;100559;265;2020-11-02;7868
2020-11-01;"Trenčiansky kraj";257;808;24;832;NA;100559;281;2020-11-01;7603
2020-10-31;"Trenčiansky kraj";332;4719;82;4801;NA;100559;414;2020-10-31;7322
2020-10-30;"Trenčiansky kraj";299;5283;102;5385;NA;100559;401;2020-10-30;6908
2020-10-29;"Trenčiansky kraj";496;764;68;832;NA;100559;564;2020-10-29;6507
2020-10-28;"Trenčiansky kraj";269;192;33;225;NA;100559;302;2020-10-28;5943
2020-10-27;"Trenčiansky kraj";473;127;27;154;NA;100559;500;2020-10-27;5641
2020-10-26;"Trenčiansky kraj";177;107;36;143;NA;100559;213;2020-10-26;5141
2020-10-25;"Trenčiansky kraj";138;9;5;14;NA;100559;143;2020-10-25;4928
2020-10-24;"Trenčiansky kraj";395;128;6;134;NA;100559;401;2020-10-24;4785
2020-10-23;"Trenčiansky kraj";301;154;8;162;NA;100559;309;2020-10-23;4384
2020-10-22;"Trenčiansky kraj";273;82;12;94;NA;100559;285;2020-10-22;4075
2020-10-21;"Trenčiansky kraj";183;53;9;62;NA;100559;192;2020-10-21;3790
2020-10-20;"Trenčiansky kraj";212;47;6;53;NA;100559;218;2020-10-20;3598
2020-10-19;"Trenčiansky kraj";41;83;25;108;NA;100559;66;2020-10-19;3380
2020-10-18;"Trenčiansky kraj";104;0;0;0;NA;100559;104;2020-10-18;3314
2020-10-17;"Trenčiansky kraj";157;0;0;0;NA;100559;157;2020-10-17;3210
2020-10-16;"Trenčiansky kraj";225;42;6;48;NA;100559;231;2020-10-16;3053
2020-10-15;"Trenčiansky kraj";255;39;4;43;NA;100559;259;2020-10-15;2822
2020-10-14;"Trenčiansky kraj";162;42;7;49;NA;100559;169;2020-10-14;2563
2020-10-13;"Trenčiansky kraj";124;105;12;117;NA;100559;136;2020-10-13;2394
2020-10-12;"Trenčiansky kraj";55;0;0;0;NA;100559;55;2020-10-12;2258
2020-10-11;"Trenčiansky kraj";73;0;0;0;NA;100559;73;2020-10-11;2203
2020-10-10;"Trenčiansky kraj";180;0;0;0;NA;100559;180;2020-10-10;2130
2020-10-09;"Trenčiansky kraj";198;0;0;0;NA;100559;198;2020-10-09;1950
2020-10-08;"Trenčiansky kraj";115;0;0;0;NA;100559;115;2020-10-08;1752
2020-10-07;"Trenčiansky kraj";75;0;0;0;NA;100559;75;2020-10-07;1637
2020-10-06;"Trenčiansky kraj";72;0;0;0;NA;100559;72;2020-10-06;1562
2020-10-05;"Trenčiansky kraj";32;0;0;0;NA;100559;32;2020-10-05;1490
2020-10-04;"Trenčiansky kraj";37;0;0;0;NA;100559;37;2020-10-04;1458
2020-10-03;"Trenčiansky kraj";79;0;0;0;NA;100559;79;2020-10-03;1421
2020-10-02;"Trenčiansky kraj";69;0;0;0;NA;100559;69;2020-10-02;1342
2020-10-01;"Trenčiansky kraj";58;0;0;0;NA;100559;58;2020-10-01;1273
2020-09-30;"Trenčiansky kraj";76;0;0;0;NA;100559;76;2020-09-30;1215
2020-09-29;"Trenčiansky kraj";43;0;0;0;NA;100559;43;2020-09-29;1139
2020-09-28;"Trenčiansky kraj";7;0;0;0;NA;100559;7;2020-09-28;1096
2020-09-27;"Trenčiansky kraj";12;0;0;0;NA;100559;12;2020-09-27;1089
2020-09-26;"Trenčiansky kraj";37;0;0;0;NA;100559;37;2020-09-26;1077
2020-09-25;"Trenčiansky kraj";72;0;0;0;NA;100559;72;2020-09-25;1040
2020-09-24;"Trenčiansky kraj";41;0;0;0;NA;100559;41;2020-09-24;968
2020-09-23;"Trenčiansky kraj";32;0;0;0;NA;100559;32;2020-09-23;927
2020-09-22;"Trenčiansky kraj";26;0;0;0;NA;100559;26;2020-09-22;895
2020-09-21;"Trenčiansky kraj";23;0;0;0;NA;100559;23;2020-09-21;869
2020-09-20;"Trenčiansky kraj";21;0;0;0;NA;100559;21;2020-09-20;846
2020-09-19;"Trenčiansky kraj";20;0;0;0;NA;100559;20;2020-09-19;825
2020-09-18;"Trenčiansky kraj";41;0;0;0;NA;100559;41;2020-09-18;805
2020-09-17;"Trenčiansky kraj";20;0;0;0;NA;100559;20;2020-09-17;764
2020-09-16;"Trenčiansky kraj";14;0;0;0;NA;100559;14;2020-09-16;744
2020-09-15;"Trenčiansky kraj";8;0;0;0;NA;100559;8;2020-09-15;730
2020-09-14;"Trenčiansky kraj";5;0;0;0;NA;100559;5;2020-09-14;722
2020-09-13;"Trenčiansky kraj";12;0;0;0;NA;100559;12;2020-09-13;717
2020-09-12;"Trenčiansky kraj";2;0;0;0;NA;100559;2;2020-09-12;705
2020-09-11;"Trenčiansky kraj";27;0;0;0;NA;100559;27;2020-09-11;703
2020-09-10;"Trenčiansky kraj";15;0;0;0;NA;100559;15;2020-09-10;676
2020-09-09;"Trenčiansky kraj";11;0;0;0;NA;100559;11;2020-09-09;661
2020-09-08;"Trenčiansky kraj";12;0;0;0;NA;100559;12;2020-09-08;650
2020-09-07;"Trenčiansky kraj";6;0;0;0;NA;100559;6;2020-09-07;638
2020-09-06;"Trenčiansky kraj";1;0;0;0;NA;100559;1;2020-09-06;632
2020-09-05;"Trenčiansky kraj";3;0;0;0;NA;100559;3;2020-09-05;631
2020-09-04;"Trenčiansky kraj";9;0;0;0;NA;100559;9;2020-09-04;628
2020-09-03;"Trenčiansky kraj";10;0;0;0;NA;100559;10;2020-09-03;619
2020-09-02;"Trenčiansky kraj";5;0;0;0;NA;100559;5;2020-09-02;609
2020-09-01;"Trenčiansky kraj";1;0;0;0;NA;100559;1;2020-09-01;604
2020-08-31;"Trenčiansky kraj";12;0;0;0;NA;100559;12;2020-08-31;603
2020-08-30;"Trenčiansky kraj";0;0;0;0;NA;100559;0;2020-08-30;591
2020-08-29;"Trenčiansky kraj";1;0;0;0;NA;100559;1;2020-08-29;591
2020-08-28;"Trenčiansky kraj";12;0;0;0;NA;100559;12;2020-08-28;590
2020-08-27;"Trenčiansky kraj";10;0;0;0;NA;100559;10;2020-08-27;578
2020-08-26;"Trenčiansky kraj";15;0;0;0;NA;100559;15;2020-08-26;568
2020-08-25;"Trenčiansky kraj";12;0;0;0;NA;100559;12;2020-08-25;553
2020-08-24;"Trenčiansky kraj";4;0;0;0;NA;100559;4;2020-08-24;541
2020-08-23;"Trenčiansky kraj";5;0;0;0;NA;100559;5;2020-08-23;537
2020-08-22;"Trenčiansky kraj";6;0;0;0;NA;100559;6;2020-08-22;532
2020-08-21;"Trenčiansky kraj";6;0;0;0;NA;100559;6;2020-08-21;526
2020-08-20;"Trenčiansky kraj";20;0;0;0;NA;100559;20;2020-08-20;520
2020-08-19;"Trenčiansky kraj";17;0;0;0;NA;100559;17;2020-08-19;500
2020-08-18;"Trenčiansky kraj";9;0;0;0;NA;100559;9;2020-08-18;483
2020-08-17;"Trenčiansky kraj";4;0;0;0;NA;100559;4;2020-08-17;474
2020-08-16;"Trenčiansky kraj";0;0;0;0;NA;100559;0;2020-08-16;470
2020-08-15;"Trenčiansky kraj";9;0;0;0;NA;100559;9;2020-08-15;470
2020-08-14;"Trenčiansky kraj";15;0;0;0;NA;100559;15;2020-08-14;461
2020-08-13;"Trenčiansky kraj";23;0;0;0;NA;100559;23;2020-08-13;446
2020-08-12;"Trenčiansky kraj";6;0;0;0;NA;100559;6;2020-08-12;423
2020-08-11;"Trenčiansky kraj";7;0;0;0;NA;100559;7;2020-08-11;417
2020-08-10;"Trenčiansky kraj";9;0;0;0;NA;100559;9;2020-08-10;410
2020-08-09;"Trenčiansky kraj";1;0;0;0;NA;100559;1;2020-08-09;401
2020-08-08;"Trenčiansky kraj";4;0;0;0;NA;100559;4;2020-08-08;400
2020-08-07;"Trenčiansky kraj";4;0;0;0;NA;100559;4;2020-08-07;396
2020-08-06;"Trenčiansky kraj";13;0;0;0;NA;100559;13;2020-08-06;392
2020-08-05;"Trenčiansky kraj";39;0;0;0;NA;100559;39;2020-08-05;379
2020-08-04;"Trenčiansky kraj";9;0;0;0;NA;100559;9;2020-08-04;340
2020-08-03;"Trenčiansky kraj";0;0;0;0;NA;100559;0;2020-08-03;331
2020-08-02;"Trenčiansky kraj";2;0;0;0;NA;100559;2;2020-08-02;331
2020-08-01;"Trenčiansky kraj";6;0;0;0;NA;100559;6;2020-08-01;329
2020-07-31;"Trenčiansky kraj";16;0;0;0;NA;100559;16;2020-07-31;323
2020-07-30;"Trenčiansky kraj";4;0;0;0;NA;100559;4;2020-07-30;307
2020-07-29;"Trenčiansky kraj";5;0;0;0;NA;100559;5;2020-07-29;303
2020-07-28;"Trenčiansky kraj";11;0;0;0;NA;100559;11;2020-07-28;298
2020-07-27;"Trenčiansky kraj";4;0;0;0;NA;100559;4;2020-07-27;287
2020-07-26;"Trenčiansky kraj";1;0;0;0;NA;100559;1;2020-07-26;283
2020-07-25;"Trenčiansky kraj";7;0;0;0;NA;100559;7;2020-07-25;282
2020-07-24;"Trenčiansky kraj";5;0;0;0;NA;100559;5;2020-07-24;275
2020-07-23;"Trenčiansky kraj";10;0;0;0;NA;100559;10;2020-07-23;270
2020-07-22;"Trenčiansky kraj";11;0;0;0;NA;100559;11;2020-07-22;260
2020-07-21;"Trenčiansky kraj";6;0;0;0;NA;100559;6;2020-07-21;249
2020-07-20;"Trenčiansky kraj";13;0;0;0;NA;100559;13;2020-07-20;243
2020-07-19;"Trenčiansky kraj";0;0;0;0;NA;100559;0;2020-07-19;230
2020-07-18;"Trenčiansky kraj";0;0;0;0;NA;100559;0;2020-07-18;230
2020-07-17;"Trenčiansky kraj";1;0;0;0;NA;100559;1;2020-07-17;230
2020-07-16;"Trenčiansky kraj";0;0;0;0;NA;100559;0;2020-07-16;229
2020-07-15;"Trenčiansky kraj";2;0;0;0;NA;100559;2;2020-07-15;229
2020-07-14;"Trenčiansky kraj";8;0;0;0;NA;100559;8;2020-07-14;227
2020-07-13;"Trenčiansky kraj";1;0;0;0;NA;100559;1;2020-07-13;219
2020-07-12;"Trenčiansky kraj";0;0;0;0;NA;100559;0;2020-07-12;218
2020-07-11;"Trenčiansky kraj";0;0;0;0;NA;100559;0;2020-07-11;218
2020-07-10;"Trenčiansky kraj";3;0;0;0;NA;100559;3;2020-07-10;218
2020-07-09;"Trenčiansky kraj";2;0;0;0;NA;100559;2;2020-07-09;215
2020-07-08;"Trenčiansky kraj";1;0;0;0;NA;100559;1;2020-07-08;213
2020-07-07;"Trenčiansky kraj";9;0;0;0;NA;100559;9;2020-07-07;212
2020-07-06;"Trenčiansky kraj";1;0;0;0;NA;100559;1;2020-07-06;203
2020-07-05;"Trenčiansky kraj";1;0;0;0;NA;100559;1;2020-07-05;202
2020-07-04;"Trenčiansky kraj";0;0;0;0;NA;100559;0;2020-07-04;201
2020-07-03;"Trenčiansky kraj";2;0;0;0;NA;100559;2;2020-07-03;201
2020-07-02;"Trenčiansky kraj";10;0;0;0;NA;100559;10;2020-07-02;199
2020-07-01;"Trenčiansky kraj";1;0;0;0;NA;100559;1;2020-07-01;189
2020-06-30;"Trenčiansky kraj";6;0;0;0;NA;100559;6;2020-06-30;188
2020-06-29;"Trenčiansky kraj";1;0;0;0;NA;100559;1;2020-06-29;182
2020-06-28;"Trenčiansky kraj";0;0;0;0;NA;100559;0;2020-06-28;181
2020-06-27;"Trenčiansky kraj";0;0;0;0;NA;100559;0;2020-06-27;181
2020-06-26;"Trenčiansky kraj";0;0;0;0;NA;100559;0;2020-06-26;181
2020-06-25;"Trenčiansky kraj";2;0;0;0;NA;100559;2;2020-06-25;181
2020-06-24;"Trenčiansky kraj";1;0;0;0;NA;100559;1;2020-06-24;179
2020-06-23;"Trenčiansky kraj";0;0;0;0;NA;100559;0;2020-06-23;178
2020-06-22;"Trenčiansky kraj";0;0;0;0;NA;100559;0;2020-06-22;178
2020-06-21;"Trenčiansky kraj";0;0;0;0;NA;100559;0;2020-06-21;178
2020-06-20;"Trenčiansky kraj";0;0;0;0;NA;100559;0;2020-06-20;178
2020-06-19;"Trenčiansky kraj";0;0;0;0;NA;100559;0;2020-06-19;178
2020-06-18;"Trenčiansky kraj";0;0;0;0;NA;100559;0;2020-06-18;178
2020-06-17;"Trenčiansky kraj";0;0;0;0;NA;100559;0;2020-06-17;178
2020-06-16;"Trenčiansky kraj";0;0;0;0;NA;100559;0;2020-06-16;178
2020-06-14;"Trenčiansky kraj";0;0;0;0;NA;100559;0;2020-06-14;178
2020-06-13;"Trenčiansky kraj";0;0;0;0;NA;100559;0;2020-06-13;178
2020-06-12;"Trenčiansky kraj";0;0;0;0;NA;100559;0;2020-06-12;178
2020-06-11;"Trenčiansky kraj";0;0;0;0;NA;100559;0;2020-06-11;178
2020-06-10;"Trenčiansky kraj";1;0;0;0;NA;100559;1;2020-06-10;178
2020-06-09;"Trenčiansky kraj";0;0;0;0;NA;100559;0;2020-06-09;177
2020-06-08;"Trenčiansky kraj";0;0;0;0;NA;100559;0;2020-06-08;177
2020-06-07;"Trenčiansky kraj";0;0;0;0;NA;100559;0;2020-06-07;177
2020-06-05;"Trenčiansky kraj";0;0;0;0;NA;100559;0;2020-06-05;177
2020-06-03;"Trenčiansky kraj";0;0;0;0;NA;100559;0;2020-06-03;177
2020-06-02;"Trenčiansky kraj";0;0;0;0;NA;100559;0;2020-06-02;177
2020-05-31;"Trenčiansky kraj";0;0;0;0;NA;100559;0;2020-05-31;177
2020-05-29;"Trenčiansky kraj";0;0;0;0;NA;100559;0;2020-05-29;177
2020-05-27;"Trenčiansky kraj";2;0;0;0;NA;100559;2;2020-05-27;177
2020-05-26;"Trenčiansky kraj";0;0;0;0;NA;100559;0;2020-05-26;175
2020-05-25;"Trenčiansky kraj";0;0;0;0;NA;100559;0;2020-05-25;175
2020-05-24;"Trenčiansky kraj";0;0;0;0;NA;100559;0;2020-05-24;175
2020-05-23;"Trenčiansky kraj";0;0;0;0;NA;100559;0;2020-05-23;175
2020-05-22;"Trenčiansky kraj";0;0;0;0;NA;100559;0;2020-05-22;175
2020-05-21;"Trenčiansky kraj";0;0;0;0;NA;100559;0;2020-05-21;175
2020-05-20;"Trenčiansky kraj";0;0;0;0;NA;100559;0;2020-05-20;175
2020-05-19;"Trenčiansky kraj";0;0;0;0;NA;100559;0;2020-05-19;175
2020-05-17;"Trenčiansky kraj";0;0;0;0;NA;100559;0;2020-05-17;175
2020-05-16;"Trenčiansky kraj";0;0;0;0;NA;100559;0;2020-05-16;175
2020-05-15;"Trenčiansky kraj";1;0;0;0;NA;100559;1;2020-05-15;175
2020-05-14;"Trenčiansky kraj";2;0;0;0;NA;100559;2;2020-05-14;174
2020-05-13;"Trenčiansky kraj";1;0;0;0;NA;100559;1;2020-05-13;172
2020-05-12;"Trenčiansky kraj";1;0;0;0;NA;100559;1;2020-05-12;171
2020-05-11;"Trenčiansky kraj";3;0;0;0;NA;100559;3;2020-05-11;170
2020-05-09;"Trenčiansky kraj";2;0;0;0;NA;100559;2;2020-05-09;167
2020-05-07;"Trenčiansky kraj";6;0;0;0;NA;100559;6;2020-05-07;165
2020-05-06;"Trenčiansky kraj";0;0;0;0;NA;100559;0;2020-05-06;159
2020-05-05;"Trenčiansky kraj";2;0;0;0;NA;100559;2;2020-05-05;159
2020-05-04;"Trenčiansky kraj";0;0;0;0;NA;100559;0;2020-05-04;157
2020-05-03;"Trenčiansky kraj";0;0;0;0;NA;100559;0;2020-05-03;157
2020-05-02;"Trenčiansky kraj";0;0;0;0;NA;100559;0;2020-05-02;157
2020-05-01;"Trenčiansky kraj";0;0;0;0;NA;100559;0;2020-05-01;157
2020-04-30;"Trenčiansky kraj";0;0;0;0;NA;100559;0;2020-04-30;157
2020-04-29;"Trenčiansky kraj";2;0;0;0;NA;100559;2;2020-04-29;157
2020-04-28;"Trenčiansky kraj";1;0;0;0;NA;100559;1;2020-04-28;155
2020-04-27;"Trenčiansky kraj";0;0;0;0;NA;100559;0;2020-04-27;154
2020-04-26;"Trenčiansky kraj";1;0;0;0;NA;100559;1;2020-04-26;154
2020-04-25;"Trenčiansky kraj";0;0;0;0;NA;100559;0;2020-04-25;153
2020-04-24;"Trenčiansky kraj";0;0;0;0;NA;100559;0;2020-04-24;153
2020-04-23;"Trenčiansky kraj";11;0;0;0;NA;100559;11;2020-04-23;153
2020-04-22;"Trenčiansky kraj";1;0;0;0;NA;100559;1;2020-04-22;142
2020-04-21;"Trenčiansky kraj";11;0;0;0;NA;100559;11;2020-04-21;141
2020-04-20;"Trenčiansky kraj";15;0;0;0;NA;100559;15;2020-04-20;130
2020-04-19;"Trenčiansky kraj";2;0;0;0;NA;100559;2;2020-04-19;115
2020-04-18;"Trenčiansky kraj";3;0;0;0;NA;100559;3;2020-04-18;113
2020-04-17;"Trenčiansky kraj";4;0;0;0;NA;100559;4;2020-04-17;110
2020-04-16;"Trenčiansky kraj";10;0;0;0;NA;100559;10;2020-04-16;106
2020-04-15;"Trenčiansky kraj";4;0;0;0;NA;100559;4;2020-04-15;96
2020-04-14;"Trenčiansky kraj";0;0;0;0;NA;100559;0;2020-04-14;92
2020-04-13;"Trenčiansky kraj";1;0;0;0;NA;100559;1;2020-04-13;92
2020-04-12;"Trenčiansky kraj";2;0;0;0;NA;100559;2;2020-04-12;91
2020-04-11;"Trenčiansky kraj";3;0;0;0;NA;100559;3;2020-04-11;89
2020-04-10;"Trenčiansky kraj";0;0;0;0;NA;100559;0;2020-04-10;86
2020-04-09;"Trenčiansky kraj";0;0;0;0;NA;100559;0;2020-04-09;86
2020-04-08;"Trenčiansky kraj";2;0;0;0;NA;100559;2;2020-04-08;86
2020-04-07;"Trenčiansky kraj";18;0;0;0;NA;100559;18;2020-04-07;84
2020-04-06;"Trenčiansky kraj";0;0;0;0;NA;100559;0;2020-04-06;66
2020-04-05;"Trenčiansky kraj";3;0;0;0;NA;100559;3;2020-04-05;66
2020-04-04;"Trenčiansky kraj";5;0;0;0;NA;100559;5;2020-04-04;63
2020-04-03;"Trenčiansky kraj";4;0;0;0;NA;100559;4;2020-04-03;58
2020-04-02;"Trenčiansky kraj";1;0;0;0;NA;100559;1;2020-04-02;54
2020-04-01;"Trenčiansky kraj";3;0;0;0;NA;100559;3;2020-04-01;53
2020-03-31;"Trenčiansky kraj";1;0;0;0;NA;100559;1;2020-03-31;50
2020-03-30;"Trenčiansky kraj";3;0;0;0;NA;100559;3;2020-03-30;49
2020-03-29;"Trenčiansky kraj";6;0;0;0;NA;100559;6;2020-03-29;46
2020-03-28;"Trenčiansky kraj";9;0;0;0;NA;100559;9;2020-03-28;40
2020-03-27;"Trenčiansky kraj";2;0;0;0;NA;100559;2;2020-03-27;31
2020-03-26;"Trenčiansky kraj";6;0;0;0;NA;100559;6;2020-03-26;29
2020-03-25;"Trenčiansky kraj";3;0;0;0;NA;100559;3;2020-03-25;23
2020-03-24;"Trenčiansky kraj";1;0;0;0;NA;100559;1;2020-03-24;20
2020-03-23;"Trenčiansky kraj";0;0;0;0;NA;100559;0;2020-03-23;19
2020-03-22;"Trenčiansky kraj";0;0;0;0;NA;100559;0;2020-03-22;19
2020-03-21;"Trenčiansky kraj";2;0;0;0;NA;100559;2;2020-03-21;19
2020-03-20;"Trenčiansky kraj";2;0;0;0;NA;100559;2;2020-03-20;17
2020-03-19;"Trenčiansky kraj";8;0;0;0;NA;100559;8;2020-03-19;15
2020-03-18;"Trenčiansky kraj";0;0;0;0;NA;100559;0;2020-03-18;7
2020-03-17;"Trenčiansky kraj";0;0;0;0;NA;100559;0;2020-03-17;7
2020-03-16;"Trenčiansky kraj";1;0;0;0;NA;100559;1;2020-03-16;7
2020-03-15;"Trenčiansky kraj";5;0;0;0;NA;100559;5;2020-03-15;6
2020-03-14;"Trenčiansky kraj";0;0;0;0;NA;100559;0;2020-03-14;1
2020-03-13;"Trenčiansky kraj";0;0;0;0;NA;100559;0;2020-03-13;1
2020-03-12;"Trenčiansky kraj";1;0;0;0;NA;100559;1;2020-03-12;1
2020-03-11;"Trenčiansky kraj";0;0;0;0;NA;100559;0;2020-03-11;0
2020-03-09;"Trenčiansky kraj";0;0;0;0;NA;100559;0;2020-03-09;0
2020-03-08;"Trenčiansky kraj";0;0;0;0;NA;100559;0;2020-03-08;0
2020-03-07;"Trenčiansky kraj";0;0;0;0;NA;100559;0;2020-03-07;0
2020-03-06;"Trenčiansky kraj";0;0;0;0;NA;100559;0;2020-03-06;0
2021-07-11;"Trnavský kraj";0;397;0;397;45814;90145;0;2021-07-11;90145
2021-07-10;"Trnavský kraj";1;640;0;640;NA;90145;1;2021-07-10;90145
2021-07-09;"Trnavský kraj";3;1072;2;1074;NA;90145;5;2021-07-09;90144
2021-07-08;"Trnavský kraj";4;603;0;603;NA;90145;4;2021-07-08;90139
2021-07-07;"Trnavský kraj";9;641;2;643;NA;90145;11;2021-07-07;90135
2021-07-06;"Trnavský kraj";2;1103;1;1104;NA;90145;3;2021-07-06;90124
2021-07-05;"Trnavský kraj";1;503;2;505;NA;90145;3;2021-07-05;90121
2021-07-04;"Trnavský kraj";0;1129;3;1132;NA;90145;3;2021-07-04;90118
2021-07-03;"Trnavský kraj";4;815;0;815;NA;90145;4;2021-07-03;90115
2021-07-02;"Trnavský kraj";2;1137;2;1139;NA;90145;4;2021-07-02;90111
2021-07-01;"Trnavský kraj";4;437;0;437;NA;90145;4;2021-07-01;90107
2021-06-30;"Trnavský kraj";0;4135;1;4136;NA;90145;1;2021-06-30;90103
2021-06-29;"Trnavský kraj";4;2321;1;2322;NA;90145;5;2021-06-29;90102
2021-06-28;"Trnavský kraj";2;2298;1;2299;NA;90145;3;2021-06-28;90097
2021-06-27;"Trnavský kraj";0;3040;0;3040;NA;90145;0;2021-06-27;90094
2021-06-26;"Trnavský kraj";3;3482;1;3483;NA;90145;4;2021-06-26;90094
2021-06-25;"Trnavský kraj";2;3967;3;3970;NA;90145;5;2021-06-25;90090
2021-06-24;"Trnavský kraj";4;2541;4;2545;NA;90145;8;2021-06-24;90085
2021-06-23;"Trnavský kraj";4;2632;1;2633;NA;90145;5;2021-06-23;90077
2021-06-22;"Trnavský kraj";2;2607;1;2608;NA;90145;3;2021-06-22;90072
2021-06-21;"Trnavský kraj";6;2907;5;2912;NA;90145;11;2021-06-21;90069
2021-06-20;"Trnavský kraj";0;3955;1;3956;NA;90145;1;2021-06-20;90058
2021-06-19;"Trnavský kraj";3;4126;2;4128;NA;90145;5;2021-06-19;90057
2021-06-18;"Trnavský kraj";5;5314;4;5318;NA;90145;9;2021-06-18;90052
2021-06-17;"Trnavský kraj";3;3084;0;3084;NA;90145;3;2021-06-17;90043
2021-06-16;"Trnavský kraj";6;2632;3;2635;NA;90145;9;2021-06-16;90040
2021-06-15;"Trnavský kraj";8;2974;2;2976;NA;90145;10;2021-06-15;90031
2021-06-14;"Trnavský kraj";2;3521;1;3522;NA;90145;3;2021-06-14;90021
2021-06-13;"Trnavský kraj";0;5003;6;5009;NA;90145;6;2021-06-13;90018
2021-06-12;"Trnavský kraj";11;5536;1;5537;NA;90145;12;2021-06-12;90012
2021-06-11;"Trnavský kraj";17;5557;4;5561;NA;90145;21;2021-06-11;90000
2021-06-10;"Trnavský kraj";14;3336;1;3337;NA;90145;15;2021-06-10;89979
2021-06-09;"Trnavský kraj";10;3500;1;3501;NA;90145;11;2021-06-09;89964
2021-06-08;"Trnavský kraj";8;2887;4;2891;NA;90145;12;2021-06-08;89953
2021-06-07;"Trnavský kraj";12;4163;8;4171;NA;90145;20;2021-06-07;89941
2021-06-06;"Trnavský kraj";0;5517;2;5519;NA;90145;2;2021-06-06;89921
2021-06-05;"Trnavský kraj";20;6779;6;6785;NA;90145;26;2021-06-05;89919
2021-06-04;"Trnavský kraj";9;6359;9;6368;NA;90145;18;2021-06-04;89893
2021-06-03;"Trnavský kraj";14;3963;11;3974;NA;90145;25;2021-06-03;89875
2021-06-02;"Trnavský kraj";4;4105;11;4116;NA;90145;15;2021-06-02;89850
2021-06-01;"Trnavský kraj";18;3394;4;3398;NA;90145;22;2021-06-01;89835
2021-05-31;"Trnavský kraj";14;5101;16;5117;NA;90145;30;2021-05-31;89813
2021-05-30;"Trnavský kraj";0;6283;6;6289;NA;90145;6;2021-05-30;89783
2021-05-29;"Trnavský kraj";11;8409;4;8413;NA;90145;15;2021-05-29;89777
2021-05-28;"Trnavský kraj";14;6720;11;6731;NA;90145;25;2021-05-28;89762
2021-05-27;"Trnavský kraj";22;4753;8;4761;NA;90145;30;2021-05-27;89737
2021-05-26;"Trnavský kraj";6;4503;8;4511;NA;90145;14;2021-05-26;89707
2021-05-25;"Trnavský kraj";19;4615;25;4640;NA;90145;44;2021-05-25;89693
2021-05-24;"Trnavský kraj";15;6520;22;6542;NA;90145;37;2021-05-24;89649
2021-05-23;"Trnavský kraj";0;7767;8;7775;NA;90145;8;2021-05-23;89612
2021-05-22;"Trnavský kraj";13;12767;18;12785;NA;90145;31;2021-05-22;89604
2021-05-21;"Trnavský kraj";16;8079;19;8098;NA;90145;35;2021-05-21;89573
2021-05-20;"Trnavský kraj";15;5223;9;5232;NA;90145;24;2021-05-20;89538
2021-05-19;"Trnavský kraj";18;5159;12;5171;NA;90145;30;2021-05-19;89514
2021-05-18;"Trnavský kraj";26;5686;15;5701;NA;90145;41;2021-05-18;89484
2021-05-17;"Trnavský kraj";17;5988;23;6011;NA;90145;40;2021-05-17;89443
2021-05-16;"Trnavský kraj";10;9725;8;9733;NA;90145;18;2021-05-16;89403
2021-05-15;"Trnavský kraj";11;18040;14;18054;NA;90145;25;2021-05-15;89385
2021-05-14;"Trnavský kraj";34;9846;20;9866;NA;90145;54;2021-05-14;89360
2021-05-13;"Trnavský kraj";26;6913;12;6925;NA;90145;38;2021-05-13;89306
2021-05-12;"Trnavský kraj";34;6621;26;6647;NA;90145;60;2021-05-12;89268
2021-05-11;"Trnavský kraj";32;6311;13;6324;NA;90145;45;2021-05-11;89208
2021-05-10;"Trnavský kraj";58;8462;24;8486;NA;90145;82;2021-05-10;89163
2021-05-09;"Trnavský kraj";21;12312;11;12323;NA;90145;32;2021-05-09;89081
2021-05-08;"Trnavský kraj";4;22539;21;22560;NA;90145;25;2021-05-08;89049
2021-05-07;"Trnavský kraj";26;14895;29;14924;NA;90145;55;2021-05-07;89024
2021-05-06;"Trnavský kraj";22;8402;22;8424;NA;90145;44;2021-05-06;88969
2021-05-05;"Trnavský kraj";34;6127;20;6147;NA;90145;54;2021-05-05;88925
2021-05-04;"Trnavský kraj";51;8538;17;8555;NA;90145;68;2021-05-04;88871
2021-05-03;"Trnavský kraj";20;8957;22;8979;NA;90145;42;2021-05-03;88803
2021-05-02;"Trnavský kraj";0;25657;29;25686;NA;90145;29;2021-05-02;88761
2021-05-01;"Trnavský kraj";30;81353;64;81417;NA;90145;94;2021-05-01;88732
2021-04-30;"Trnavský kraj";45;26843;35;26878;NA;90145;80;2021-04-30;88638
2021-04-29;"Trnavský kraj";25;20323;28;20351;NA;90145;53;2021-04-29;88558
2021-04-28;"Trnavský kraj";46;8867;28;8895;NA;90145;74;2021-04-28;88505
2021-04-27;"Trnavský kraj";54;8744;37;8781;NA;90145;91;2021-04-27;88431
2021-04-26;"Trnavský kraj";53;16116;42;16158;NA;90145;95;2021-04-26;88340
2021-04-25;"Trnavský kraj";0;30183;24;30207;NA;90145;24;2021-04-25;88245
2021-04-24;"Trnavský kraj";46;125418;82;125500;NA;90145;128;2021-04-24;88221
2021-04-23;"Trnavský kraj";71;25639;53;25692;NA;90145;124;2021-04-23;88093
2021-04-22;"Trnavský kraj";40;10901;25;10926;NA;90145;65;2021-04-22;87969
2021-04-21;"Trnavský kraj";60;10748;45;10793;NA;90145;105;2021-04-21;87904
2021-04-20;"Trnavský kraj";57;13499;28;13527;NA;90145;85;2021-04-20;87799
2021-04-19;"Trnavský kraj";46;14587;18;14605;NA;90145;64;2021-04-19;87714
2021-04-18;"Trnavský kraj";7;40843;43;40886;NA;90145;50;2021-04-18;87650
2021-04-17;"Trnavský kraj";58;118102;89;118191;NA;90145;147;2021-04-17;87600
2021-04-16;"Trnavský kraj";67;25962;48;26010;NA;90145;115;2021-04-16;87453
2021-04-15;"Trnavský kraj";65;11373;36;11409;NA;90145;101;2021-04-15;87338
2021-04-14;"Trnavský kraj";78;18442;53;18495;NA;90145;131;2021-04-14;87237
2021-04-13;"Trnavský kraj";126;9831;44;9875;NA;90145;170;2021-04-13;87106
2021-04-12;"Trnavský kraj";40;15575;40;15615;NA;90145;80;2021-04-12;86936
2021-04-11;"Trnavský kraj";3;44417;44;44461;NA;90145;47;2021-04-11;86856
2021-04-10;"Trnavský kraj";60;123822;107;123929;NA;90145;167;2021-04-10;86809
2021-04-09;"Trnavský kraj";95;26084;34;26118;NA;90145;129;2021-04-09;86642
2021-04-08;"Trnavský kraj";85;10893;52;10945;NA;90145;137;2021-04-08;86513
2021-04-07;"Trnavský kraj";131;15964;81;16045;NA;90145;212;2021-04-07;86376
2021-04-06;"Trnavský kraj";92;20579;90;20669;NA;90145;182;2021-04-06;86164
2021-04-05;"Trnavský kraj";91;7517;17;7534;NA;90145;108;2021-04-05;85982
2021-04-04;"Trnavský kraj";9;28831;49;28880;NA;90145;58;2021-04-04;85874
2021-04-03;"Trnavský kraj";29;144077;186;144263;NA;90145;215;2021-04-03;85816
2021-04-02;"Trnavský kraj";91;17538;33;17571;NA;90145;124;2021-04-02;85601
2021-04-01;"Trnavský kraj";118;22027;69;22096;NA;90145;187;2021-04-01;85477
2021-03-31;"Trnavský kraj";140;15819;82;15901;NA;90145;222;2021-03-31;85290
2021-03-30;"Trnavský kraj";182;10482;79;10561;NA;90145;261;2021-03-30;85068
2021-03-29;"Trnavský kraj";126;19249;122;19371;NA;90145;248;2021-03-29;84807
2021-03-28;"Trnavský kraj";26;50792;134;50926;NA;90145;160;2021-03-28;84559
2021-03-27;"Trnavský kraj";64;129602;245;129847;NA;90145;309;2021-03-27;84399
2021-03-26;"Trnavský kraj";139;30217;130;30347;NA;90145;269;2021-03-26;84090
2021-03-25;"Trnavský kraj";135;14212;80;14292;NA;90145;215;2021-03-25;83821
2021-03-24;"Trnavský kraj";159;10521;89;10610;NA;90145;248;2021-03-24;83606
2021-03-23;"Trnavský kraj";221;12735;104;12839;NA;90145;325;2021-03-23;83358
2021-03-22;"Trnavský kraj";103;17068;110;17178;NA;90145;213;2021-03-22;83033
2021-03-21;"Trnavský kraj";31;49119;150;49269;NA;90145;181;2021-03-21;82820
2021-03-20;"Trnavský kraj";112;136963;317;137280;NA;90145;429;2021-03-20;82639
2021-03-19;"Trnavský kraj";174;29071;137;29208;NA;90145;311;2021-03-19;82210
2021-03-18;"Trnavský kraj";158;12217;136;12353;NA;90145;294;2021-03-18;81899
2021-03-17;"Trnavský kraj";245;10434;103;10537;NA;90145;348;2021-03-17;81605
2021-03-16;"Trnavský kraj";311;12811;135;12946;NA;90145;446;2021-03-16;81257
2021-03-15;"Trnavský kraj";127;18400;146;18546;NA;90145;273;2021-03-15;80811
2021-03-14;"Trnavský kraj";14;47608;164;47772;NA;90145;178;2021-03-14;80538
2021-03-13;"Trnavský kraj";155;139224;409;139633;NA;90145;564;2021-03-13;80360
2021-03-12;"Trnavský kraj";201;28559;181;28740;NA;90145;382;2021-03-12;79796
2021-03-11;"Trnavský kraj";204;13285;140;13425;NA;90145;344;2021-03-11;79414
2021-03-10;"Trnavský kraj";242;10583;135;10718;NA;90145;377;2021-03-10;79070
2021-03-09;"Trnavský kraj";442;12820;155;12975;NA;90145;597;2021-03-09;78693
2021-03-08;"Trnavský kraj";182;21812;166;21978;NA;90145;348;2021-03-08;78096
2021-03-07;"Trnavský kraj";30;45463;227;45690;NA;90145;257;2021-03-07;77748
2021-03-06;"Trnavský kraj";154;135635;531;136166;NA;90145;685;2021-03-06;77491
2021-03-05;"Trnavský kraj";299;27951;239;28190;NA;90145;538;2021-03-05;76806
2021-03-04;"Trnavský kraj";238;14489;175;14664;NA;90145;413;2021-03-04;76268
2021-03-03;"Trnavský kraj";413;11566;246;11812;NA;90145;659;2021-03-03;75855
2021-03-02;"Trnavský kraj";477;12347;191;12538;NA;90145;668;2021-03-02;75196
2021-03-01;"Trnavský kraj";189;18581;234;18815;NA;90145;423;2021-03-01;74528
2021-02-28;"Trnavský kraj";87;47709;321;48030;NA;90145;408;2021-02-28;74105
2021-02-27;"Trnavský kraj";264;140224;800;141024;NA;90145;1064;2021-02-27;73697
2021-02-26;"Trnavský kraj";362;26637;284;26921;NA;90145;646;2021-02-26;72633
2021-02-25;"Trnavský kraj";433;10490;227;10717;NA;90145;660;2021-02-25;71987
2021-02-24;"Trnavský kraj";407;9110;290;9400;NA;90145;697;2021-02-24;71327
2021-02-23;"Trnavský kraj";469;11322;284;11606;NA;90145;753;2021-02-23;70630
2021-02-22;"Trnavský kraj";206;19896;330;20226;NA;90145;536;2021-02-22;69877
2021-02-21;"Trnavský kraj";38;48221;329;48550;NA;90145;367;2021-02-21;69341
2021-02-20;"Trnavský kraj";273;135835;859;136694;NA;90145;1132;2021-02-20;68974
2021-02-19;"Trnavský kraj";335;26339;347;26686;NA;90145;682;2021-02-19;67842
2021-02-18;"Trnavský kraj";344;11263;348;11611;NA;90145;692;2021-02-18;67160
2021-02-17;"Trnavský kraj";431;8781;416;9197;NA;90145;847;2021-02-17;66468
2021-02-16;"Trnavský kraj";426;11236;294;11530;NA;90145;720;2021-02-16;65621
2021-02-15;"Trnavský kraj";146;18075;291;18366;NA;90145;437;2021-02-15;64901
2021-02-14;"Trnavský kraj";51;57642;495;58137;NA;90145;546;2021-02-14;64464
2021-02-13;"Trnavský kraj";218;137051;994;138045;NA;90145;1212;2021-02-13;63918
2021-02-12;"Trnavský kraj";300;23682;336;24018;NA;90145;636;2021-02-12;62706
2021-02-11;"Trnavský kraj";422;9816;349;10165;NA;90145;771;2021-02-11;62070
2021-02-10;"Trnavský kraj";511;9180;342;9522;NA;90145;853;2021-02-10;61299
2021-02-09;"Trnavský kraj";544;12752;369;13121;NA;90145;913;2021-02-09;60446
2021-02-08;"Trnavský kraj";220;33407;497;33904;NA;90145;717;2021-02-08;59533
2021-02-07;"Trnavský kraj";140;68646;623;69269;NA;90145;763;2021-02-07;58816
2021-02-06;"Trnavský kraj";348;112687;1482;114169;NA;90145;1830;2021-02-06;58053
2021-02-05;"Trnavský kraj";377;16063;373;16436;NA;90145;750;2021-02-05;56223
2021-02-04;"Trnavský kraj";456;7317;456;7773;NA;90145;912;2021-02-04;55473
2021-02-03;"Trnavský kraj";472;6584;434;7018;NA;90145;906;2021-02-03;54561
2021-02-02;"Trnavský kraj";446;14240;424;14664;NA;90145;870;2021-02-02;53655
2021-02-01;"Trnavský kraj";198;38882;679;39561;NA;90145;877;2021-02-01;52785
2021-01-31;"Trnavský kraj";19;64673;817;65490;NA;90145;836;2021-01-31;51908
2021-01-30;"Trnavský kraj";323;111483;1288;112771;NA;90145;1611;2021-01-30;51072
2021-01-29;"Trnavský kraj";421;9689;290;9979;NA;90145;711;2021-01-29;49461
2021-01-28;"Trnavský kraj";389;5815;286;6101;NA;90145;675;2021-01-28;48750
2021-01-27;"Trnavský kraj";433;5554;225;5779;NA;90145;658;2021-01-27;48075
2021-01-26;"Trnavský kraj";565;25392;636;26028;NA;90145;1201;2021-01-26;47417
2021-01-25;"Trnavský kraj";210;41420;607;42027;NA;90145;817;2021-01-25;46216
2021-01-24;"Trnavský kraj";91;66399;779;67178;NA;90145;870;2021-01-24;45399
2021-01-23;"Trnavský kraj";372;113375;1319;114694;NA;90145;1691;2021-01-23;44529
2021-01-22;"Trnavský kraj";217;32753;505;33258;NA;90145;722;2021-01-22;42838
2021-01-21;"Trnavský kraj";311;13913;377;14290;NA;90145;688;2021-01-21;42116
2021-01-20;"Trnavský kraj";503;8564;283;8847;NA;90145;786;2021-01-20;41428
2021-01-19;"Trnavský kraj";415;7013;347;7360;NA;90145;762;2021-01-19;40642
2021-01-18;"Trnavský kraj";247;6690;512;7202;NA;90145;759;2021-01-18;39880
2021-01-17;"Trnavský kraj";128;854;215;1069;NA;90145;343;2021-01-17;39121
2021-01-16;"Trnavský kraj";103;898;24;922;NA;90145;127;2021-01-16;38778
2021-01-15;"Trnavský kraj";278;5467;336;5803;NA;90145;614;2021-01-15;38651
2021-01-14;"Trnavský kraj";452;4001;338;4339;NA;90145;790;2021-01-14;38037
2021-01-13;"Trnavský kraj";457;4751;378;5129;NA;90145;835;2021-01-13;37247
2021-01-12;"Trnavský kraj";469;7175;483;7658;NA;90145;952;2021-01-12;36412
2021-01-11;"Trnavský kraj";370;5012;392;5404;NA;90145;762;2021-01-11;35460
2021-01-10;"Trnavský kraj";71;13;0;13;NA;90145;71;2021-01-10;34698
2021-01-09;"Trnavský kraj";417;1775;100;1875;NA;90145;517;2021-01-09;34627
2021-01-08;"Trnavský kraj";381;6554;532;7086;NA;90145;913;2021-01-08;34110
2021-01-07;"Trnavský kraj";501;4080;390;4470;NA;90145;891;2021-01-07;33197
2021-01-06;"Trnavský kraj";179;758;132;890;NA;90145;311;2021-01-06;32306
2021-01-05;"Trnavský kraj";611;5608;616;6224;NA;90145;1227;2021-01-05;31995
2021-01-04;"Trnavský kraj";302;5556;709;6265;NA;90145;1011;2021-01-04;30768
2021-01-03;"Trnavský kraj";60;53;7;60;NA;90145;67;2021-01-03;29757
2021-01-02;"Trnavský kraj";282;417;32;449;NA;90145;314;2021-01-02;29690
2021-01-01;"Trnavský kraj";143;455;76;531;NA;90145;219;2021-01-01;29376
2020-12-31;"Trnavský kraj";498;8488;858;9346;NA;90145;1356;2020-12-31;29157
2020-12-30;"Trnavský kraj";785;5318;612;5930;NA;90145;1397;2020-12-30;27801
2020-12-29;"Trnavský kraj";322;5364;639;6003;NA;90145;961;2020-12-29;26404
2020-12-28;"Trnavský kraj";213;5334;615;5949;NA;90145;828;2020-12-28;25443
2020-12-27;"Trnavský kraj";27;20;4;24;NA;90145;31;2020-12-27;24615
2020-12-26;"Trnavský kraj";148;44;1;45;NA;90145;149;2020-12-26;24584
2020-12-25;"Trnavský kraj";65;49;5;54;NA;90145;70;2020-12-25;24435
2020-12-24;"Trnavský kraj";333;1359;117;1476;NA;90145;450;2020-12-24;24365
2020-12-23;"Trnavský kraj";210;7259;414;7673;NA;90145;624;2020-12-23;23915
2020-12-22;"Trnavský kraj";311;5590;491;6081;NA;90145;802;2020-12-22;23291
2020-12-21;"Trnavský kraj";328;4527;399;4926;NA;90145;727;2020-12-21;22489
2020-12-20;"Trnavský kraj";134;133;12;145;NA;90145;146;2020-12-20;21762
2020-12-19;"Trnavský kraj";201;1407;103;1510;NA;90145;304;2020-12-19;21616
2020-12-18;"Trnavský kraj";341;4898;378;5276;NA;90145;719;2020-12-18;21312
2020-12-17;"Trnavský kraj";375;5271;443;5714;NA;90145;818;2020-12-17;20593
2020-12-16;"Trnavský kraj";312;5249;405;5654;NA;90145;717;2020-12-16;19775
2020-12-15;"Trnavský kraj";492;6623;632;7255;NA;90145;1124;2020-12-15;19058
2020-12-14;"Trnavský kraj";161;3505;292;3797;NA;90145;453;2020-12-14;17934
2020-12-13;"Trnavský kraj";7;7;0;7;NA;90145;7;2020-12-13;17481
2020-12-12;"Trnavský kraj";254;1456;114;1570;NA;90145;368;2020-12-12;17474
2020-12-11;"Trnavský kraj";384;4683;262;4945;NA;90145;646;2020-12-11;17106
2020-12-10;"Trnavský kraj";183;5194;320;5514;NA;90145;503;2020-12-10;16460
2020-12-09;"Trnavský kraj";521;4283;321;4604;NA;90145;842;2020-12-09;15957
2020-12-08;"Trnavský kraj";281;4090;304;4394;NA;90145;585;2020-12-08;15115
2020-12-07;"Trnavský kraj";178;2895;199;3094;NA;90145;377;2020-12-07;14530
2020-12-06;"Trnavský kraj";46;0;0;0;NA;90145;46;2020-12-06;14153
2020-12-05;"Trnavský kraj";129;2218;41;2259;NA;90145;170;2020-12-05;14107
2020-12-04;"Trnavský kraj";242;3948;158;4106;NA;90145;400;2020-12-04;13937
2020-12-03;"Trnavský kraj";248;2770;190;2960;NA;90145;438;2020-12-03;13537
2020-12-02;"Trnavský kraj";284;4516;176;4692;NA;90145;460;2020-12-02;13099
2020-12-01;"Trnavský kraj";253;3190;205;3395;NA;90145;458;2020-12-01;12639
2020-11-30;"Trnavský kraj";200;7360;186;7546;NA;90145;386;2020-11-30;12181
2020-11-29;"Trnavský kraj";17;738;36;774;NA;90145;53;2020-11-29;11795
2020-11-28;"Trnavský kraj";83;1453;77;1530;NA;90145;160;2020-11-28;11742
2020-11-27;"Trnavský kraj";148;1779;85;1864;NA;90145;233;2020-11-27;11582
2020-11-26;"Trnavský kraj";234;1123;68;1191;NA;90145;302;2020-11-26;11349
2020-11-25;"Trnavský kraj";232;1168;74;1242;NA;90145;306;2020-11-25;11047
2020-11-24;"Trnavský kraj";295;1909;96;2005;NA;90145;391;2020-11-24;10741
2020-11-23;"Trnavský kraj";242;7393;129;7522;NA;90145;371;2020-11-23;10350
2020-11-22;"Trnavský kraj";10;82;9;91;NA;90145;19;2020-11-22;9979
2020-11-21;"Trnavský kraj";129;1354;36;1390;NA;90145;165;2020-11-21;9960
2020-11-20;"Trnavský kraj";246;1154;64;1218;NA;90145;310;2020-11-20;9795
2020-11-19;"Trnavský kraj";157;823;64;887;NA;90145;221;2020-11-19;9485
2020-11-18;"Trnavský kraj";235;822;82;904;NA;90145;317;2020-11-18;9264
2020-11-17;"Trnavský kraj";129;705;74;779;NA;90145;203;2020-11-17;8947
2020-11-16;"Trnavský kraj";187;732;32;764;NA;90145;219;2020-11-16;8744
2020-11-15;"Trnavský kraj";23;73;4;77;NA;90145;27;2020-11-15;8525
2020-11-14;"Trnavský kraj";86;397;12;409;NA;90145;98;2020-11-14;8498
2020-11-13;"Trnavský kraj";219;1312;21;1333;NA;90145;240;2020-11-13;8400
2020-11-12;"Trnavský kraj";162;420;18;438;NA;90145;180;2020-11-12;8160
2020-11-11;"Trnavský kraj";257;392;15;407;NA;90145;272;2020-11-11;7980
2020-11-10;"Trnavský kraj";189;889;30;919;NA;90145;219;2020-11-10;7708
2020-11-09;"Trnavský kraj";196;369;23;392;NA;90145;219;2020-11-09;7489
2020-11-08;"Trnavský kraj";55;400;4;404;NA;90145;59;2020-11-08;7270
2020-11-07;"Trnavský kraj";207;6070;74;6144;NA;90145;281;2020-11-07;7211
2020-11-06;"Trnavský kraj";260;1531;19;1550;NA;90145;279;2020-11-06;6930
2020-11-05;"Trnavský kraj";150;220;27;247;NA;90145;177;2020-11-05;6651
2020-11-04;"Trnavský kraj";188;212;10;222;NA;90145;198;2020-11-04;6474
2020-11-03;"Trnavský kraj";317;127;8;135;NA;90145;325;2020-11-03;6276
2020-11-02;"Trnavský kraj";281;1728;31;1759;NA;90145;312;2020-11-02;5951
2020-11-01;"Trnavský kraj";87;494;27;521;NA;90145;114;2020-11-01;5639
2020-10-31;"Trnavský kraj";259;5024;41;5065;NA;90145;300;2020-10-31;5525
2020-10-30;"Trnavský kraj";198;3784;27;3811;NA;90145;225;2020-10-30;5225
2020-10-29;"Trnavský kraj";273;1461;16;1477;NA;90145;289;2020-10-29;5000
2020-10-28;"Trnavský kraj";319;117;16;133;NA;90145;335;2020-10-28;4711
2020-10-27;"Trnavský kraj";199;461;36;497;NA;90145;235;2020-10-27;4376
2020-10-26;"Trnavský kraj";153;29;2;31;NA;90145;155;2020-10-26;4141
2020-10-25;"Trnavský kraj";95;19;1;20;NA;90145;96;2020-10-25;3986
2020-10-24;"Trnavský kraj";158;109;2;111;NA;90145;160;2020-10-24;3890
2020-10-23;"Trnavský kraj";201;89;4;93;NA;90145;205;2020-10-23;3730
2020-10-22;"Trnavský kraj";195;55;2;57;NA;90145;197;2020-10-22;3525
2020-10-21;"Trnavský kraj";134;73;3;76;NA;90145;137;2020-10-21;3328
2020-10-20;"Trnavský kraj";202;82;3;85;NA;90145;205;2020-10-20;3191
2020-10-19;"Trnavský kraj";67;55;0;55;NA;90145;67;2020-10-19;2986
2020-10-18;"Trnavský kraj";84;0;0;0;NA;90145;84;2020-10-18;2919
2020-10-17;"Trnavský kraj";123;0;0;0;NA;90145;123;2020-10-17;2835
2020-10-16;"Trnavský kraj";86;45;2;47;NA;90145;88;2020-10-16;2712
2020-10-15;"Trnavský kraj";155;66;2;68;NA;90145;157;2020-10-15;2624
2020-10-14;"Trnavský kraj";236;468;3;471;NA;90145;239;2020-10-14;2467
2020-10-13;"Trnavský kraj";138;16;2;18;NA;90145;140;2020-10-13;2228
2020-10-12;"Trnavský kraj";33;41;1;42;NA;90145;34;2020-10-12;2088
2020-10-11;"Trnavský kraj";31;0;0;0;NA;90145;31;2020-10-11;2054
2020-10-10;"Trnavský kraj";128;0;0;0;NA;90145;128;2020-10-10;2023
2020-10-09;"Trnavský kraj";156;0;0;0;NA;90145;156;2020-10-09;1895
2020-10-08;"Trnavský kraj";153;0;0;0;NA;90145;153;2020-10-08;1739
2020-10-07;"Trnavský kraj";80;0;0;0;NA;90145;80;2020-10-07;1586
2020-10-06;"Trnavský kraj";112;0;0;0;NA;90145;112;2020-10-06;1506
2020-10-05;"Trnavský kraj";33;0;0;0;NA;90145;33;2020-10-05;1394
2020-10-04;"Trnavský kraj";44;0;0;0;NA;90145;44;2020-10-04;1361
2020-10-03;"Trnavský kraj";60;0;0;0;NA;90145;60;2020-10-03;1317
2020-10-02;"Trnavský kraj";41;0;0;0;NA;90145;41;2020-10-02;1257
2020-10-01;"Trnavský kraj";53;0;0;0;NA;90145;53;2020-10-01;1216
2020-09-30;"Trnavský kraj";91;0;0;0;NA;90145;91;2020-09-30;1163
2020-09-29;"Trnavský kraj";40;0;0;0;NA;90145;40;2020-09-29;1072
2020-09-28;"Trnavský kraj";69;0;0;0;NA;90145;69;2020-09-28;1032
2020-09-27;"Trnavský kraj";30;0;0;0;NA;90145;30;2020-09-27;963
2020-09-26;"Trnavský kraj";46;0;0;0;NA;90145;46;2020-09-26;933
2020-09-25;"Trnavský kraj";32;0;0;0;NA;90145;32;2020-09-25;887
2020-09-24;"Trnavský kraj";42;0;0;0;NA;90145;42;2020-09-24;855
2020-09-23;"Trnavský kraj";43;0;0;0;NA;90145;43;2020-09-23;813
2020-09-22;"Trnavský kraj";55;0;0;0;NA;90145;55;2020-09-22;770
2020-09-21;"Trnavský kraj";41;0;0;0;NA;90145;41;2020-09-21;715
2020-09-20;"Trnavský kraj";17;0;0;0;NA;90145;17;2020-09-20;674
2020-09-19;"Trnavský kraj";4;0;0;0;NA;90145;4;2020-09-19;657
2020-09-18;"Trnavský kraj";33;0;0;0;NA;90145;33;2020-09-18;653
2020-09-17;"Trnavský kraj";42;0;0;0;NA;90145;42;2020-09-17;620
2020-09-16;"Trnavský kraj";49;0;0;0;NA;90145;49;2020-09-16;578
2020-09-15;"Trnavský kraj";5;0;0;0;NA;90145;5;2020-09-15;529
2020-09-14;"Trnavský kraj";26;0;0;0;NA;90145;26;2020-09-14;524
2020-09-13;"Trnavský kraj";9;0;0;0;NA;90145;9;2020-09-13;498
2020-09-12;"Trnavský kraj";12;0;0;0;NA;90145;12;2020-09-12;489
2020-09-11;"Trnavský kraj";16;0;0;0;NA;90145;16;2020-09-11;477
2020-09-10;"Trnavský kraj";32;0;0;0;NA;90145;32;2020-09-10;461
2020-09-09;"Trnavský kraj";14;0;0;0;NA;90145;14;2020-09-09;429
2020-09-08;"Trnavský kraj";11;0;0;0;NA;90145;11;2020-09-08;415
2020-09-07;"Trnavský kraj";7;0;0;0;NA;90145;7;2020-09-07;404
2020-09-06;"Trnavský kraj";5;0;0;0;NA;90145;5;2020-09-06;397
2020-09-05;"Trnavský kraj";7;0;0;0;NA;90145;7;2020-09-05;392
2020-09-04;"Trnavský kraj";16;0;0;0;NA;90145;16;2020-09-04;385
2020-09-03;"Trnavský kraj";8;0;0;0;NA;90145;8;2020-09-03;369
2020-09-02;"Trnavský kraj";7;0;0;0;NA;90145;7;2020-09-02;361
2020-09-01;"Trnavský kraj";1;0;0;0;NA;90145;1;2020-09-01;354
2020-08-31;"Trnavský kraj";6;0;0;0;NA;90145;6;2020-08-31;353
2020-08-30;"Trnavský kraj";1;0;0;0;NA;90145;1;2020-08-30;347
2020-08-29;"Trnavský kraj";3;0;0;0;NA;90145;3;2020-08-29;346
2020-08-28;"Trnavský kraj";14;0;0;0;NA;90145;14;2020-08-28;343
2020-08-27;"Trnavský kraj";6;0;0;0;NA;90145;6;2020-08-27;329
2020-08-26;"Trnavský kraj";4;0;0;0;NA;90145;4;2020-08-26;323
2020-08-25;"Trnavský kraj";7;0;0;0;NA;90145;7;2020-08-25;319
2020-08-24;"Trnavský kraj";1;0;0;0;NA;90145;1;2020-08-24;312
2020-08-23;"Trnavský kraj";6;0;0;0;NA;90145;6;2020-08-23;311
2020-08-22;"Trnavský kraj";3;0;0;0;NA;90145;3;2020-08-22;305
2020-08-21;"Trnavský kraj";4;0;0;0;NA;90145;4;2020-08-21;302
2020-08-20;"Trnavský kraj";23;0;0;0;NA;90145;23;2020-08-20;298
2020-08-19;"Trnavský kraj";13;0;0;0;NA;90145;13;2020-08-19;275
2020-08-18;"Trnavský kraj";20;0;0;0;NA;90145;20;2020-08-18;262
2020-08-17;"Trnavský kraj";3;0;0;0;NA;90145;3;2020-08-17;242
2020-08-16;"Trnavský kraj";0;0;0;0;NA;90145;0;2020-08-16;239
2020-08-15;"Trnavský kraj";7;0;0;0;NA;90145;7;2020-08-15;239
2020-08-14;"Trnavský kraj";6;0;0;0;NA;90145;6;2020-08-14;232
2020-08-13;"Trnavský kraj";10;0;0;0;NA;90145;10;2020-08-13;226
2020-08-12;"Trnavský kraj";2;0;0;0;NA;90145;2;2020-08-12;216
2020-08-11;"Trnavský kraj";30;0;0;0;NA;90145;30;2020-08-11;214
2020-08-10;"Trnavský kraj";0;0;0;0;NA;90145;0;2020-08-10;184
2020-08-09;"Trnavský kraj";0;0;0;0;NA;90145;0;2020-08-09;184
2020-08-08;"Trnavský kraj";13;0;0;0;NA;90145;13;2020-08-08;184
2020-08-07;"Trnavský kraj";4;0;0;0;NA;90145;4;2020-08-07;171
2020-08-06;"Trnavský kraj";4;0;0;0;NA;90145;4;2020-08-06;167
2020-08-05;"Trnavský kraj";0;0;0;0;NA;90145;0;2020-08-05;163
2020-08-04;"Trnavský kraj";1;0;0;0;NA;90145;1;2020-08-04;163
2020-08-03;"Trnavský kraj";2;0;0;0;NA;90145;2;2020-08-03;162
2020-08-02;"Trnavský kraj";1;0;0;0;NA;90145;1;2020-08-02;160
2020-08-01;"Trnavský kraj";0;0;0;0;NA;90145;0;2020-08-01;159
2020-07-31;"Trnavský kraj";7;0;0;0;NA;90145;7;2020-07-31;159
2020-07-30;"Trnavský kraj";6;0;0;0;NA;90145;6;2020-07-30;152
2020-07-29;"Trnavský kraj";0;0;0;0;NA;90145;0;2020-07-29;146
2020-07-28;"Trnavský kraj";1;0;0;0;NA;90145;1;2020-07-28;146
2020-07-27;"Trnavský kraj";2;0;0;0;NA;90145;2;2020-07-27;145
2020-07-26;"Trnavský kraj";0;0;0;0;NA;90145;0;2020-07-26;143
2020-07-25;"Trnavský kraj";0;0;0;0;NA;90145;0;2020-07-25;143
2020-07-24;"Trnavský kraj";1;0;0;0;NA;90145;1;2020-07-24;143
2020-07-23;"Trnavský kraj";2;0;0;0;NA;90145;2;2020-07-23;142
2020-07-22;"Trnavský kraj";1;0;0;0;NA;90145;1;2020-07-22;140
2020-07-21;"Trnavský kraj";2;0;0;0;NA;90145;2;2020-07-21;139
2020-07-20;"Trnavský kraj";0;0;0;0;NA;90145;0;2020-07-20;137
2020-07-19;"Trnavský kraj";0;0;0;0;NA;90145;0;2020-07-19;137
2020-07-18;"Trnavský kraj";0;0;0;0;NA;90145;0;2020-07-18;137
2020-07-17;"Trnavský kraj";0;0;0;0;NA;90145;0;2020-07-17;137
2020-07-16;"Trnavský kraj";0;0;0;0;NA;90145;0;2020-07-16;137
2020-07-15;"Trnavský kraj";1;0;0;0;NA;90145;1;2020-07-15;137
2020-07-14;"Trnavský kraj";0;0;0;0;NA;90145;0;2020-07-14;136
2020-07-13;"Trnavský kraj";0;0;0;0;NA;90145;0;2020-07-13;136
2020-07-12;"Trnavský kraj";0;0;0;0;NA;90145;0;2020-07-12;136
2020-07-11;"Trnavský kraj";0;0;0;0;NA;90145;0;2020-07-11;136
2020-07-10;"Trnavský kraj";0;0;0;0;NA;90145;0;2020-07-10;136
2020-07-09;"Trnavský kraj";0;0;0;0;NA;90145;0;2020-07-09;136
2020-07-08;"Trnavský kraj";3;0;0;0;NA;90145;3;2020-07-08;136
2020-07-07;"Trnavský kraj";4;0;0;0;NA;90145;4;2020-07-07;133
2020-07-06;"Trnavský kraj";0;0;0;0;NA;90145;0;2020-07-06;129
2020-07-05;"Trnavský kraj";0;0;0;0;NA;90145;0;2020-07-05;129
2020-07-04;"Trnavský kraj";0;0;0;0;NA;90145;0;2020-07-04;129
2020-07-03;"Trnavský kraj";0;0;0;0;NA;90145;0;2020-07-03;129
2020-07-02;"Trnavský kraj";3;0;0;0;NA;90145;3;2020-07-02;129
2020-07-01;"Trnavský kraj";0;0;0;0;NA;90145;0;2020-07-01;126
2020-06-30;"Trnavský kraj";0;0;0;0;NA;90145;0;2020-06-30;126
2020-06-29;"Trnavský kraj";0;0;0;0;NA;90145;0;2020-06-29;126
2020-06-28;"Trnavský kraj";0;0;0;0;NA;90145;0;2020-06-28;126
2020-06-27;"Trnavský kraj";0;0;0;0;NA;90145;0;2020-06-27;126
2020-06-26;"Trnavský kraj";0;0;0;0;NA;90145;0;2020-06-26;126
2020-06-25;"Trnavský kraj";0;0;0;0;NA;90145;0;2020-06-25;126
2020-06-24;"Trnavský kraj";0;0;0;0;NA;90145;0;2020-06-24;126
2020-06-23;"Trnavský kraj";0;0;0;0;NA;90145;0;2020-06-23;126
2020-06-22;"Trnavský kraj";0;0;0;0;NA;90145;0;2020-06-22;126
2020-06-21;"Trnavský kraj";0;0;0;0;NA;90145;0;2020-06-21;126
2020-06-20;"Trnavský kraj";0;0;0;0;NA;90145;0;2020-06-20;126
2020-06-19;"Trnavský kraj";0;0;0;0;NA;90145;0;2020-06-19;126
2020-06-18;"Trnavský kraj";2;0;0;0;NA;90145;2;2020-06-18;126
2020-06-17;"Trnavský kraj";0;0;0;0;NA;90145;0;2020-06-17;124
2020-06-16;"Trnavský kraj";0;0;0;0;NA;90145;0;2020-06-16;124
2020-06-14;"Trnavský kraj";0;0;0;0;NA;90145;0;2020-06-14;124
2020-06-13;"Trnavský kraj";0;0;0;0;NA;90145;0;2020-06-13;124
2020-06-12;"Trnavský kraj";0;0;0;0;NA;90145;0;2020-06-12;124
2020-06-11;"Trnavský kraj";0;0;0;0;NA;90145;0;2020-06-11;124
2020-06-10;"Trnavský kraj";0;0;0;0;NA;90145;0;2020-06-10;124
2020-06-09;"Trnavský kraj";0;0;0;0;NA;90145;0;2020-06-09;124
2020-06-08;"Trnavský kraj";0;0;0;0;NA;90145;0;2020-06-08;124
2020-06-07;"Trnavský kraj";0;0;0;0;NA;90145;0;2020-06-07;124
2020-06-05;"Trnavský kraj";0;0;0;0;NA;90145;0;2020-06-05;124
2020-06-03;"Trnavský kraj";0;0;0;0;NA;90145;0;2020-06-03;124
2020-06-02;"Trnavský kraj";0;0;0;0;NA;90145;0;2020-06-02;124
2020-05-31;"Trnavský kraj";0;0;0;0;NA;90145;0;2020-05-31;124
2020-05-29;"Trnavský kraj";0;0;0;0;NA;90145;0;2020-05-29;124
2020-05-27;"Trnavský kraj";0;0;0;0;NA;90145;0;2020-05-27;124
2020-05-26;"Trnavský kraj";0;0;0;0;NA;90145;0;2020-05-26;124
2020-05-25;"Trnavský kraj";1;0;0;0;NA;90145;1;2020-05-25;124
2020-05-24;"Trnavský kraj";0;0;0;0;NA;90145;0;2020-05-24;123
2020-05-23;"Trnavský kraj";2;0;0;0;NA;90145;2;2020-05-23;123
2020-05-22;"Trnavský kraj";0;0;0;0;NA;90145;0;2020-05-22;121
2020-05-21;"Trnavský kraj";0;0;0;0;NA;90145;0;2020-05-21;121
2020-05-20;"Trnavský kraj";2;0;0;0;NA;90145;2;2020-05-20;121
2020-05-19;"Trnavský kraj";0;0;0;0;NA;90145;0;2020-05-19;119
2020-05-17;"Trnavský kraj";0;0;0;0;NA;90145;0;2020-05-17;119
2020-05-16;"Trnavský kraj";0;0;0;0;NA;90145;0;2020-05-16;119
2020-05-15;"Trnavský kraj";1;0;0;0;NA;90145;1;2020-05-15;119
2020-05-14;"Trnavský kraj";0;0;0;0;NA;90145;0;2020-05-14;118
2020-05-13;"Trnavský kraj";0;0;0;0;NA;90145;0;2020-05-13;118
2020-05-12;"Trnavský kraj";0;0;0;0;NA;90145;0;2020-05-12;118
2020-05-11;"Trnavský kraj";2;0;0;0;NA;90145;2;2020-05-11;118
2020-05-09;"Trnavský kraj";0;0;0;0;NA;90145;0;2020-05-09;116
2020-05-07;"Trnavský kraj";0;0;0;0;NA;90145;0;2020-05-07;116
2020-05-06;"Trnavský kraj";0;0;0;0;NA;90145;0;2020-05-06;116
2020-05-05;"Trnavský kraj";0;0;0;0;NA;90145;0;2020-05-05;116
2020-05-04;"Trnavský kraj";0;0;0;0;NA;90145;0;2020-05-04;116
2020-05-03;"Trnavský kraj";0;0;0;0;NA;90145;0;2020-05-03;116
2020-05-02;"Trnavský kraj";0;0;0;0;NA;90145;0;2020-05-02;116
2020-05-01;"Trnavský kraj";0;0;0;0;NA;90145;0;2020-05-01;116
2020-04-30;"Trnavský kraj";0;0;0;0;NA;90145;0;2020-04-30;116
2020-04-29;"Trnavský kraj";0;0;0;0;NA;90145;0;2020-04-29;116
2020-04-28;"Trnavský kraj";1;0;0;0;NA;90145;1;2020-04-28;116
2020-04-27;"Trnavský kraj";0;0;0;0;NA;90145;0;2020-04-27;115
2020-04-26;"Trnavský kraj";0;0;0;0;NA;90145;0;2020-04-26;115
2020-04-25;"Trnavský kraj";2;0;0;0;NA;90145;2;2020-04-25;115
2020-04-24;"Trnavský kraj";4;0;0;0;NA;90145;4;2020-04-24;113
2020-04-23;"Trnavský kraj";5;0;0;0;NA;90145;5;2020-04-23;109
2020-04-22;"Trnavský kraj";10;0;0;0;NA;90145;10;2020-04-22;104
2020-04-21;"Trnavský kraj";5;0;0;0;NA;90145;5;2020-04-21;94
2020-04-20;"Trnavský kraj";0;0;0;0;NA;90145;0;2020-04-20;89
2020-04-19;"Trnavský kraj";1;0;0;0;NA;90145;1;2020-04-19;89
2020-04-18;"Trnavský kraj";4;0;0;0;NA;90145;4;2020-04-18;88
2020-04-17;"Trnavský kraj";7;0;0;0;NA;90145;7;2020-04-17;84
2020-04-16;"Trnavský kraj";5;0;0;0;NA;90145;5;2020-04-16;77
2020-04-15;"Trnavský kraj";5;0;0;0;NA;90145;5;2020-04-15;72
2020-04-14;"Trnavský kraj";1;0;0;0;NA;90145;1;2020-04-14;67
2020-04-13;"Trnavský kraj";0;0;0;0;NA;90145;0;2020-04-13;66
2020-04-12;"Trnavský kraj";0;0;0;0;NA;90145;0;2020-04-12;66
2020-04-11;"Trnavský kraj";0;0;0;0;NA;90145;0;2020-04-11;66
2020-04-10;"Trnavský kraj";2;0;0;0;NA;90145;2;2020-04-10;66
2020-04-09;"Trnavský kraj";3;0;0;0;NA;90145;3;2020-04-09;64
2020-04-08;"Trnavský kraj";4;0;0;0;NA;90145;4;2020-04-08;61
2020-04-07;"Trnavský kraj";6;0;0;0;NA;90145;6;2020-04-07;57
2020-04-06;"Trnavský kraj";6;0;0;0;NA;90145;6;2020-04-06;51
2020-04-05;"Trnavský kraj";1;0;0;0;NA;90145;1;2020-04-05;45
2020-04-04;"Trnavský kraj";1;0;0;0;NA;90145;1;2020-04-04;44
2020-04-03;"Trnavský kraj";3;0;0;0;NA;90145;3;2020-04-03;43
2020-04-02;"Trnavský kraj";4;0;0;0;NA;90145;4;2020-04-02;40
2020-04-01;"Trnavský kraj";0;0;0;0;NA;90145;0;2020-04-01;36
2020-03-31;"Trnavský kraj";3;0;0;0;NA;90145;3;2020-03-31;36
2020-03-30;"Trnavský kraj";4;0;0;0;NA;90145;4;2020-03-30;33
2020-03-29;"Trnavský kraj";1;0;0;0;NA;90145;1;2020-03-29;29
2020-03-28;"Trnavský kraj";3;0;0;0;NA;90145;3;2020-03-28;28
2020-03-27;"Trnavský kraj";5;0;0;0;NA;90145;5;2020-03-27;25
2020-03-26;"Trnavský kraj";5;0;0;0;NA;90145;5;2020-03-26;20
2020-03-25;"Trnavský kraj";1;0;0;0;NA;90145;1;2020-03-25;15
2020-03-24;"Trnavský kraj";0;0;0;0;NA;90145;0;2020-03-24;14
2020-03-23;"Trnavský kraj";2;0;0;0;NA;90145;2;2020-03-23;14
2020-03-22;"Trnavský kraj";1;0;0;0;NA;90145;1;2020-03-22;12
2020-03-21;"Trnavský kraj";5;0;0;0;NA;90145;5;2020-03-21;11
2020-03-20;"Trnavský kraj";0;0;0;0;NA;90145;0;2020-03-20;6
2020-03-19;"Trnavský kraj";0;0;0;0;NA;90145;0;2020-03-19;6
2020-03-18;"Trnavský kraj";0;0;0;0;NA;90145;0;2020-03-18;6
2020-03-17;"Trnavský kraj";3;0;0;0;NA;90145;3;2020-03-17;6
2020-03-16;"Trnavský kraj";1;0;0;0;NA;90145;1;2020-03-16;3
2020-03-15;"Trnavský kraj";0;0;0;0;NA;90145;0;2020-03-15;2
2020-03-14;"Trnavský kraj";0;0;0;0;NA;90145;0;2020-03-14;2
2020-03-13;"Trnavský kraj";1;0;0;0;NA;90145;1;2020-03-13;2
2020-03-12;"Trnavský kraj";1;0;0;0;NA;90145;1;2020-03-12;1
2020-03-11;"Trnavský kraj";0;0;0;0;NA;90145;0;2020-03-11;0
2020-03-09;"Trnavský kraj";0;0;0;0;NA;90145;0;2020-03-09;0
2020-03-08;"Trnavský kraj";0;0;0;0;NA;90145;0;2020-03-08;0
2020-03-07;"Trnavský kraj";0;0;0;0;NA;90145;0;2020-03-07;0
2020-03-06;"Trnavský kraj";0;0;0;0;NA;90145;0;2020-03-06;0
2021-07-11;"Žilinský kraj";2;562;0;562;57989;108584;2;2021-07-11;108584
2021-07-10;"Žilinský kraj";1;1088;0;1088;NA;108584;1;2021-07-10;108582
2021-07-09;"Žilinský kraj";1;1911;1;1912;NA;108584;2;2021-07-09;108581
2021-07-08;"Žilinský kraj";6;1586;3;1589;NA;108584;9;2021-07-08;108579
2021-07-07;"Žilinský kraj";1;1394;3;1397;NA;108584;4;2021-07-07;108570
2021-07-06;"Žilinský kraj";4;1809;0;1809;NA;108584;4;2021-07-06;108566
2021-07-05;"Žilinský kraj";2;853;1;854;NA;108584;3;2021-07-05;108562
2021-07-04;"Žilinský kraj";0;921;0;921;NA;108584;0;2021-07-04;108559
2021-07-03;"Žilinský kraj";1;1345;1;1346;NA;108584;2;2021-07-03;108559
2021-07-02;"Žilinský kraj";0;3327;3;3330;NA;108584;3;2021-07-02;108557
2021-07-01;"Žilinský kraj";1;1070;0;1070;NA;108584;1;2021-07-01;108554
2021-06-30;"Žilinský kraj";1;9372;5;9377;NA;108584;6;2021-06-30;108553
2021-06-29;"Žilinský kraj";10;5917;0;5917;NA;108584;10;2021-06-29;108547
2021-06-28;"Žilinský kraj";4;5640;1;5641;NA;108584;5;2021-06-28;108537
2021-06-27;"Žilinský kraj";3;4349;1;4350;NA;108584;4;2021-06-27;108532
2021-06-26;"Žilinský kraj";4;5312;0;5312;NA;108584;4;2021-06-26;108528
2021-06-25;"Žilinský kraj";8;8924;5;8929;NA;108584;13;2021-06-25;108524
2021-06-24;"Žilinský kraj";6;5352;2;5354;NA;108584;8;2021-06-24;108511
2021-06-23;"Žilinský kraj";7;5217;10;5227;NA;108584;17;2021-06-23;108503
2021-06-22;"Žilinský kraj";6;4628;6;4634;NA;108584;12;2021-06-22;108486
2021-06-21;"Žilinský kraj";6;5364;8;5372;NA;108584;14;2021-06-21;108474
2021-06-20;"Žilinský kraj";1;5305;5;5310;NA;108584;6;2021-06-20;108460
2021-06-19;"Žilinský kraj";9;7183;2;7185;NA;108584;11;2021-06-19;108454
2021-06-18;"Žilinský kraj";11;9309;12;9321;NA;108584;23;2021-06-18;108443
2021-06-17;"Žilinský kraj";10;5326;11;5337;NA;108584;21;2021-06-17;108420
2021-06-16;"Žilinský kraj";17;5043;10;5053;NA;108584;27;2021-06-16;108399
2021-06-15;"Žilinský kraj";13;5546;12;5558;NA;108584;25;2021-06-15;108372
2021-06-14;"Žilinský kraj";10;6711;16;6727;NA;108584;26;2021-06-14;108347
2021-06-13;"Žilinský kraj";2;6137;8;6145;NA;108584;10;2021-06-13;108321
2021-06-12;"Žilinský kraj";9;7511;8;7519;NA;108584;17;2021-06-12;108311
2021-06-11;"Žilinský kraj";11;10370;12;10382;NA;108584;23;2021-06-11;108294
2021-06-10;"Žilinský kraj";14;6185;10;6195;NA;108584;24;2021-06-10;108271
2021-06-09;"Žilinský kraj";23;5222;10;5232;NA;108584;33;2021-06-09;108247
2021-06-08;"Žilinský kraj";18;6170;15;6185;NA;108584;33;2021-06-08;108214
2021-06-07;"Žilinský kraj";25;7606;20;7626;NA;108584;45;2021-06-07;108181
2021-06-06;"Žilinský kraj";10;7522;25;7547;NA;108584;35;2021-06-06;108136
2021-06-05;"Žilinský kraj";8;8036;9;8045;NA;108584;17;2021-06-05;108101
2021-06-04;"Žilinský kraj";19;11033;26;11059;NA;108584;45;2021-06-04;108084
2021-06-03;"Žilinský kraj";12;6094;30;6124;NA;108584;42;2021-06-03;108039
2021-06-02;"Žilinský kraj";17;6900;28;6928;NA;108584;45;2021-06-02;107997
2021-06-01;"Žilinský kraj";38;7671;42;7713;NA;108584;80;2021-06-01;107952
2021-05-31;"Žilinský kraj";31;8534;55;8589;NA;108584;86;2021-05-31;107872
2021-05-30;"Žilinský kraj";21;8533;30;8563;NA;108584;51;2021-05-30;107786
2021-05-29;"Žilinský kraj";13;9956;18;9974;NA;108584;31;2021-05-29;107735
2021-05-28;"Žilinský kraj";28;12113;30;12143;NA;108584;58;2021-05-28;107704
2021-05-27;"Žilinský kraj";17;8267;39;8306;NA;108584;56;2021-05-27;107646
2021-05-26;"Žilinský kraj";20;7324;21;7345;NA;108584;41;2021-05-26;107590
2021-05-25;"Žilinský kraj";21;9027;36;9063;NA;108584;57;2021-05-25;107549
2021-05-24;"Žilinský kraj";36;11437;57;11494;NA;108584;93;2021-05-24;107492
2021-05-23;"Žilinský kraj";4;10300;52;10352;NA;108584;56;2021-05-23;107399
2021-05-22;"Žilinský kraj";21;10580;26;10606;NA;108584;47;2021-05-22;107343
2021-05-21;"Žilinský kraj";28;14377;46;14423;NA;108584;74;2021-05-21;107296
2021-05-20;"Žilinský kraj";30;8544;30;8574;NA;108584;60;2021-05-20;107222
2021-05-19;"Žilinský kraj";46;8010;40;8050;NA;108584;86;2021-05-19;107162
2021-05-18;"Žilinský kraj";52;10365;43;10408;NA;108584;95;2021-05-18;107076
2021-05-17;"Žilinský kraj";51;11859;77;11936;NA;108584;128;2021-05-17;106981
2021-05-16;"Žilinský kraj";13;13429;37;13466;NA;108584;50;2021-05-16;106853
2021-05-15;"Žilinský kraj";30;16589;32;16621;NA;108584;62;2021-05-15;106803
2021-05-14;"Žilinský kraj";34;19200;72;19272;NA;108584;106;2021-05-14;106741
2021-05-13;"Žilinský kraj";64;11865;51;11916;NA;108584;115;2021-05-13;106635
2021-05-12;"Žilinský kraj";57;10337;51;10388;NA;108584;108;2021-05-12;106520
2021-05-11;"Žilinský kraj";70;11601;48;11649;NA;108584;118;2021-05-11;106412
2021-05-10;"Žilinský kraj";69;14664;70;14734;NA;108584;139;2021-05-10;106294
2021-05-09;"Žilinský kraj";58;19295;72;19367;NA;108584;130;2021-05-09;106155
2021-05-08;"Žilinský kraj";0;22132;58;22190;NA;108584;58;2021-05-08;106025
2021-05-07;"Žilinský kraj";65;23787;78;23865;NA;108584;143;2021-05-07;105967
2021-05-06;"Žilinský kraj";67;16605;72;16677;NA;108584;139;2021-05-06;105824
2021-05-05;"Žilinský kraj";71;12152;71;12223;NA;108584;142;2021-05-05;105685
2021-05-04;"Žilinský kraj";81;16309;79;16388;NA;108584;160;2021-05-04;105543
2021-05-03;"Žilinský kraj";97;19768;110;19878;NA;108584;207;2021-05-03;105383
2021-05-02;"Žilinský kraj";8;28886;64;28950;NA;108584;72;2021-05-02;105176
2021-05-01;"Žilinský kraj";65;54670;103;54773;NA;108584;168;2021-05-01;105104
2021-04-30;"Žilinský kraj";84;43812;117;43929;NA;108584;201;2021-04-30;104936
2021-04-29;"Žilinský kraj";77;24553;101;24654;NA;108584;178;2021-04-29;104735
2021-04-28;"Žilinský kraj";76;19205;91;19296;NA;108584;167;2021-04-28;104557
2021-04-27;"Žilinský kraj";97;21795;110;21905;NA;108584;207;2021-04-27;104390
2021-04-26;"Žilinský kraj";114;27412;136;27548;NA;108584;250;2021-04-26;104183
2021-04-25;"Žilinský kraj";38;35750;82;35832;NA;108584;120;2021-04-25;103933
2021-04-24;"Žilinský kraj";93;78854;157;79011;NA;108584;250;2021-04-24;103813
2021-04-23;"Žilinský kraj";144;49219;153;49372;NA;108584;297;2021-04-23;103563
2021-04-22;"Žilinský kraj";110;25209;132;25341;NA;108584;242;2021-04-22;103266
2021-04-21;"Žilinský kraj";118;20616;145;20761;NA;108584;263;2021-04-21;103024
2021-04-20;"Žilinský kraj";128;23778;136;23914;NA;108584;264;2021-04-20;102761
2021-04-19;"Žilinský kraj";164;32773;210;32983;NA;108584;374;2021-04-19;102497
2021-04-18;"Žilinský kraj";18;36767;91;36858;NA;108584;109;2021-04-18;102123
2021-04-17;"Žilinský kraj";108;89377;156;89533;NA;108584;264;2021-04-17;102014
2021-04-16;"Žilinský kraj";185;46876;207;47083;NA;108584;392;2021-04-16;101750
2021-04-15;"Žilinský kraj";108;24825;130;24955;NA;108584;238;2021-04-15;101358
2021-04-14;"Žilinský kraj";135;23108;145;23253;NA;108584;280;2021-04-14;101120
2021-04-13;"Žilinský kraj";171;25050;135;25185;NA;108584;306;2021-04-13;100840
2021-04-12;"Žilinský kraj";266;30726;189;30915;NA;108584;455;2021-04-12;100534
2021-04-11;"Žilinský kraj";19;37126;107;37233;NA;108584;126;2021-04-11;100079
2021-04-10;"Žilinský kraj";111;86284;237;86521;NA;108584;348;2021-04-10;99953
2021-04-09;"Žilinský kraj";195;41752;205;41957;NA;108584;400;2021-04-09;99605
2021-04-08;"Žilinský kraj";179;24382;141;24523;NA;108584;320;2021-04-08;99205
2021-04-07;"Žilinský kraj";309;28651;174;28825;NA;108584;483;2021-04-07;98885
2021-04-06;"Žilinský kraj";308;38818;294;39112;NA;108584;602;2021-04-06;98402
2021-04-05;"Žilinský kraj";17;14747;140;14887;NA;108584;157;2021-04-05;97800
2021-04-04;"Žilinský kraj";17;16284;69;16353;NA;108584;86;2021-04-04;97643
2021-04-03;"Žilinský kraj";180;100430;401;100831;NA;108584;581;2021-04-03;97557
2021-04-02;"Žilinský kraj";73;22411;83;22494;NA;108584;156;2021-04-02;96976
2021-04-01;"Žilinský kraj";334;43264;240;43504;NA;108584;574;2021-04-01;96820
2021-03-31;"Žilinský kraj";170;31632;247;31879;NA;108584;417;2021-03-31;96246
2021-03-30;"Žilinský kraj";406;26323;243;26566;NA;108584;649;2021-03-30;95829
2021-03-29;"Žilinský kraj";297;28022;268;28290;NA;108584;565;2021-03-29;95180
2021-03-28;"Žilinský kraj";21;36206;239;36445;NA;108584;260;2021-03-28;94615
2021-03-27;"Žilinský kraj";151;89107;353;89460;NA;108584;504;2021-03-27;94355
2021-03-26;"Žilinský kraj";312;51705;330;52035;NA;108584;642;2021-03-26;93851
2021-03-25;"Žilinský kraj";281;27620;214;27834;NA;108584;495;2021-03-25;93209
2021-03-24;"Žilinský kraj";280;21268;260;21528;NA;108584;540;2021-03-24;92714
2021-03-23;"Žilinský kraj";418;23187;278;23465;NA;108584;696;2021-03-23;92174
2021-03-22;"Žilinský kraj";293;29289;314;29603;NA;108584;607;2021-03-22;91478
2021-03-21;"Žilinský kraj";32;33705;227;33932;NA;108584;259;2021-03-21;90871
2021-03-20;"Žilinský kraj";165;93015;497;93512;NA;108584;662;2021-03-20;90612
2021-03-19;"Žilinský kraj";357;51982;413;52395;NA;108584;770;2021-03-19;89950
2021-03-18;"Žilinský kraj";329;28451;294;28745;NA;108584;623;2021-03-18;89180
2021-03-17;"Žilinský kraj";395;21916;269;22185;NA;108584;664;2021-03-17;88557
2021-03-16;"Žilinský kraj";514;24341;317;24658;NA;108584;831;2021-03-16;87893
2021-03-15;"Žilinský kraj";341;29607;419;30026;NA;108584;760;2021-03-15;87062
2021-03-14;"Žilinský kraj";87;34121;267;34388;NA;108584;354;2021-03-14;86302
2021-03-13;"Žilinský kraj";113;93386;581;93967;NA;108584;694;2021-03-13;85948
2021-03-12;"Žilinský kraj";520;52109;411;52520;NA;108584;931;2021-03-12;85254
2021-03-11;"Žilinský kraj";399;28189;302;28491;NA;108584;701;2021-03-11;84323
2021-03-10;"Žilinský kraj";368;22414;378;22792;NA;108584;746;2021-03-10;83622
2021-03-09;"Žilinský kraj";537;24857;316;25173;NA;108584;853;2021-03-09;82876
2021-03-08;"Žilinský kraj";387;30839;458;31297;NA;108584;845;2021-03-08;82023
2021-03-07;"Žilinský kraj";48;33469;290;33759;NA;108584;338;2021-03-07;81178
2021-03-06;"Žilinský kraj";173;92410;589;92999;NA;108584;762;2021-03-06;80840
2021-03-05;"Žilinský kraj";369;51748;483;52231;NA;108584;852;2021-03-05;80078
2021-03-04;"Žilinský kraj";467;30036;377;30413;NA;108584;844;2021-03-04;79226
2021-03-03;"Žilinský kraj";448;26261;394;26655;NA;108584;842;2021-03-03;78382
2021-03-02;"Žilinský kraj";551;25908;378;26286;NA;108584;929;2021-03-02;77540
2021-03-01;"Žilinský kraj";375;30493;441;30934;NA;108584;816;2021-03-01;76611
2021-02-28;"Žilinský kraj";61;34802;327;35129;NA;108584;388;2021-02-28;75795
2021-02-27;"Žilinský kraj";159;83781;639;84420;NA;108584;798;2021-02-27;75407
2021-02-26;"Žilinský kraj";459;47494;508;48002;NA;108584;967;2021-02-26;74609
2021-02-25;"Žilinský kraj";347;30879;393;31272;NA;108584;740;2021-02-25;73642
2021-02-24;"Žilinský kraj";339;18745;395;19140;NA;108584;734;2021-02-24;72902
2021-02-23;"Žilinský kraj";437;22172;418;22590;NA;108584;855;2021-02-23;72168
2021-02-22;"Žilinský kraj";345;29240;438;29678;NA;108584;783;2021-02-22;71313
2021-02-21;"Žilinský kraj";36;28686;322;29008;NA;108584;358;2021-02-21;70530
2021-02-20;"Žilinský kraj";152;89085;669;89754;NA;108584;821;2021-02-20;70172
2021-02-19;"Žilinský kraj";337;44804;415;45219;NA;108584;752;2021-02-19;69351
2021-02-18;"Žilinský kraj";263;24679;339;25018;NA;108584;602;2021-02-18;68599
2021-02-17;"Žilinský kraj";269;17932;355;18287;NA;108584;624;2021-02-17;67997
2021-02-16;"Žilinský kraj";321;24298;325;24623;NA;108584;646;2021-02-16;67373
2021-02-15;"Žilinský kraj";230;30420;311;30731;NA;108584;541;2021-02-15;66727
2021-02-14;"Žilinský kraj";30;28574;231;28805;NA;108584;261;2021-02-14;66186
2021-02-13;"Žilinský kraj";91;69638;453;70091;NA;108584;544;2021-02-13;65925
2021-02-12;"Žilinský kraj";242;42689;335;43024;NA;108584;577;2021-02-12;65381
2021-02-11;"Žilinský kraj";228;23521;300;23821;NA;108584;528;2021-02-11;64804
2021-02-10;"Žilinský kraj";259;17875;267;18142;NA;108584;526;2021-02-10;64276
2021-02-09;"Žilinský kraj";377;24784;274;25058;NA;108584;651;2021-02-09;63750
2021-02-08;"Žilinský kraj";160;41375;390;41765;NA;108584;550;2021-02-08;63099
2021-02-07;"Žilinský kraj";24;46446;252;46698;NA;108584;276;2021-02-07;62549
2021-02-06;"Žilinský kraj";71;72880;367;73247;NA;108584;438;2021-02-06;62273
2021-02-05;"Žilinský kraj";248;31868;323;32191;NA;108584;571;2021-02-05;61835
2021-02-04;"Žilinský kraj";238;13242;258;13500;NA;108584;496;2021-02-04;61264
2021-02-03;"Žilinský kraj";194;9187;255;9442;NA;108584;449;2021-02-03;60768
2021-02-02;"Žilinský kraj";216;9280;272;9552;NA;108584;488;2021-02-02;60319
2021-02-01;"Žilinský kraj";220;19688;370;20058;NA;108584;590;2021-02-01;59831
2021-01-31;"Žilinský kraj";11;2652;27;2679;NA;108584;38;2021-01-31;59241
2021-01-30;"Žilinský kraj";85;18447;187;18634;NA;108584;272;2021-01-30;59203
2021-01-29;"Žilinský kraj";209;22891;304;23195;NA;108584;513;2021-01-29;58931
2021-01-28;"Žilinský kraj";240;5533;172;5705;NA;108584;412;2021-01-28;58418
2021-01-27;"Žilinský kraj";256;7065;121;7186;NA;108584;377;2021-01-27;58006
2021-01-26;"Žilinský kraj";245;49441;346;49787;NA;108584;591;2021-01-26;57629
2021-01-25;"Žilinský kraj";159;21147;150;21297;NA;108584;309;2021-01-25;57038
2021-01-24;"Žilinský kraj";22;67309;305;67614;NA;108584;327;2021-01-24;56729
2021-01-23;"Žilinský kraj";91;90991;408;91399;NA;108584;499;2021-01-23;56402
2021-01-22;"Žilinský kraj";163;31991;239;32230;NA;108584;402;2021-01-22;55903
2021-01-21;"Žilinský kraj";116;19874;181;20055;NA;108584;297;2021-01-21;55501
2021-01-20;"Žilinský kraj";236;17089;165;17254;NA;108584;401;2021-01-20;55204
2021-01-19;"Žilinský kraj";245;15578;283;15861;NA;108584;528;2021-01-19;54803
2021-01-18;"Žilinský kraj";236;12216;319;12535;NA;108584;555;2021-01-18;54275
2021-01-17;"Žilinský kraj";95;147;8;155;NA;108584;103;2021-01-17;53720
2021-01-16;"Žilinský kraj";14;758;35;793;NA;108584;49;2021-01-16;53617
2021-01-15;"Žilinský kraj";248;7244;205;7449;NA;108584;453;2021-01-15;53568
2021-01-14;"Žilinský kraj";166;5572;248;5820;NA;108584;414;2021-01-14;53115
2021-01-13;"Žilinský kraj";247;11304;554;11858;NA;108584;801;2021-01-13;52701
2021-01-12;"Žilinský kraj";376;8754;413;9167;NA;108584;789;2021-01-12;51900
2021-01-11;"Žilinský kraj";351;10385;513;10898;NA;108584;864;2021-01-11;51111
2021-01-10;"Žilinský kraj";38;229;6;235;NA;108584;44;2021-01-10;50247
2021-01-09;"Žilinský kraj";192;1983;85;2068;NA;108584;277;2021-01-09;50203
2021-01-08;"Žilinský kraj";413;9245;497;9742;NA;108584;910;2021-01-08;49926
2021-01-07;"Žilinský kraj";438;23485;1881;25366;NA;108584;2319;2021-01-07;49016
2021-01-06;"Žilinský kraj";145;1412;96;1508;NA;108584;241;2021-01-06;46697
2021-01-05;"Žilinský kraj";717;10702;845;11547;NA;108584;1562;2021-01-05;46456
2021-01-04;"Žilinský kraj";479;9739;1012;10751;NA;108584;1491;2021-01-04;44894
2021-01-03;"Žilinský kraj";13;1006;107;1113;NA;108584;120;2021-01-03;43403
2021-01-02;"Žilinský kraj";98;789;91;880;NA;108584;189;2021-01-02;43283
2021-01-01;"Žilinský kraj";118;615;37;652;NA;108584;155;2021-01-01;43094
2020-12-31;"Žilinský kraj";395;10008;809;10817;NA;108584;1204;2020-12-31;42939
2020-12-30;"Žilinský kraj";1038;12030;849;12879;NA;108584;1887;2020-12-30;41735
2020-12-29;"Žilinský kraj";256;10584;1041;11625;NA;108584;1297;2020-12-29;39848
2020-12-28;"Žilinský kraj";406;11177;1048;12225;NA;108584;1454;2020-12-28;38551
2020-12-27;"Žilinský kraj";40;684;94;778;NA;108584;134;2020-12-27;37097
2020-12-26;"Žilinský kraj";135;593;48;641;NA;108584;183;2020-12-26;36963
2020-12-25;"Žilinský kraj";66;83;9;92;NA;108584;75;2020-12-25;36780
2020-12-24;"Žilinský kraj";643;1060;80;1140;NA;108584;723;2020-12-24;36705
2020-12-23;"Žilinský kraj";228;17281;1031;18312;NA;108584;1259;2020-12-23;35982
2020-12-22;"Žilinský kraj";519;13746;1031;14777;NA;108584;1550;2020-12-22;34723
2020-12-21;"Žilinský kraj";444;12608;1096;13704;NA;108584;1540;2020-12-21;33173
2020-12-20;"Žilinský kraj";36;598;80;678;NA;108584;116;2020-12-20;31633
2020-12-19;"Žilinský kraj";208;2076;145;2221;NA;108584;353;2020-12-19;31517
2020-12-18;"Žilinský kraj";333;6925;400;7325;NA;108584;733;2020-12-18;31164
2020-12-17;"Žilinský kraj";500;4243;279;4522;NA;108584;779;2020-12-17;30431
2020-12-16;"Žilinský kraj";333;3999;280;4279;NA;108584;613;2020-12-16;29652
2020-12-15;"Žilinský kraj";528;4139;378;4517;NA;108584;906;2020-12-15;29039
2020-12-14;"Žilinský kraj";321;4300;355;4655;NA;108584;676;2020-12-14;28133
2020-12-13;"Žilinský kraj";26;494;66;560;NA;108584;92;2020-12-13;27457
2020-12-12;"Žilinský kraj";95;1116;61;1177;NA;108584;156;2020-12-12;27365
2020-12-11;"Žilinský kraj";455;4507;269;4776;NA;108584;724;2020-12-11;27209
2020-12-10;"Žilinský kraj";166;9341;838;10179;NA;108584;1004;2020-12-10;26485
2020-12-09;"Žilinský kraj";392;2200;131;2331;NA;108584;523;2020-12-09;25481
2020-12-08;"Žilinský kraj";331;3248;123;3371;NA;108584;454;2020-12-08;24958
2020-12-07;"Žilinský kraj";348;2254;127;2381;NA;108584;475;2020-12-07;24504
2020-12-06;"Žilinský kraj";15;128;6;134;NA;108584;21;2020-12-06;24029
2020-12-05;"Žilinský kraj";98;1500;53;1553;NA;108584;151;2020-12-05;24008
2020-12-04;"Žilinský kraj";228;2891;122;3013;NA;108584;350;2020-12-04;23857
2020-12-03;"Žilinský kraj";237;1424;117;1541;NA;108584;354;2020-12-03;23507
2020-12-02;"Žilinský kraj";181;1396;69;1465;NA;108584;250;2020-12-02;23153
2020-12-01;"Žilinský kraj";209;6239;284;6523;NA;108584;493;2020-12-01;22903
2020-11-30;"Žilinský kraj";203;5326;305;5631;NA;108584;508;2020-11-30;22410
2020-11-29;"Žilinský kraj";18;81;7;88;NA;108584;25;2020-11-29;21902
2020-11-28;"Žilinský kraj";99;349;15;364;NA;108584;114;2020-11-28;21877
2020-11-27;"Žilinský kraj";218;904;46;950;NA;108584;264;2020-11-27;21763
2020-11-26;"Žilinský kraj";190;1041;54;1095;NA;108584;244;2020-11-26;21499
2020-11-25;"Žilinský kraj";225;1217;49;1266;NA;108584;274;2020-11-25;21255
2020-11-24;"Žilinský kraj";213;2139;67;2206;NA;108584;280;2020-11-24;20981
2020-11-23;"Žilinský kraj";170;759;44;803;NA;108584;214;2020-11-23;20701
2020-11-22;"Žilinský kraj";11;67;2;69;NA;108584;13;2020-11-22;20487
2020-11-21;"Žilinský kraj";61;505;20;525;NA;108584;81;2020-11-21;20474
2020-11-20;"Žilinský kraj";251;1074;45;1119;NA;108584;296;2020-11-20;20393
2020-11-19;"Žilinský kraj";252;752;61;813;NA;108584;313;2020-11-19;20097
2020-11-18;"Žilinský kraj";346;348;15;363;NA;108584;361;2020-11-18;19784
2020-11-17;"Žilinský kraj";123;490;15;505;NA;108584;138;2020-11-17;19423
2020-11-16;"Žilinský kraj";227;247;15;262;NA;108584;242;2020-11-16;19285
2020-11-15;"Žilinský kraj";63;13;0;13;NA;108584;63;2020-11-15;19043
2020-11-14;"Žilinský kraj";189;1038;11;1049;NA;108584;200;2020-11-14;18980
2020-11-13;"Žilinský kraj";181;125;9;134;NA;108584;190;2020-11-13;18780
2020-11-12;"Žilinský kraj";334;79;2;81;NA;108584;336;2020-11-12;18590
2020-11-11;"Žilinský kraj";489;147;10;157;NA;108584;499;2020-11-11;18254
2020-11-10;"Žilinský kraj";374;519;9;528;NA;108584;383;2020-11-10;17755
2020-11-09;"Žilinský kraj";143;2335;30;2365;NA;108584;173;2020-11-09;17372
2020-11-08;"Žilinský kraj";59;2538;37;2575;NA;108584;96;2020-11-08;17199
2020-11-07;"Žilinský kraj";312;8175;88;8263;NA;108584;400;2020-11-07;17103
2020-11-06;"Žilinský kraj";503;4090;38;4128;NA;108584;541;2020-11-06;16703
2020-11-05;"Žilinský kraj";473;64;4;68;NA;108584;477;2020-11-05;16162
2020-11-04;"Žilinský kraj";423;178;10;188;NA;108584;433;2020-11-04;15685
2020-11-03;"Žilinský kraj";688;889;16;905;NA;108584;704;2020-11-03;15252
2020-11-02;"Žilinský kraj";472;1043;39;1082;NA;108584;511;2020-11-02;14548
2020-11-01;"Žilinský kraj";349;5096;130;5226;NA;108584;479;2020-11-01;14037
2020-10-31;"Žilinský kraj";661;7963;203;8166;NA;108584;864;2020-10-31;13558
2020-10-30;"Žilinský kraj";529;2575;61;2636;NA;108584;590;2020-10-30;12694
2020-10-29;"Žilinský kraj";740;503;17;520;NA;108584;757;2020-10-29;12104
2020-10-28;"Žilinský kraj";635;105;11;116;NA;108584;646;2020-10-28;11347
2020-10-27;"Žilinský kraj";355;154;24;178;NA;108584;379;2020-10-27;10701
2020-10-26;"Žilinský kraj";148;117;28;145;NA;108584;176;2020-10-26;10322
2020-10-25;"Žilinský kraj";436;0;0;0;NA;108584;436;2020-10-25;10146
2020-10-24;"Žilinský kraj";803;0;0;0;NA;108584;803;2020-10-24;9710
2020-10-23;"Žilinský kraj";659;102;13;115;NA;108584;672;2020-10-23;8907
2020-10-22;"Žilinský kraj";525;33;3;36;NA;108584;528;2020-10-22;8235
2020-10-21;"Žilinský kraj";478;74;14;88;NA;108584;492;2020-10-21;7707
2020-10-20;"Žilinský kraj";524;127;8;135;NA;108584;532;2020-10-20;7215
2020-10-19;"Žilinský kraj";70;80;12;92;NA;108584;82;2020-10-19;6683
2020-10-18;"Žilinský kraj";159;0;0;0;NA;108584;159;2020-10-18;6601
2020-10-17;"Žilinský kraj";509;0;0;0;NA;108584;509;2020-10-17;6442
2020-10-16;"Žilinský kraj";603;51;9;60;NA;108584;612;2020-10-16;5933
2020-10-15;"Žilinský kraj";679;61;3;64;NA;108584;682;2020-10-15;5321
2020-10-14;"Žilinský kraj";523;269;6;275;NA;108584;529;2020-10-14;4639
2020-10-13;"Žilinský kraj";367;458;40;498;NA;108584;407;2020-10-13;4110
2020-10-12;"Žilinský kraj";62;0;0;0;NA;108584;62;2020-10-12;3703
2020-10-11;"Žilinský kraj";50;0;0;0;NA;108584;50;2020-10-11;3641
2020-10-10;"Žilinský kraj";213;0;0;0;NA;108584;213;2020-10-10;3591
2020-10-09;"Žilinský kraj";543;0;0;0;NA;108584;543;2020-10-09;3378
2020-10-08;"Žilinský kraj";238;0;0;0;NA;108584;238;2020-10-08;2835
2020-10-07;"Žilinský kraj";168;0;0;0;NA;108584;168;2020-10-07;2597
2020-10-06;"Žilinský kraj";233;0;0;0;NA;108584;233;2020-10-06;2429
2020-10-05;"Žilinský kraj";33;0;0;0;NA;108584;33;2020-10-05;2196
2020-10-04;"Žilinský kraj";35;0;0;0;NA;108584;35;2020-10-04;2163
2020-10-03;"Žilinský kraj";155;0;0;0;NA;108584;155;2020-10-03;2128
2020-10-02;"Žilinský kraj";105;0;0;0;NA;108584;105;2020-10-02;1973
2020-10-01;"Žilinský kraj";147;0;0;0;NA;108584;147;2020-10-01;1868
2020-09-30;"Žilinský kraj";163;0;0;0;NA;108584;163;2020-09-30;1721
2020-09-29;"Žilinský kraj";105;0;0;0;NA;108584;105;2020-09-29;1558
2020-09-28;"Žilinský kraj";34;0;0;0;NA;108584;34;2020-09-28;1453
2020-09-27;"Žilinský kraj";108;0;0;0;NA;108584;108;2020-09-27;1419
2020-09-26;"Žilinský kraj";96;0;0;0;NA;108584;96;2020-09-26;1311
2020-09-25;"Žilinský kraj";69;0;0;0;NA;108584;69;2020-09-25;1215
2020-09-24;"Žilinský kraj";100;0;0;0;NA;108584;100;2020-09-24;1146
2020-09-23;"Žilinský kraj";65;0;0;0;NA;108584;65;2020-09-23;1046
2020-09-22;"Žilinský kraj";65;0;0;0;NA;108584;65;2020-09-22;981
2020-09-21;"Žilinský kraj";47;0;0;0;NA;108584;47;2020-09-21;916
2020-09-20;"Žilinský kraj";4;0;0;0;NA;108584;4;2020-09-20;869
2020-09-19;"Žilinský kraj";6;0;0;0;NA;108584;6;2020-09-19;865
2020-09-18;"Žilinský kraj";82;0;0;0;NA;108584;82;2020-09-18;859
2020-09-17;"Žilinský kraj";30;0;0;0;NA;108584;30;2020-09-17;777
2020-09-16;"Žilinský kraj";34;0;0;0;NA;108584;34;2020-09-16;747
2020-09-15;"Žilinský kraj";12;0;0;0;NA;108584;12;2020-09-15;713
2020-09-14;"Žilinský kraj";39;0;0;0;NA;108584;39;2020-09-14;701
2020-09-13;"Žilinský kraj";6;0;0;0;NA;108584;6;2020-09-13;662
2020-09-12;"Žilinský kraj";4;0;0;0;NA;108584;4;2020-09-12;656
2020-09-11;"Žilinský kraj";31;0;0;0;NA;108584;31;2020-09-11;652
2020-09-10;"Žilinský kraj";31;0;0;0;NA;108584;31;2020-09-10;621
2020-09-09;"Žilinský kraj";23;0;0;0;NA;108584;23;2020-09-09;590
2020-09-08;"Žilinský kraj";25;0;0;0;NA;108584;25;2020-09-08;567
2020-09-07;"Žilinský kraj";11;0;0;0;NA;108584;11;2020-09-07;542
2020-09-06;"Žilinský kraj";0;0;0;0;NA;108584;0;2020-09-06;531
2020-09-05;"Žilinský kraj";2;0;0;0;NA;108584;2;2020-09-05;531
2020-09-04;"Žilinský kraj";33;0;0;0;NA;108584;33;2020-09-04;529
2020-09-03;"Žilinský kraj";18;0;0;0;NA;108584;18;2020-09-03;496
2020-09-02;"Žilinský kraj";16;0;0;0;NA;108584;16;2020-09-02;478
2020-09-01;"Žilinský kraj";4;0;0;0;NA;108584;4;2020-09-01;462
2020-08-31;"Žilinský kraj";5;0;0;0;NA;108584;5;2020-08-31;458
2020-08-30;"Žilinský kraj";3;0;0;0;NA;108584;3;2020-08-30;453
2020-08-29;"Žilinský kraj";5;0;0;0;NA;108584;5;2020-08-29;450
2020-08-28;"Žilinský kraj";13;0;0;0;NA;108584;13;2020-08-28;445
2020-08-27;"Žilinský kraj";18;0;0;0;NA;108584;18;2020-08-27;432
2020-08-26;"Žilinský kraj";8;0;0;0;NA;108584;8;2020-08-26;414
2020-08-25;"Žilinský kraj";2;0;0;0;NA;108584;2;2020-08-25;406
2020-08-24;"Žilinský kraj";5;0;0;0;NA;108584;5;2020-08-24;404
2020-08-23;"Žilinský kraj";0;0;0;0;NA;108584;0;2020-08-23;399
2020-08-22;"Žilinský kraj";0;0;0;0;NA;108584;0;2020-08-22;399
2020-08-21;"Žilinský kraj";10;0;0;0;NA;108584;10;2020-08-21;399
2020-08-20;"Žilinský kraj";13;0;0;0;NA;108584;13;2020-08-20;389
2020-08-19;"Žilinský kraj";7;0;0;0;NA;108584;7;2020-08-19;376
2020-08-18;"Žilinský kraj";9;0;0;0;NA;108584;9;2020-08-18;369
2020-08-17;"Žilinský kraj";1;0;0;0;NA;108584;1;2020-08-17;360
2020-08-16;"Žilinský kraj";0;0;0;0;NA;108584;0;2020-08-16;359
2020-08-15;"Žilinský kraj";0;0;0;0;NA;108584;0;2020-08-15;359
2020-08-14;"Žilinský kraj";4;0;0;0;NA;108584;4;2020-08-14;359
2020-08-13;"Žilinský kraj";2;0;0;0;NA;108584;2;2020-08-13;355
2020-08-12;"Žilinský kraj";0;0;0;0;NA;108584;0;2020-08-12;353
2020-08-11;"Žilinský kraj";4;0;0;0;NA;108584;4;2020-08-11;353
2020-08-10;"Žilinský kraj";1;0;0;0;NA;108584;1;2020-08-10;349
2020-08-09;"Žilinský kraj";0;0;0;0;NA;108584;0;2020-08-09;348
2020-08-08;"Žilinský kraj";3;0;0;0;NA;108584;3;2020-08-08;348
2020-08-07;"Žilinský kraj";8;0;0;0;NA;108584;8;2020-08-07;345
2020-08-06;"Žilinský kraj";1;0;0;0;NA;108584;1;2020-08-06;337
2020-08-05;"Žilinský kraj";1;0;0;0;NA;108584;1;2020-08-05;336
2020-08-04;"Žilinský kraj";2;0;0;0;NA;108584;2;2020-08-04;335
2020-08-03;"Žilinský kraj";0;0;0;0;NA;108584;0;2020-08-03;333
2020-08-02;"Žilinský kraj";1;0;0;0;NA;108584;1;2020-08-02;333
2020-08-01;"Žilinský kraj";0;0;0;0;NA;108584;0;2020-08-01;332
2020-07-31;"Žilinský kraj";4;0;0;0;NA;108584;4;2020-07-31;332
2020-07-30;"Žilinský kraj";2;0;0;0;NA;108584;2;2020-07-30;328
2020-07-29;"Žilinský kraj";2;0;0;0;NA;108584;2;2020-07-29;326
2020-07-28;"Žilinský kraj";4;0;0;0;NA;108584;4;2020-07-28;324
2020-07-27;"Žilinský kraj";6;0;0;0;NA;108584;6;2020-07-27;320
2020-07-26;"Žilinský kraj";0;0;0;0;NA;108584;0;2020-07-26;314
2020-07-25;"Žilinský kraj";0;0;0;0;NA;108584;0;2020-07-25;314
2020-07-24;"Žilinský kraj";2;0;0;0;NA;108584;2;2020-07-24;314
2020-07-23;"Žilinský kraj";0;0;0;0;NA;108584;0;2020-07-23;312
2020-07-22;"Žilinský kraj";1;0;0;0;NA;108584;1;2020-07-22;312
2020-07-21;"Žilinský kraj";2;0;0;0;NA;108584;2;2020-07-21;311
2020-07-20;"Žilinský kraj";3;0;0;0;NA;108584;3;2020-07-20;309
2020-07-19;"Žilinský kraj";0;0;0;0;NA;108584;0;2020-07-19;306
2020-07-18;"Žilinský kraj";0;0;0;0;NA;108584;0;2020-07-18;306
2020-07-17;"Žilinský kraj";2;0;0;0;NA;108584;2;2020-07-17;306
2020-07-16;"Žilinský kraj";2;0;0;0;NA;108584;2;2020-07-16;304
2020-07-15;"Žilinský kraj";2;0;0;0;NA;108584;2;2020-07-15;302
2020-07-14;"Žilinský kraj";1;0;0;0;NA;108584;1;2020-07-14;300
2020-07-13;"Žilinský kraj";0;0;0;0;NA;108584;0;2020-07-13;299
2020-07-12;"Žilinský kraj";0;0;0;0;NA;108584;0;2020-07-12;299
2020-07-11;"Žilinský kraj";2;0;0;0;NA;108584;2;2020-07-11;299
2020-07-10;"Žilinský kraj";3;0;0;0;NA;108584;3;2020-07-10;297
2020-07-09;"Žilinský kraj";2;0;0;0;NA;108584;2;2020-07-09;294
2020-07-08;"Žilinský kraj";10;0;0;0;NA;108584;10;2020-07-08;292
2020-07-07;"Žilinský kraj";7;0;0;0;NA;108584;7;2020-07-07;282
2020-07-06;"Žilinský kraj";0;0;0;0;NA;108584;0;2020-07-06;275
2020-07-05;"Žilinský kraj";0;0;0;0;NA;108584;0;2020-07-05;275
2020-07-04;"Žilinský kraj";10;0;0;0;NA;108584;10;2020-07-04;275
2020-07-03;"Žilinský kraj";18;0;0;0;NA;108584;18;2020-07-03;265
2020-07-02;"Žilinský kraj";7;0;0;0;NA;108584;7;2020-07-02;247
2020-07-01;"Žilinský kraj";0;0;0;0;NA;108584;0;2020-07-01;240
2020-06-30;"Žilinský kraj";4;0;0;0;NA;108584;4;2020-06-30;240
2020-06-29;"Žilinský kraj";0;0;0;0;NA;108584;0;2020-06-29;236
2020-06-28;"Žilinský kraj";1;0;0;0;NA;108584;1;2020-06-28;236
2020-06-27;"Žilinský kraj";3;0;0;0;NA;108584;3;2020-06-27;235
2020-06-26;"Žilinský kraj";5;0;0;0;NA;108584;5;2020-06-26;232
2020-06-25;"Žilinský kraj";7;0;0;0;NA;108584;7;2020-06-25;227
2020-06-24;"Žilinský kraj";11;0;0;0;NA;108584;11;2020-06-24;220
2020-06-23;"Žilinský kraj";9;0;0;0;NA;108584;9;2020-06-23;209
2020-06-22;"Žilinský kraj";0;0;0;0;NA;108584;0;2020-06-22;200
2020-06-21;"Žilinský kraj";1;0;0;0;NA;108584;1;2020-06-21;200
2020-06-20;"Žilinský kraj";1;0;0;0;NA;108584;1;2020-06-20;199
2020-06-19;"Žilinský kraj";4;0;0;0;NA;108584;4;2020-06-19;198
2020-06-18;"Žilinský kraj";1;0;0;0;NA;108584;1;2020-06-18;194
2020-06-17;"Žilinský kraj";0;0;0;0;NA;108584;0;2020-06-17;193
2020-06-16;"Žilinský kraj";1;0;0;0;NA;108584;1;2020-06-16;193
2020-06-14;"Žilinský kraj";0;0;0;0;NA;108584;0;2020-06-14;192
2020-06-13;"Žilinský kraj";0;0;0;0;NA;108584;0;2020-06-13;192
2020-06-12;"Žilinský kraj";0;0;0;0;NA;108584;0;2020-06-12;192
2020-06-11;"Žilinský kraj";0;0;0;0;NA;108584;0;2020-06-11;192
2020-06-10;"Žilinský kraj";0;0;0;0;NA;108584;0;2020-06-10;192
2020-06-09;"Žilinský kraj";1;0;0;0;NA;108584;1;2020-06-09;192
2020-06-08;"Žilinský kraj";0;0;0;0;NA;108584;0;2020-06-08;191
2020-06-07;"Žilinský kraj";0;0;0;0;NA;108584;0;2020-06-07;191
2020-06-05;"Žilinský kraj";0;0;0;0;NA;108584;0;2020-06-05;191
2020-06-03;"Žilinský kraj";0;0;0;0;NA;108584;0;2020-06-03;191
2020-06-02;"Žilinský kraj";0;0;0;0;NA;108584;0;2020-06-02;191
2020-05-31;"Žilinský kraj";0;0;0;0;NA;108584;0;2020-05-31;191
2020-05-29;"Žilinský kraj";0;0;0;0;NA;108584;0;2020-05-29;191
2020-05-27;"Žilinský kraj";1;0;0;0;NA;108584;1;2020-05-27;191
2020-05-26;"Žilinský kraj";1;0;0;0;NA;108584;1;2020-05-26;190
2020-05-25;"Žilinský kraj";0;0;0;0;NA;108584;0;2020-05-25;189
2020-05-24;"Žilinský kraj";0;0;0;0;NA;108584;0;2020-05-24;189
2020-05-23;"Žilinský kraj";0;0;0;0;NA;108584;0;2020-05-23;189
2020-05-22;"Žilinský kraj";0;0;0;0;NA;108584;0;2020-05-22;189
2020-05-21;"Žilinský kraj";0;0;0;0;NA;108584;0;2020-05-21;189
2020-05-20;"Žilinský kraj";0;0;0;0;NA;108584;0;2020-05-20;189
2020-05-19;"Žilinský kraj";1;0;0;0;NA;108584;1;2020-05-19;189
2020-05-17;"Žilinský kraj";0;0;0;0;NA;108584;0;2020-05-17;188
2020-05-16;"Žilinský kraj";0;0;0;0;NA;108584;0;2020-05-16;188
2020-05-15;"Žilinský kraj";0;0;0;0;NA;108584;0;2020-05-15;188
2020-05-14;"Žilinský kraj";0;0;0;0;NA;108584;0;2020-05-14;188
2020-05-13;"Žilinský kraj";0;0;0;0;NA;108584;0;2020-05-13;188
2020-05-12;"Žilinský kraj";0;0;0;0;NA;108584;0;2020-05-12;188
2020-05-11;"Žilinský kraj";0;0;0;0;NA;108584;0;2020-05-11;188
2020-05-09;"Žilinský kraj";0;0;0;0;NA;108584;0;2020-05-09;188
2020-05-07;"Žilinský kraj";0;0;0;0;NA;108584;0;2020-05-07;188
2020-05-06;"Žilinský kraj";2;0;0;0;NA;108584;2;2020-05-06;188
2020-05-05;"Žilinský kraj";3;0;0;0;NA;108584;3;2020-05-05;186
2020-05-04;"Žilinský kraj";3;0;0;0;NA;108584;3;2020-05-04;183
2020-05-03;"Žilinský kraj";1;0;0;0;NA;108584;1;2020-05-03;180
2020-05-02;"Žilinský kraj";0;0;0;0;NA;108584;0;2020-05-02;179
2020-05-01;"Žilinský kraj";1;0;0;0;NA;108584;1;2020-05-01;179
2020-04-30;"Žilinský kraj";0;0;0;0;NA;108584;0;2020-04-30;178
2020-04-29;"Žilinský kraj";0;0;0;0;NA;108584;0;2020-04-29;178
2020-04-28;"Žilinský kraj";0;0;0;0;NA;108584;0;2020-04-28;178
2020-04-27;"Žilinský kraj";0;0;0;0;NA;108584;0;2020-04-27;178
2020-04-26;"Žilinský kraj";0;0;0;0;NA;108584;0;2020-04-26;178
2020-04-25;"Žilinský kraj";2;0;0;0;NA;108584;2;2020-04-25;178
2020-04-24;"Žilinský kraj";1;0;0;0;NA;108584;1;2020-04-24;176
2020-04-23;"Žilinský kraj";2;0;0;0;NA;108584;2;2020-04-23;175
2020-04-22;"Žilinský kraj";9;0;0;0;NA;108584;9;2020-04-22;173
2020-04-21;"Žilinský kraj";1;0;0;0;NA;108584;1;2020-04-21;164
2020-04-20;"Žilinský kraj";4;0;0;0;NA;108584;4;2020-04-20;163
2020-04-19;"Žilinský kraj";0;0;0;0;NA;108584;0;2020-04-19;159
2020-04-18;"Žilinský kraj";49;0;0;0;NA;108584;49;2020-04-18;159
2020-04-17;"Žilinský kraj";3;0;0;0;NA;108584;3;2020-04-17;110
2020-04-16;"Žilinský kraj";4;0;0;0;NA;108584;4;2020-04-16;107
2020-04-15;"Žilinský kraj";7;0;0;0;NA;108584;7;2020-04-15;103
2020-04-14;"Žilinský kraj";1;0;0;0;NA;108584;1;2020-04-14;96
2020-04-13;"Žilinský kraj";2;0;0;0;NA;108584;2;2020-04-13;95
2020-04-12;"Žilinský kraj";5;0;0;0;NA;108584;5;2020-04-12;93
2020-04-11;"Žilinský kraj";2;0;0;0;NA;108584;2;2020-04-11;88
2020-04-10;"Žilinský kraj";1;0;0;0;NA;108584;1;2020-04-10;86
2020-04-09;"Žilinský kraj";1;0;0;0;NA;108584;1;2020-04-09;85
2020-04-08;"Žilinský kraj";3;0;0;0;NA;108584;3;2020-04-08;84
2020-04-07;"Žilinský kraj";5;0;0;0;NA;108584;5;2020-04-07;81
2020-04-06;"Žilinský kraj";6;0;0;0;NA;108584;6;2020-04-06;76
2020-04-05;"Žilinský kraj";8;0;0;0;NA;108584;8;2020-04-05;70
2020-04-04;"Žilinský kraj";0;0;0;0;NA;108584;0;2020-04-04;62
2020-04-03;"Žilinský kraj";3;0;0;0;NA;108584;3;2020-04-03;62
2020-04-02;"Žilinský kraj";5;0;0;0;NA;108584;5;2020-04-02;59
2020-04-01;"Žilinský kraj";4;0;0;0;NA;108584;4;2020-04-01;54
2020-03-31;"Žilinský kraj";1;0;0;0;NA;108584;1;2020-03-31;50
2020-03-30;"Žilinský kraj";3;0;0;0;NA;108584;3;2020-03-30;49
2020-03-29;"Žilinský kraj";0;0;0;0;NA;108584;0;2020-03-29;46
2020-03-28;"Žilinský kraj";1;0;0;0;NA;108584;1;2020-03-28;46
2020-03-27;"Žilinský kraj";9;0;0;0;NA;108584;9;2020-03-27;45
2020-03-26;"Žilinský kraj";4;0;0;0;NA;108584;4;2020-03-26;36
2020-03-25;"Žilinský kraj";1;0;0;0;NA;108584;1;2020-03-25;32
2020-03-24;"Žilinský kraj";2;0;0;0;NA;108584;2;2020-03-24;31
2020-03-23;"Žilinský kraj";3;0;0;0;NA;108584;3;2020-03-23;29
2020-03-22;"Žilinský kraj";1;0;0;0;NA;108584;1;2020-03-22;26
2020-03-21;"Žilinský kraj";2;0;0;0;NA;108584;2;2020-03-21;25
2020-03-20;"Žilinský kraj";4;0;0;0;NA;108584;4;2020-03-20;23
2020-03-19;"Žilinský kraj";2;0;0;0;NA;108584;2;2020-03-19;19
2020-03-18;"Žilinský kraj";1;0;0;0;NA;108584;1;2020-03-18;17
2020-03-17;"Žilinský kraj";5;0;0;0;NA;108584;5;2020-03-17;16
2020-03-16;"Žilinský kraj";1;0;0;0;NA;108584;1;2020-03-16;11
2020-03-15;"Žilinský kraj";2;0;0;0;NA;108584;2;2020-03-15;10
2020-03-14;"Žilinský kraj";1;0;0;0;NA;108584;1;2020-03-14;8
2020-03-13;"Žilinský kraj";5;0;0;0;NA;108584;5;2020-03-13;7
2020-03-12;"Žilinský kraj";1;0;0;0;NA;108584;1;2020-03-12;2
2020-03-11;"Žilinský kraj";0;0;0;0;NA;108584;0;2020-03-11;1
2020-03-09;"Žilinský kraj";1;0;0;0;NA;108584;1;2020-03-09;1
2020-03-08;"Žilinský kraj";0;0;0;0;NA;108584;0;2020-03-08;0
2020-03-07;"Žilinský kraj";0;0;0;0;NA;108584;0;2020-03-07;0
2020-03-06;"Žilinský kraj";0;0;0;0;NA;108584;0;2020-03-06;0
