"Datum";"Region";"PCR_Pos";"Ag_Neg";"Ag_Pos";"Total";"Pocet.potvrdenych";"Potvrdenych";"newcases";"date";"positive"
2022-05-24;"Banskobystrický kraj";14;0;0;0;183085;274485;14;2022-05-24;274485
2022-05-23;"Banskobystrický kraj";12;0;0;0;NA;274485;12;2022-05-23;274471
2022-05-22;"Banskobystrický kraj";1;0;2;2;NA;274485;3;2022-05-22;274459
2022-05-21;"Banskobystrický kraj";9;3;1;4;NA;274485;10;2022-05-21;274456
2022-05-20;"Banskobystrický kraj";17;149;7;156;NA;274485;24;2022-05-20;274446
2022-05-19;"Banskobystrický kraj";6;382;4;386;NA;274485;10;2022-05-19;274422
2022-05-18;"Banskobystrický kraj";23;210;8;218;NA;274485;31;2022-05-18;274412
2022-05-17;"Banskobystrický kraj";6;295;7;302;NA;274485;13;2022-05-17;274381
2022-05-16;"Banskobystrický kraj";22;618;16;634;NA;274485;38;2022-05-16;274368
2022-05-15;"Banskobystrický kraj";4;27;1;28;NA;274485;5;2022-05-15;274330
2022-05-14;"Banskobystrický kraj";4;17;0;17;NA;274485;4;2022-05-14;274325
2022-05-13;"Banskobystrický kraj";32;319;5;324;NA;274485;37;2022-05-13;274321
2022-05-12;"Banskobystrický kraj";16;515;15;530;NA;274485;31;2022-05-12;274284
2022-05-11;"Banskobystrický kraj";19;374;9;383;NA;274485;28;2022-05-11;274253
2022-05-10;"Banskobystrický kraj";49;267;11;278;NA;274485;60;2022-05-10;274225
2022-05-09;"Banskobystrický kraj";35;714;24;738;NA;274485;59;2022-05-09;274165
2022-05-08;"Banskobystrický kraj";1;64;0;64;NA;274485;1;2022-05-08;274106
2022-05-07;"Banskobystrický kraj";6;111;1;112;NA;274485;7;2022-05-07;274105
2022-05-06;"Banskobystrický kraj";51;276;6;282;NA;274485;57;2022-05-06;274098
2022-05-05;"Banskobystrický kraj";41;555;11;566;NA;274485;52;2022-05-05;274041
2022-05-04;"Banskobystrický kraj";45;498;14;512;NA;274485;59;2022-05-04;273989
2022-05-03;"Banskobystrický kraj";60;421;5;426;NA;274485;65;2022-05-03;273930
2022-05-02;"Banskobystrický kraj";48;1063;38;1101;NA;274485;86;2022-05-02;273865
2022-05-01;"Banskobystrický kraj";12;69;1;70;NA;274485;13;2022-05-01;273779
2022-04-30;"Banskobystrický kraj";31;82;5;87;NA;274485;36;2022-04-30;273766
2022-04-29;"Banskobystrický kraj";57;681;16;697;NA;274485;73;2022-04-29;273730
2022-04-28;"Banskobystrický kraj";72;972;20;992;NA;274485;92;2022-04-28;273657
2022-04-27;"Banskobystrický kraj";85;866;29;895;NA;274485;114;2022-04-27;273565
2022-04-26;"Banskobystrický kraj";97;720;18;738;NA;274485;115;2022-04-26;273451
2022-04-25;"Banskobystrický kraj";148;1463;33;1496;NA;274485;181;2022-04-25;273336
2022-04-24;"Banskobystrický kraj";16;139;5;144;NA;274485;21;2022-04-24;273155
2022-04-23;"Banskobystrický kraj";110;64;9;73;NA;274485;119;2022-04-23;273134
2022-04-22;"Banskobystrický kraj";140;1044;32;1076;NA;274485;172;2022-04-22;273015
2022-04-21;"Banskobystrický kraj";154;1228;41;1269;NA;274485;195;2022-04-21;272843
2022-04-20;"Banskobystrický kraj";243;2052;141;2193;NA;274485;384;2022-04-20;272648
2022-04-19;"Banskobystrický kraj";209;1976;94;2070;NA;274485;303;2022-04-19;272264
2022-04-18;"Banskobystrický kraj";25;113;7;120;NA;274485;32;2022-04-18;271961
2022-04-17;"Banskobystrický kraj";105;54;3;57;NA;274485;108;2022-04-17;271929
2022-04-16;"Banskobystrický kraj";58;96;12;108;NA;274485;70;2022-04-16;271821
2022-04-15;"Banskobystrický kraj";44;106;5;111;NA;274485;49;2022-04-15;271751
2022-04-14;"Banskobystrický kraj";230;1095;31;1126;NA;274485;261;2022-04-14;271702
2022-04-13;"Banskobystrický kraj";212;932;60;992;NA;274485;272;2022-04-13;271441
2022-04-12;"Banskobystrický kraj";242;1066;60;1126;NA;274485;302;2022-04-12;271169
2022-04-11;"Banskobystrický kraj";300;2346;99;2445;NA;274485;399;2022-04-11;270867
2022-04-10;"Banskobystrický kraj";62;260;28;288;NA;274485;90;2022-04-10;270468
2022-04-09;"Banskobystrický kraj";147;112;16;128;NA;274485;163;2022-04-09;270378
2022-04-08;"Banskobystrický kraj";284;1193;95;1288;NA;274485;379;2022-04-08;270215
2022-04-07;"Banskobystrický kraj";298;1622;74;1696;NA;274485;372;2022-04-07;269836
2022-04-06;"Banskobystrický kraj";505;1191;89;1280;NA;274485;594;2022-04-06;269464
2022-04-05;"Banskobystrický kraj";458;1359;84;1443;NA;274485;542;2022-04-05;268870
2022-04-04;"Banskobystrický kraj";553;2810;177;2987;NA;274485;730;2022-04-04;268328
2022-04-03;"Banskobystrický kraj";66;441;83;524;NA;274485;149;2022-04-03;267598
2022-04-02;"Banskobystrický kraj";208;133;34;167;NA;274485;242;2022-04-02;267449
2022-04-01;"Banskobystrický kraj";529;1195;137;1332;NA;274485;666;2022-04-01;267207
2022-03-31;"Banskobystrický kraj";516;1775;102;1877;NA;274485;618;2022-03-31;266541
2022-03-30;"Banskobystrický kraj";734;1541;125;1666;NA;274485;859;2022-03-30;265923
2022-03-29;"Banskobystrický kraj";666;1406;161;1567;NA;274485;827;2022-03-29;265064
2022-03-28;"Banskobystrický kraj";618;2523;318;2841;NA;274485;936;2022-03-28;264237
2022-03-27;"Banskobystrický kraj";147;687;114;801;NA;274485;261;2022-03-27;263301
2022-03-26;"Banskobystrický kraj";343;150;53;203;NA;274485;396;2022-03-26;263040
2022-03-25;"Banskobystrický kraj";721;1382;192;1574;NA;274485;913;2022-03-25;262644
2022-03-24;"Banskobystrický kraj";769;1789;162;1951;NA;274485;931;2022-03-24;261731
2022-03-23;"Banskobystrický kraj";823;1643;201;1844;NA;274485;1024;2022-03-23;260800
2022-03-22;"Banskobystrický kraj";1148;1703;220;1923;NA;274485;1368;2022-03-22;259776
2022-03-21;"Banskobystrický kraj";879;2711;356;3067;NA;274485;1235;2022-03-21;258408
2022-03-20;"Banskobystrický kraj";172;605;174;779;NA;274485;346;2022-03-20;257173
2022-03-19;"Banskobystrický kraj";529;218;89;307;NA;274485;618;2022-03-19;256827
2022-03-18;"Banskobystrický kraj";819;2081;200;2281;NA;274485;1019;2022-03-18;256209
2022-03-17;"Banskobystrický kraj";981;3476;224;3700;NA;274485;1205;2022-03-17;255190
2022-03-16;"Banskobystrický kraj";1189;1396;235;1631;NA;274485;1424;2022-03-16;253985
2022-03-15;"Banskobystrický kraj";1420;1730;231;1961;NA;274485;1651;2022-03-15;252561
2022-03-14;"Banskobystrický kraj";948;3220;426;3646;NA;274485;1374;2022-03-14;250910
2022-03-13;"Banskobystrický kraj";224;577;216;793;NA;274485;440;2022-03-13;249536
2022-03-12;"Banskobystrický kraj";625;262;94;356;NA;274485;719;2022-03-12;249096
2022-03-11;"Banskobystrický kraj";1144;1817;287;2104;NA;274485;1431;2022-03-11;248377
2022-03-10;"Banskobystrický kraj";1325;2126;311;2437;NA;274485;1636;2022-03-10;246946
2022-03-09;"Banskobystrický kraj";1370;2036;333;2369;NA;274485;1703;2022-03-09;245310
2022-03-08;"Banskobystrický kraj";1738;2329;376;2705;NA;274485;2114;2022-03-08;243607
2022-03-07;"Banskobystrický kraj";1048;4977;604;5581;NA;274485;1652;2022-03-07;241493
2022-03-06;"Banskobystrický kraj";356;1265;278;1543;NA;274485;634;2022-03-06;239841
2022-03-05;"Banskobystrický kraj";745;497;180;677;NA;274485;925;2022-03-05;239207
2022-03-04;"Banskobystrický kraj";1302;2576;391;2967;NA;274485;1693;2022-03-04;238282
2022-03-03;"Banskobystrický kraj";1766;3466;386;3852;NA;274485;2152;2022-03-03;236589
2022-03-02;"Banskobystrický kraj";1515;5604;415;6019;NA;274485;1930;2022-03-02;234437
2022-03-01;"Banskobystrický kraj";1842;3325;396;3721;NA;274485;2238;2022-03-01;232507
2022-02-28;"Banskobystrický kraj";1050;4913;708;5621;NA;274485;1758;2022-02-28;230269
2022-02-27;"Banskobystrický kraj";604;1162;303;1465;NA;274485;907;2022-02-27;228511
2022-02-26;"Banskobystrický kraj";909;528;154;682;NA;274485;1063;2022-02-26;227604
2022-02-25;"Banskobystrický kraj";1591;2519;430;2949;NA;274485;2021;2022-02-25;226541
2022-02-24;"Banskobystrický kraj";1781;3858;404;4262;NA;274485;2185;2022-02-24;224520
2022-02-23;"Banskobystrický kraj";2094;2869;454;3323;NA;274485;2548;2022-02-23;222335
2022-02-22;"Banskobystrický kraj";2195;3737;469;4206;NA;274485;2664;2022-02-22;219787
2022-02-21;"Banskobystrický kraj";1409;5733;806;6539;NA;274485;2215;2022-02-21;217123
2022-02-20;"Banskobystrický kraj";484;1717;423;2140;NA;274485;907;2022-02-20;214908
2022-02-19;"Banskobystrický kraj";1180;774;242;1016;NA;274485;1422;2022-02-19;214001
2022-02-18;"Banskobystrický kraj";2473;3620;541;4161;NA;274485;3014;2022-02-18;212579
2022-02-17;"Banskobystrický kraj";1924;4239;460;4699;NA;274485;2384;2022-02-17;209565
2022-02-16;"Banskobystrický kraj";1856;3635;543;4178;NA;274485;2399;2022-02-16;207181
2022-02-15;"Banskobystrický kraj";2287;4460;584;5044;NA;274485;2871;2022-02-15;204782
2022-02-14;"Banskobystrický kraj";2071;6848;891;7739;NA;274485;2962;2022-02-14;201911
2022-02-13;"Banskobystrický kraj";577;2247;471;2718;NA;274485;1048;2022-02-13;198949
2022-02-12;"Banskobystrický kraj";1308;906;308;1214;NA;274485;1616;2022-02-12;197901
2022-02-11;"Banskobystrický kraj";2684;3845;555;4400;NA;274485;3239;2022-02-11;196285
2022-02-10;"Banskobystrický kraj";1765;5733;567;6300;NA;274485;2332;2022-02-10;193046
2022-02-09;"Banskobystrický kraj";2544;3794;569;4363;NA;274485;3113;2022-02-09;190714
2022-02-08;"Banskobystrický kraj";1806;4418;538;4956;NA;274485;2344;2022-02-08;187601
2022-02-07;"Banskobystrický kraj";1683;7388;728;8116;NA;274485;2411;2022-02-07;185257
2022-02-06;"Banskobystrický kraj";604;2244;392;2636;NA;274485;996;2022-02-06;182846
2022-02-05;"Banskobystrický kraj";1032;1434;233;1667;NA;274485;1265;2022-02-05;181850
2022-02-04;"Banskobystrický kraj";1866;3745;438;4183;NA;274485;2304;2022-02-04;180585
2022-02-03;"Banskobystrický kraj";1561;5433;359;5792;NA;274485;1920;2022-02-03;178281
2022-02-02;"Banskobystrický kraj";1716;4793;395;5188;NA;274485;2111;2022-02-02;176361
2022-02-01;"Banskobystrický kraj";1918;4558;410;4968;NA;274485;2328;2022-02-01;174250
2022-01-31;"Banskobystrický kraj";779;9006;553;9559;NA;274485;1332;2022-01-31;171922
2022-01-30;"Banskobystrický kraj";412;3055;267;3322;NA;274485;679;2022-01-30;170590
2022-01-29;"Banskobystrický kraj";981;1155;174;1329;NA;274485;1155;2022-01-29;169911
2022-01-28;"Banskobystrický kraj";1040;3814;313;4127;NA;274485;1353;2022-01-28;168756
2022-01-27;"Banskobystrický kraj";1035;4955;225;5180;NA;274485;1260;2022-01-27;167403
2022-01-26;"Banskobystrický kraj";1060;4035;213;4248;NA;274485;1273;2022-01-26;166143
2022-01-25;"Banskobystrický kraj";1001;6119;257;6376;NA;274485;1258;2022-01-25;164870
2022-01-24;"Banskobystrický kraj";557;10186;257;10443;NA;274485;814;2022-01-24;163612
2022-01-23;"Banskobystrický kraj";246;3710;129;3839;NA;274485;375;2022-01-23;162798
2022-01-22;"Banskobystrický kraj";411;1077;64;1141;NA;274485;475;2022-01-22;162423
2022-01-21;"Banskobystrický kraj";578;3491;113;3604;NA;274485;691;2022-01-21;161948
2022-01-20;"Banskobystrický kraj";490;3810;91;3901;NA;274485;581;2022-01-20;161257
2022-01-19;"Banskobystrický kraj";421;4173;98;4271;NA;274485;519;2022-01-19;160676
2022-01-18;"Banskobystrický kraj";517;4737;95;4832;NA;274485;612;2022-01-18;160157
2022-01-17;"Banskobystrický kraj";269;8102;114;8216;NA;274485;383;2022-01-17;159545
2022-01-16;"Banskobystrický kraj";63;2746;84;2830;NA;274485;147;2022-01-16;159162
2022-01-15;"Banskobystrický kraj";287;858;16;874;NA;274485;303;2022-01-15;159015
2022-01-14;"Banskobystrický kraj";165;2758;67;2825;NA;274485;232;2022-01-14;158712
2022-01-13;"Banskobystrický kraj";182;3411;57;3468;NA;274485;239;2022-01-13;158480
2022-01-12;"Banskobystrický kraj";241;3787;67;3854;NA;274485;308;2022-01-12;158241
2022-01-11;"Banskobystrický kraj";327;4970;74;5044;NA;274485;401;2022-01-11;157933
2022-01-10;"Banskobystrický kraj";219;8173;113;8286;NA;274485;332;2022-01-10;157532
2022-01-09;"Banskobystrický kraj";54;3514;38;3552;NA;274485;92;2022-01-09;157200
2022-01-08;"Banskobystrický kraj";177;1054;40;1094;NA;274485;217;2022-01-08;157108
2022-01-07;"Banskobystrický kraj";320;3087;86;3173;NA;274485;406;2022-01-07;156891
2022-01-06;"Banskobystrický kraj";101;985;21;1006;NA;274485;122;2022-01-06;156485
2022-01-05;"Banskobystrický kraj";376;2852;67;2919;NA;274485;443;2022-01-05;156363
2022-01-04;"Banskobystrický kraj";458;4197;72;4269;NA;274485;530;2022-01-04;155920
2022-01-03;"Banskobystrický kraj";420;8216;115;8331;NA;274485;535;2022-01-03;155390
2022-01-02;"Banskobystrický kraj";117;2239;95;2334;NA;274485;212;2022-01-02;154855
2022-01-01;"Banskobystrický kraj";33;80;4;84;NA;274485;37;2022-01-01;154643
2021-12-31;"Banskobystrický kraj";314;1803;68;1871;NA;274485;382;2021-12-31;154606
2021-12-30;"Banskobystrický kraj";308;2833;88;2921;NA;274485;396;2021-12-30;154224
2021-12-29;"Banskobystrický kraj";390;2448;83;2531;NA;274485;473;2021-12-29;153828
2021-12-28;"Banskobystrický kraj";492;2902;95;2997;NA;274485;587;2021-12-28;153355
2021-12-27;"Banskobystrický kraj";397;5029;203;5232;NA;274485;600;2021-12-27;152768
2021-12-26;"Banskobystrický kraj";76;1245;62;1307;NA;274485;138;2021-12-26;152168
2021-12-25;"Banskobystrický kraj";107;373;45;418;NA;274485;152;2021-12-25;152030
2021-12-24;"Banskobystrický kraj";116;213;10;223;NA;274485;126;2021-12-24;151878
2021-12-23;"Banskobystrický kraj";429;3501;107;3608;NA;274485;536;2021-12-23;151752
2021-12-22;"Banskobystrický kraj";393;3394;106;3500;NA;274485;499;2021-12-22;151216
2021-12-21;"Banskobystrický kraj";508;4173;88;4261;NA;274485;596;2021-12-21;150717
2021-12-20;"Banskobystrický kraj";424;7610;186;7796;NA;274485;610;2021-12-20;150121
2021-12-19;"Banskobystrický kraj";39;2681;87;2768;NA;274485;126;2021-12-19;149511
2021-12-18;"Banskobystrický kraj";333;1036;67;1103;NA;274485;400;2021-12-18;149385
2021-12-17;"Banskobystrický kraj";465;3805;102;3907;NA;274485;567;2021-12-17;148985
2021-12-16;"Banskobystrický kraj";499;4278;116;4394;NA;274485;615;2021-12-16;148418
2021-12-15;"Banskobystrický kraj";554;4772;102;4874;NA;274485;656;2021-12-15;147803
2021-12-14;"Banskobystrický kraj";729;4614;108;4722;NA;274485;837;2021-12-14;147147
2021-12-13;"Banskobystrický kraj";470;8201;222;8423;NA;274485;692;2021-12-13;146310
2021-12-12;"Banskobystrický kraj";161;3332;101;3433;NA;274485;262;2021-12-12;145618
2021-12-11;"Banskobystrický kraj";568;1166;82;1248;NA;274485;650;2021-12-11;145356
2021-12-10;"Banskobystrický kraj";731;4033;185;4218;NA;274485;916;2021-12-10;144706
2021-12-09;"Banskobystrický kraj";652;4381;139;4520;NA;274485;791;2021-12-09;143790
2021-12-08;"Banskobystrický kraj";1087;4100;169;4269;NA;274485;1256;2021-12-08;142999
2021-12-07;"Banskobystrický kraj";1104;5410;201;5611;NA;274485;1305;2021-12-07;141743
2021-12-06;"Banskobystrický kraj";647;9113;324;9437;NA;274485;971;2021-12-06;140438
2021-12-05;"Banskobystrický kraj";217;3425;155;3580;NA;274485;372;2021-12-05;139467
2021-12-04;"Banskobystrický kraj";654;1334;131;1465;NA;274485;785;2021-12-04;139095
2021-12-03;"Banskobystrický kraj";1117;5057;246;5303;NA;274485;1363;2021-12-03;138310
2021-12-02;"Banskobystrický kraj";1710;5259;258;5517;NA;274485;1968;2021-12-02;136947
2021-12-01;"Banskobystrický kraj";947;4753;264;5017;NA;274485;1211;2021-12-01;134979
2021-11-30;"Banskobystrický kraj";1266;6543;245;6788;NA;274485;1511;2021-11-30;133768
2021-11-29;"Banskobystrický kraj";591;10653;468;11121;NA;274485;1059;2021-11-29;132257
2021-11-28;"Banskobystrický kraj";418;4289;216;4505;NA;274485;634;2021-11-28;131198
2021-11-27;"Banskobystrický kraj";827;1781;208;1989;NA;274485;1035;2021-11-27;130564
2021-11-26;"Banskobystrický kraj";963;4771;354;5125;NA;274485;1317;2021-11-26;129529
2021-11-25;"Banskobystrický kraj";1110;5911;350;6261;NA;274485;1460;2021-11-25;128212
2021-11-24;"Banskobystrický kraj";1387;5956;330;6286;NA;274485;1717;2021-11-24;126752
2021-11-23;"Banskobystrický kraj";1436;6082;377;6459;NA;274485;1813;2021-11-23;125035
2021-11-22;"Banskobystrický kraj";489;8727;579;9306;NA;274485;1068;2021-11-22;123222
2021-11-21;"Banskobystrický kraj";408;4109;307;4416;NA;274485;715;2021-11-21;122154
2021-11-20;"Banskobystrický kraj";985;1758;199;1957;NA;274485;1184;2021-11-20;121439
2021-11-19;"Banskobystrický kraj";1006;4886;470;5356;NA;274485;1476;2021-11-19;120255
2021-11-18;"Banskobystrický kraj";979;8037;620;8657;NA;274485;1599;2021-11-18;118779
2021-11-17;"Banskobystrický kraj";772;1051;147;1198;NA;274485;919;2021-11-17;117180
2021-11-16;"Banskobystrický kraj";1130;5473;453;5926;NA;274485;1583;2021-11-16;116261
2021-11-15;"Banskobystrický kraj";749;7884;588;8472;NA;274485;1337;2021-11-15;114678
2021-11-14;"Banskobystrický kraj";311;2629;302;2931;NA;274485;613;2021-11-14;113341
2021-11-13;"Banskobystrický kraj";761;1471;214;1685;NA;274485;975;2021-11-13;112728
2021-11-12;"Banskobystrický kraj";972;5019;434;5453;NA;274485;1406;2021-11-12;111753
2021-11-11;"Banskobystrický kraj";1023;5584;345;5929;NA;274485;1368;2021-11-11;110347
2021-11-10;"Banskobystrický kraj";950;4713;333;5046;NA;274485;1283;2021-11-10;108979
2021-11-09;"Banskobystrický kraj";921;4616;283;4899;NA;274485;1204;2021-11-09;107696
2021-11-08;"Banskobystrický kraj";519;7249;488;7737;NA;274485;1007;2021-11-08;106492
2021-11-07;"Banskobystrický kraj";460;2479;258;2737;NA;274485;718;2021-11-07;105485
2021-11-06;"Banskobystrický kraj";505;1344;170;1514;NA;274485;675;2021-11-06;104767
2021-11-05;"Banskobystrický kraj";997;4773;342;5115;NA;274485;1339;2021-11-05;104092
2021-11-04;"Banskobystrický kraj";1086;4811;248;5059;NA;274485;1334;2021-11-04;102753
2021-11-03;"Banskobystrický kraj";976;4825;330;5155;NA;274485;1306;2021-11-03;101419
2021-11-02;"Banskobystrický kraj";538;5709;492;6201;NA;274485;1030;2021-11-02;100113
2021-11-01;"Banskobystrický kraj";390;1178;132;1310;NA;274485;522;2021-11-01;99083
2021-10-31;"Banskobystrický kraj";150;1700;210;1910;NA;274485;360;2021-10-31;98561
2021-10-30;"Banskobystrický kraj";449;1508;140;1648;NA;274485;589;2021-10-30;98201
2021-10-29;"Banskobystrický kraj";780;4178;286;4464;NA;274485;1066;2021-10-29;97612
2021-10-28;"Banskobystrický kraj";744;4182;247;4429;NA;274485;991;2021-10-28;96546
2021-10-27;"Banskobystrický kraj";664;4577;233;4810;NA;274485;897;2021-10-27;95555
2021-10-26;"Banskobystrický kraj";700;3673;187;3860;NA;274485;887;2021-10-26;94658
2021-10-25;"Banskobystrický kraj";376;5478;257;5735;NA;274485;633;2021-10-25;93771
2021-10-24;"Banskobystrický kraj";161;1707;143;1850;NA;274485;304;2021-10-24;93138
2021-10-23;"Banskobystrický kraj";238;1286;79;1365;NA;274485;317;2021-10-23;92834
2021-10-22;"Banskobystrický kraj";530;3816;185;4001;NA;274485;715;2021-10-22;92517
2021-10-21;"Banskobystrický kraj";416;4128;140;4268;NA;274485;556;2021-10-21;91802
2021-10-20;"Banskobystrický kraj";387;3615;123;3738;NA;274485;510;2021-10-20;91246
2021-10-19;"Banskobystrický kraj";419;4094;103;4197;NA;274485;522;2021-10-19;90736
2021-10-18;"Banskobystrický kraj";162;5286;175;5461;NA;274485;337;2021-10-18;90214
2021-10-17;"Banskobystrický kraj";26;1555;71;1626;NA;274485;97;2021-10-17;89877
2021-10-16;"Banskobystrický kraj";162;1387;50;1437;NA;274485;212;2021-10-16;89780
2021-10-15;"Banskobystrický kraj";187;3693;81;3774;NA;274485;268;2021-10-15;89568
2021-10-14;"Banskobystrický kraj";198;3705;47;3752;NA;274485;245;2021-10-14;89300
2021-10-13;"Banskobystrický kraj";217;3068;55;3123;NA;274485;272;2021-10-13;89055
2021-10-12;"Banskobystrický kraj";301;3743;59;3802;NA;274485;360;2021-10-12;88783
2021-10-11;"Banskobystrický kraj";128;4734;96;4830;NA;274485;224;2021-10-11;88423
2021-10-10;"Banskobystrický kraj";26;1815;53;1868;NA;274485;79;2021-10-10;88199
2021-10-09;"Banskobystrický kraj";73;1122;27;1149;NA;274485;100;2021-10-09;88120
2021-10-08;"Banskobystrický kraj";239;3027;61;3088;NA;274485;300;2021-10-08;88020
2021-10-07;"Banskobystrický kraj";179;3437;42;3479;NA;274485;221;2021-10-07;87720
2021-10-06;"Banskobystrický kraj";136;3862;48;3910;NA;274485;184;2021-10-06;87499
2021-10-05;"Banskobystrický kraj";209;2979;54;3033;NA;274485;263;2021-10-05;87315
2021-10-04;"Banskobystrický kraj";126;3725;64;3789;NA;274485;190;2021-10-04;87052
2021-10-03;"Banskobystrický kraj";11;1407;34;1441;NA;274485;45;2021-10-03;86862
2021-10-02;"Banskobystrický kraj";66;1042;26;1068;NA;274485;92;2021-10-02;86817
2021-10-01;"Banskobystrický kraj";158;3228;51;3279;NA;274485;209;2021-10-01;86725
2021-09-30;"Banskobystrický kraj";120;3362;30;3392;NA;274485;150;2021-09-30;86516
2021-09-29;"Banskobystrický kraj";118;2626;40;2666;NA;274485;158;2021-09-29;86366
2021-09-28;"Banskobystrický kraj";112;3061;45;3106;NA;274485;157;2021-09-28;86208
2021-09-27;"Banskobystrický kraj";90;4456;72;4528;NA;274485;162;2021-09-27;86051
2021-09-26;"Banskobystrický kraj";17;1498;31;1529;NA;274485;48;2021-09-26;85889
2021-09-25;"Banskobystrický kraj";17;1481;7;1488;NA;274485;24;2021-09-25;85841
2021-09-24;"Banskobystrický kraj";98;4254;32;4286;NA;274485;130;2021-09-24;85817
2021-09-23;"Banskobystrický kraj";63;3019;13;3032;NA;274485;76;2021-09-23;85687
2021-09-22;"Banskobystrický kraj";75;2442;19;2461;NA;274485;94;2021-09-22;85611
2021-09-21;"Banskobystrický kraj";125;2976;20;2996;NA;274485;145;2021-09-21;85517
2021-09-20;"Banskobystrický kraj";45;3951;30;3981;NA;274485;75;2021-09-20;85372
2021-09-19;"Banskobystrický kraj";6;1456;24;1480;NA;274485;30;2021-09-19;85297
2021-09-18;"Banskobystrický kraj";44;1318;15;1333;NA;274485;59;2021-09-18;85267
2021-09-17;"Banskobystrický kraj";73;3485;32;3517;NA;274485;105;2021-09-17;85208
2021-09-16;"Banskobystrický kraj";95;3019;29;3048;NA;274485;124;2021-09-16;85103
2021-09-15;"Banskobystrický kraj";22;394;1;395;NA;274485;23;2021-09-15;84979
2021-09-14;"Banskobystrický kraj";95;2508;28;2536;NA;274485;123;2021-09-14;84956
2021-09-13;"Banskobystrický kraj";29;3206;28;3234;NA;274485;57;2021-09-13;84833
2021-09-12;"Banskobystrický kraj";7;958;15;973;NA;274485;22;2021-09-12;84776
2021-09-11;"Banskobystrický kraj";31;865;11;876;NA;274485;42;2021-09-11;84754
2021-09-10;"Banskobystrický kraj";59;2250;24;2274;NA;274485;83;2021-09-10;84712
2021-09-09;"Banskobystrický kraj";46;2011;17;2028;NA;274485;63;2021-09-09;84629
2021-09-08;"Banskobystrický kraj";46;1713;27;1740;NA;274485;73;2021-09-08;84566
2021-09-07;"Banskobystrický kraj";27;1422;21;1443;NA;274485;48;2021-09-07;84493
2021-09-06;"Banskobystrický kraj";26;2570;13;2583;NA;274485;39;2021-09-06;84445
2021-09-05;"Banskobystrický kraj";9;742;2;744;NA;274485;11;2021-09-05;84406
2021-09-04;"Banskobystrický kraj";14;745;10;755;NA;274485;24;2021-09-04;84395
2021-09-03;"Banskobystrický kraj";49;2116;22;2138;NA;274485;71;2021-09-03;84371
2021-09-02;"Banskobystrický kraj";19;1730;25;1755;NA;274485;44;2021-09-02;84300
2021-09-01;"Banskobystrický kraj";6;230;6;236;NA;274485;12;2021-09-01;84256
2021-08-31;"Banskobystrický kraj";18;1406;13;1419;NA;274485;31;2021-08-31;84244
2021-08-30;"Banskobystrický kraj";23;1867;10;1877;NA;274485;33;2021-08-30;84213
2021-08-29;"Banskobystrický kraj";0;351;5;356;NA;274485;5;2021-08-29;84180
2021-08-28;"Banskobystrický kraj";9;827;5;832;NA;274485;14;2021-08-28;84175
2021-08-27;"Banskobystrický kraj";7;1608;12;1620;NA;274485;19;2021-08-27;84161
2021-08-26;"Banskobystrický kraj";7;1161;2;1163;NA;274485;9;2021-08-26;84142
2021-08-25;"Banskobystrický kraj";6;1052;1;1053;NA;274485;7;2021-08-25;84133
2021-08-24;"Banskobystrický kraj";12;1117;1;1118;NA;274485;13;2021-08-24;84126
2021-08-23;"Banskobystrický kraj";7;1368;5;1373;NA;274485;12;2021-08-23;84113
2021-08-22;"Banskobystrický kraj";0;773;2;775;NA;274485;2;2021-08-22;84101
2021-08-21;"Banskobystrický kraj";3;793;1;794;NA;274485;4;2021-08-21;84099
2021-08-20;"Banskobystrický kraj";5;1616;4;1620;NA;274485;9;2021-08-20;84095
2021-08-19;"Banskobystrický kraj";4;1092;3;1095;NA;274485;7;2021-08-19;84086
2021-08-18;"Banskobystrický kraj";1;1044;1;1045;NA;274485;2;2021-08-18;84079
2021-08-17;"Banskobystrický kraj";12;890;0;890;NA;274485;12;2021-08-17;84077
2021-08-16;"Banskobystrický kraj";7;1321;3;1324;NA;274485;10;2021-08-16;84065
2021-08-15;"Banskobystrický kraj";0;366;3;369;NA;274485;3;2021-08-15;84055
2021-08-14;"Banskobystrický kraj";6;435;1;436;NA;274485;7;2021-08-14;84052
2021-08-13;"Banskobystrický kraj";11;898;0;898;NA;274485;11;2021-08-13;84045
2021-08-12;"Banskobystrický kraj";10;951;1;952;NA;274485;11;2021-08-12;84034
2021-08-11;"Banskobystrický kraj";7;575;3;578;NA;274485;10;2021-08-11;84023
2021-08-10;"Banskobystrický kraj";7;678;2;680;NA;274485;9;2021-08-10;84013
2021-08-09;"Banskobystrický kraj";9;1064;0;1064;NA;274485;9;2021-08-09;84004
2021-08-08;"Banskobystrický kraj";4;335;1;336;NA;274485;5;2021-08-08;83995
2021-08-07;"Banskobystrický kraj";0;308;4;312;NA;274485;4;2021-08-07;83990
2021-08-06;"Banskobystrický kraj";5;929;2;931;NA;274485;7;2021-08-06;83986
2021-08-05;"Banskobystrický kraj";2;838;1;839;NA;274485;3;2021-08-05;83979
2021-08-04;"Banskobystrický kraj";2;579;1;580;NA;274485;3;2021-08-04;83976
2021-08-03;"Banskobystrický kraj";4;743;0;743;NA;274485;4;2021-08-03;83973
2021-08-02;"Banskobystrický kraj";6;934;0;934;NA;274485;6;2021-08-02;83969
2021-08-01;"Banskobystrický kraj";0;271;0;271;NA;274485;0;2021-08-01;83963
2021-07-31;"Banskobystrický kraj";1;370;4;374;NA;274485;5;2021-07-31;83963
2021-07-30;"Banskobystrický kraj";27;928;2;930;NA;274485;29;2021-07-30;83958
2021-07-29;"Banskobystrický kraj";2;890;1;891;NA;274485;3;2021-07-29;83929
2021-07-28;"Banskobystrický kraj";4;520;1;521;NA;274485;5;2021-07-28;83926
2021-07-27;"Banskobystrický kraj";15;1092;0;1092;NA;274485;15;2021-07-27;83921
2021-07-26;"Banskobystrický kraj";2;911;1;912;NA;274485;3;2021-07-26;83906
2021-07-25;"Banskobystrický kraj";0;367;1;368;NA;274485;1;2021-07-25;83903
2021-07-24;"Banskobystrický kraj";2;298;0;298;NA;274485;2;2021-07-24;83902
2021-07-23;"Banskobystrický kraj";7;840;0;840;NA;274485;7;2021-07-23;83900
2021-07-22;"Banskobystrický kraj";5;727;3;730;NA;274485;8;2021-07-22;83893
2021-07-21;"Banskobystrický kraj";2;560;0;560;NA;274485;2;2021-07-21;83885
2021-07-20;"Banskobystrický kraj";6;885;2;887;NA;274485;8;2021-07-20;83883
2021-07-19;"Banskobystrický kraj";1;854;3;857;NA;274485;4;2021-07-19;83875
2021-07-18;"Banskobystrický kraj";0;377;1;378;NA;274485;1;2021-07-18;83871
2021-07-17;"Banskobystrický kraj";1;324;0;324;NA;274485;1;2021-07-17;83870
2021-07-16;"Banskobystrický kraj";3;974;1;975;NA;274485;4;2021-07-16;83869
2021-07-15;"Banskobystrický kraj";1;1038;0;1038;NA;274485;1;2021-07-15;83865
2021-07-14;"Banskobystrický kraj";3;765;0;765;NA;274485;3;2021-07-14;83864
2021-07-13;"Banskobystrický kraj";2;695;0;695;NA;274485;2;2021-07-13;83861
2021-07-12;"Banskobystrický kraj";1;1057;0;1057;NA;274485;1;2021-07-12;83859
2021-07-11;"Banskobystrický kraj";0;446;0;446;NA;274485;0;2021-07-11;83858
2021-07-10;"Banskobystrický kraj";2;368;0;368;NA;274485;2;2021-07-10;83858
2021-07-09;"Banskobystrický kraj";3;1209;0;1209;NA;274485;3;2021-07-09;83856
2021-07-08;"Banskobystrický kraj";0;1083;1;1084;NA;274485;1;2021-07-08;83853
2021-07-07;"Banskobystrický kraj";1;798;0;798;NA;274485;1;2021-07-07;83852
2021-07-06;"Banskobystrický kraj";6;1365;0;1365;NA;274485;6;2021-07-06;83851
2021-07-05;"Banskobystrický kraj";2;392;1;393;NA;274485;3;2021-07-05;83845
2021-07-04;"Banskobystrický kraj";0;318;0;318;NA;274485;0;2021-07-04;83842
2021-07-03;"Banskobystrický kraj";1;413;1;414;NA;274485;2;2021-07-03;83842
2021-07-02;"Banskobystrický kraj";3;1045;0;1045;NA;274485;3;2021-07-02;83840
2021-07-01;"Banskobystrický kraj";0;705;1;706;NA;274485;1;2021-07-01;83837
2021-06-30;"Banskobystrický kraj";3;7607;1;7608;NA;274485;4;2021-06-30;83836
2021-06-29;"Banskobystrický kraj";2;4642;1;4643;NA;274485;3;2021-06-29;83832
2021-06-28;"Banskobystrický kraj";3;5695;1;5696;NA;274485;4;2021-06-28;83829
2021-06-27;"Banskobystrický kraj";0;4369;5;4374;NA;274485;5;2021-06-27;83825
2021-06-26;"Banskobystrický kraj";0;4289;4;4293;NA;274485;4;2021-06-26;83820
2021-06-25;"Banskobystrický kraj";2;6717;2;6719;NA;274485;4;2021-06-25;83816
2021-06-24;"Banskobystrický kraj";6;4585;2;4587;NA;274485;8;2021-06-24;83812
2021-06-23;"Banskobystrický kraj";4;4947;0;4947;NA;274485;4;2021-06-23;83804
2021-06-22;"Banskobystrický kraj";7;4527;0;4527;NA;274485;7;2021-06-22;83800
2021-06-21;"Banskobystrický kraj";6;5836;8;5844;NA;274485;14;2021-06-21;83793
2021-06-20;"Banskobystrický kraj";0;5055;7;5062;NA;274485;7;2021-06-20;83779
2021-06-19;"Banskobystrický kraj";0;5639;4;5643;NA;274485;4;2021-06-19;83772
2021-06-18;"Banskobystrický kraj";4;7642;1;7643;NA;274485;5;2021-06-18;83768
2021-06-17;"Banskobystrický kraj";2;5245;3;5248;NA;274485;5;2021-06-17;83763
2021-06-16;"Banskobystrický kraj";10;5951;5;5956;NA;274485;15;2021-06-16;83758
2021-06-15;"Banskobystrický kraj";9;5576;6;5582;NA;274485;15;2021-06-15;83743
2021-06-14;"Banskobystrický kraj";8;6922;7;6929;NA;274485;15;2021-06-14;83728
2021-06-13;"Banskobystrický kraj";0;6407;7;6414;NA;274485;7;2021-06-13;83713
2021-06-12;"Banskobystrický kraj";3;6338;6;6344;NA;274485;9;2021-06-12;83706
2021-06-11;"Banskobystrický kraj";5;9693;15;9708;NA;274485;20;2021-06-11;83697
2021-06-10;"Banskobystrický kraj";10;5726;8;5734;NA;274485;18;2021-06-10;83677
2021-06-09;"Banskobystrický kraj";9;5720;4;5724;NA;274485;13;2021-06-09;83659
2021-06-08;"Banskobystrický kraj";15;5645;10;5655;NA;274485;25;2021-06-08;83646
2021-06-07;"Banskobystrický kraj";4;7582;21;7603;NA;274485;25;2021-06-07;83621
2021-06-06;"Banskobystrický kraj";1;7497;12;7509;NA;274485;13;2021-06-06;83596
2021-06-05;"Banskobystrický kraj";15;7531;9;7540;NA;274485;24;2021-06-05;83583
2021-06-04;"Banskobystrický kraj";2;9352;14;9366;NA;274485;16;2021-06-04;83559
2021-06-03;"Banskobystrický kraj";8;6507;24;6531;NA;274485;32;2021-06-03;83543
2021-06-02;"Banskobystrický kraj";7;6837;6;6843;NA;274485;13;2021-06-02;83511
2021-06-01;"Banskobystrický kraj";12;7146;14;7160;NA;274485;26;2021-06-01;83498
2021-05-31;"Banskobystrický kraj";4;9546;31;9577;NA;274485;35;2021-05-31;83472
2021-05-30;"Banskobystrický kraj";3;8959;19;8978;NA;274485;22;2021-05-30;83437
2021-05-29;"Banskobystrický kraj";11;9763;18;9781;NA;274485;29;2021-05-29;83415
2021-05-28;"Banskobystrický kraj";13;11908;27;11935;NA;274485;40;2021-05-28;83386
2021-05-27;"Banskobystrický kraj";7;8760;12;8772;NA;274485;19;2021-05-27;83346
2021-05-26;"Banskobystrický kraj";18;7905;17;7922;NA;274485;35;2021-05-26;83327
2021-05-25;"Banskobystrický kraj";27;8951;30;8981;NA;274485;57;2021-05-25;83292
2021-05-24;"Banskobystrický kraj";9;12472;44;12516;NA;274485;53;2021-05-24;83235
2021-05-23;"Banskobystrický kraj";0;9798;27;9825;NA;274485;27;2021-05-23;83182
2021-05-22;"Banskobystrický kraj";20;9608;26;9634;NA;274485;46;2021-05-22;83155
2021-05-21;"Banskobystrický kraj";22;12796;25;12821;NA;274485;47;2021-05-21;83109
2021-05-20;"Banskobystrický kraj";14;8994;25;9019;NA;274485;39;2021-05-20;83062
2021-05-19;"Banskobystrický kraj";42;8608;21;8629;NA;274485;63;2021-05-19;83023
2021-05-18;"Banskobystrický kraj";27;9450;25;9475;NA;274485;52;2021-05-18;82960
2021-05-17;"Banskobystrický kraj";11;13399;33;13432;NA;274485;44;2021-05-17;82908
2021-05-16;"Banskobystrický kraj";15;14072;26;14098;NA;274485;41;2021-05-16;82864
2021-05-15;"Banskobystrický kraj";11;15356;29;15385;NA;274485;40;2021-05-15;82823
2021-05-14;"Banskobystrický kraj";35;18939;45;18984;NA;274485;80;2021-05-14;82783
2021-05-13;"Banskobystrický kraj";37;10605;40;10645;NA;274485;77;2021-05-13;82703
2021-05-12;"Banskobystrický kraj";31;10860;45;10905;NA;274485;76;2021-05-12;82626
2021-05-11;"Banskobystrický kraj";42;11328;48;11376;NA;274485;90;2021-05-11;82550
2021-05-10;"Banskobystrický kraj";28;17621;68;17689;NA;274485;96;2021-05-10;82460
2021-05-09;"Banskobystrický kraj";25;21902;68;21970;NA;274485;93;2021-05-09;82364
2021-05-08;"Banskobystrický kraj";11;14285;26;14311;NA;274485;37;2021-05-08;82271
2021-05-07;"Banskobystrický kraj";41;21809;78;21887;NA;274485;119;2021-05-07;82234
2021-05-06;"Banskobystrický kraj";36;12254;70;12324;NA;274485;106;2021-05-06;82115
2021-05-05;"Banskobystrický kraj";34;12595;63;12658;NA;274485;97;2021-05-05;82009
2021-05-04;"Banskobystrický kraj";83;13888;47;13935;NA;274485;130;2021-05-04;81912
2021-05-03;"Banskobystrický kraj";30;20875;80;20955;NA;274485;110;2021-05-03;81782
2021-05-02;"Banskobystrický kraj";6;33040;60;33100;NA;274485;66;2021-05-02;81672
2021-05-01;"Banskobystrický kraj";54;36903;67;36970;NA;274485;121;2021-05-01;81606
2021-04-30;"Banskobystrický kraj";38;34957;86;35043;NA;274485;124;2021-04-30;81485
2021-04-29;"Banskobystrický kraj";55;16839;68;16907;NA;274485;123;2021-04-29;81361
2021-04-28;"Banskobystrický kraj";66;17959;67;18026;NA;274485;133;2021-04-28;81238
2021-04-27;"Banskobystrický kraj";70;19152;73;19225;NA;274485;143;2021-04-27;81105
2021-04-26;"Banskobystrický kraj";34;28517;101;28618;NA;274485;135;2021-04-26;80962
2021-04-25;"Banskobystrický kraj";14;40601;106;40707;NA;274485;120;2021-04-25;80827
2021-04-24;"Banskobystrický kraj";40;51944;98;52042;NA;274485;138;2021-04-24;80707
2021-04-23;"Banskobystrický kraj";78;37922;88;38010;NA;274485;166;2021-04-23;80569
2021-04-22;"Banskobystrický kraj";51;17415;57;17472;NA;274485;108;2021-04-22;80403
2021-04-21;"Banskobystrický kraj";76;19218;94;19312;NA;274485;170;2021-04-21;80295
2021-04-20;"Banskobystrický kraj";116;21234;98;21332;NA;274485;214;2021-04-20;80125
2021-04-19;"Banskobystrický kraj";48;31408;105;31513;NA;274485;153;2021-04-19;79911
2021-04-18;"Banskobystrický kraj";16;43375;90;43465;NA;274485;106;2021-04-18;79758
2021-04-17;"Banskobystrický kraj";42;64939;92;65031;NA;274485;134;2021-04-17;79652
2021-04-16;"Banskobystrický kraj";72;37307;100;37407;NA;274485;172;2021-04-16;79518
2021-04-15;"Banskobystrický kraj";67;20127;83;20210;NA;274485;150;2021-04-15;79346
2021-04-14;"Banskobystrický kraj";69;21260;86;21346;NA;274485;155;2021-04-14;79196
2021-04-13;"Banskobystrický kraj";130;23076;77;23153;NA;274485;207;2021-04-13;79041
2021-04-12;"Banskobystrický kraj";60;32272;130;32402;NA;274485;190;2021-04-12;78834
2021-04-11;"Banskobystrický kraj";0;41367;88;41455;NA;274485;88;2021-04-11;78644
2021-04-10;"Banskobystrický kraj";56;64728;141;64869;NA;274485;197;2021-04-10;78556
2021-04-09;"Banskobystrický kraj";106;31570;118;31688;NA;274485;224;2021-04-09;78359
2021-04-08;"Banskobystrický kraj";132;19000;148;19148;NA;274485;280;2021-04-08;78135
2021-04-07;"Banskobystrický kraj";226;25121;94;25215;NA;274485;320;2021-04-07;77855
2021-04-06;"Banskobystrický kraj";93;42496;187;42683;NA;274485;280;2021-04-06;77535
2021-04-05;"Banskobystrický kraj";15;11797;87;11884;NA;274485;102;2021-04-05;77255
2021-04-04;"Banskobystrický kraj";24;19683;79;19762;NA;274485;103;2021-04-04;77153
2021-04-03;"Banskobystrický kraj";5;72553;211;72764;NA;274485;216;2021-04-03;77050
2021-04-02;"Banskobystrický kraj";71;13455;66;13521;NA;274485;137;2021-04-02;76834
2021-04-01;"Banskobystrický kraj";171;39407;200;39607;NA;274485;371;2021-04-01;76697
2021-03-31;"Banskobystrický kraj";147;25543;161;25704;NA;274485;308;2021-03-31;76326
2021-03-30;"Banskobystrický kraj";167;21442;159;21601;NA;274485;326;2021-03-30;76018
2021-03-29;"Banskobystrický kraj";119;29492;218;29710;NA;274485;337;2021-03-29;75692
2021-03-28;"Banskobystrický kraj";25;40610;189;40799;NA;274485;214;2021-03-28;75355
2021-03-27;"Banskobystrický kraj";85;63414;260;63674;NA;274485;345;2021-03-27;75141
2021-03-26;"Banskobystrický kraj";122;43671;240;43911;NA;274485;362;2021-03-26;74796
2021-03-25;"Banskobystrický kraj";120;21598;240;21838;NA;274485;360;2021-03-25;74434
2021-03-24;"Banskobystrický kraj";200;19337;227;19564;NA;274485;427;2021-03-24;74074
2021-03-23;"Banskobystrický kraj";241;21541;257;21798;NA;274485;498;2021-03-23;73647
2021-03-22;"Banskobystrický kraj";65;30480;274;30754;NA;274485;339;2021-03-22;73149
2021-03-21;"Banskobystrický kraj";31;40039;280;40319;NA;274485;311;2021-03-21;72810
2021-03-20;"Banskobystrický kraj";119;67926;383;68309;NA;274485;502;2021-03-20;72499
2021-03-19;"Banskobystrický kraj";240;44038;306;44344;NA;274485;546;2021-03-19;71997
2021-03-18;"Banskobystrický kraj";160;22469;273;22742;NA;274485;433;2021-03-18;71451
2021-03-17;"Banskobystrický kraj";262;21573;245;21818;NA;274485;507;2021-03-17;71018
2021-03-16;"Banskobystrický kraj";340;23349;224;23573;NA;274485;564;2021-03-16;70511
2021-03-15;"Banskobystrický kraj";95;32306;366;32672;NA;274485;461;2021-03-15;69947
2021-03-14;"Banskobystrický kraj";39;39212;218;39430;NA;274485;257;2021-03-14;69486
2021-03-13;"Banskobystrický kraj";209;67463;395;67858;NA;274485;604;2021-03-13;69229
2021-03-12;"Banskobystrický kraj";206;41444;330;41774;NA;274485;536;2021-03-12;68625
2021-03-11;"Banskobystrický kraj";228;21338;274;21612;NA;274485;502;2021-03-11;68089
2021-03-10;"Banskobystrický kraj";260;20408;241;20649;NA;274485;501;2021-03-10;67587
2021-03-09;"Banskobystrický kraj";352;21790;284;22074;NA;274485;636;2021-03-09;67086
2021-03-08;"Banskobystrický kraj";191;31471;427;31898;NA;274485;618;2021-03-08;66450
2021-03-07;"Banskobystrický kraj";60;39191;295;39486;NA;274485;355;2021-03-07;65832
2021-03-06;"Banskobystrický kraj";164;70897;410;71307;NA;274485;574;2021-03-06;65477
2021-03-05;"Banskobystrický kraj";221;42336;389;42725;NA;274485;610;2021-03-05;64903
2021-03-04;"Banskobystrický kraj";226;22009;334;22343;NA;274485;560;2021-03-04;64293
2021-03-03;"Banskobystrický kraj";317;21949;331;22280;NA;274485;648;2021-03-03;63733
2021-03-02;"Banskobystrický kraj";291;23160;354;23514;NA;274485;645;2021-03-02;63085
2021-03-01;"Banskobystrický kraj";151;31773;434;32207;NA;274485;585;2021-03-01;62440
2021-02-28;"Banskobystrický kraj";45;38665;336;39001;NA;274485;381;2021-02-28;61855
2021-02-27;"Banskobystrický kraj";289;66667;529;67196;NA;274485;818;2021-02-27;61474
2021-02-26;"Banskobystrický kraj";326;39674;468;40142;NA;274485;794;2021-02-26;60656
2021-02-25;"Banskobystrický kraj";375;18081;366;18447;NA;274485;741;2021-02-25;59862
2021-02-24;"Banskobystrický kraj";332;16735;373;17108;NA;274485;705;2021-02-24;59121
2021-02-23;"Banskobystrický kraj";462;19932;439;20371;NA;274485;901;2021-02-23;58416
2021-02-22;"Banskobystrický kraj";67;28643;598;29241;NA;274485;665;2021-02-22;57515
2021-02-21;"Banskobystrický kraj";68;37619;444;38063;NA;274485;512;2021-02-21;56850
2021-02-20;"Banskobystrický kraj";280;68851;598;69449;NA;274485;878;2021-02-20;56338
2021-02-19;"Banskobystrický kraj";420;39888;511;40399;NA;274485;931;2021-02-19;55460
2021-02-18;"Banskobystrický kraj";241;18618;396;19014;NA;274485;637;2021-02-18;54529
2021-02-17;"Banskobystrický kraj";415;16740;389;17129;NA;274485;804;2021-02-17;53892
2021-02-16;"Banskobystrický kraj";338;19731;368;20099;NA;274485;706;2021-02-16;53088
2021-02-15;"Banskobystrický kraj";118;35835;591;36426;NA;274485;709;2021-02-15;52382
2021-02-14;"Banskobystrický kraj";60;31894;386;32280;NA;274485;446;2021-02-14;51673
2021-02-13;"Banskobystrický kraj";202;53889;492;54381;NA;274485;694;2021-02-13;51227
2021-02-12;"Banskobystrický kraj";312;37270;533;37803;NA;274485;845;2021-02-12;50533
2021-02-11;"Banskobystrický kraj";305;21196;386;21582;NA;274485;691;2021-02-11;49688
2021-02-10;"Banskobystrický kraj";333;14790;344;15134;NA;274485;677;2021-02-10;48997
2021-02-09;"Banskobystrický kraj";329;18504;362;18866;NA;274485;691;2021-02-09;48320
2021-02-08;"Banskobystrický kraj";103;49716;695;50411;NA;274485;798;2021-02-08;47629
2021-02-07;"Banskobystrický kraj";70;37659;335;37994;NA;274485;405;2021-02-07;46831
2021-02-06;"Banskobystrický kraj";178;69388;570;69958;NA;274485;748;2021-02-06;46426
2021-02-05;"Banskobystrický kraj";282;24577;363;24940;NA;274485;645;2021-02-05;45678
2021-02-04;"Banskobystrický kraj";240;14367;430;14797;NA;274485;670;2021-02-04;45033
2021-02-03;"Banskobystrický kraj";350;9459;255;9714;NA;274485;605;2021-02-03;44363
2021-02-02;"Banskobystrický kraj";277;15741;334;16075;NA;274485;611;2021-02-02;43758
2021-02-01;"Banskobystrický kraj";75;24346;489;24835;NA;274485;564;2021-02-01;43147
2021-01-31;"Banskobystrický kraj";34;19983;201;20184;NA;274485;235;2021-01-31;42583
2021-01-30;"Banskobystrický kraj";163;63896;525;64421;NA;274485;688;2021-01-30;42348
2021-01-29;"Banskobystrický kraj";196;17368;274;17642;NA;274485;470;2021-01-29;41660
2021-01-28;"Banskobystrický kraj";218;15613;382;15995;NA;274485;600;2021-01-28;41190
2021-01-27;"Banskobystrický kraj";191;8132;200;8332;NA;274485;391;2021-01-27;40590
2021-01-26;"Banskobystrický kraj";238;19795;283;20078;NA;274485;521;2021-01-26;40199
2021-01-25;"Banskobystrický kraj";82;33666;412;34078;NA;274485;494;2021-01-25;39678
2021-01-24;"Banskobystrický kraj";38;35587;278;35865;NA;274485;316;2021-01-24;39184
2021-01-23;"Banskobystrický kraj";142;89058;523;89581;NA;274485;665;2021-01-23;38868
2021-01-22;"Banskobystrický kraj";175;25887;355;26242;NA;274485;530;2021-01-22;38203
2021-01-21;"Banskobystrický kraj";194;17063;279;17342;NA;274485;473;2021-01-21;37673
2021-01-20;"Banskobystrický kraj";231;9142;186;9328;NA;274485;417;2021-01-20;37200
2021-01-19;"Banskobystrický kraj";213;10708;311;11019;NA;274485;524;2021-01-19;36783
2021-01-18;"Banskobystrický kraj";94;7402;401;7803;NA;274485;495;2021-01-18;36259
2021-01-17;"Banskobystrický kraj";110;8154;77;8231;NA;274485;187;2021-01-17;35764
2021-01-16;"Banskobystrický kraj";58;2274;57;2331;NA;274485;115;2021-01-16;35577
2021-01-15;"Banskobystrický kraj";164;7673;217;7890;NA;274485;381;2021-01-15;35462
2021-01-14;"Banskobystrický kraj";220;5760;325;6085;NA;274485;545;2021-01-14;35081
2021-01-13;"Banskobystrický kraj";235;5974;217;6191;NA;274485;452;2021-01-13;34536
2021-01-12;"Banskobystrický kraj";194;6600;290;6890;NA;274485;484;2021-01-12;34084
2021-01-11;"Banskobystrický kraj";76;8231;481;8712;NA;274485;557;2021-01-11;33600
2021-01-10;"Banskobystrický kraj";110;433;4;437;NA;274485;114;2021-01-10;33043
2021-01-09;"Banskobystrický kraj";297;2378;81;2459;NA;274485;378;2021-01-09;32929
2021-01-08;"Banskobystrický kraj";435;9805;443;10248;NA;274485;878;2021-01-08;32551
2021-01-07;"Banskobystrický kraj";127;6322;366;6688;NA;274485;493;2021-01-07;31673
2021-01-06;"Banskobystrický kraj";305;3374;185;3559;NA;274485;490;2021-01-06;31180
2021-01-05;"Banskobystrický kraj";372;7349;533;7882;NA;274485;905;2021-01-05;30690
2021-01-04;"Banskobystrický kraj";130;7087;700;7787;NA;274485;830;2021-01-04;29785
2021-01-03;"Banskobystrický kraj";199;320;19;339;NA;274485;218;2021-01-03;28955
2021-01-02;"Banskobystrický kraj";123;702;85;787;NA;274485;208;2021-01-02;28737
2021-01-01;"Banskobystrický kraj";220;1958;132;2090;NA;274485;352;2021-01-01;28529
2020-12-31;"Banskobystrický kraj";499;7679;633;8312;NA;274485;1132;2020-12-31;28177
2020-12-30;"Banskobystrický kraj";593;7407;541;7948;NA;274485;1134;2020-12-30;27045
2020-12-29;"Banskobystrický kraj";240;7876;660;8536;NA;274485;900;2020-12-29;25911
2020-12-28;"Banskobystrický kraj";131;6120;720;6840;NA;274485;851;2020-12-28;25011
2020-12-27;"Banskobystrický kraj";116;541;25;566;NA;274485;141;2020-12-27;24160
2020-12-26;"Banskobystrický kraj";61;295;35;330;NA;274485;96;2020-12-26;24019
2020-12-25;"Banskobystrický kraj";65;888;10;898;NA;274485;75;2020-12-25;23923
2020-12-24;"Banskobystrický kraj";452;3685;135;3820;NA;274485;587;2020-12-24;23848
2020-12-23;"Banskobystrický kraj";368;9892;473;10365;NA;274485;841;2020-12-23;23261
2020-12-22;"Banskobystrický kraj";307;8468;619;9087;NA;274485;926;2020-12-22;22420
2020-12-21;"Banskobystrický kraj";286;4922;455;5377;NA;274485;741;2020-12-21;21494
2020-12-20;"Banskobystrický kraj";155;250;14;264;NA;274485;169;2020-12-20;20753
2020-12-19;"Banskobystrický kraj";170;3084;138;3222;NA;274485;308;2020-12-19;20584
2020-12-18;"Banskobystrický kraj";432;5959;331;6290;NA;274485;763;2020-12-18;20276
2020-12-17;"Banskobystrický kraj";468;8753;653;9406;NA;274485;1121;2020-12-17;19513
2020-12-16;"Banskobystrický kraj";379;10184;567;10751;NA;274485;946;2020-12-16;18392
2020-12-15;"Banskobystrický kraj";336;5281;425;5706;NA;274485;761;2020-12-15;17446
2020-12-14;"Banskobystrický kraj";148;4012;259;4271;NA;274485;407;2020-12-14;16685
2020-12-13;"Banskobystrický kraj";122;142;1;143;NA;274485;123;2020-12-13;16278
2020-12-12;"Banskobystrický kraj";137;2714;138;2852;NA;274485;275;2020-12-12;16155
2020-12-11;"Banskobystrický kraj";468;6633;362;6995;NA;274485;830;2020-12-11;15880
2020-12-10;"Banskobystrický kraj";280;5501;369;5870;NA;274485;649;2020-12-10;15050
2020-12-09;"Banskobystrický kraj";323;3941;205;4146;NA;274485;528;2020-12-09;14401
2020-12-08;"Banskobystrický kraj";256;3782;272;4054;NA;274485;528;2020-12-08;13873
2020-12-07;"Banskobystrický kraj";175;2633;177;2810;NA;274485;352;2020-12-07;13345
2020-12-06;"Banskobystrický kraj";121;507;11;518;NA;274485;132;2020-12-06;12993
2020-12-05;"Banskobystrický kraj";109;1099;34;1133;NA;274485;143;2020-12-05;12861
2020-12-04;"Banskobystrický kraj";339;3828;174;4002;NA;274485;513;2020-12-04;12718
2020-12-03;"Banskobystrický kraj";240;3193;234;3427;NA;274485;474;2020-12-03;12205
2020-12-02;"Banskobystrický kraj";217;4442;186;4628;NA;274485;403;2020-12-02;11731
2020-12-01;"Banskobystrický kraj";215;2702;134;2836;NA;274485;349;2020-12-01;11328
2020-11-30;"Banskobystrický kraj";74;4314;241;4555;NA;274485;315;2020-11-30;10979
2020-11-29;"Banskobystrický kraj";19;208;7;215;NA;274485;26;2020-11-29;10664
2020-11-28;"Banskobystrický kraj";81;1408;55;1463;NA;274485;136;2020-11-28;10638
2020-11-27;"Banskobystrický kraj";219;2566;123;2689;NA;274485;342;2020-11-27;10502
2020-11-26;"Banskobystrický kraj";208;2124;93;2217;NA;274485;301;2020-11-26;10160
2020-11-25;"Banskobystrický kraj";170;1952;86;2038;NA;274485;256;2020-11-25;9859
2020-11-24;"Banskobystrický kraj";166;2566;69;2635;NA;274485;235;2020-11-24;9603
2020-11-23;"Banskobystrický kraj";66;10147;193;10340;NA;274485;259;2020-11-23;9368
2020-11-22;"Banskobystrický kraj";38;104;1;105;NA;274485;39;2020-11-22;9109
2020-11-21;"Banskobystrický kraj";52;904;14;918;NA;274485;66;2020-11-21;9070
2020-11-20;"Banskobystrický kraj";127;2005;107;2112;NA;274485;234;2020-11-20;9004
2020-11-19;"Banskobystrický kraj";170;1218;82;1300;NA;274485;252;2020-11-19;8770
2020-11-18;"Banskobystrický kraj";153;698;65;763;NA;274485;218;2020-11-18;8518
2020-11-17;"Banskobystrický kraj";52;578;35;613;NA;274485;87;2020-11-17;8300
2020-11-16;"Banskobystrický kraj";106;470;25;495;NA;274485;131;2020-11-16;8213
2020-11-15;"Banskobystrický kraj";52;301;4;305;NA;274485;56;2020-11-15;8082
2020-11-14;"Banskobystrický kraj";73;305;2;307;NA;274485;75;2020-11-14;8026
2020-11-13;"Banskobystrický kraj";157;552;11;563;NA;274485;168;2020-11-13;7951
2020-11-12;"Banskobystrický kraj";218;952;44;996;NA;274485;262;2020-11-12;7783
2020-11-11;"Banskobystrický kraj";224;437;9;446;NA;274485;233;2020-11-11;7521
2020-11-10;"Banskobystrický kraj";263;463;18;481;NA;274485;281;2020-11-10;7288
2020-11-09;"Banskobystrický kraj";80;2678;31;2709;NA;274485;111;2020-11-09;7007
2020-11-08;"Banskobystrický kraj";82;981;16;997;NA;274485;98;2020-11-08;6896
2020-11-07;"Banskobystrický kraj";164;8828;94;8922;NA;274485;258;2020-11-07;6798
2020-11-06;"Banskobystrický kraj";227;2496;16;2512;NA;274485;243;2020-11-06;6540
2020-11-05;"Banskobystrický kraj";240;290;33;323;NA;274485;273;2020-11-05;6297
2020-11-04;"Banskobystrický kraj";254;1366;13;1379;NA;274485;267;2020-11-04;6024
2020-11-03;"Banskobystrický kraj";246;1332;4;1336;NA;274485;250;2020-11-03;5757
2020-11-02;"Banskobystrický kraj";90;2909;65;2974;NA;274485;155;2020-11-02;5507
2020-11-01;"Banskobystrický kraj";101;2671;42;2713;NA;274485;143;2020-11-01;5352
2020-10-31;"Banskobystrický kraj";199;13516;116;13632;NA;274485;315;2020-10-31;5209
2020-10-30;"Banskobystrický kraj";254;2829;20;2849;NA;274485;274;2020-10-30;4894
2020-10-29;"Banskobystrický kraj";372;969;42;1011;NA;274485;414;2020-10-29;4620
2020-10-28;"Banskobystrický kraj";285;302;30;332;NA;274485;315;2020-10-28;4206
2020-10-27;"Banskobystrický kraj";266;654;40;694;NA;274485;306;2020-10-27;3891
2020-10-26;"Banskobystrický kraj";38;234;29;263;NA;274485;67;2020-10-26;3585
2020-10-25;"Banskobystrický kraj";50;140;11;151;NA;274485;61;2020-10-25;3518
2020-10-24;"Banskobystrický kraj";315;114;12;126;NA;274485;327;2020-10-24;3457
2020-10-23;"Banskobystrický kraj";231;230;29;259;NA;274485;260;2020-10-23;3130
2020-10-22;"Banskobystrický kraj";264;253;24;277;NA;274485;288;2020-10-22;2870
2020-10-21;"Banskobystrický kraj";209;266;3;269;NA;274485;212;2020-10-21;2582
2020-10-20;"Banskobystrický kraj";210;66;3;69;NA;274485;213;2020-10-20;2370
2020-10-19;"Banskobystrický kraj";27;73;12;85;NA;274485;39;2020-10-19;2157
2020-10-18;"Banskobystrický kraj";49;0;0;0;NA;274485;49;2020-10-18;2118
2020-10-17;"Banskobystrický kraj";91;0;0;0;NA;274485;91;2020-10-17;2069
2020-10-16;"Banskobystrický kraj";224;37;3;40;NA;274485;227;2020-10-16;1978
2020-10-15;"Banskobystrický kraj";133;29;1;30;NA;274485;134;2020-10-15;1751
2020-10-14;"Banskobystrický kraj";139;31;1;32;NA;274485;140;2020-10-14;1617
2020-10-13;"Banskobystrický kraj";151;169;11;180;NA;274485;162;2020-10-13;1477
2020-10-12;"Banskobystrický kraj";11;110;4;114;NA;274485;15;2020-10-12;1315
2020-10-11;"Banskobystrický kraj";14;0;0;0;NA;274485;14;2020-10-11;1300
2020-10-10;"Banskobystrický kraj";53;0;0;0;NA;274485;53;2020-10-10;1286
2020-10-09;"Banskobystrický kraj";128;0;0;0;NA;274485;128;2020-10-09;1233
2020-10-08;"Banskobystrický kraj";99;0;0;0;NA;274485;99;2020-10-08;1105
2020-10-07;"Banskobystrický kraj";124;0;0;0;NA;274485;124;2020-10-07;1006
2020-10-06;"Banskobystrický kraj";68;0;0;0;NA;274485;68;2020-10-06;882
2020-10-05;"Banskobystrický kraj";49;0;0;0;NA;274485;49;2020-10-05;814
2020-10-04;"Banskobystrický kraj";8;0;0;0;NA;274485;8;2020-10-04;765
2020-10-03;"Banskobystrický kraj";37;0;0;0;NA;274485;37;2020-10-03;757
2020-10-02;"Banskobystrický kraj";74;0;0;0;NA;274485;74;2020-10-02;720
2020-10-01;"Banskobystrický kraj";49;16;0;16;NA;274485;49;2020-10-01;646
2020-09-30;"Banskobystrický kraj";60;0;0;0;NA;274485;60;2020-09-30;597
2020-09-29;"Banskobystrický kraj";24;0;0;0;NA;274485;24;2020-09-29;537
2020-09-28;"Banskobystrický kraj";0;0;0;0;NA;274485;0;2020-09-28;513
2020-09-27;"Banskobystrický kraj";20;0;0;0;NA;274485;20;2020-09-27;513
2020-09-26;"Banskobystrický kraj";24;0;0;0;NA;274485;24;2020-09-26;493
2020-09-25;"Banskobystrický kraj";29;0;0;0;NA;274485;29;2020-09-25;469
2020-09-24;"Banskobystrický kraj";25;0;0;0;NA;274485;25;2020-09-24;440
2020-09-23;"Banskobystrický kraj";17;0;0;0;NA;274485;17;2020-09-23;415
2020-09-22;"Banskobystrický kraj";25;0;0;0;NA;274485;25;2020-09-22;398
2020-09-21;"Banskobystrický kraj";3;0;0;0;NA;274485;3;2020-09-21;373
2020-09-20;"Banskobystrický kraj";0;0;0;0;NA;274485;0;2020-09-20;370
2020-09-19;"Banskobystrický kraj";3;0;0;0;NA;274485;3;2020-09-19;370
2020-09-18;"Banskobystrický kraj";24;0;0;0;NA;274485;24;2020-09-18;367
2020-09-17;"Banskobystrický kraj";14;0;0;0;NA;274485;14;2020-09-17;343
2020-09-16;"Banskobystrický kraj";6;0;0;0;NA;274485;6;2020-09-16;329
2020-09-15;"Banskobystrický kraj";2;0;0;0;NA;274485;2;2020-09-15;323
2020-09-14;"Banskobystrický kraj";13;0;0;0;NA;274485;13;2020-09-14;321
2020-09-13;"Banskobystrický kraj";1;0;0;0;NA;274485;1;2020-09-13;308
2020-09-12;"Banskobystrický kraj";5;0;0;0;NA;274485;5;2020-09-12;307
2020-09-11;"Banskobystrický kraj";19;0;0;0;NA;274485;19;2020-09-11;302
2020-09-10;"Banskobystrický kraj";11;0;0;0;NA;274485;11;2020-09-10;283
2020-09-09;"Banskobystrický kraj";13;0;0;0;NA;274485;13;2020-09-09;272
2020-09-08;"Banskobystrický kraj";5;0;0;0;NA;274485;5;2020-09-08;259
2020-09-07;"Banskobystrický kraj";2;0;0;0;NA;274485;2;2020-09-07;254
2020-09-06;"Banskobystrický kraj";0;0;0;0;NA;274485;0;2020-09-06;252
2020-09-05;"Banskobystrický kraj";0;0;0;0;NA;274485;0;2020-09-05;252
2020-09-04;"Banskobystrický kraj";9;0;0;0;NA;274485;9;2020-09-04;252
2020-09-03;"Banskobystrický kraj";5;0;0;0;NA;274485;5;2020-09-03;243
2020-09-02;"Banskobystrický kraj";6;0;0;0;NA;274485;6;2020-09-02;238
2020-09-01;"Banskobystrický kraj";2;0;0;0;NA;274485;2;2020-09-01;232
2020-08-31;"Banskobystrický kraj";6;0;0;0;NA;274485;6;2020-08-31;230
2020-08-30;"Banskobystrický kraj";0;0;0;0;NA;274485;0;2020-08-30;224
2020-08-29;"Banskobystrický kraj";1;0;0;0;NA;274485;1;2020-08-29;224
2020-08-28;"Banskobystrický kraj";3;0;0;0;NA;274485;3;2020-08-28;223
2020-08-27;"Banskobystrický kraj";1;0;0;0;NA;274485;1;2020-08-27;220
2020-08-26;"Banskobystrický kraj";2;0;0;0;NA;274485;2;2020-08-26;219
2020-08-25;"Banskobystrický kraj";2;0;0;0;NA;274485;2;2020-08-25;217
2020-08-24;"Banskobystrický kraj";0;0;0;0;NA;274485;0;2020-08-24;215
2020-08-23;"Banskobystrický kraj";0;0;0;0;NA;274485;0;2020-08-23;215
2020-08-22;"Banskobystrický kraj";0;0;0;0;NA;274485;0;2020-08-22;215
2020-08-21;"Banskobystrický kraj";4;0;0;0;NA;274485;4;2020-08-21;215
2020-08-20;"Banskobystrický kraj";1;0;0;0;NA;274485;1;2020-08-20;211
2020-08-19;"Banskobystrický kraj";4;0;0;0;NA;274485;4;2020-08-19;210
2020-08-18;"Banskobystrický kraj";0;0;0;0;NA;274485;0;2020-08-18;206
2020-08-17;"Banskobystrický kraj";1;0;0;0;NA;274485;1;2020-08-17;206
2020-08-16;"Banskobystrický kraj";0;0;0;0;NA;274485;0;2020-08-16;205
2020-08-15;"Banskobystrický kraj";0;0;0;0;NA;274485;0;2020-08-15;205
2020-08-14;"Banskobystrický kraj";5;0;0;0;NA;274485;5;2020-08-14;205
2020-08-13;"Banskobystrický kraj";0;0;0;0;NA;274485;0;2020-08-13;200
2020-08-12;"Banskobystrický kraj";0;0;0;0;NA;274485;0;2020-08-12;200
2020-08-11;"Banskobystrický kraj";2;0;0;0;NA;274485;2;2020-08-11;200
2020-08-10;"Banskobystrický kraj";3;0;0;0;NA;274485;3;2020-08-10;198
2020-08-09;"Banskobystrický kraj";0;0;0;0;NA;274485;0;2020-08-09;195
2020-08-08;"Banskobystrický kraj";2;0;0;0;NA;274485;2;2020-08-08;195
2020-08-07;"Banskobystrický kraj";1;0;0;0;NA;274485;1;2020-08-07;193
2020-08-06;"Banskobystrický kraj";1;0;0;0;NA;274485;1;2020-08-06;192
2020-08-05;"Banskobystrický kraj";0;0;0;0;NA;274485;0;2020-08-05;191
2020-08-04;"Banskobystrický kraj";3;0;0;0;NA;274485;3;2020-08-04;191
2020-08-03;"Banskobystrický kraj";0;0;0;0;NA;274485;0;2020-08-03;188
2020-08-02;"Banskobystrický kraj";0;0;0;0;NA;274485;0;2020-08-02;188
2020-08-01;"Banskobystrický kraj";1;0;0;0;NA;274485;1;2020-08-01;188
2020-07-31;"Banskobystrický kraj";2;0;0;0;NA;274485;2;2020-07-31;187
2020-07-30;"Banskobystrický kraj";1;0;0;0;NA;274485;1;2020-07-30;185
2020-07-29;"Banskobystrický kraj";0;0;0;0;NA;274485;0;2020-07-29;184
2020-07-28;"Banskobystrický kraj";2;0;0;0;NA;274485;2;2020-07-28;184
2020-07-27;"Banskobystrický kraj";3;0;0;0;NA;274485;3;2020-07-27;182
2020-07-26;"Banskobystrický kraj";0;0;0;0;NA;274485;0;2020-07-26;179
2020-07-25;"Banskobystrický kraj";0;0;0;0;NA;274485;0;2020-07-25;179
2020-07-24;"Banskobystrický kraj";9;0;0;0;NA;274485;9;2020-07-24;179
2020-07-23;"Banskobystrický kraj";0;0;0;0;NA;274485;0;2020-07-23;170
2020-07-22;"Banskobystrický kraj";3;0;0;0;NA;274485;3;2020-07-22;170
2020-07-21;"Banskobystrický kraj";3;0;0;0;NA;274485;3;2020-07-21;167
2020-07-20;"Banskobystrický kraj";1;0;0;0;NA;274485;1;2020-07-20;164
2020-07-19;"Banskobystrický kraj";1;0;0;0;NA;274485;1;2020-07-19;163
2020-07-18;"Banskobystrický kraj";0;0;0;0;NA;274485;0;2020-07-18;162
2020-07-17;"Banskobystrický kraj";2;0;0;0;NA;274485;2;2020-07-17;162
2020-07-16;"Banskobystrický kraj";1;0;0;0;NA;274485;1;2020-07-16;160
2020-07-15;"Banskobystrický kraj";4;0;0;0;NA;274485;4;2020-07-15;159
2020-07-14;"Banskobystrický kraj";2;0;0;0;NA;274485;2;2020-07-14;155
2020-07-13;"Banskobystrický kraj";1;0;0;0;NA;274485;1;2020-07-13;153
2020-07-12;"Banskobystrický kraj";0;0;0;0;NA;274485;0;2020-07-12;152
2020-07-11;"Banskobystrický kraj";0;0;0;0;NA;274485;0;2020-07-11;152
2020-07-10;"Banskobystrický kraj";3;0;0;0;NA;274485;3;2020-07-10;152
2020-07-09;"Banskobystrický kraj";9;0;0;0;NA;274485;9;2020-07-09;149
2020-07-08;"Banskobystrický kraj";0;0;0;0;NA;274485;0;2020-07-08;140
2020-07-07;"Banskobystrický kraj";4;0;0;0;NA;274485;4;2020-07-07;140
2020-07-06;"Banskobystrický kraj";0;0;0;0;NA;274485;0;2020-07-06;136
2020-07-05;"Banskobystrický kraj";0;0;0;0;NA;274485;0;2020-07-05;136
2020-07-04;"Banskobystrický kraj";1;0;0;0;NA;274485;1;2020-07-04;136
2020-07-03;"Banskobystrický kraj";4;0;0;0;NA;274485;4;2020-07-03;135
2020-07-02;"Banskobystrický kraj";0;0;0;0;NA;274485;0;2020-07-02;131
2020-07-01;"Banskobystrický kraj";1;0;0;0;NA;274485;1;2020-07-01;131
2020-06-30;"Banskobystrický kraj";0;12;0;12;NA;274485;0;2020-06-30;130
2020-06-29;"Banskobystrický kraj";0;0;0;0;NA;274485;0;2020-06-29;130
2020-06-28;"Banskobystrický kraj";0;0;0;0;NA;274485;0;2020-06-28;130
2020-06-27;"Banskobystrický kraj";0;0;0;0;NA;274485;0;2020-06-27;130
2020-06-26;"Banskobystrický kraj";0;0;0;0;NA;274485;0;2020-06-26;130
2020-06-25;"Banskobystrický kraj";1;0;0;0;NA;274485;1;2020-06-25;130
2020-06-24;"Banskobystrický kraj";0;0;0;0;NA;274485;0;2020-06-24;129
2020-06-23;"Banskobystrický kraj";6;0;0;0;NA;274485;6;2020-06-23;129
2020-06-22;"Banskobystrický kraj";0;0;0;0;NA;274485;0;2020-06-22;123
2020-06-21;"Banskobystrický kraj";0;0;0;0;NA;274485;0;2020-06-21;123
2020-06-20;"Banskobystrický kraj";0;0;0;0;NA;274485;0;2020-06-20;123
2020-06-19;"Banskobystrický kraj";2;0;0;0;NA;274485;2;2020-06-19;123
2020-06-18;"Banskobystrický kraj";10;0;0;0;NA;274485;10;2020-06-18;121
2020-06-17;"Banskobystrický kraj";1;0;0;0;NA;274485;1;2020-06-17;111
2020-06-16;"Banskobystrický kraj";0;0;0;0;NA;274485;0;2020-06-16;110
2020-06-14;"Banskobystrický kraj";2;0;0;0;NA;274485;2;2020-06-14;110
2020-06-13;"Banskobystrický kraj";2;0;0;0;NA;274485;2;2020-06-13;108
2020-06-12;"Banskobystrický kraj";0;0;0;0;NA;274485;0;2020-06-12;106
2020-06-11;"Banskobystrický kraj";1;0;0;0;NA;274485;1;2020-06-11;106
2020-06-10;"Banskobystrický kraj";0;0;0;0;NA;274485;0;2020-06-10;105
2020-06-09;"Banskobystrický kraj";0;0;0;0;NA;274485;0;2020-06-09;105
2020-06-08;"Banskobystrický kraj";0;0;0;0;NA;274485;0;2020-06-08;105
2020-06-07;"Banskobystrický kraj";0;0;0;0;NA;274485;0;2020-06-07;105
2020-06-05;"Banskobystrický kraj";2;0;0;0;NA;274485;2;2020-06-05;105
2020-06-03;"Banskobystrický kraj";0;0;0;0;NA;274485;0;2020-06-03;103
2020-06-02;"Banskobystrický kraj";0;0;0;0;NA;274485;0;2020-06-02;103
2020-05-31;"Banskobystrický kraj";0;0;0;0;NA;274485;0;2020-05-31;103
2020-05-29;"Banskobystrický kraj";0;0;0;0;NA;274485;0;2020-05-29;103
2020-05-27;"Banskobystrický kraj";1;0;0;0;NA;274485;1;2020-05-27;103
2020-05-26;"Banskobystrický kraj";0;0;0;0;NA;274485;0;2020-05-26;102
2020-05-25;"Banskobystrický kraj";0;0;0;0;NA;274485;0;2020-05-25;102
2020-05-24;"Banskobystrický kraj";0;0;0;0;NA;274485;0;2020-05-24;102
2020-05-23;"Banskobystrický kraj";1;0;0;0;NA;274485;1;2020-05-23;102
2020-05-22;"Banskobystrický kraj";0;0;0;0;NA;274485;0;2020-05-22;101
2020-05-21;"Banskobystrický kraj";0;0;0;0;NA;274485;0;2020-05-21;101
2020-05-20;"Banskobystrický kraj";1;0;0;0;NA;274485;1;2020-05-20;101
2020-05-19;"Banskobystrický kraj";0;0;0;0;NA;274485;0;2020-05-19;100
2020-05-17;"Banskobystrický kraj";0;0;0;0;NA;274485;0;2020-05-17;100
2020-05-16;"Banskobystrický kraj";0;0;0;0;NA;274485;0;2020-05-16;100
2020-05-15;"Banskobystrický kraj";0;0;0;0;NA;274485;0;2020-05-15;100
2020-05-14;"Banskobystrický kraj";0;0;0;0;NA;274485;0;2020-05-14;100
2020-05-13;"Banskobystrický kraj";0;0;0;0;NA;274485;0;2020-05-13;100
2020-05-12;"Banskobystrický kraj";1;0;0;0;NA;274485;1;2020-05-12;100
2020-05-11;"Banskobystrický kraj";0;0;0;0;NA;274485;0;2020-05-11;99
2020-05-09;"Banskobystrický kraj";0;0;0;0;NA;274485;0;2020-05-09;99
2020-05-07;"Banskobystrický kraj";2;0;0;0;NA;274485;2;2020-05-07;99
2020-05-06;"Banskobystrický kraj";1;0;0;0;NA;274485;1;2020-05-06;97
2020-05-05;"Banskobystrický kraj";2;0;0;0;NA;274485;2;2020-05-05;96
2020-05-04;"Banskobystrický kraj";0;0;0;0;NA;274485;0;2020-05-04;94
2020-05-03;"Banskobystrický kraj";0;0;0;0;NA;274485;0;2020-05-03;94
2020-05-02;"Banskobystrický kraj";0;0;0;0;NA;274485;0;2020-05-02;94
2020-05-01;"Banskobystrický kraj";0;0;0;0;NA;274485;0;2020-05-01;94
2020-04-30;"Banskobystrický kraj";1;0;0;0;NA;274485;1;2020-04-30;94
2020-04-29;"Banskobystrický kraj";1;0;0;0;NA;274485;1;2020-04-29;93
2020-04-28;"Banskobystrický kraj";0;0;0;0;NA;274485;0;2020-04-28;92
2020-04-27;"Banskobystrický kraj";0;0;0;0;NA;274485;0;2020-04-27;92
2020-04-26;"Banskobystrický kraj";0;0;0;0;NA;274485;0;2020-04-26;92
2020-04-25;"Banskobystrický kraj";2;0;0;0;NA;274485;2;2020-04-25;92
2020-04-24;"Banskobystrický kraj";3;0;0;0;NA;274485;3;2020-04-24;90
2020-04-23;"Banskobystrický kraj";2;0;0;0;NA;274485;2;2020-04-23;87
2020-04-22;"Banskobystrický kraj";2;0;0;0;NA;274485;2;2020-04-22;85
2020-04-21;"Banskobystrický kraj";2;0;0;0;NA;274485;2;2020-04-21;83
2020-04-20;"Banskobystrický kraj";0;0;0;0;NA;274485;0;2020-04-20;81
2020-04-19;"Banskobystrický kraj";0;0;0;0;NA;274485;0;2020-04-19;81
2020-04-18;"Banskobystrický kraj";8;0;0;0;NA;274485;8;2020-04-18;81
2020-04-17;"Banskobystrický kraj";2;0;0;0;NA;274485;2;2020-04-17;73
2020-04-16;"Banskobystrický kraj";0;0;0;0;NA;274485;0;2020-04-16;71
2020-04-15;"Banskobystrický kraj";10;0;0;0;NA;274485;10;2020-04-15;71
2020-04-14;"Banskobystrický kraj";0;0;0;0;NA;274485;0;2020-04-14;61
2020-04-13;"Banskobystrický kraj";2;0;0;0;NA;274485;2;2020-04-13;61
2020-04-12;"Banskobystrický kraj";4;0;0;0;NA;274485;4;2020-04-12;59
2020-04-11;"Banskobystrický kraj";1;0;0;0;NA;274485;1;2020-04-11;55
2020-04-10;"Banskobystrický kraj";0;0;0;0;NA;274485;0;2020-04-10;54
2020-04-09;"Banskobystrický kraj";2;0;0;0;NA;274485;2;2020-04-09;54
2020-04-08;"Banskobystrický kraj";0;0;0;0;NA;274485;0;2020-04-08;52
2020-04-07;"Banskobystrický kraj";4;0;0;0;NA;274485;4;2020-04-07;52
2020-04-06;"Banskobystrický kraj";10;0;0;0;NA;274485;10;2020-04-06;48
2020-04-05;"Banskobystrický kraj";9;0;0;0;NA;274485;9;2020-04-05;38
2020-04-04;"Banskobystrický kraj";0;0;0;0;NA;274485;0;2020-04-04;29
2020-04-03;"Banskobystrický kraj";2;0;0;0;NA;274485;2;2020-04-03;29
2020-04-02;"Banskobystrický kraj";2;0;0;0;NA;274485;2;2020-04-02;27
2020-04-01;"Banskobystrický kraj";5;0;0;0;NA;274485;5;2020-04-01;25
2020-03-31;"Banskobystrický kraj";3;0;0;0;NA;274485;3;2020-03-31;20
2020-03-30;"Banskobystrický kraj";1;0;0;0;NA;274485;1;2020-03-30;17
2020-03-29;"Banskobystrický kraj";2;0;0;0;NA;274485;2;2020-03-29;16
2020-03-28;"Banskobystrický kraj";1;0;0;0;NA;274485;1;2020-03-28;14
2020-03-27;"Banskobystrický kraj";1;0;0;0;NA;274485;1;2020-03-27;13
2020-03-26;"Banskobystrický kraj";1;0;0;0;NA;274485;1;2020-03-26;12
2020-03-25;"Banskobystrický kraj";0;0;0;0;NA;274485;0;2020-03-25;11
2020-03-24;"Banskobystrický kraj";1;0;0;0;NA;274485;1;2020-03-24;11
2020-03-23;"Banskobystrický kraj";1;0;0;0;NA;274485;1;2020-03-23;10
2020-03-22;"Banskobystrický kraj";0;0;0;0;NA;274485;0;2020-03-22;9
2020-03-21;"Banskobystrický kraj";3;0;0;0;NA;274485;3;2020-03-21;9
2020-03-20;"Banskobystrický kraj";0;0;0;0;NA;274485;0;2020-03-20;6
2020-03-19;"Banskobystrický kraj";2;0;0;0;NA;274485;2;2020-03-19;6
2020-03-18;"Banskobystrický kraj";1;0;0;0;NA;274485;1;2020-03-18;4
2020-03-17;"Banskobystrický kraj";1;0;0;0;NA;274485;1;2020-03-17;3
2020-03-16;"Banskobystrický kraj";0;0;0;0;NA;274485;0;2020-03-16;2
2020-03-15;"Banskobystrický kraj";1;0;0;0;NA;274485;1;2020-03-15;2
2020-03-14;"Banskobystrický kraj";0;0;0;0;NA;274485;0;2020-03-14;1
2020-03-13;"Banskobystrický kraj";1;0;0;0;NA;274485;1;2020-03-13;1
2020-03-12;"Banskobystrický kraj";0;0;0;0;NA;274485;0;2020-03-12;0
2020-03-11;"Banskobystrický kraj";0;0;0;0;NA;274485;0;2020-03-11;0
2020-03-09;"Banskobystrický kraj";0;0;0;0;NA;274485;0;2020-03-09;0
2020-03-08;"Banskobystrický kraj";0;0;0;0;NA;274485;0;2020-03-08;0
2020-03-07;"Banskobystrický kraj";0;0;0;0;NA;274485;0;2020-03-07;0
2020-03-06;"Banskobystrický kraj";0;0;0;0;NA;274485;0;2020-03-06;0
2022-05-24;"Bratislavský kraj";46;0;0;0;251273;344557;46;2022-05-24;344557
2022-05-23;"Bratislavský kraj";66;0;0;0;NA;344557;66;2022-05-23;344511
2022-05-22;"Bratislavský kraj";25;230;4;234;NA;344557;29;2022-05-22;344445
2022-05-21;"Bratislavský kraj";35;182;4;186;NA;344557;39;2022-05-21;344416
2022-05-20;"Bratislavský kraj";39;819;2;821;NA;344557;41;2022-05-20;344377
2022-05-19;"Bratislavský kraj";50;837;8;845;NA;344557;58;2022-05-19;344336
2022-05-18;"Bratislavský kraj";66;711;10;721;NA;344557;76;2022-05-18;344278
2022-05-17;"Bratislavský kraj";49;835;14;849;NA;344557;63;2022-05-17;344202
2022-05-16;"Bratislavský kraj";56;988;16;1004;NA;344557;72;2022-05-16;344139
2022-05-15;"Bratislavský kraj";16;316;5;321;NA;344557;21;2022-05-15;344067
2022-05-14;"Bratislavský kraj";33;410;11;421;NA;344557;44;2022-05-14;344046
2022-05-13;"Bratislavský kraj";63;962;8;970;NA;344557;71;2022-05-13;344002
2022-05-12;"Bratislavský kraj";59;936;13;949;NA;344557;72;2022-05-12;343931
2022-05-11;"Bratislavský kraj";89;987;17;1004;NA;344557;106;2022-05-11;343859
2022-05-10;"Bratislavský kraj";82;1004;17;1021;NA;344557;99;2022-05-10;343753
2022-05-09;"Bratislavský kraj";89;1108;36;1144;NA;344557;125;2022-05-09;343654
2022-05-08;"Bratislavský kraj";31;360;7;367;NA;344557;38;2022-05-08;343529
2022-05-07;"Bratislavský kraj";79;349;8;357;NA;344557;87;2022-05-07;343491
2022-05-06;"Bratislavský kraj";89;1043;14;1057;NA;344557;103;2022-05-06;343404
2022-05-05;"Bratislavský kraj";137;1136;11;1147;NA;344557;148;2022-05-05;343301
2022-05-04;"Bratislavský kraj";153;1159;28;1187;NA;344557;181;2022-05-04;343153
2022-05-03;"Bratislavský kraj";137;1206;29;1235;NA;344557;166;2022-05-03;342972
2022-05-02;"Bratislavský kraj";174;2123;51;2174;NA;344557;225;2022-05-02;342806
2022-05-01;"Bratislavský kraj";54;655;15;670;NA;344557;69;2022-05-01;342581
2022-04-30;"Bratislavský kraj";178;705;9;714;NA;344557;187;2022-04-30;342512
2022-04-29;"Bratislavský kraj";192;1911;34;1945;NA;344557;226;2022-04-29;342325
2022-04-28;"Bratislavský kraj";206;1731;21;1752;NA;344557;227;2022-04-28;342099
2022-04-27;"Bratislavský kraj";188;1875;24;1899;NA;344557;212;2022-04-27;341872
2022-04-26;"Bratislavský kraj";292;1786;37;1823;NA;344557;329;2022-04-26;341660
2022-04-25;"Bratislavský kraj";199;2342;46;2388;NA;344557;245;2022-04-25;341331
2022-04-24;"Bratislavský kraj";126;815;31;846;NA;344557;157;2022-04-24;341086
2022-04-23;"Bratislavský kraj";216;760;18;778;NA;344557;234;2022-04-23;340929
2022-04-22;"Bratislavský kraj";343;1780;43;1823;NA;344557;386;2022-04-22;340695
2022-04-21;"Bratislavský kraj";359;1933;59;1992;NA;344557;418;2022-04-21;340309
2022-04-20;"Bratislavský kraj";543;2153;48;2201;NA;344557;591;2022-04-20;339891
2022-04-19;"Bratislavský kraj";253;2891;99;2990;NA;344557;352;2022-04-19;339300
2022-04-18;"Bratislavský kraj";174;710;26;736;NA;344557;200;2022-04-18;338948
2022-04-17;"Bratislavský kraj";315;655;27;682;NA;344557;342;2022-04-17;338748
2022-04-16;"Bratislavský kraj";170;761;33;794;NA;344557;203;2022-04-16;338406
2022-04-15;"Bratislavský kraj";281;835;25;860;NA;344557;306;2022-04-15;338203
2022-04-14;"Bratislavský kraj";538;1896;63;1959;NA;344557;601;2022-04-14;337897
2022-04-13;"Bratislavský kraj";555;1917;47;1964;NA;344557;602;2022-04-13;337296
2022-04-12;"Bratislavský kraj";612;2239;68;2307;NA;344557;680;2022-04-12;336694
2022-04-11;"Bratislavský kraj";514;2967;105;3072;NA;344557;619;2022-04-11;336014
2022-04-10;"Bratislavský kraj";293;963;63;1026;NA;344557;356;2022-04-10;335395
2022-04-09;"Bratislavský kraj";610;898;43;941;NA;344557;653;2022-04-09;335039
2022-04-08;"Bratislavský kraj";668;1746;82;1828;NA;344557;750;2022-04-08;334386
2022-04-07;"Bratislavský kraj";833;2348;96;2444;NA;344557;929;2022-04-07;333636
2022-04-06;"Bratislavský kraj";865;2042;100;2142;NA;344557;965;2022-04-06;332707
2022-04-05;"Bratislavský kraj";914;2358;127;2485;NA;344557;1041;2022-04-05;331742
2022-04-04;"Bratislavský kraj";827;3232;167;3399;NA;344557;994;2022-04-04;330701
2022-04-03;"Bratislavský kraj";589;1031;70;1101;NA;344557;659;2022-04-03;329707
2022-04-02;"Bratislavský kraj";863;1128;75;1203;NA;344557;938;2022-04-02;329048
2022-04-01;"Bratislavský kraj";1381;2274;128;2402;NA;344557;1509;2022-04-01;328110
2022-03-31;"Bratislavský kraj";1305;2861;154;3015;NA;344557;1459;2022-03-31;326601
2022-03-30;"Bratislavský kraj";1516;2133;161;2294;NA;344557;1677;2022-03-30;325142
2022-03-29;"Bratislavský kraj";1327;2570;216;2786;NA;344557;1543;2022-03-29;323465
2022-03-28;"Bratislavský kraj";1275;4214;267;4481;NA;344557;1542;2022-03-28;321922
2022-03-27;"Bratislavský kraj";962;1236;151;1387;NA;344557;1113;2022-03-27;320380
2022-03-26;"Bratislavský kraj";1391;1170;105;1275;NA;344557;1496;2022-03-26;319267
2022-03-25;"Bratislavský kraj";1793;2513;170;2683;NA;344557;1963;2022-03-25;317771
2022-03-24;"Bratislavský kraj";1708;2866;197;3063;NA;344557;1905;2022-03-24;315808
2022-03-23;"Bratislavský kraj";2093;2832;200;3032;NA;344557;2293;2022-03-23;313903
2022-03-22;"Bratislavský kraj";1857;2889;236;3125;NA;344557;2093;2022-03-22;311610
2022-03-21;"Bratislavský kraj";1469;4361;383;4744;NA;344557;1852;2022-03-21;309517
2022-03-20;"Bratislavský kraj";935;1359;181;1540;NA;344557;1116;2022-03-20;307665
2022-03-19;"Bratislavský kraj";1672;1510;142;1652;NA;344557;1814;2022-03-19;306549
2022-03-18;"Bratislavský kraj";1977;2942;209;3151;NA;344557;2186;2022-03-18;304735
2022-03-17;"Bratislavský kraj";2024;3501;253;3754;NA;344557;2277;2022-03-17;302549
2022-03-16;"Bratislavský kraj";1895;2773;265;3038;NA;344557;2160;2022-03-16;300272
2022-03-15;"Bratislavský kraj";1982;3813;343;4156;NA;344557;2325;2022-03-15;298112
2022-03-14;"Bratislavský kraj";1557;4138;348;4486;NA;344557;1905;2022-03-14;295787
2022-03-13;"Bratislavský kraj";738;1324;166;1490;NA;344557;904;2022-03-13;293882
2022-03-12;"Bratislavský kraj";1632;1264;110;1374;NA;344557;1742;2022-03-12;292978
2022-03-11;"Bratislavský kraj";1184;3161;318;3479;NA;344557;1502;2022-03-11;291236
2022-03-10;"Bratislavský kraj";1706;3603;355;3958;NA;344557;2061;2022-03-10;289734
2022-03-09;"Bratislavský kraj";1723;2818;276;3094;NA;344557;1999;2022-03-09;287673
2022-03-08;"Bratislavský kraj";1925;3830;342;4172;NA;344557;2267;2022-03-08;285674
2022-03-07;"Bratislavský kraj";1451;4303;486;4789;NA;344557;1937;2022-03-07;283407
2022-03-06;"Bratislavský kraj";850;1557;217;1774;NA;344557;1067;2022-03-06;281470
2022-03-05;"Bratislavský kraj";1203;1345;183;1528;NA;344557;1386;2022-03-05;280403
2022-03-04;"Bratislavský kraj";1443;3024;309;3333;NA;344557;1752;2022-03-04;279017
2022-03-03;"Bratislavský kraj";1599;3287;330;3617;NA;344557;1929;2022-03-03;277265
2022-03-02;"Bratislavský kraj";1677;2555;319;2874;NA;344557;1996;2022-03-02;275336
2022-03-01;"Bratislavský kraj";1560;3676;344;4020;NA;344557;1904;2022-03-01;273340
2022-02-28;"Bratislavský kraj";1593;4052;472;4524;NA;344557;2065;2022-02-28;271436
2022-02-27;"Bratislavský kraj";1156;1746;227;1973;NA;344557;1383;2022-02-27;269371
2022-02-26;"Bratislavský kraj";1228;1749;209;1958;NA;344557;1437;2022-02-26;267988
2022-02-25;"Bratislavský kraj";1692;3604;323;3927;NA;344557;2015;2022-02-25;266551
2022-02-24;"Bratislavský kraj";1760;3992;324;4316;NA;344557;2084;2022-02-24;264536
2022-02-23;"Bratislavský kraj";2105;3450;393;3843;NA;344557;2498;2022-02-23;262452
2022-02-22;"Bratislavský kraj";2951;4213;384;4597;NA;344557;3335;2022-02-22;259954
2022-02-21;"Bratislavský kraj";781;5116;517;5633;NA;344557;1298;2022-02-21;256619
2022-02-20;"Bratislavský kraj";1314;2005;294;2299;NA;344557;1608;2022-02-20;255321
2022-02-19;"Bratislavský kraj";1510;1929;235;2164;NA;344557;1745;2022-02-19;253713
2022-02-18;"Bratislavský kraj";2315;3835;378;4213;NA;344557;2693;2022-02-18;251968
2022-02-17;"Bratislavský kraj";2279;4412;416;4828;NA;344557;2695;2022-02-17;249275
2022-02-16;"Bratislavský kraj";2137;3749;419;4168;NA;344557;2556;2022-02-16;246580
2022-02-15;"Bratislavský kraj";2276;4894;475;5369;NA;344557;2751;2022-02-15;244024
2022-02-14;"Bratislavský kraj";2700;6170;601;6771;NA;344557;3301;2022-02-14;241273
2022-02-13;"Bratislavský kraj";1343;2248;395;2643;NA;344557;1738;2022-02-13;237972
2022-02-12;"Bratislavský kraj";1872;2273;336;2609;NA;344557;2208;2022-02-12;236234
2022-02-11;"Bratislavský kraj";2431;5054;419;5473;NA;344557;2850;2022-02-11;234026
2022-02-10;"Bratislavský kraj";2595;4563;427;4990;NA;344557;3022;2022-02-10;231176
2022-02-09;"Bratislavský kraj";2414;4706;477;5183;NA;344557;2891;2022-02-09;228154
2022-02-08;"Bratislavský kraj";2878;5134;512;5646;NA;344557;3390;2022-02-08;225263
2022-02-07;"Bratislavský kraj";2636;6970;668;7638;NA;344557;3304;2022-02-07;221873
2022-02-06;"Bratislavský kraj";1680;3005;382;3387;NA;344557;2062;2022-02-06;218569
2022-02-05;"Bratislavský kraj";2156;2456;315;2771;NA;344557;2471;2022-02-05;216507
2022-02-04;"Bratislavský kraj";2586;4679;408;5087;NA;344557;2994;2022-02-04;214036
2022-02-03;"Bratislavský kraj";2540;6005;435;6440;NA;344557;2975;2022-02-03;211042
2022-02-02;"Bratislavský kraj";2655;5035;465;5500;NA;344557;3120;2022-02-02;208067
2022-02-01;"Bratislavský kraj";2758;6001;469;6470;NA;344557;3227;2022-02-01;204947
2022-01-31;"Bratislavský kraj";2172;8357;712;9069;NA;344557;2884;2022-01-31;201720
2022-01-30;"Bratislavský kraj";1418;3314;362;3676;NA;344557;1780;2022-01-30;198836
2022-01-29;"Bratislavský kraj";1762;3138;326;3464;NA;344557;2088;2022-01-29;197056
2022-01-28;"Bratislavský kraj";2237;5047;389;5436;NA;344557;2626;2022-01-28;194968
2022-01-27;"Bratislavský kraj";2014;5975;334;6309;NA;344557;2348;2022-01-27;192342
2022-01-26;"Bratislavský kraj";1792;4895;367;5262;NA;344557;2159;2022-01-26;189994
2022-01-25;"Bratislavský kraj";1933;5551;385;5936;NA;344557;2318;2022-01-25;187835
2022-01-24;"Bratislavský kraj";1173;7911;315;8226;NA;344557;1488;2022-01-24;185517
2022-01-23;"Bratislavský kraj";862;3289;151;3440;NA;344557;1013;2022-01-23;184029
2022-01-22;"Bratislavský kraj";1130;2802;125;2927;NA;344557;1255;2022-01-22;183016
2022-01-21;"Bratislavský kraj";1057;4656;166;4822;NA;344557;1223;2022-01-21;181761
2022-01-20;"Bratislavský kraj";940;4893;146;5039;NA;344557;1086;2022-01-20;180538
2022-01-19;"Bratislavský kraj";857;4618;169;4787;NA;344557;1026;2022-01-19;179452
2022-01-18;"Bratislavský kraj";794;5002;163;5165;NA;344557;957;2022-01-18;178426
2022-01-17;"Bratislavský kraj";534;7242;150;7392;NA;344557;684;2022-01-17;177469
2022-01-16;"Bratislavský kraj";300;2854;77;2931;NA;344557;377;2022-01-16;176785
2022-01-15;"Bratislavský kraj";543;2139;71;2210;NA;344557;614;2022-01-15;176408
2022-01-14;"Bratislavský kraj";356;3692;70;3762;NA;344557;426;2022-01-14;175794
2022-01-13;"Bratislavský kraj";382;4579;82;4661;NA;344557;464;2022-01-13;175368
2022-01-12;"Bratislavský kraj";415;4014;71;4085;NA;344557;486;2022-01-12;174904
2022-01-11;"Bratislavský kraj";407;4910;110;5020;NA;344557;517;2022-01-11;174418
2022-01-10;"Bratislavský kraj";413;6380;101;6481;NA;344557;514;2022-01-10;173901
2022-01-09;"Bratislavský kraj";187;3080;71;3151;NA;344557;258;2022-01-09;173387
2022-01-08;"Bratislavský kraj";323;1951;58;2009;NA;344557;381;2022-01-08;173129
2022-01-07;"Bratislavský kraj";436;3809;100;3909;NA;344557;536;2022-01-07;172748
2022-01-06;"Bratislavský kraj";192;2163;51;2214;NA;344557;243;2022-01-06;172212
2022-01-05;"Bratislavský kraj";426;4047;69;4116;NA;344557;495;2022-01-05;171969
2022-01-04;"Bratislavský kraj";446;4467;101;4568;NA;344557;547;2022-01-04;171474
2022-01-03;"Bratislavský kraj";578;5672;129;5801;NA;344557;707;2022-01-03;170927
2022-01-02;"Bratislavský kraj";198;3137;80;3217;NA;344557;278;2022-01-02;170220
2022-01-01;"Bratislavský kraj";7;1103;36;1139;NA;344557;43;2022-01-01;169942
2021-12-31;"Bratislavský kraj";371;3443;92;3535;NA;344557;463;2021-12-31;169899
2021-12-30;"Bratislavský kraj";468;3619;119;3738;NA;344557;587;2021-12-30;169436
2021-12-29;"Bratislavský kraj";404;3598;85;3683;NA;344557;489;2021-12-29;168849
2021-12-28;"Bratislavský kraj";578;4329;121;4450;NA;344557;699;2021-12-28;168360
2021-12-27;"Bratislavský kraj";656;4693;108;4801;NA;344557;764;2021-12-27;167661
2021-12-26;"Bratislavský kraj";198;2549;83;2632;NA;344557;281;2021-12-26;166897
2021-12-25;"Bratislavský kraj";34;1160;53;1213;NA;344557;87;2021-12-25;166616
2021-12-24;"Bratislavský kraj";171;2214;55;2269;NA;344557;226;2021-12-24;166529
2021-12-23;"Bratislavský kraj";678;4134;115;4249;NA;344557;793;2021-12-23;166303
2021-12-22;"Bratislavský kraj";575;4919;118;5037;NA;344557;693;2021-12-22;165510
2021-12-21;"Bratislavský kraj";625;5628;167;5795;NA;344557;792;2021-12-21;164817
2021-12-20;"Bratislavský kraj";528;6163;158;6321;NA;344557;686;2021-12-20;164025
2021-12-19;"Bratislavský kraj";250;3042;98;3140;NA;344557;348;2021-12-19;163339
2021-12-18;"Bratislavský kraj";528;2654;103;2757;NA;344557;631;2021-12-18;162991
2021-12-17;"Bratislavský kraj";683;4917;145;5062;NA;344557;828;2021-12-17;162360
2021-12-16;"Bratislavský kraj";730;5576;162;5738;NA;344557;892;2021-12-16;161532
2021-12-15;"Bratislavský kraj";881;4884;158;5042;NA;344557;1039;2021-12-15;160640
2021-12-14;"Bratislavský kraj";869;5397;179;5576;NA;344557;1048;2021-12-14;159601
2021-12-13;"Bratislavský kraj";648;7614;239;7853;NA;344557;887;2021-12-13;158553
2021-12-12;"Bratislavský kraj";534;3474;129;3603;NA;344557;663;2021-12-12;157666
2021-12-11;"Bratislavský kraj";698;2377;153;2530;NA;344557;851;2021-12-11;157003
2021-12-10;"Bratislavský kraj";796;4728;186;4914;NA;344557;982;2021-12-10;156152
2021-12-09;"Bratislavský kraj";1040;4152;174;4326;NA;344557;1214;2021-12-09;155170
2021-12-08;"Bratislavský kraj";1172;4602;196;4798;NA;344557;1368;2021-12-08;153956
2021-12-07;"Bratislavský kraj";1236;5173;257;5430;NA;344557;1493;2021-12-07;152588
2021-12-06;"Bratislavský kraj";1434;8714;312;9026;NA;344557;1746;2021-12-06;151095
2021-12-05;"Bratislavský kraj";633;3874;197;4071;NA;344557;830;2021-12-05;149349
2021-12-04;"Bratislavský kraj";936;4332;195;4527;NA;344557;1131;2021-12-04;148519
2021-12-03;"Bratislavský kraj";1222;4351;269;4620;NA;344557;1491;2021-12-03;147388
2021-12-02;"Bratislavský kraj";2053;5097;311;5408;NA;344557;2364;2021-12-02;145897
2021-12-01;"Bratislavský kraj";1161;9058;295;9353;NA;344557;1456;2021-12-01;143533
2021-11-30;"Bratislavský kraj";1442;6508;355;6863;NA;344557;1797;2021-11-30;142077
2021-11-29;"Bratislavský kraj";863;8823;452;9275;NA;344557;1315;2021-11-29;140280
2021-11-28;"Bratislavský kraj";617;5102;295;5397;NA;344557;912;2021-11-28;138965
2021-11-27;"Bratislavský kraj";1026;3497;329;3826;NA;344557;1355;2021-11-27;138053
2021-11-26;"Bratislavský kraj";1346;5483;422;5905;NA;344557;1768;2021-11-26;136698
2021-11-25;"Bratislavský kraj";1415;6383;451;6834;NA;344557;1866;2021-11-25;134930
2021-11-24;"Bratislavský kraj";1286;6849;467;7316;NA;344557;1753;2021-11-24;133064
2021-11-23;"Bratislavský kraj";1651;6351;433;6784;NA;344557;2084;2021-11-23;131311
2021-11-22;"Bratislavský kraj";1197;8722;584;9306;NA;344557;1781;2021-11-22;129227
2021-11-21;"Bratislavský kraj";702;4324;320;4644;NA;344557;1022;2021-11-21;127446
2021-11-20;"Bratislavský kraj";1005;3514;360;3874;NA;344557;1365;2021-11-20;126424
2021-11-19;"Bratislavský kraj";1444;5927;549;6476;NA;344557;1993;2021-11-19;125059
2021-11-18;"Bratislavský kraj";1052;6358;548;6906;NA;344557;1600;2021-11-18;123066
2021-11-17;"Bratislavský kraj";832;2439;308;2747;NA;344557;1140;2021-11-17;121466
2021-11-16;"Bratislavský kraj";1067;5792;443;6235;NA;344557;1510;2021-11-16;120326
2021-11-15;"Bratislavský kraj";1014;6330;519;6849;NA;344557;1533;2021-11-15;118816
2021-11-14;"Bratislavský kraj";448;3202;335;3537;NA;344557;783;2021-11-14;117283
2021-11-13;"Bratislavský kraj";587;3251;313;3564;NA;344557;900;2021-11-13;116500
2021-11-12;"Bratislavský kraj";856;5723;357;6080;NA;344557;1213;2021-11-12;115600
2021-11-11;"Bratislavský kraj";787;6028;355;6383;NA;344557;1142;2021-11-11;114387
2021-11-10;"Bratislavský kraj";840;5903;385;6288;NA;344557;1225;2021-11-10;113245
2021-11-09;"Bratislavský kraj";939;5733;350;6083;NA;344557;1289;2021-11-09;112020
2021-11-08;"Bratislavský kraj";579;5641;404;6045;NA;344557;983;2021-11-08;110731
2021-11-07;"Bratislavský kraj";363;2836;244;3080;NA;344557;607;2021-11-07;109748
2021-11-06;"Bratislavský kraj";538;2901;243;3144;NA;344557;781;2021-11-06;109141
2021-11-05;"Bratislavský kraj";801;5640;318;5958;NA;344557;1119;2021-11-05;108360
2021-11-04;"Bratislavský kraj";768;5233;273;5506;NA;344557;1041;2021-11-04;107241
2021-11-03;"Bratislavský kraj";690;5120;290;5410;NA;344557;980;2021-11-03;106200
2021-11-02;"Bratislavský kraj";422;6356;327;6683;NA;344557;749;2021-11-02;105220
2021-11-01;"Bratislavský kraj";395;1733;136;1869;NA;344557;531;2021-11-01;104471
2021-10-31;"Bratislavský kraj";209;2280;163;2443;NA;344557;372;2021-10-31;103940
2021-10-30;"Bratislavský kraj";429;2138;118;2256;NA;344557;547;2021-10-30;103568
2021-10-29;"Bratislavský kraj";445;4757;219;4976;NA;344557;664;2021-10-29;103021
2021-10-28;"Bratislavský kraj";372;4777;179;4956;NA;344557;551;2021-10-28;102357
2021-10-27;"Bratislavský kraj";376;4522;164;4686;NA;344557;540;2021-10-27;101806
2021-10-26;"Bratislavský kraj";461;4492;188;4680;NA;344557;649;2021-10-26;101266
2021-10-25;"Bratislavský kraj";379;5347;192;5539;NA;344557;571;2021-10-25;100617
2021-10-24;"Bratislavský kraj";114;2369;91;2460;NA;344557;205;2021-10-24;100046
2021-10-23;"Bratislavský kraj";301;2666;91;2757;NA;344557;392;2021-10-23;99841
2021-10-22;"Bratislavský kraj";309;4466;122;4588;NA;344557;431;2021-10-22;99449
2021-10-21;"Bratislavský kraj";244;4544;101;4645;NA;344557;345;2021-10-21;99018
2021-10-20;"Bratislavský kraj";262;3897;95;3992;NA;344557;357;2021-10-20;98673
2021-10-19;"Bratislavský kraj";260;4116;68;4184;NA;344557;328;2021-10-19;98316
2021-10-18;"Bratislavský kraj";250;5014;114;5128;NA;344557;364;2021-10-18;97988
2021-10-17;"Bratislavský kraj";54;2460;73;2533;NA;344557;127;2021-10-17;97624
2021-10-16;"Bratislavský kraj";185;2687;63;2750;NA;344557;248;2021-10-16;97497
2021-10-15;"Bratislavský kraj";169;4200;64;4264;NA;344557;233;2021-10-15;97249
2021-10-14;"Bratislavský kraj";173;4714;61;4775;NA;344557;234;2021-10-14;97016
2021-10-13;"Bratislavský kraj";143;3671;76;3747;NA;344557;219;2021-10-13;96782
2021-10-12;"Bratislavský kraj";183;4037;78;4115;NA;344557;261;2021-10-12;96563
2021-10-11;"Bratislavský kraj";191;4798;88;4886;NA;344557;279;2021-10-11;96302
2021-10-10;"Bratislavský kraj";29;2176;43;2219;NA;344557;72;2021-10-10;96023
2021-10-09;"Bratislavský kraj";141;2419;34;2453;NA;344557;175;2021-10-09;95951
2021-10-08;"Bratislavský kraj";130;4511;63;4574;NA;344557;193;2021-10-08;95776
2021-10-07;"Bratislavský kraj";92;4137;61;4198;NA;344557;153;2021-10-07;95583
2021-10-06;"Bratislavský kraj";147;4028;68;4096;NA;344557;215;2021-10-06;95430
2021-10-05;"Bratislavský kraj";164;4468;70;4538;NA;344557;234;2021-10-05;95215
2021-10-04;"Bratislavský kraj";129;4653;79;4732;NA;344557;208;2021-10-04;94981
2021-10-03;"Bratislavský kraj";41;2144;42;2186;NA;344557;83;2021-10-03;94773
2021-10-02;"Bratislavský kraj";104;2605;40;2645;NA;344557;144;2021-10-02;94690
2021-10-01;"Bratislavský kraj";108;4818;57;4875;NA;344557;165;2021-10-01;94546
2021-09-30;"Bratislavský kraj";90;3854;60;3914;NA;344557;150;2021-09-30;94381
2021-09-29;"Bratislavský kraj";115;3508;58;3566;NA;344557;173;2021-09-29;94231
2021-09-28;"Bratislavský kraj";144;4003;48;4051;NA;344557;192;2021-09-28;94058
2021-09-27;"Bratislavský kraj";123;4427;70;4497;NA;344557;193;2021-09-27;93866
2021-09-26;"Bratislavský kraj";32;2194;31;2225;NA;344557;63;2021-09-26;93673
2021-09-25;"Bratislavský kraj";85;2742;38;2780;NA;344557;123;2021-09-25;93610
2021-09-24;"Bratislavský kraj";82;4212;59;4271;NA;344557;141;2021-09-24;93487
2021-09-23;"Bratislavský kraj";90;3975;51;4026;NA;344557;141;2021-09-23;93346
2021-09-22;"Bratislavský kraj";84;3757;63;3820;NA;344557;147;2021-09-22;93205
2021-09-21;"Bratislavský kraj";95;3574;39;3613;NA;344557;134;2021-09-21;93058
2021-09-20;"Bratislavský kraj";84;3937;31;3968;NA;344557;115;2021-09-20;92924
2021-09-19;"Bratislavský kraj";31;1850;28;1878;NA;344557;59;2021-09-19;92809
2021-09-18;"Bratislavský kraj";60;1989;19;2008;NA;344557;79;2021-09-18;92750
2021-09-17;"Bratislavský kraj";87;3443;27;3470;NA;344557;114;2021-09-17;92671
2021-09-16;"Bratislavský kraj";57;3781;43;3824;NA;344557;100;2021-09-16;92557
2021-09-15;"Bratislavský kraj";41;1104;21;1125;NA;344557;62;2021-09-15;92457
2021-09-14;"Bratislavský kraj";78;3518;31;3549;NA;344557;109;2021-09-14;92395
2021-09-13;"Bratislavský kraj";47;3191;28;3219;NA;344557;75;2021-09-13;92286
2021-09-12;"Bratislavský kraj";13;1713;21;1734;NA;344557;34;2021-09-12;92211
2021-09-11;"Bratislavský kraj";36;2064;13;2077;NA;344557;49;2021-09-11;92177
2021-09-10;"Bratislavský kraj";47;3628;18;3646;NA;344557;65;2021-09-10;92128
2021-09-09;"Bratislavský kraj";50;3010;30;3040;NA;344557;80;2021-09-09;92063
2021-09-08;"Bratislavský kraj";56;2925;20;2945;NA;344557;76;2021-09-08;91983
2021-09-07;"Bratislavský kraj";50;3272;18;3290;NA;344557;68;2021-09-07;91907
2021-09-06;"Bratislavský kraj";63;2821;29;2850;NA;344557;92;2021-09-06;91839
2021-09-05;"Bratislavský kraj";10;1682;14;1696;NA;344557;24;2021-09-05;91747
2021-09-04;"Bratislavský kraj";41;2612;11;2623;NA;344557;52;2021-09-04;91723
2021-09-03;"Bratislavský kraj";55;3016;14;3030;NA;344557;69;2021-09-03;91671
2021-09-02;"Bratislavský kraj";35;2423;23;2446;NA;344557;58;2021-09-02;91602
2021-09-01;"Bratislavský kraj";16;929;9;938;NA;344557;25;2021-09-01;91544
2021-08-31;"Bratislavský kraj";28;5197;22;5219;NA;344557;50;2021-08-31;91519
2021-08-30;"Bratislavský kraj";24;2403;13;2416;NA;344557;37;2021-08-30;91469
2021-08-29;"Bratislavský kraj";11;1016;6;1022;NA;344557;17;2021-08-29;91432
2021-08-28;"Bratislavský kraj";24;1714;11;1725;NA;344557;35;2021-08-28;91415
2021-08-27;"Bratislavský kraj";19;2850;9;2859;NA;344557;28;2021-08-27;91380
2021-08-26;"Bratislavský kraj";15;2382;19;2401;NA;344557;34;2021-08-26;91352
2021-08-25;"Bratislavský kraj";29;1888;10;1898;NA;344557;39;2021-08-25;91318
2021-08-24;"Bratislavský kraj";22;1785;4;1789;NA;344557;26;2021-08-24;91279
2021-08-23;"Bratislavský kraj";21;2183;7;2190;NA;344557;28;2021-08-23;91253
2021-08-22;"Bratislavský kraj";5;1383;8;1391;NA;344557;13;2021-08-22;91225
2021-08-21;"Bratislavský kraj";18;1681;4;1685;NA;344557;22;2021-08-21;91212
2021-08-20;"Bratislavský kraj";27;2747;19;2766;NA;344557;46;2021-08-20;91190
2021-08-19;"Bratislavský kraj";15;2122;9;2131;NA;344557;24;2021-08-19;91144
2021-08-18;"Bratislavský kraj";16;1659;11;1670;NA;344557;27;2021-08-18;91120
2021-08-17;"Bratislavský kraj";18;1608;5;1613;NA;344557;23;2021-08-17;91093
2021-08-16;"Bratislavský kraj";18;2559;12;2571;NA;344557;30;2021-08-16;91070
2021-08-15;"Bratislavský kraj";3;1169;6;1175;NA;344557;9;2021-08-15;91040
2021-08-14;"Bratislavský kraj";11;1519;4;1523;NA;344557;15;2021-08-14;91031
2021-08-13;"Bratislavský kraj";32;2634;7;2641;NA;344557;39;2021-08-13;91016
2021-08-12;"Bratislavský kraj";16;1824;9;1833;NA;344557;25;2021-08-12;90977
2021-08-11;"Bratislavský kraj";22;1621;5;1626;NA;344557;27;2021-08-11;90952
2021-08-10;"Bratislavský kraj";15;1630;7;1637;NA;344557;22;2021-08-10;90925
2021-08-09;"Bratislavský kraj";35;1927;9;1936;NA;344557;44;2021-08-09;90903
2021-08-08;"Bratislavský kraj";3;1152;4;1156;NA;344557;7;2021-08-08;90859
2021-08-07;"Bratislavský kraj";6;1572;9;1581;NA;344557;15;2021-08-07;90852
2021-08-06;"Bratislavský kraj";9;2510;10;2520;NA;344557;19;2021-08-06;90837
2021-08-05;"Bratislavský kraj";10;1651;7;1658;NA;344557;17;2021-08-05;90818
2021-08-04;"Bratislavský kraj";9;1578;0;1578;NA;344557;9;2021-08-04;90801
2021-08-03;"Bratislavský kraj";11;1507;5;1512;NA;344557;16;2021-08-03;90792
2021-08-02;"Bratislavský kraj";15;1749;11;1760;NA;344557;26;2021-08-02;90776
2021-08-01;"Bratislavský kraj";4;1224;8;1232;NA;344557;12;2021-08-01;90750
2021-07-31;"Bratislavský kraj";7;1623;2;1625;NA;344557;9;2021-07-31;90738
2021-07-30;"Bratislavský kraj";15;2540;7;2547;NA;344557;22;2021-07-30;90729
2021-07-29;"Bratislavský kraj";19;1790;7;1797;NA;344557;26;2021-07-29;90707
2021-07-28;"Bratislavský kraj";8;1538;11;1549;NA;344557;19;2021-07-28;90681
2021-07-27;"Bratislavský kraj";9;1476;5;1481;NA;344557;14;2021-07-27;90662
2021-07-26;"Bratislavský kraj";17;1806;7;1813;NA;344557;24;2021-07-26;90648
2021-07-25;"Bratislavský kraj";4;1411;2;1413;NA;344557;6;2021-07-25;90624
2021-07-24;"Bratislavský kraj";9;1732;3;1735;NA;344557;12;2021-07-24;90618
2021-07-23;"Bratislavský kraj";6;2400;3;2403;NA;344557;9;2021-07-23;90606
2021-07-22;"Bratislavský kraj";12;1944;6;1950;NA;344557;18;2021-07-22;90597
2021-07-21;"Bratislavský kraj";5;1860;6;1866;NA;344557;11;2021-07-21;90579
2021-07-20;"Bratislavský kraj";19;1559;1;1560;NA;344557;20;2021-07-20;90568
2021-07-19;"Bratislavský kraj";15;2259;3;2262;NA;344557;18;2021-07-19;90548
2021-07-18;"Bratislavský kraj";2;1462;3;1465;NA;344557;5;2021-07-18;90530
2021-07-17;"Bratislavský kraj";3;1870;2;1872;NA;344557;5;2021-07-17;90525
2021-07-16;"Bratislavský kraj";8;2834;4;2838;NA;344557;12;2021-07-16;90520
2021-07-15;"Bratislavský kraj";5;1677;0;1677;NA;344557;5;2021-07-15;90508
2021-07-14;"Bratislavský kraj";5;1904;3;1907;NA;344557;8;2021-07-14;90503
2021-07-13;"Bratislavský kraj";4;1584;4;1588;NA;344557;8;2021-07-13;90495
2021-07-12;"Bratislavský kraj";6;1780;5;1785;NA;344557;11;2021-07-12;90487
2021-07-11;"Bratislavský kraj";3;1896;3;1899;NA;344557;6;2021-07-11;90476
2021-07-10;"Bratislavský kraj";5;2240;3;2243;NA;344557;8;2021-07-10;90470
2021-07-09;"Bratislavský kraj";13;3546;7;3553;NA;344557;20;2021-07-09;90462
2021-07-08;"Bratislavský kraj";9;2433;4;2437;NA;344557;13;2021-07-08;90442
2021-07-07;"Bratislavský kraj";5;2792;4;2796;NA;344557;9;2021-07-07;90429
2021-07-06;"Bratislavský kraj";19;2771;4;2775;NA;344557;23;2021-07-06;90420
2021-07-05;"Bratislavský kraj";5;2481;5;2486;NA;344557;10;2021-07-05;90397
2021-07-04;"Bratislavský kraj";3;1824;2;1826;NA;344557;5;2021-07-04;90387
2021-07-03;"Bratislavský kraj";8;2205;5;2210;NA;344557;13;2021-07-03;90382
2021-07-02;"Bratislavský kraj";4;2227;4;2231;NA;344557;8;2021-07-02;90369
2021-07-01;"Bratislavský kraj";6;1809;5;1814;NA;344557;11;2021-07-01;90361
2021-06-30;"Bratislavský kraj";2;11548;11;11559;NA;344557;13;2021-06-30;90350
2021-06-29;"Bratislavský kraj";5;6831;7;6838;NA;344557;12;2021-06-29;90337
2021-06-28;"Bratislavský kraj";16;6654;24;6678;NA;344557;40;2021-06-28;90325
2021-06-27;"Bratislavský kraj";4;6689;11;6700;NA;344557;15;2021-06-27;90285
2021-06-26;"Bratislavský kraj";3;8741;6;8747;NA;344557;9;2021-06-26;90270
2021-06-25;"Bratislavský kraj";7;10285;15;10300;NA;344557;22;2021-06-25;90261
2021-06-24;"Bratislavský kraj";3;7384;16;7400;NA;344557;19;2021-06-24;90239
2021-06-23;"Bratislavský kraj";4;7346;12;7358;NA;344557;16;2021-06-23;90220
2021-06-22;"Bratislavský kraj";6;7244;10;7254;NA;344557;16;2021-06-22;90204
2021-06-21;"Bratislavský kraj";5;7641;9;7650;NA;344557;14;2021-06-21;90188
2021-06-20;"Bratislavský kraj";0;7369;5;7374;NA;344557;5;2021-06-20;90174
2021-06-19;"Bratislavský kraj";3;9226;4;9230;NA;344557;7;2021-06-19;90169
2021-06-18;"Bratislavský kraj";5;12763;9;12772;NA;344557;14;2021-06-18;90162
2021-06-17;"Bratislavský kraj";3;8625;13;8638;NA;344557;16;2021-06-17;90148
2021-06-16;"Bratislavský kraj";3;7105;4;7109;NA;344557;7;2021-06-16;90132
2021-06-15;"Bratislavský kraj";7;7309;17;7326;NA;344557;24;2021-06-15;90125
2021-06-14;"Bratislavský kraj";4;8231;9;8240;NA;344557;13;2021-06-14;90101
2021-06-13;"Bratislavský kraj";2;8791;11;8802;NA;344557;13;2021-06-13;90088
2021-06-12;"Bratislavský kraj";4;11152;11;11163;NA;344557;15;2021-06-12;90075
2021-06-11;"Bratislavský kraj";9;13644;21;13665;NA;344557;30;2021-06-11;90060
2021-06-10;"Bratislavský kraj";12;8637;15;8652;NA;344557;27;2021-06-10;90030
2021-06-09;"Bratislavský kraj";12;7596;12;7608;NA;344557;24;2021-06-09;90003
2021-06-08;"Bratislavský kraj";13;7907;29;7936;NA;344557;42;2021-06-08;89979
2021-06-07;"Bratislavský kraj";13;9247;43;9290;NA;344557;56;2021-06-07;89937
2021-06-06;"Bratislavský kraj";3;10350;20;10370;NA;344557;23;2021-06-06;89881
2021-06-05;"Bratislavský kraj";2;12692;15;12707;NA;344557;17;2021-06-05;89858
2021-06-04;"Bratislavský kraj";10;13846;31;13877;NA;344557;41;2021-06-04;89841
2021-06-03;"Bratislavský kraj";12;9615;19;9634;NA;344557;31;2021-06-03;89800
2021-06-02;"Bratislavský kraj";10;8684;17;8701;NA;344557;27;2021-06-02;89769
2021-06-01;"Bratislavský kraj";3;8812;25;8837;NA;344557;28;2021-06-01;89742
2021-05-31;"Bratislavský kraj";18;11248;32;11280;NA;344557;50;2021-05-31;89714
2021-05-30;"Bratislavský kraj";1;11758;17;11775;NA;344557;18;2021-05-30;89664
2021-05-29;"Bratislavský kraj";4;12245;8;12253;NA;344557;12;2021-05-29;89646
2021-05-28;"Bratislavský kraj";14;15865;23;15888;NA;344557;37;2021-05-28;89634
2021-05-27;"Bratislavský kraj";5;11321;18;11339;NA;344557;23;2021-05-27;89597
2021-05-26;"Bratislavský kraj";20;10709;17;10726;NA;344557;37;2021-05-26;89574
2021-05-25;"Bratislavský kraj";19;11864;31;11895;NA;344557;50;2021-05-25;89537
2021-05-24;"Bratislavský kraj";12;12966;23;12989;NA;344557;35;2021-05-24;89487
2021-05-23;"Bratislavský kraj";7;13074;24;13098;NA;344557;31;2021-05-23;89452
2021-05-22;"Bratislavský kraj";6;14044;22;14066;NA;344557;28;2021-05-22;89421
2021-05-21;"Bratislavský kraj";15;18996;22;19018;NA;344557;37;2021-05-21;89393
2021-05-20;"Bratislavský kraj";15;14112;17;14129;NA;344557;32;2021-05-20;89356
2021-05-19;"Bratislavský kraj";21;11958;24;11982;NA;344557;45;2021-05-19;89324
2021-05-18;"Bratislavský kraj";14;13005;33;13038;NA;344557;47;2021-05-18;89279
2021-05-17;"Bratislavský kraj";15;13854;29;13883;NA;344557;44;2021-05-17;89232
2021-05-16;"Bratislavský kraj";12;19797;32;19829;NA;344557;44;2021-05-16;89188
2021-05-15;"Bratislavský kraj";1;18113;30;18143;NA;344557;31;2021-05-15;89144
2021-05-14;"Bratislavský kraj";15;22228;30;22258;NA;344557;45;2021-05-14;89113
2021-05-13;"Bratislavský kraj";9;16211;17;16228;NA;344557;26;2021-05-13;89068
2021-05-12;"Bratislavský kraj";11;14638;28;14666;NA;344557;39;2021-05-12;89042
2021-05-11;"Bratislavský kraj";29;16741;32;16773;NA;344557;61;2021-05-11;89003
2021-05-10;"Bratislavský kraj";27;19991;64;20055;NA;344557;91;2021-05-10;88942
2021-05-09;"Bratislavský kraj";9;29358;32;29390;NA;344557;41;2021-05-09;88851
2021-05-08;"Bratislavský kraj";5;19451;24;19475;NA;344557;29;2021-05-08;88810
2021-05-07;"Bratislavský kraj";32;28211;65;28276;NA;344557;97;2021-05-07;88781
2021-05-06;"Bratislavský kraj";19;20079;52;20131;NA;344557;71;2021-05-06;88684
2021-05-05;"Bratislavský kraj";29;15526;31;15557;NA;344557;60;2021-05-05;88613
2021-05-04;"Bratislavský kraj";46;19143;53;19196;NA;344557;99;2021-05-04;88553
2021-05-03;"Bratislavský kraj";37;22322;64;22386;NA;344557;101;2021-05-03;88454
2021-05-02;"Bratislavský kraj";38;43064;75;43139;NA;344557;113;2021-05-02;88353
2021-05-01;"Bratislavský kraj";11;39905;40;39945;NA;344557;51;2021-05-01;88240
2021-04-30;"Bratislavský kraj";43;47403;82;47485;NA;344557;125;2021-04-30;88189
2021-04-29;"Bratislavský kraj";48;30257;96;30353;NA;344557;144;2021-04-29;88064
2021-04-28;"Bratislavský kraj";40;28905;78;28983;NA;344557;118;2021-04-28;87920
2021-04-27;"Bratislavský kraj";41;30168;52;30220;NA;344557;93;2021-04-27;87802
2021-04-26;"Bratislavský kraj";59;34733;97;34830;NA;344557;156;2021-04-26;87709
2021-04-25;"Bratislavský kraj";8;57615;74;57689;NA;344557;82;2021-04-25;87553
2021-04-24;"Bratislavský kraj";28;74858;66;74924;NA;344557;94;2021-04-24;87471
2021-04-23;"Bratislavský kraj";70;48614;62;48676;NA;344557;132;2021-04-23;87377
2021-04-22;"Bratislavský kraj";39;31037;72;31109;NA;344557;111;2021-04-22;87245
2021-04-21;"Bratislavský kraj";48;30442;62;30504;NA;344557;110;2021-04-21;87134
2021-04-20;"Bratislavský kraj";58;35216;63;35279;NA;344557;121;2021-04-20;87024
2021-04-19;"Bratislavský kraj";48;39500;80;39580;NA;344557;128;2021-04-19;86903
2021-04-18;"Bratislavský kraj";35;62300;76;62376;NA;344557;111;2021-04-18;86775
2021-04-17;"Bratislavský kraj";13;80359;111;80470;NA;344557;124;2021-04-17;86664
2021-04-16;"Bratislavský kraj";62;47296;80;47376;NA;344557;142;2021-04-16;86540
2021-04-15;"Bratislavský kraj";34;32176;74;32250;NA;344557;108;2021-04-15;86398
2021-04-14;"Bratislavský kraj";65;33961;88;34049;NA;344557;153;2021-04-14;86290
2021-04-13;"Bratislavský kraj";82;35512;82;35594;NA;344557;164;2021-04-13;86137
2021-04-12;"Bratislavský kraj";77;42286;115;42401;NA;344557;192;2021-04-12;85973
2021-04-11;"Bratislavský kraj";42;61151;123;61274;NA;344557;165;2021-04-11;85781
2021-04-10;"Bratislavský kraj";14;77874;167;78041;NA;344557;181;2021-04-10;85616
2021-04-09;"Bratislavský kraj";72;41556;97;41653;NA;344557;169;2021-04-09;85435
2021-04-08;"Bratislavský kraj";71;28866;95;28961;NA;344557;166;2021-04-08;85266
2021-04-07;"Bratislavský kraj";96;38061;101;38162;NA;344557;197;2021-04-07;85100
2021-04-06;"Bratislavský kraj";94;56204;179;56383;NA;344557;273;2021-04-06;84903
2021-04-05;"Bratislavský kraj";85;18538;85;18623;NA;344557;170;2021-04-05;84630
2021-04-04;"Bratislavský kraj";37;29225;75;29300;NA;344557;112;2021-04-04;84460
2021-04-03;"Bratislavský kraj";52;79865;220;80085;NA;344557;272;2021-04-03;84348
2021-04-02;"Bratislavský kraj";33;23790;104;23894;NA;344557;137;2021-04-02;84076
2021-04-01;"Bratislavský kraj";119;57388;159;57547;NA;344557;278;2021-04-01;83939
2021-03-31;"Bratislavský kraj";105;46371;177;46548;NA;344557;282;2021-03-31;83661
2021-03-30;"Bratislavský kraj";100;39599;144;39743;NA;344557;244;2021-03-30;83379
2021-03-29;"Bratislavský kraj";153;40364;178;40542;NA;344557;331;2021-03-29;83135
2021-03-28;"Bratislavský kraj";59;53372;137;53509;NA;344557;196;2021-03-28;82804
2021-03-27;"Bratislavský kraj";53;79834;240;80074;NA;344557;293;2021-03-27;82608
2021-03-26;"Bratislavský kraj";114;56108;191;56299;NA;344557;305;2021-03-26;82315
2021-03-25;"Bratislavský kraj";76;36859;172;37031;NA;344557;248;2021-03-25;82010
2021-03-24;"Bratislavský kraj";120;30567;201;30768;NA;344557;321;2021-03-24;81762
2021-03-23;"Bratislavský kraj";138;36438;190;36628;NA;344557;328;2021-03-23;81441
2021-03-22;"Bratislavský kraj";110;42756;220;42976;NA;344557;330;2021-03-22;81113
2021-03-21;"Bratislavský kraj";54;61299;212;61511;NA;344557;266;2021-03-21;80783
2021-03-20;"Bratislavský kraj";59;73300;228;73528;NA;344557;287;2021-03-20;80517
2021-03-19;"Bratislavský kraj";139;54576;257;54833;NA;344557;396;2021-03-19;80230
2021-03-18;"Bratislavský kraj";142;34611;192;34803;NA;344557;334;2021-03-18;79834
2021-03-17;"Bratislavský kraj";177;30482;217;30699;NA;344557;394;2021-03-17;79500
2021-03-16;"Bratislavský kraj";258;36798;287;37085;NA;344557;545;2021-03-16;79106
2021-03-15;"Bratislavský kraj";180;38226;255;38481;NA;344557;435;2021-03-15;78561
2021-03-14;"Bratislavský kraj";75;52611;275;52886;NA;344557;350;2021-03-14;78126
2021-03-13;"Bratislavský kraj";110;81405;341;81746;NA;344557;451;2021-03-13;77776
2021-03-12;"Bratislavský kraj";152;55233;312;55545;NA;344557;464;2021-03-12;77325
2021-03-11;"Bratislavský kraj";178;34678;286;34964;NA;344557;464;2021-03-11;76861
2021-03-10;"Bratislavský kraj";164;31061;280;31341;NA;344557;444;2021-03-10;76397
2021-03-09;"Bratislavský kraj";242;37687;267;37954;NA;344557;509;2021-03-09;75953
2021-03-08;"Bratislavský kraj";255;41199;348;41547;NA;344557;603;2021-03-08;75444
2021-03-07;"Bratislavský kraj";142;52812;301;53113;NA;344557;443;2021-03-07;74841
2021-03-06;"Bratislavský kraj";79;71821;415;72236;NA;344557;494;2021-03-06;74398
2021-03-05;"Bratislavský kraj";238;50653;293;50946;NA;344557;531;2021-03-05;73904
2021-03-04;"Bratislavský kraj";204;34544;344;34888;NA;344557;548;2021-03-04;73373
2021-03-03;"Bratislavský kraj";250;30527;364;30891;NA;344557;614;2021-03-03;72825
2021-03-02;"Bratislavský kraj";267;39735;388;40123;NA;344557;655;2021-03-02;72211
2021-03-01;"Bratislavský kraj";320;38222;432;38654;NA;344557;752;2021-03-01;71556
2021-02-28;"Bratislavský kraj";184;50323;323;50646;NA;344557;507;2021-02-28;70804
2021-02-27;"Bratislavský kraj";151;76580;464;77044;NA;344557;615;2021-02-27;70297
2021-02-26;"Bratislavský kraj";277;47326;401;47727;NA;344557;678;2021-02-26;69682
2021-02-25;"Bratislavský kraj";277;28769;405;29174;NA;344557;682;2021-02-25;69004
2021-02-24;"Bratislavský kraj";217;27095;412;27507;NA;344557;629;2021-02-24;68322
2021-02-23;"Bratislavský kraj";257;31297;395;31692;NA;344557;652;2021-02-23;67693
2021-02-22;"Bratislavský kraj";353;36607;483;37090;NA;344557;836;2021-02-22;67041
2021-02-21;"Bratislavský kraj";185;54150;396;54546;NA;344557;581;2021-02-21;66205
2021-02-20;"Bratislavský kraj";167;74814;550;75364;NA;344557;717;2021-02-20;65624
2021-02-19;"Bratislavský kraj";280;44882;416;45298;NA;344557;696;2021-02-19;64907
2021-02-18;"Bratislavský kraj";263;26379;371;26750;NA;344557;634;2021-02-18;64211
2021-02-17;"Bratislavský kraj";264;22820;316;23136;NA;344557;580;2021-02-17;63577
2021-02-16;"Bratislavský kraj";289;28262;352;28614;NA;344557;641;2021-02-16;62997
2021-02-15;"Bratislavský kraj";248;36893;396;37289;NA;344557;644;2021-02-15;62356
2021-02-14;"Bratislavský kraj";153;47948;323;48271;NA;344557;476;2021-02-14;61712
2021-02-13;"Bratislavský kraj";173;68589;515;69104;NA;344557;688;2021-02-13;61236
2021-02-12;"Bratislavský kraj";282;35729;327;36056;NA;344557;609;2021-02-12;60548
2021-02-11;"Bratislavský kraj";337;24565;285;24850;NA;344557;622;2021-02-11;59939
2021-02-10;"Bratislavský kraj";314;22944;356;23300;NA;344557;670;2021-02-10;59317
2021-02-09;"Bratislavský kraj";288;36565;454;37019;NA;344557;742;2021-02-09;58647
2021-02-08;"Bratislavský kraj";484;31896;397;32293;NA;344557;881;2021-02-08;57905
2021-02-07;"Bratislavský kraj";243;51290;425;51715;NA;344557;668;2021-02-07;57024
2021-02-06;"Bratislavský kraj";116;61682;501;62183;NA;344557;617;2021-02-06;56356
2021-02-05;"Bratislavský kraj";327;27033;375;27408;NA;344557;702;2021-02-05;55739
2021-02-04;"Bratislavský kraj";555;17260;348;17608;NA;344557;903;2021-02-04;55037
2021-02-03;"Bratislavský kraj";161;13020;352;13372;NA;344557;513;2021-02-03;54134
2021-02-02;"Bratislavský kraj";397;25947;480;26427;NA;344557;877;2021-02-02;53621
2021-02-01;"Bratislavský kraj";221;35541;513;36054;NA;344557;734;2021-02-01;52744
2021-01-31;"Bratislavský kraj";180;35693;425;36118;NA;344557;605;2021-01-31;52010
2021-01-30;"Bratislavský kraj";310;49588;521;50109;NA;344557;831;2021-01-30;51405
2021-01-29;"Bratislavský kraj";344;16568;344;16912;NA;344557;688;2021-01-29;50574
2021-01-28;"Bratislavský kraj";307;10715;297;11012;NA;344557;604;2021-01-28;49886
2021-01-27;"Bratislavský kraj";336;22222;345;22567;NA;344557;681;2021-01-27;49282
2021-01-26;"Bratislavský kraj";297;21894;300;22194;NA;344557;597;2021-01-26;48601
2021-01-25;"Bratislavský kraj";356;23335;249;23584;NA;344557;605;2021-01-25;48004
2021-01-24;"Bratislavský kraj";175;37903;404;38307;NA;344557;579;2021-01-24;47399
2021-01-23;"Bratislavský kraj";396;79453;690;80143;NA;344557;1086;2021-01-23;46820
2021-01-22;"Bratislavský kraj";199;42055;365;42420;NA;344557;564;2021-01-22;45734
2021-01-21;"Bratislavský kraj";255;105746;1317;107063;NA;344557;1572;2021-01-21;45170
2021-01-20;"Bratislavský kraj";360;27289;452;27741;NA;344557;812;2021-01-20;43598
2021-01-19;"Bratislavský kraj";375;15318;346;15664;NA;344557;721;2021-01-19;42786
2021-01-18;"Bratislavský kraj";357;12533;707;13240;NA;344557;1064;2021-01-18;42065
2021-01-17;"Bratislavský kraj";244;482;26;508;NA;344557;270;2021-01-17;41001
2021-01-16;"Bratislavský kraj";70;3016;156;3172;NA;344557;226;2021-01-16;40731
2021-01-15;"Bratislavský kraj";251;7896;256;8152;NA;344557;507;2021-01-15;40505
2021-01-14;"Bratislavský kraj";363;8523;273;8796;NA;344557;636;2021-01-14;39998
2021-01-13;"Bratislavský kraj";336;8490;327;8817;NA;344557;663;2021-01-13;39362
2021-01-12;"Bratislavský kraj";450;10509;455;10964;NA;344557;905;2021-01-12;38699
2021-01-11;"Bratislavský kraj";397;19863;364;20227;NA;344557;761;2021-01-11;37794
2021-01-10;"Bratislavský kraj";252;1507;79;1586;NA;344557;331;2021-01-10;37033
2021-01-09;"Bratislavský kraj";351;4721;277;4998;NA;344557;628;2021-01-09;36702
2021-01-08;"Bratislavský kraj";556;10045;436;10481;NA;344557;992;2021-01-08;36074
2021-01-07;"Bratislavský kraj";537;6872;352;7224;NA;344557;889;2021-01-07;35082
2021-01-06;"Bratislavský kraj";271;3329;216;3545;NA;344557;487;2021-01-06;34193
2021-01-05;"Bratislavský kraj";619;10635;814;11449;NA;344557;1433;2021-01-05;33706
2021-01-04;"Bratislavský kraj";601;8226;538;8764;NA;344557;1139;2021-01-04;32273
2021-01-03;"Bratislavský kraj";77;433;41;474;NA;344557;118;2021-01-03;31134
2021-01-02;"Bratislavský kraj";185;462;57;519;NA;344557;242;2021-01-02;31016
2021-01-01;"Bratislavský kraj";235;3277;131;3408;NA;344557;366;2021-01-01;30774
2020-12-31;"Bratislavský kraj";925;14135;519;14654;NA;344557;1444;2020-12-31;30408
2020-12-30;"Bratislavský kraj";650;9164;533;9697;NA;344557;1183;2020-12-30;28964
2020-12-29;"Bratislavský kraj";303;10108;699;10807;NA;344557;1002;2020-12-29;27781
2020-12-28;"Bratislavský kraj";255;7784;473;8257;NA;344557;728;2020-12-28;26779
2020-12-27;"Bratislavský kraj";160;709;76;785;NA;344557;236;2020-12-27;26051
2020-12-26;"Bratislavský kraj";75;480;27;507;NA;344557;102;2020-12-26;25815
2020-12-25;"Bratislavský kraj";114;503;38;541;NA;344557;152;2020-12-25;25713
2020-12-24;"Bratislavský kraj";536;3367;104;3471;NA;344557;640;2020-12-24;25561
2020-12-23;"Bratislavský kraj";416;12590;447;13037;NA;344557;863;2020-12-23;24921
2020-12-22;"Bratislavský kraj";327;14587;699;15286;NA;344557;1026;2020-12-22;24058
2020-12-21;"Bratislavský kraj";392;14972;1946;16918;NA;344557;2338;2020-12-21;23032
2020-12-20;"Bratislavský kraj";180;797;57;854;NA;344557;237;2020-12-20;20694
2020-12-19;"Bratislavský kraj";396;3314;130;3444;NA;344557;526;2020-12-19;20457
2020-12-18;"Bratislavský kraj";306;9938;345;10283;NA;344557;651;2020-12-18;19931
2020-12-17;"Bratislavský kraj";502;9739;386;10125;NA;344557;888;2020-12-17;19280
2020-12-16;"Bratislavský kraj";282;10201;418;10619;NA;344557;700;2020-12-16;18392
2020-12-15;"Bratislavský kraj";423;10450;454;10904;NA;344557;877;2020-12-15;17692
2020-12-14;"Bratislavský kraj";279;6793;261;7054;NA;344557;540;2020-12-14;16815
2020-12-13;"Bratislavský kraj";125;139;10;149;NA;344557;135;2020-12-13;16275
2020-12-12;"Bratislavský kraj";361;3886;157;4043;NA;344557;518;2020-12-12;16140
2020-12-11;"Bratislavský kraj";326;6824;235;7059;NA;344557;561;2020-12-11;15622
2020-12-10;"Bratislavský kraj";286;5279;166;5445;NA;344557;452;2020-12-10;15061
2020-12-09;"Bratislavský kraj";382;4778;177;4955;NA;344557;559;2020-12-09;14609
2020-12-08;"Bratislavský kraj";234;6243;207;6450;NA;344557;441;2020-12-08;14050
2020-12-07;"Bratislavský kraj";272;4639;152;4791;NA;344557;424;2020-12-07;13609
2020-12-06;"Bratislavský kraj";61;1625;52;1677;NA;344557;113;2020-12-06;13185
2020-12-05;"Bratislavský kraj";266;2221;41;2262;NA;344557;307;2020-12-05;13072
2020-12-04;"Bratislavský kraj";200;4954;99;5053;NA;344557;299;2020-12-04;12765
2020-12-03;"Bratislavský kraj";213;5672;95;5767;NA;344557;308;2020-12-03;12466
2020-12-02;"Bratislavský kraj";205;3462;103;3565;NA;344557;308;2020-12-02;12158
2020-12-01;"Bratislavský kraj";255;3889;172;4061;NA;344557;427;2020-12-01;11850
2020-11-30;"Bratislavský kraj";152;2153;121;2274;NA;344557;273;2020-11-30;11423
2020-11-29;"Bratislavský kraj";52;201;24;225;NA;344557;76;2020-11-29;11150
2020-11-28;"Bratislavský kraj";232;2624;33;2657;NA;344557;265;2020-11-28;11074
2020-11-27;"Bratislavský kraj";54;2540;64;2604;NA;344557;118;2020-11-27;10809
2020-11-26;"Bratislavský kraj";129;1976;60;2036;NA;344557;189;2020-11-26;10691
2020-11-25;"Bratislavský kraj";140;1770;47;1817;NA;344557;187;2020-11-25;10502
2020-11-24;"Bratislavský kraj";81;2988;67;3055;NA;344557;148;2020-11-24;10315
2020-11-23;"Bratislavský kraj";67;7083;58;7141;NA;344557;125;2020-11-23;10167
2020-11-22;"Bratislavský kraj";36;81;7;88;NA;344557;43;2020-11-22;10042
2020-11-21;"Bratislavský kraj";109;2126;47;2173;NA;344557;156;2020-11-21;9999
2020-11-20;"Bratislavský kraj";118;2876;48;2924;NA;344557;166;2020-11-20;9843
2020-11-19;"Bratislavský kraj";173;987;29;1016;NA;344557;202;2020-11-19;9677
2020-11-18;"Bratislavský kraj";118;616;75;691;NA;344557;193;2020-11-18;9475
2020-11-17;"Bratislavský kraj";108;928;23;951;NA;344557;131;2020-11-17;9282
2020-11-16;"Bratislavský kraj";82;651;9;660;NA;344557;91;2020-11-16;9151
2020-11-15;"Bratislavský kraj";47;236;0;236;NA;344557;47;2020-11-15;9060
2020-11-14;"Bratislavský kraj";53;1834;15;1849;NA;344557;68;2020-11-14;9013
2020-11-13;"Bratislavský kraj";94;2096;21;2117;NA;344557;115;2020-11-13;8945
2020-11-12;"Bratislavský kraj";141;1727;6;1733;NA;344557;147;2020-11-12;8830
2020-11-11;"Bratislavský kraj";159;1429;12;1441;NA;344557;171;2020-11-11;8683
2020-11-10;"Bratislavský kraj";136;805;14;819;NA;344557;150;2020-11-10;8512
2020-11-09;"Bratislavský kraj";70;616;8;624;NA;344557;78;2020-11-09;8362
2020-11-08;"Bratislavský kraj";82;869;6;875;NA;344557;88;2020-11-08;8284
2020-11-07;"Bratislavský kraj";88;4039;17;4056;NA;344557;105;2020-11-07;8196
2020-11-06;"Bratislavský kraj";281;6441;25;6466;NA;344557;306;2020-11-06;8091
2020-11-05;"Bratislavský kraj";175;476;11;487;NA;344557;186;2020-11-05;7785
2020-11-04;"Bratislavský kraj";65;411;10;421;NA;344557;75;2020-11-04;7599
2020-11-03;"Bratislavský kraj";251;1085;12;1097;NA;344557;263;2020-11-03;7524
2020-11-02;"Bratislavský kraj";202;3365;22;3387;NA;344557;224;2020-11-02;7261
2020-11-01;"Bratislavský kraj";227;8694;39;8733;NA;344557;266;2020-11-01;7037
2020-10-31;"Bratislavský kraj";173;22407;123;22530;NA;344557;296;2020-10-31;6771
2020-10-30;"Bratislavský kraj";158;17350;138;17488;NA;344557;296;2020-10-30;6475
2020-10-29;"Bratislavský kraj";262;116;4;120;NA;344557;266;2020-10-29;6179
2020-10-28;"Bratislavský kraj";220;260;15;275;NA;344557;235;2020-10-28;5913
2020-10-27;"Bratislavský kraj";256;145;4;149;NA;344557;260;2020-10-27;5678
2020-10-26;"Bratislavský kraj";123;229;11;240;NA;344557;134;2020-10-26;5418
2020-10-25;"Bratislavský kraj";152;33;2;35;NA;344557;154;2020-10-25;5284
2020-10-24;"Bratislavský kraj";170;221;6;227;NA;344557;176;2020-10-24;5130
2020-10-23;"Bratislavský kraj";151;144;8;152;NA;344557;159;2020-10-23;4954
2020-10-22;"Bratislavský kraj";192;204;15;219;NA;344557;207;2020-10-22;4795
2020-10-21;"Bratislavský kraj";66;90;6;96;NA;344557;72;2020-10-21;4588
2020-10-20;"Bratislavský kraj";183;97;4;101;NA;344557;187;2020-10-20;4516
2020-10-19;"Bratislavský kraj";148;80;3;83;NA;344557;151;2020-10-19;4329
2020-10-18;"Bratislavský kraj";75;92;0;92;NA;344557;75;2020-10-18;4178
2020-10-17;"Bratislavský kraj";136;0;0;0;NA;344557;136;2020-10-17;4103
2020-10-16;"Bratislavský kraj";103;14;1;15;NA;344557;104;2020-10-16;3967
2020-10-15;"Bratislavský kraj";135;6;1;7;NA;344557;136;2020-10-15;3863
2020-10-14;"Bratislavský kraj";127;4;0;4;NA;344557;127;2020-10-14;3727
2020-10-13;"Bratislavský kraj";86;108;8;116;NA;344557;94;2020-10-13;3600
2020-10-12;"Bratislavský kraj";46;0;0;0;NA;344557;46;2020-10-12;3506
2020-10-11;"Bratislavský kraj";80;0;0;0;NA;344557;80;2020-10-11;3460
2020-10-10;"Bratislavský kraj";55;0;0;0;NA;344557;55;2020-10-10;3380
2020-10-09;"Bratislavský kraj";148;0;0;0;NA;344557;148;2020-10-09;3325
2020-10-08;"Bratislavský kraj";100;0;0;0;NA;344557;100;2020-10-08;3177
2020-10-07;"Bratislavský kraj";107;0;0;0;NA;344557;107;2020-10-07;3077
2020-10-06;"Bratislavský kraj";108;0;0;0;NA;344557;108;2020-10-06;2970
2020-10-05;"Bratislavský kraj";30;0;0;0;NA;344557;30;2020-10-05;2862
2020-10-04;"Bratislavský kraj";49;0;0;0;NA;344557;49;2020-10-04;2832
2020-10-03;"Bratislavský kraj";82;0;0;0;NA;344557;82;2020-10-03;2783
2020-10-02;"Bratislavský kraj";101;0;0;0;NA;344557;101;2020-10-02;2701
2020-10-01;"Bratislavský kraj";72;0;0;0;NA;344557;72;2020-10-01;2600
2020-09-30;"Bratislavský kraj";91;0;0;0;NA;344557;91;2020-09-30;2528
2020-09-29;"Bratislavský kraj";74;0;0;0;NA;344557;74;2020-09-29;2437
2020-09-28;"Bratislavský kraj";29;0;0;0;NA;344557;29;2020-09-28;2363
2020-09-27;"Bratislavský kraj";48;0;0;0;NA;344557;48;2020-09-27;2334
2020-09-26;"Bratislavský kraj";86;0;0;0;NA;344557;86;2020-09-26;2286
2020-09-25;"Bratislavský kraj";97;0;0;0;NA;344557;97;2020-09-25;2200
2020-09-24;"Bratislavský kraj";73;0;0;0;NA;344557;73;2020-09-24;2103
2020-09-23;"Bratislavský kraj";55;0;0;0;NA;344557;55;2020-09-23;2030
2020-09-22;"Bratislavský kraj";81;0;0;0;NA;344557;81;2020-09-22;1975
2020-09-21;"Bratislavský kraj";32;0;0;0;NA;344557;32;2020-09-21;1894
2020-09-20;"Bratislavský kraj";25;0;0;0;NA;344557;25;2020-09-20;1862
2020-09-19;"Bratislavský kraj";59;0;0;0;NA;344557;59;2020-09-19;1837
2020-09-18;"Bratislavský kraj";42;0;0;0;NA;344557;42;2020-09-18;1778
2020-09-17;"Bratislavský kraj";52;0;0;0;NA;344557;52;2020-09-17;1736
2020-09-16;"Bratislavský kraj";32;0;0;0;NA;344557;32;2020-09-16;1684
2020-09-15;"Bratislavský kraj";26;0;0;0;NA;344557;26;2020-09-15;1652
2020-09-14;"Bratislavský kraj";24;0;0;0;NA;344557;24;2020-09-14;1626
2020-09-13;"Bratislavský kraj";11;0;0;0;NA;344557;11;2020-09-13;1602
2020-09-12;"Bratislavský kraj";24;0;0;0;NA;344557;24;2020-09-12;1591
2020-09-11;"Bratislavský kraj";50;0;0;0;NA;344557;50;2020-09-11;1567
2020-09-10;"Bratislavský kraj";47;0;0;0;NA;344557;47;2020-09-10;1517
2020-09-09;"Bratislavský kraj";40;0;0;0;NA;344557;40;2020-09-09;1470
2020-09-08;"Bratislavský kraj";58;0;0;0;NA;344557;58;2020-09-08;1430
2020-09-07;"Bratislavský kraj";39;0;0;0;NA;344557;39;2020-09-07;1372
2020-09-06;"Bratislavský kraj";11;0;0;0;NA;344557;11;2020-09-06;1333
2020-09-05;"Bratislavský kraj";37;0;0;0;NA;344557;37;2020-09-05;1322
2020-09-04;"Bratislavský kraj";87;0;0;0;NA;344557;87;2020-09-04;1285
2020-09-03;"Bratislavský kraj";51;0;0;0;NA;344557;51;2020-09-03;1198
2020-09-02;"Bratislavský kraj";50;0;0;0;NA;344557;50;2020-09-02;1147
2020-09-01;"Bratislavský kraj";16;0;0;0;NA;344557;16;2020-09-01;1097
2020-08-31;"Bratislavský kraj";19;0;0;0;NA;344557;19;2020-08-31;1081
2020-08-30;"Bratislavský kraj";9;0;0;0;NA;344557;9;2020-08-30;1062
2020-08-29;"Bratislavský kraj";12;0;0;0;NA;344557;12;2020-08-29;1053
2020-08-28;"Bratislavský kraj";35;0;0;0;NA;344557;35;2020-08-28;1041
2020-08-27;"Bratislavský kraj";33;0;0;0;NA;344557;33;2020-08-27;1006
2020-08-26;"Bratislavský kraj";27;0;0;0;NA;344557;27;2020-08-26;973
2020-08-25;"Bratislavský kraj";29;0;0;0;NA;344557;29;2020-08-25;946
2020-08-24;"Bratislavský kraj";6;0;0;0;NA;344557;6;2020-08-24;917
2020-08-23;"Bratislavský kraj";45;0;0;0;NA;344557;45;2020-08-23;911
2020-08-22;"Bratislavský kraj";13;0;0;0;NA;344557;13;2020-08-22;866
2020-08-21;"Bratislavský kraj";46;0;0;0;NA;344557;46;2020-08-21;853
2020-08-20;"Bratislavský kraj";41;0;0;0;NA;344557;41;2020-08-20;807
2020-08-19;"Bratislavský kraj";27;0;0;0;NA;344557;27;2020-08-19;766
2020-08-18;"Bratislavský kraj";47;0;0;0;NA;344557;47;2020-08-18;739
2020-08-17;"Bratislavský kraj";2;0;0;0;NA;344557;2;2020-08-17;692
2020-08-16;"Bratislavský kraj";3;0;0;0;NA;344557;3;2020-08-16;690
2020-08-15;"Bratislavský kraj";18;0;0;0;NA;344557;18;2020-08-15;687
2020-08-14;"Bratislavský kraj";16;0;0;0;NA;344557;16;2020-08-14;669
2020-08-13;"Bratislavský kraj";12;0;0;0;NA;344557;12;2020-08-13;653
2020-08-12;"Bratislavský kraj";10;0;0;0;NA;344557;10;2020-08-12;641
2020-08-11;"Bratislavský kraj";23;0;0;0;NA;344557;23;2020-08-11;631
2020-08-10;"Bratislavský kraj";2;0;0;0;NA;344557;2;2020-08-10;608
2020-08-09;"Bratislavský kraj";2;0;0;0;NA;344557;2;2020-08-09;606
2020-08-08;"Bratislavský kraj";1;0;0;0;NA;344557;1;2020-08-08;604
2020-08-07;"Bratislavský kraj";9;0;0;0;NA;344557;9;2020-08-07;603
2020-08-06;"Bratislavský kraj";15;0;0;0;NA;344557;15;2020-08-06;594
2020-08-05;"Bratislavský kraj";11;0;0;0;NA;344557;11;2020-08-05;579
2020-08-04;"Bratislavský kraj";21;0;0;0;NA;344557;21;2020-08-04;568
2020-08-03;"Bratislavský kraj";7;0;0;0;NA;344557;7;2020-08-03;547
2020-08-02;"Bratislavský kraj";0;0;0;0;NA;344557;0;2020-08-02;540
2020-08-01;"Bratislavský kraj";0;0;0;0;NA;344557;0;2020-08-01;540
2020-07-31;"Bratislavský kraj";14;0;0;0;NA;344557;14;2020-07-31;540
2020-07-30;"Bratislavský kraj";6;0;0;0;NA;344557;6;2020-07-30;526
2020-07-29;"Bratislavský kraj";7;0;0;0;NA;344557;7;2020-07-29;520
2020-07-28;"Bratislavský kraj";14;0;0;0;NA;344557;14;2020-07-28;513
2020-07-27;"Bratislavský kraj";3;0;0;0;NA;344557;3;2020-07-27;499
2020-07-26;"Bratislavský kraj";0;0;0;0;NA;344557;0;2020-07-26;496
2020-07-25;"Bratislavský kraj";8;0;0;0;NA;344557;8;2020-07-25;496
2020-07-24;"Bratislavský kraj";2;0;0;0;NA;344557;2;2020-07-24;488
2020-07-23;"Bratislavský kraj";8;0;0;0;NA;344557;8;2020-07-23;486
2020-07-22;"Bratislavský kraj";11;0;0;0;NA;344557;11;2020-07-22;478
2020-07-21;"Bratislavský kraj";8;0;0;0;NA;344557;8;2020-07-21;467
2020-07-20;"Bratislavský kraj";12;0;0;0;NA;344557;12;2020-07-20;459
2020-07-19;"Bratislavský kraj";0;0;0;0;NA;344557;0;2020-07-19;447
2020-07-18;"Bratislavský kraj";2;0;0;0;NA;344557;2;2020-07-18;447
2020-07-17;"Bratislavský kraj";2;0;0;0;NA;344557;2;2020-07-17;445
2020-07-16;"Bratislavský kraj";6;0;0;0;NA;344557;6;2020-07-16;443
2020-07-15;"Bratislavský kraj";3;0;0;0;NA;344557;3;2020-07-15;437
2020-07-14;"Bratislavský kraj";2;0;0;0;NA;344557;2;2020-07-14;434
2020-07-13;"Bratislavský kraj";2;0;0;0;NA;344557;2;2020-07-13;432
2020-07-12;"Bratislavský kraj";0;0;0;0;NA;344557;0;2020-07-12;430
2020-07-11;"Bratislavský kraj";0;0;0;0;NA;344557;0;2020-07-11;430
2020-07-10;"Bratislavský kraj";8;0;0;0;NA;344557;8;2020-07-10;430
2020-07-09;"Bratislavský kraj";2;0;0;0;NA;344557;2;2020-07-09;422
2020-07-08;"Bratislavský kraj";11;0;0;0;NA;344557;11;2020-07-08;420
2020-07-07;"Bratislavský kraj";5;0;0;0;NA;344557;5;2020-07-07;409
2020-07-06;"Bratislavský kraj";1;0;0;0;NA;344557;1;2020-07-06;404
2020-07-05;"Bratislavský kraj";0;0;0;0;NA;344557;0;2020-07-05;403
2020-07-04;"Bratislavský kraj";3;0;0;0;NA;344557;3;2020-07-04;403
2020-07-03;"Bratislavský kraj";1;0;0;0;NA;344557;1;2020-07-03;400
2020-07-02;"Bratislavský kraj";0;0;0;0;NA;344557;0;2020-07-02;399
2020-07-01;"Bratislavský kraj";7;0;0;0;NA;344557;7;2020-07-01;399
2020-06-30;"Bratislavský kraj";3;0;0;0;NA;344557;3;2020-06-30;392
2020-06-29;"Bratislavský kraj";1;0;0;0;NA;344557;1;2020-06-29;389
2020-06-28;"Bratislavský kraj";0;0;0;0;NA;344557;0;2020-06-28;388
2020-06-27;"Bratislavský kraj";1;0;0;0;NA;344557;1;2020-06-27;388
2020-06-26;"Bratislavský kraj";6;0;0;0;NA;344557;6;2020-06-26;387
2020-06-25;"Bratislavský kraj";0;0;0;0;NA;344557;0;2020-06-25;381
2020-06-24;"Bratislavský kraj";3;0;0;0;NA;344557;3;2020-06-24;381
2020-06-23;"Bratislavský kraj";0;0;0;0;NA;344557;0;2020-06-23;378
2020-06-22;"Bratislavský kraj";1;0;0;0;NA;344557;1;2020-06-22;378
2020-06-21;"Bratislavský kraj";0;0;0;0;NA;344557;0;2020-06-21;377
2020-06-20;"Bratislavský kraj";0;0;0;0;NA;344557;0;2020-06-20;377
2020-06-19;"Bratislavský kraj";3;0;0;0;NA;344557;3;2020-06-19;377
2020-06-18;"Bratislavský kraj";0;0;0;0;NA;344557;0;2020-06-18;374
2020-06-17;"Bratislavský kraj";0;0;0;0;NA;344557;0;2020-06-17;374
2020-06-16;"Bratislavský kraj";0;0;0;0;NA;344557;0;2020-06-16;374
2020-06-14;"Bratislavský kraj";2;0;0;0;NA;344557;2;2020-06-14;374
2020-06-13;"Bratislavský kraj";1;0;0;0;NA;344557;1;2020-06-13;372
2020-06-12;"Bratislavský kraj";2;0;0;0;NA;344557;2;2020-06-12;371
2020-06-11;"Bratislavský kraj";0;0;0;0;NA;344557;0;2020-06-11;369
2020-06-10;"Bratislavský kraj";0;0;0;0;NA;344557;0;2020-06-10;369
2020-06-09;"Bratislavský kraj";0;0;0;0;NA;344557;0;2020-06-09;369
2020-06-08;"Bratislavský kraj";1;0;0;0;NA;344557;1;2020-06-08;369
2020-06-07;"Bratislavský kraj";0;0;0;0;NA;344557;0;2020-06-07;368
2020-06-05;"Bratislavský kraj";0;0;0;0;NA;344557;0;2020-06-05;368
2020-06-03;"Bratislavský kraj";1;0;0;0;NA;344557;1;2020-06-03;368
2020-06-02;"Bratislavský kraj";0;0;0;0;NA;344557;0;2020-06-02;367
2020-05-31;"Bratislavský kraj";0;0;0;0;NA;344557;0;2020-05-31;367
2020-05-29;"Bratislavský kraj";0;0;0;0;NA;344557;0;2020-05-29;367
2020-05-27;"Bratislavský kraj";1;0;0;0;NA;344557;1;2020-05-27;367
2020-05-26;"Bratislavský kraj";0;0;0;0;NA;344557;0;2020-05-26;366
2020-05-25;"Bratislavský kraj";0;0;0;0;NA;344557;0;2020-05-25;366
2020-05-24;"Bratislavský kraj";0;0;0;0;NA;344557;0;2020-05-24;366
2020-05-23;"Bratislavský kraj";2;0;0;0;NA;344557;2;2020-05-23;366
2020-05-22;"Bratislavský kraj";0;0;0;0;NA;344557;0;2020-05-22;364
2020-05-21;"Bratislavský kraj";0;0;0;0;NA;344557;0;2020-05-21;364
2020-05-20;"Bratislavský kraj";0;0;0;0;NA;344557;0;2020-05-20;364
2020-05-19;"Bratislavský kraj";0;0;0;0;NA;344557;0;2020-05-19;364
2020-05-17;"Bratislavský kraj";0;0;0;0;NA;344557;0;2020-05-17;364
2020-05-16;"Bratislavský kraj";0;0;0;0;NA;344557;0;2020-05-16;364
2020-05-15;"Bratislavský kraj";0;0;0;0;NA;344557;0;2020-05-15;364
2020-05-14;"Bratislavský kraj";0;0;0;0;NA;344557;0;2020-05-14;364
2020-05-13;"Bratislavský kraj";0;0;0;0;NA;344557;0;2020-05-13;364
2020-05-12;"Bratislavský kraj";2;0;0;0;NA;344557;2;2020-05-12;364
2020-05-11;"Bratislavský kraj";0;0;0;0;NA;344557;0;2020-05-11;362
2020-05-09;"Bratislavský kraj";0;0;0;0;NA;344557;0;2020-05-09;362
2020-05-07;"Bratislavský kraj";1;0;0;0;NA;344557;1;2020-05-07;362
2020-05-06;"Bratislavský kraj";3;0;0;0;NA;344557;3;2020-05-06;361
2020-05-05;"Bratislavský kraj";0;0;0;0;NA;344557;0;2020-05-05;358
2020-05-04;"Bratislavský kraj";0;0;0;0;NA;344557;0;2020-05-04;358
2020-05-03;"Bratislavský kraj";2;0;0;0;NA;344557;2;2020-05-03;358
2020-05-02;"Bratislavský kraj";0;0;0;0;NA;344557;0;2020-05-02;356
2020-05-01;"Bratislavský kraj";0;0;0;0;NA;344557;0;2020-05-01;356
2020-04-30;"Bratislavský kraj";5;0;0;0;NA;344557;5;2020-04-30;356
2020-04-29;"Bratislavský kraj";0;0;0;0;NA;344557;0;2020-04-29;351
2020-04-28;"Bratislavský kraj";2;0;0;0;NA;344557;2;2020-04-28;351
2020-04-27;"Bratislavský kraj";0;0;0;0;NA;344557;0;2020-04-27;349
2020-04-26;"Bratislavský kraj";1;0;0;0;NA;344557;1;2020-04-26;349
2020-04-25;"Bratislavský kraj";0;0;0;0;NA;344557;0;2020-04-25;348
2020-04-24;"Bratislavský kraj";2;0;0;0;NA;344557;2;2020-04-24;348
2020-04-23;"Bratislavský kraj";6;0;0;0;NA;344557;6;2020-04-23;346
2020-04-22;"Bratislavský kraj";11;0;0;0;NA;344557;11;2020-04-22;340
2020-04-21;"Bratislavský kraj";4;0;0;0;NA;344557;4;2020-04-21;329
2020-04-20;"Bratislavský kraj";0;0;0;0;NA;344557;0;2020-04-20;325
2020-04-19;"Bratislavský kraj";4;0;0;0;NA;344557;4;2020-04-19;325
2020-04-18;"Bratislavský kraj";5;0;0;0;NA;344557;5;2020-04-18;321
2020-04-17;"Bratislavský kraj";6;0;0;0;NA;344557;6;2020-04-17;316
2020-04-16;"Bratislavský kraj";15;0;0;0;NA;344557;15;2020-04-16;310
2020-04-15;"Bratislavský kraj";11;0;0;0;NA;344557;11;2020-04-15;295
2020-04-14;"Bratislavský kraj";19;0;0;0;NA;344557;19;2020-04-14;284
2020-04-13;"Bratislavský kraj";53;0;0;0;NA;344557;53;2020-04-13;265
2020-04-12;"Bratislavský kraj";3;0;0;0;NA;344557;3;2020-04-12;212
2020-04-11;"Bratislavský kraj";1;0;0;0;NA;344557;1;2020-04-11;209
2020-04-10;"Bratislavský kraj";8;0;0;0;NA;344557;8;2020-04-10;208
2020-04-09;"Bratislavský kraj";3;0;0;0;NA;344557;3;2020-04-09;200
2020-04-08;"Bratislavský kraj";3;0;0;0;NA;344557;3;2020-04-08;197
2020-04-07;"Bratislavský kraj";24;0;0;0;NA;344557;24;2020-04-07;194
2020-04-06;"Bratislavský kraj";5;0;0;0;NA;344557;5;2020-04-06;170
2020-04-05;"Bratislavský kraj";6;0;0;0;NA;344557;6;2020-04-05;165
2020-04-04;"Bratislavský kraj";2;0;0;0;NA;344557;2;2020-04-04;159
2020-04-03;"Bratislavský kraj";1;0;0;0;NA;344557;1;2020-04-03;157
2020-04-02;"Bratislavský kraj";2;0;0;0;NA;344557;2;2020-04-02;156
2020-04-01;"Bratislavský kraj";5;0;0;0;NA;344557;5;2020-04-01;154
2020-03-31;"Bratislavský kraj";19;0;0;0;NA;344557;19;2020-03-31;149
2020-03-30;"Bratislavský kraj";6;0;0;0;NA;344557;6;2020-03-30;130
2020-03-29;"Bratislavský kraj";8;0;0;0;NA;344557;8;2020-03-29;124
2020-03-28;"Bratislavský kraj";4;0;0;0;NA;344557;4;2020-03-28;116
2020-03-27;"Bratislavský kraj";3;0;0;0;NA;344557;3;2020-03-27;112
2020-03-26;"Bratislavský kraj";15;0;0;0;NA;344557;15;2020-03-26;109
2020-03-25;"Bratislavský kraj";1;0;0;0;NA;344557;1;2020-03-25;94
2020-03-24;"Bratislavský kraj";4;0;0;0;NA;344557;4;2020-03-24;93
2020-03-23;"Bratislavský kraj";9;0;0;0;NA;344557;9;2020-03-23;89
2020-03-22;"Bratislavský kraj";2;0;0;0;NA;344557;2;2020-03-22;80
2020-03-21;"Bratislavský kraj";22;0;0;0;NA;344557;22;2020-03-21;78
2020-03-20;"Bratislavský kraj";3;0;0;0;NA;344557;3;2020-03-20;56
2020-03-19;"Bratislavský kraj";4;0;0;0;NA;344557;4;2020-03-19;53
2020-03-18;"Bratislavský kraj";3;0;0;0;NA;344557;3;2020-03-18;49
2020-03-17;"Bratislavský kraj";13;0;0;0;NA;344557;13;2020-03-17;46
2020-03-16;"Bratislavský kraj";1;0;0;0;NA;344557;1;2020-03-16;33
2020-03-15;"Bratislavský kraj";4;0;0;0;NA;344557;4;2020-03-15;32
2020-03-14;"Bratislavský kraj";9;0;0;0;NA;344557;9;2020-03-14;28
2020-03-13;"Bratislavský kraj";2;0;0;0;NA;344557;2;2020-03-13;19
2020-03-12;"Bratislavský kraj";8;0;0;0;NA;344557;8;2020-03-12;17
2020-03-11;"Bratislavský kraj";3;0;0;0;NA;344557;3;2020-03-11;9
2020-03-09;"Bratislavský kraj";0;0;0;0;NA;344557;0;2020-03-09;6
2020-03-08;"Bratislavský kraj";2;0;0;0;NA;344557;2;2020-03-08;6
2020-03-07;"Bratislavský kraj";2;0;0;0;NA;344557;2;2020-03-07;4
2020-03-06;"Bratislavský kraj";1;0;0;0;NA;344557;1;2020-03-06;2
2022-05-24;"Košický kraj";20;0;0;0;235960;346390;20;2022-05-24;346390
2022-05-23;"Košický kraj";20;0;0;0;NA;346390;20;2022-05-23;346370
2022-05-22;"Košický kraj";2;9;3;12;NA;346390;5;2022-05-22;346350
2022-05-21;"Košický kraj";16;31;4;35;NA;346390;20;2022-05-21;346345
2022-05-20;"Košický kraj";30;148;5;153;NA;346390;35;2022-05-20;346325
2022-05-19;"Košický kraj";35;434;12;446;NA;346390;47;2022-05-19;346290
2022-05-18;"Košický kraj";48;231;8;239;NA;346390;56;2022-05-18;346243
2022-05-17;"Košický kraj";49;311;17;328;NA;346390;66;2022-05-17;346187
2022-05-16;"Košický kraj";22;375;28;403;NA;346390;50;2022-05-16;346121
2022-05-15;"Košický kraj";10;205;21;226;NA;346390;31;2022-05-15;346071
2022-05-14;"Košický kraj";38;177;18;195;NA;346390;56;2022-05-14;346040
2022-05-13;"Košický kraj";63;459;32;491;NA;346390;95;2022-05-13;345984
2022-05-12;"Košický kraj";54;393;25;418;NA;346390;79;2022-05-12;345889
2022-05-11;"Košický kraj";44;602;40;642;NA;346390;84;2022-05-11;345810
2022-05-10;"Košický kraj";47;421;41;462;NA;346390;88;2022-05-10;345726
2022-05-09;"Košický kraj";33;663;59;722;NA;346390;92;2022-05-09;345638
2022-05-08;"Košický kraj";9;230;22;252;NA;346390;31;2022-05-08;345546
2022-05-07;"Košický kraj";36;242;16;258;NA;346390;52;2022-05-07;345515
2022-05-06;"Košický kraj";73;453;42;495;NA;346390;115;2022-05-06;345463
2022-05-05;"Košický kraj";66;571;42;613;NA;346390;108;2022-05-05;345348
2022-05-04;"Košický kraj";56;528;40;568;NA;346390;96;2022-05-04;345240
2022-05-03;"Košický kraj";104;776;46;822;NA;346390;150;2022-05-03;345144
2022-05-02;"Košický kraj";97;1285;106;1391;NA;346390;203;2022-05-02;344994
2022-05-01;"Košický kraj";16;249;34;283;NA;346390;50;2022-05-01;344791
2022-04-30;"Košický kraj";106;308;28;336;NA;346390;134;2022-04-30;344741
2022-04-29;"Košický kraj";124;843;49;892;NA;346390;173;2022-04-29;344607
2022-04-28;"Košický kraj";108;1107;72;1179;NA;346390;180;2022-04-28;344434
2022-04-27;"Košický kraj";184;1254;54;1308;NA;346390;238;2022-04-27;344254
2022-04-26;"Košický kraj";160;1786;78;1864;NA;346390;238;2022-04-26;344016
2022-04-25;"Košický kraj";208;1912;121;2033;NA;346390;329;2022-04-25;343778
2022-04-24;"Košický kraj";43;553;59;612;NA;346390;102;2022-04-24;343449
2022-04-23;"Košický kraj";183;497;46;543;NA;346390;229;2022-04-23;343347
2022-04-22;"Košický kraj";237;1202;80;1282;NA;346390;317;2022-04-22;343118
2022-04-21;"Košický kraj";169;1571;110;1681;NA;346390;279;2022-04-21;342801
2022-04-20;"Košický kraj";331;1796;91;1887;NA;346390;422;2022-04-20;342522
2022-04-19;"Košický kraj";306;2580;181;2761;NA;346390;487;2022-04-19;342100
2022-04-18;"Košický kraj";63;715;60;775;NA;346390;123;2022-04-18;341613
2022-04-17;"Košický kraj";163;305;32;337;NA;346390;195;2022-04-17;341490
2022-04-16;"Košický kraj";129;540;88;628;NA;346390;217;2022-04-16;341295
2022-04-15;"Košický kraj";65;410;25;435;NA;346390;90;2022-04-15;341078
2022-04-14;"Košický kraj";364;1677;106;1783;NA;346390;470;2022-04-14;340988
2022-04-13;"Košický kraj";417;1889;104;1993;NA;346390;521;2022-04-13;340518
2022-04-12;"Košický kraj";254;1713;136;1849;NA;346390;390;2022-04-12;339997
2022-04-11;"Košický kraj";418;2765;184;2949;NA;346390;602;2022-04-11;339607
2022-04-10;"Košický kraj";164;795;66;861;NA;346390;230;2022-04-10;339005
2022-04-09;"Košický kraj";210;623;55;678;NA;346390;265;2022-04-09;338775
2022-04-08;"Košický kraj";373;1705;151;1856;NA;346390;524;2022-04-08;338510
2022-04-07;"Košický kraj";428;2176;173;2349;NA;346390;601;2022-04-07;337986
2022-04-06;"Košický kraj";580;1845;172;2017;NA;346390;752;2022-04-06;337385
2022-04-05;"Košický kraj";721;1818;187;2005;NA;346390;908;2022-04-05;336633
2022-04-04;"Košický kraj";694;3029;326;3355;NA;346390;1020;2022-04-04;335725
2022-04-03;"Košický kraj";208;861;136;997;NA;346390;344;2022-04-03;334705
2022-04-02;"Košický kraj";331;628;86;714;NA;346390;417;2022-04-02;334361
2022-04-01;"Košický kraj";714;1919;227;2146;NA;346390;941;2022-04-01;333944
2022-03-31;"Košický kraj";745;1899;205;2104;NA;346390;950;2022-03-31;333003
2022-03-30;"Košický kraj";1081;2171;241;2412;NA;346390;1322;2022-03-30;332053
2022-03-29;"Košický kraj";683;2337;310;2647;NA;346390;993;2022-03-29;330731
2022-03-28;"Košický kraj";886;3310;435;3745;NA;346390;1321;2022-03-28;329738
2022-03-27;"Košický kraj";355;1168;230;1398;NA;346390;585;2022-03-27;328417
2022-03-26;"Košický kraj";593;940;165;1105;NA;346390;758;2022-03-26;327832
2022-03-25;"Košický kraj";958;1831;316;2147;NA;346390;1274;2022-03-25;327074
2022-03-24;"Košický kraj";998;2433;328;2761;NA;346390;1326;2022-03-24;325800
2022-03-23;"Košický kraj";1143;2615;348;2963;NA;346390;1491;2022-03-23;324474
2022-03-22;"Košický kraj";1508;2766;378;3144;NA;346390;1886;2022-03-22;322983
2022-03-21;"Košický kraj";1241;3484;530;4014;NA;346390;1771;2022-03-21;321097
2022-03-20;"Košický kraj";199;1514;318;1832;NA;346390;517;2022-03-20;319326
2022-03-19;"Košický kraj";952;1133;241;1374;NA;346390;1193;2022-03-19;318809
2022-03-18;"Košický kraj";1382;2278;343;2621;NA;346390;1725;2022-03-18;317616
2022-03-17;"Košický kraj";1181;2717;358;3075;NA;346390;1539;2022-03-17;315891
2022-03-16;"Košický kraj";1631;4800;372;5172;NA;346390;2003;2022-03-16;314352
2022-03-15;"Košický kraj";1591;2889;436;3325;NA;346390;2027;2022-03-15;312349
2022-03-14;"Košický kraj";1424;3479;585;4064;NA;346390;2009;2022-03-14;310322
2022-03-13;"Košický kraj";565;1711;375;2086;NA;346390;940;2022-03-13;308313
2022-03-12;"Košický kraj";1227;1263;218;1481;NA;346390;1445;2022-03-12;307373
2022-03-11;"Košický kraj";1451;2815;513;3328;NA;346390;1964;2022-03-11;305928
2022-03-10;"Košický kraj";990;3158;406;3564;NA;346390;1396;2022-03-10;303964
2022-03-09;"Košický kraj";1545;3322;397;3719;NA;346390;1942;2022-03-09;302568
2022-03-08;"Košický kraj";1487;3633;441;4074;NA;346390;1928;2022-03-08;300626
2022-03-07;"Košický kraj";1347;4968;713;5681;NA;346390;2060;2022-03-07;298698
2022-03-06;"Košický kraj";297;1811;372;2183;NA;346390;669;2022-03-06;296638
2022-03-05;"Košický kraj";874;1317;264;1581;NA;346390;1138;2022-03-05;295969
2022-03-04;"Košický kraj";1255;3130;424;3554;NA;346390;1679;2022-03-04;294831
2022-03-03;"Košický kraj";1111;3543;433;3976;NA;346390;1544;2022-03-03;293152
2022-03-02;"Košický kraj";1458;3437;455;3892;NA;346390;1913;2022-03-02;291608
2022-03-01;"Košický kraj";1723;3720;487;4207;NA;346390;2210;2022-03-01;289695
2022-02-28;"Košický kraj";1345;5497;805;6302;NA;346390;2150;2022-02-28;287485
2022-02-27;"Košický kraj";465;2397;440;2837;NA;346390;905;2022-02-27;285335
2022-02-26;"Košický kraj";979;1348;329;1677;NA;346390;1308;2022-02-26;284430
2022-02-25;"Košický kraj";1691;3274;510;3784;NA;346390;2201;2022-02-25;283122
2022-02-24;"Košický kraj";1988;4033;594;4627;NA;346390;2582;2022-02-24;280921
2022-02-23;"Košický kraj";1787;4151;558;4709;NA;346390;2345;2022-02-23;278339
2022-02-22;"Košický kraj";2649;4695;660;5355;NA;346390;3309;2022-02-22;275994
2022-02-21;"Košický kraj";1646;6499;910;7409;NA;346390;2556;2022-02-21;272685
2022-02-20;"Košický kraj";577;2919;578;3497;NA;346390;1155;2022-02-20;270129
2022-02-19;"Košický kraj";1941;2169;409;2578;NA;346390;2350;2022-02-19;268974
2022-02-18;"Košický kraj";2210;4534;640;5174;NA;346390;2850;2022-02-18;266624
2022-02-17;"Košický kraj";2555;4668;675;5343;NA;346390;3230;2022-02-17;263774
2022-02-16;"Košický kraj";2153;5477;736;6213;NA;346390;2889;2022-02-16;260544
2022-02-15;"Košický kraj";2768;5507;830;6337;NA;346390;3598;2022-02-15;257655
2022-02-14;"Košický kraj";2337;8076;1104;9180;NA;346390;3441;2022-02-14;254057
2022-02-13;"Košický kraj";1235;4248;809;5057;NA;346390;2044;2022-02-13;250616
2022-02-12;"Košický kraj";1728;2014;524;2538;NA;346390;2252;2022-02-12;248572
2022-02-11;"Košický kraj";2665;4797;633;5430;NA;346390;3298;2022-02-11;246320
2022-02-10;"Košický kraj";2135;5323;728;6051;NA;346390;2863;2022-02-10;243022
2022-02-09;"Košický kraj";2067;5940;743;6683;NA;346390;2810;2022-02-09;240159
2022-02-08;"Košický kraj";2993;6143;762;6905;NA;346390;3755;2022-02-08;237349
2022-02-07;"Košický kraj";1939;7973;978;8951;NA;346390;2917;2022-02-07;233594
2022-02-06;"Košický kraj";998;4482;680;5162;NA;346390;1678;2022-02-06;230677
2022-02-05;"Košický kraj";2209;2454;434;2888;NA;346390;2643;2022-02-05;228999
2022-02-04;"Košický kraj";2563;5634;632;6266;NA;346390;3195;2022-02-04;226356
2022-02-03;"Košický kraj";1916;6379;659;7038;NA;346390;2575;2022-02-03;223161
2022-02-02;"Košický kraj";2498;6923;629;7552;NA;346390;3127;2022-02-02;220586
2022-02-01;"Košický kraj";2173;6706;678;7384;NA;346390;2851;2022-02-01;217459
2022-01-31;"Košický kraj";2020;9960;841;10801;NA;346390;2861;2022-01-31;214608
2022-01-30;"Košický kraj";1002;5716;541;6257;NA;346390;1543;2022-01-30;211747
2022-01-29;"Košický kraj";1731;2720;387;3107;NA;346390;2118;2022-01-29;210204
2022-01-28;"Košický kraj";1743;5571;492;6063;NA;346390;2235;2022-01-28;208086
2022-01-27;"Košický kraj";1553;5792;413;6205;NA;346390;1966;2022-01-27;205851
2022-01-26;"Košický kraj";1683;5613;399;6012;NA;346390;2082;2022-01-26;203885
2022-01-25;"Košický kraj";1409;6210;404;6614;NA;346390;1813;2022-01-25;201803
2022-01-24;"Košický kraj";1141;8669;431;9100;NA;346390;1572;2022-01-24;199990
2022-01-23;"Košický kraj";516;5418;287;5705;NA;346390;803;2022-01-23;198418
2022-01-22;"Košický kraj";914;2528;177;2705;NA;346390;1091;2022-01-22;197615
2022-01-21;"Košický kraj";589;5194;227;5421;NA;346390;816;2022-01-21;196524
2022-01-20;"Košický kraj";769;5379;200;5579;NA;346390;969;2022-01-20;195708
2022-01-19;"Košický kraj";629;5329;178;5507;NA;346390;807;2022-01-19;194739
2022-01-18;"Košický kraj";716;5758;140;5898;NA;346390;856;2022-01-18;193932
2022-01-17;"Košický kraj";486;9004;187;9191;NA;346390;673;2022-01-17;193076
2022-01-16;"Košický kraj";51;5264;137;5401;NA;346390;188;2022-01-16;192403
2022-01-15;"Košický kraj";422;2208;69;2277;NA;346390;491;2022-01-15;192215
2022-01-14;"Košický kraj";175;4208;93;4301;NA;346390;268;2022-01-14;191724
2022-01-13;"Košický kraj";165;4919;77;4996;NA;346390;242;2022-01-13;191456
2022-01-12;"Košický kraj";295;4609;78;4687;NA;346390;373;2022-01-12;191214
2022-01-11;"Košický kraj";349;5295;70;5365;NA;346390;419;2022-01-11;190841
2022-01-10;"Košický kraj";290;8254;128;8382;NA;346390;418;2022-01-10;190422
2022-01-09;"Košický kraj";230;5838;86;5924;NA;346390;316;2022-01-09;190004
2022-01-08;"Košický kraj";157;2417;57;2474;NA;346390;214;2022-01-08;189688
2022-01-07;"Košický kraj";388;5017;129;5146;NA;346390;517;2022-01-07;189474
2022-01-06;"Košický kraj";118;1576;55;1631;NA;346390;173;2022-01-06;188957
2022-01-05;"Košický kraj";354;5082;102;5184;NA;346390;456;2022-01-05;188784
2022-01-04;"Košický kraj";450;5273;84;5357;NA;346390;534;2022-01-04;188328
2022-01-03;"Košický kraj";439;7970;140;8110;NA;346390;579;2022-01-03;187794
2022-01-02;"Košický kraj";284;4614;109;4723;NA;346390;393;2022-01-02;187215
2022-01-01;"Košický kraj";28;360;18;378;NA;346390;46;2022-01-01;186822
2021-12-31;"Košický kraj";122;2999;86;3085;NA;346390;208;2021-12-31;186776
2021-12-30;"Košický kraj";401;3949;118;4067;NA;346390;519;2021-12-30;186568
2021-12-29;"Košický kraj";378;4194;111;4305;NA;346390;489;2021-12-29;186049
2021-12-28;"Košický kraj";509;4450;125;4575;NA;346390;634;2021-12-28;185560
2021-12-27;"Košický kraj";495;6822;205;7027;NA;346390;700;2021-12-27;184926
2021-12-26;"Košický kraj";109;2510;115;2625;NA;346390;224;2021-12-26;184226
2021-12-25;"Košický kraj";30;644;43;687;NA;346390;73;2021-12-25;184002
2021-12-24;"Košický kraj";95;1055;50;1105;NA;346390;145;2021-12-24;183929
2021-12-23;"Košický kraj";644;4479;131;4610;NA;346390;775;2021-12-23;183784
2021-12-22;"Košický kraj";224;4309;106;4415;NA;346390;330;2021-12-22;183009
2021-12-21;"Košický kraj";544;6491;138;6629;NA;346390;682;2021-12-21;182679
2021-12-20;"Košický kraj";464;8630;196;8826;NA;346390;660;2021-12-20;181997
2021-12-19;"Košický kraj";137;5447;177;5624;NA;346390;314;2021-12-19;181337
2021-12-18;"Košický kraj";414;2555;102;2657;NA;346390;516;2021-12-18;181023
2021-12-17;"Košický kraj";428;4832;145;4977;NA;346390;573;2021-12-17;180507
2021-12-16;"Košický kraj";476;5845;168;6013;NA;346390;644;2021-12-16;179934
2021-12-15;"Košický kraj";508;5956;172;6128;NA;346390;680;2021-12-15;179290
2021-12-14;"Košický kraj";957;5789;172;5961;NA;346390;1129;2021-12-14;178610
2021-12-13;"Košický kraj";679;9657;248;9905;NA;346390;927;2021-12-13;177481
2021-12-12;"Košický kraj";243;6657;198;6855;NA;346390;441;2021-12-12;176554
2021-12-11;"Košický kraj";519;2996;134;3130;NA;346390;653;2021-12-11;176113
2021-12-10;"Košický kraj";936;5465;185;5650;NA;346390;1121;2021-12-10;175460
2021-12-09;"Košický kraj";755;5779;198;5977;NA;346390;953;2021-12-09;174339
2021-12-08;"Košický kraj";1095;6574;275;6849;NA;346390;1370;2021-12-08;173386
2021-12-07;"Košický kraj";1212;6323;267;6590;NA;346390;1479;2021-12-07;172016
2021-12-06;"Košický kraj";904;10627;313;10940;NA;346390;1217;2021-12-06;170537
2021-12-05;"Košický kraj";404;7756;263;8019;NA;346390;667;2021-12-05;169320
2021-12-04;"Košický kraj";1007;3097;180;3277;NA;346390;1187;2021-12-04;168653
2021-12-03;"Košický kraj";1338;6065;271;6336;NA;346390;1609;2021-12-03;167466
2021-12-02;"Košický kraj";2209;5654;302;5956;NA;346390;2511;2021-12-02;165857
2021-12-01;"Košický kraj";1016;6483;388;6871;NA;346390;1404;2021-12-01;163346
2021-11-30;"Košický kraj";1125;8173;471;8644;NA;346390;1596;2021-11-30;161942
2021-11-29;"Košický kraj";993;14057;634;14691;NA;346390;1627;2021-11-29;160346
2021-11-28;"Košický kraj";972;10211;473;10684;NA;346390;1445;2021-11-28;158719
2021-11-27;"Košický kraj";1103;3566;219;3785;NA;346390;1322;2021-11-27;157274
2021-11-26;"Košický kraj";1395;6059;383;6442;NA;346390;1778;2021-11-26;155952
2021-11-25;"Košický kraj";1373;7016;499;7515;NA;346390;1872;2021-11-25;154174
2021-11-24;"Košický kraj";1194;7067;473;7540;NA;346390;1667;2021-11-24;152302
2021-11-23;"Košický kraj";1178;7185;488;7673;NA;346390;1666;2021-11-23;150635
2021-11-22;"Košický kraj";861;10709;741;11450;NA;346390;1602;2021-11-22;148969
2021-11-21;"Košický kraj";985;7394;657;8051;NA;346390;1642;2021-11-21;147367
2021-11-20;"Košický kraj";1083;2859;295;3154;NA;346390;1378;2021-11-20;145725
2021-11-19;"Košický kraj";1078;7543;516;8059;NA;346390;1594;2021-11-19;144347
2021-11-18;"Košický kraj";1061;9410;719;10129;NA;346390;1780;2021-11-18;142753
2021-11-17;"Košický kraj";1319;2824;262;3086;NA;346390;1581;2021-11-17;140973
2021-11-16;"Košický kraj";1484;7135;543;7678;NA;346390;2027;2021-11-16;139392
2021-11-15;"Košický kraj";902;10812;754;11566;NA;346390;1656;2021-11-15;137365
2021-11-14;"Košický kraj";715;5756;455;6211;NA;346390;1170;2021-11-14;135709
2021-11-13;"Košický kraj";869;2686;312;2998;NA;346390;1181;2021-11-13;134539
2021-11-12;"Košický kraj";1132;5616;410;6026;NA;346390;1542;2021-11-12;133358
2021-11-11;"Košický kraj";1035;6139;460;6599;NA;346390;1495;2021-11-11;131816
2021-11-10;"Košický kraj";933;6633;497;7130;NA;346390;1430;2021-11-10;130321
2021-11-09;"Košický kraj";967;5540;389;5929;NA;346390;1356;2021-11-09;128891
2021-11-08;"Košický kraj";701;7838;601;8439;NA;346390;1302;2021-11-08;127535
2021-11-07;"Košický kraj";691;4578;425;5003;NA;346390;1116;2021-11-07;126233
2021-11-06;"Košický kraj";996;2276;217;2493;NA;346390;1213;2021-11-06;125117
2021-11-05;"Košický kraj";1029;4905;367;5272;NA;346390;1396;2021-11-05;123904
2021-11-04;"Košický kraj";1000;5354;360;5714;NA;346390;1360;2021-11-04;122508
2021-11-03;"Košický kraj";1051;5749;361;6110;NA;346390;1412;2021-11-03;121148
2021-11-02;"Košický kraj";915;8775;566;9341;NA;346390;1481;2021-11-02;119736
2021-11-01;"Košický kraj";181;1999;265;2264;NA;346390;446;2021-11-01;118255
2021-10-31;"Košický kraj";385;2337;227;2564;NA;346390;612;2021-10-31;117809
2021-10-30;"Košický kraj";641;2380;180;2560;NA;346390;821;2021-10-30;117197
2021-10-29;"Košický kraj";750;4608;289;4897;NA;346390;1039;2021-10-29;116376
2021-10-28;"Košický kraj";823;5115;255;5370;NA;346390;1078;2021-10-28;115337
2021-10-27;"Košický kraj";723;4831;259;5090;NA;346390;982;2021-10-27;114259
2021-10-26;"Košický kraj";618;5049;225;5274;NA;346390;843;2021-10-26;113277
2021-10-25;"Košický kraj";268;6747;292;7039;NA;346390;560;2021-10-25;112434
2021-10-24;"Košický kraj";170;3447;205;3652;NA;346390;375;2021-10-24;111874
2021-10-23;"Košický kraj";397;1953;86;2039;NA;346390;483;2021-10-23;111499
2021-10-22;"Košický kraj";474;4679;130;4809;NA;346390;604;2021-10-22;111016
2021-10-21;"Košický kraj";669;5094;172;5266;NA;346390;841;2021-10-21;110412
2021-10-20;"Košický kraj";398;4963;152;5115;NA;346390;550;2021-10-20;109571
2021-10-19;"Košický kraj";579;4870;161;5031;NA;346390;740;2021-10-19;109021
2021-10-18;"Košický kraj";180;7090;171;7261;NA;346390;351;2021-10-18;108281
2021-10-17;"Košický kraj";70;3614;125;3739;NA;346390;195;2021-10-17;107930
2021-10-16;"Košický kraj";312;1839;40;1879;NA;346390;352;2021-10-16;107735
2021-10-15;"Košický kraj";312;4530;77;4607;NA;346390;389;2021-10-15;107383
2021-10-14;"Košický kraj";327;4652;95;4747;NA;346390;422;2021-10-14;106994
2021-10-13;"Košický kraj";168;4168;88;4256;NA;346390;256;2021-10-13;106572
2021-10-12;"Košický kraj";391;4119;75;4194;NA;346390;466;2021-10-12;106316
2021-10-11;"Košický kraj";119;6351;121;6472;NA;346390;240;2021-10-11;105850
2021-10-10;"Košický kraj";104;2921;63;2984;NA;346390;167;2021-10-10;105610
2021-10-09;"Košický kraj";111;1687;43;1730;NA;346390;154;2021-10-09;105443
2021-10-08;"Košický kraj";274;4143;68;4211;NA;346390;342;2021-10-08;105289
2021-10-07;"Košický kraj";277;4399;74;4473;NA;346390;351;2021-10-07;104947
2021-10-06;"Košický kraj";178;4369;89;4458;NA;346390;267;2021-10-06;104596
2021-10-05;"Košický kraj";345;4542;78;4620;NA;346390;423;2021-10-05;104329
2021-10-04;"Košický kraj";122;6094;110;6204;NA;346390;232;2021-10-04;103906
2021-10-03;"Košický kraj";133;3176;74;3250;NA;346390;207;2021-10-03;103674
2021-10-02;"Košický kraj";124;2567;41;2608;NA;346390;165;2021-10-02;103467
2021-10-01;"Košický kraj";181;4251;73;4324;NA;346390;254;2021-10-01;103302
2021-09-30;"Košický kraj";244;4780;71;4851;NA;346390;315;2021-09-30;103048
2021-09-29;"Košický kraj";183;3824;64;3888;NA;346390;247;2021-09-29;102733
2021-09-28;"Košický kraj";303;4339;80;4419;NA;346390;383;2021-09-28;102486
2021-09-27;"Košický kraj";117;6358;77;6435;NA;346390;194;2021-09-27;102103
2021-09-26;"Košický kraj";13;2809;44;2853;NA;346390;57;2021-09-26;101909
2021-09-25;"Košický kraj";162;2521;35;2556;NA;346390;197;2021-09-25;101852
2021-09-24;"Košický kraj";183;4756;43;4799;NA;346390;226;2021-09-24;101655
2021-09-23;"Košický kraj";142;3880;51;3931;NA;346390;193;2021-09-23;101429
2021-09-22;"Košický kraj";151;4436;52;4488;NA;346390;203;2021-09-22;101236
2021-09-21;"Košický kraj";234;4441;44;4485;NA;346390;278;2021-09-21;101033
2021-09-20;"Košický kraj";158;6017;73;6090;NA;346390;231;2021-09-20;100755
2021-09-19;"Košický kraj";15;2487;30;2517;NA;346390;45;2021-09-19;100524
2021-09-18;"Košický kraj";187;2504;24;2528;NA;346390;211;2021-09-18;100479
2021-09-17;"Košický kraj";121;4797;41;4838;NA;346390;162;2021-09-17;100268
2021-09-16;"Košický kraj";228;4503;71;4574;NA;346390;299;2021-09-16;100106
2021-09-15;"Košický kraj";52;989;16;1005;NA;346390;68;2021-09-15;99807
2021-09-14;"Košický kraj";142;3456;47;3503;NA;346390;189;2021-09-14;99739
2021-09-13;"Košický kraj";96;4949;48;4997;NA;346390;144;2021-09-13;99550
2021-09-12;"Košický kraj";14;2003;31;2034;NA;346390;45;2021-09-12;99406
2021-09-11;"Košický kraj";105;2186;19;2205;NA;346390;124;2021-09-11;99361
2021-09-10;"Košický kraj";125;4293;42;4335;NA;346390;167;2021-09-10;99237
2021-09-09;"Košický kraj";115;3226;30;3256;NA;346390;145;2021-09-09;99070
2021-09-08;"Košický kraj";86;2753;36;2789;NA;346390;122;2021-09-08;98925
2021-09-07;"Košický kraj";79;2686;53;2739;NA;346390;132;2021-09-07;98803
2021-09-06;"Košický kraj";41;2786;36;2822;NA;346390;77;2021-09-06;98671
2021-09-05;"Košický kraj";52;1393;18;1411;NA;346390;70;2021-09-05;98594
2021-09-04;"Košický kraj";37;1678;12;1690;NA;346390;49;2021-09-04;98524
2021-09-03;"Košický kraj";47;2913;35;2948;NA;346390;82;2021-09-03;98475
2021-09-02;"Košický kraj";56;2686;26;2712;NA;346390;82;2021-09-02;98393
2021-09-01;"Košický kraj";95;629;13;642;NA;346390;108;2021-09-01;98311
2021-08-31;"Košický kraj";30;2525;22;2547;NA;346390;52;2021-08-31;98203
2021-08-30;"Košický kraj";8;2404;28;2432;NA;346390;36;2021-08-30;98151
2021-08-29;"Košický kraj";16;603;1;604;NA;346390;17;2021-08-29;98115
2021-08-28;"Košický kraj";14;2103;11;2114;NA;346390;25;2021-08-28;98098
2021-08-27;"Košický kraj";22;2908;16;2924;NA;346390;38;2021-08-27;98073
2021-08-26;"Košický kraj";19;2292;13;2305;NA;346390;32;2021-08-26;98035
2021-08-25;"Košický kraj";33;2010;6;2016;NA;346390;39;2021-08-25;98003
2021-08-24;"Košický kraj";14;2337;3;2340;NA;346390;17;2021-08-24;97964
2021-08-23;"Košický kraj";33;2461;5;2466;NA;346390;38;2021-08-23;97947
2021-08-22;"Košický kraj";4;1457;8;1465;NA;346390;12;2021-08-22;97909
2021-08-21;"Košický kraj";35;2134;5;2139;NA;346390;40;2021-08-21;97897
2021-08-20;"Košický kraj";13;3215;5;3220;NA;346390;18;2021-08-20;97857
2021-08-19;"Košický kraj";14;2178;6;2184;NA;346390;20;2021-08-19;97839
2021-08-18;"Košický kraj";30;1827;8;1835;NA;346390;38;2021-08-18;97819
2021-08-17;"Košický kraj";24;1619;3;1622;NA;346390;27;2021-08-17;97781
2021-08-16;"Košický kraj";3;2236;10;2246;NA;346390;13;2021-08-16;97754
2021-08-15;"Košický kraj";1;778;5;783;NA;346390;6;2021-08-15;97741
2021-08-14;"Košický kraj";15;1222;1;1223;NA;346390;16;2021-08-14;97735
2021-08-13;"Košický kraj";14;1928;8;1936;NA;346390;22;2021-08-13;97719
2021-08-12;"Košický kraj";10;1248;3;1251;NA;346390;13;2021-08-12;97697
2021-08-11;"Košický kraj";6;1368;5;1373;NA;346390;11;2021-08-11;97684
2021-08-10;"Košický kraj";10;1352;8;1360;NA;346390;18;2021-08-10;97673
2021-08-09;"Košický kraj";12;1651;3;1654;NA;346390;15;2021-08-09;97655
2021-08-08;"Košický kraj";8;688;1;689;NA;346390;9;2021-08-08;97640
2021-08-07;"Košický kraj";3;1125;3;1128;NA;346390;6;2021-08-07;97631
2021-08-06;"Košický kraj";9;1614;6;1620;NA;346390;15;2021-08-06;97625
2021-08-05;"Košický kraj";26;1254;6;1260;NA;346390;32;2021-08-05;97610
2021-08-04;"Košický kraj";8;1373;5;1378;NA;346390;13;2021-08-04;97578
2021-08-03;"Košický kraj";33;1121;3;1124;NA;346390;36;2021-08-03;97565
2021-08-02;"Košický kraj";6;1702;8;1710;NA;346390;14;2021-08-02;97529
2021-08-01;"Košický kraj";1;662;1;663;NA;346390;2;2021-08-01;97515
2021-07-31;"Košický kraj";17;1153;2;1155;NA;346390;19;2021-07-31;97513
2021-07-30;"Košický kraj";12;1657;7;1664;NA;346390;19;2021-07-30;97494
2021-07-29;"Košický kraj";7;1242;5;1247;NA;346390;12;2021-07-29;97475
2021-07-28;"Košický kraj";15;956;5;961;NA;346390;20;2021-07-28;97463
2021-07-27;"Košický kraj";17;1180;7;1187;NA;346390;24;2021-07-27;97443
2021-07-26;"Košický kraj";3;1666;9;1675;NA;346390;12;2021-07-26;97419
2021-07-25;"Košický kraj";0;719;3;722;NA;346390;3;2021-07-25;97407
2021-07-24;"Košický kraj";18;996;4;1000;NA;346390;22;2021-07-24;97404
2021-07-23;"Košický kraj";9;1524;5;1529;NA;346390;14;2021-07-23;97382
2021-07-22;"Košický kraj";1;1254;4;1258;NA;346390;5;2021-07-22;97368
2021-07-21;"Košický kraj";4;1117;3;1120;NA;346390;7;2021-07-21;97363
2021-07-20;"Košický kraj";6;1355;1;1356;NA;346390;7;2021-07-20;97356
2021-07-19;"Košický kraj";2;1517;2;1519;NA;346390;4;2021-07-19;97349
2021-07-18;"Košický kraj";0;644;0;644;NA;346390;0;2021-07-18;97345
2021-07-17;"Košický kraj";3;1101;5;1106;NA;346390;8;2021-07-17;97345
2021-07-16;"Košický kraj";3;1609;4;1613;NA;346390;7;2021-07-16;97337
2021-07-15;"Košický kraj";4;1383;4;1387;NA;346390;8;2021-07-15;97330
2021-07-14;"Košický kraj";2;1175;4;1179;NA;346390;6;2021-07-14;97322
2021-07-13;"Košický kraj";4;1331;1;1332;NA;346390;5;2021-07-13;97316
2021-07-12;"Košický kraj";3;1894;3;1897;NA;346390;6;2021-07-12;97311
2021-07-11;"Košický kraj";1;537;2;539;NA;346390;3;2021-07-11;97305
2021-07-10;"Košický kraj";9;1167;0;1167;NA;346390;9;2021-07-10;97302
2021-07-09;"Košický kraj";5;2005;5;2010;NA;346390;10;2021-07-09;97293
2021-07-08;"Košický kraj";13;1282;2;1284;NA;346390;15;2021-07-08;97283
2021-07-07;"Košický kraj";6;1524;1;1525;NA;346390;7;2021-07-07;97268
2021-07-06;"Košický kraj";4;1886;2;1888;NA;346390;6;2021-07-06;97261
2021-07-05;"Košický kraj";1;573;1;574;NA;346390;2;2021-07-05;97255
2021-07-04;"Košický kraj";0;482;2;484;NA;346390;2;2021-07-04;97253
2021-07-03;"Košický kraj";2;1227;0;1227;NA;346390;2;2021-07-03;97251
2021-07-02;"Košický kraj";2;1883;3;1886;NA;346390;5;2021-07-02;97249
2021-07-01;"Košický kraj";0;1211;2;1213;NA;346390;2;2021-07-01;97244
2021-06-30;"Košický kraj";5;9306;7;9313;NA;346390;12;2021-06-30;97242
2021-06-29;"Košický kraj";6;5692;7;5699;NA;346390;13;2021-06-29;97230
2021-06-28;"Košický kraj";5;6129;2;6131;NA;346390;7;2021-06-28;97217
2021-06-27;"Košický kraj";8;4636;3;4639;NA;346390;11;2021-06-27;97210
2021-06-26;"Košický kraj";4;5699;14;5713;NA;346390;18;2021-06-26;97199
2021-06-25;"Košický kraj";5;6981;2;6983;NA;346390;7;2021-06-25;97181
2021-06-24;"Košický kraj";1;5072;3;5075;NA;346390;4;2021-06-24;97174
2021-06-23;"Košický kraj";8;5373;3;5376;NA;346390;11;2021-06-23;97170
2021-06-22;"Košický kraj";1;5269;3;5272;NA;346390;4;2021-06-22;97159
2021-06-21;"Košický kraj";5;6830;11;6841;NA;346390;16;2021-06-21;97155
2021-06-20;"Košický kraj";0;4882;6;4888;NA;346390;6;2021-06-20;97139
2021-06-19;"Košický kraj";7;6473;1;6474;NA;346390;8;2021-06-19;97133
2021-06-18;"Košický kraj";4;7969;8;7977;NA;346390;12;2021-06-18;97125
2021-06-17;"Košický kraj";6;6128;3;6131;NA;346390;9;2021-06-17;97113
2021-06-16;"Košický kraj";11;6059;7;6066;NA;346390;18;2021-06-16;97104
2021-06-15;"Košický kraj";12;6301;2;6303;NA;346390;14;2021-06-15;97086
2021-06-14;"Košický kraj";10;7076;9;7085;NA;346390;19;2021-06-14;97072
2021-06-13;"Košický kraj";7;6948;8;6956;NA;346390;15;2021-06-13;97053
2021-06-12;"Košický kraj";7;7485;9;7494;NA;346390;16;2021-06-12;97038
2021-06-11;"Košický kraj";15;8973;6;8979;NA;346390;21;2021-06-11;97022
2021-06-10;"Košický kraj";11;6588;16;6604;NA;346390;27;2021-06-10;97001
2021-06-09;"Košický kraj";37;6056;7;6063;NA;346390;44;2021-06-09;96974
2021-06-08;"Košický kraj";33;7019;13;7032;NA;346390;46;2021-06-08;96930
2021-06-07;"Košický kraj";11;8106;22;8128;NA;346390;33;2021-06-07;96884
2021-06-06;"Košický kraj";1;7843;7;7850;NA;346390;8;2021-06-06;96851
2021-06-05;"Košický kraj";21;9286;3;9289;NA;346390;24;2021-06-05;96843
2021-06-04;"Košický kraj";26;11418;20;11438;NA;346390;46;2021-06-04;96819
2021-06-03;"Košický kraj";23;6467;14;6481;NA;346390;37;2021-06-03;96773
2021-06-02;"Košický kraj";15;7180;24;7204;NA;346390;39;2021-06-02;96736
2021-06-01;"Košický kraj";13;7562;10;7572;NA;346390;23;2021-06-01;96697
2021-05-31;"Košický kraj";13;9256;18;9274;NA;346390;31;2021-05-31;96674
2021-05-30;"Košický kraj";3;11215;10;11225;NA;346390;13;2021-05-30;96643
2021-05-29;"Košický kraj";25;10942;22;10964;NA;346390;47;2021-05-29;96630
2021-05-28;"Košický kraj";17;13055;29;13084;NA;346390;46;2021-05-28;96583
2021-05-27;"Košický kraj";19;7924;26;7950;NA;346390;45;2021-05-27;96537
2021-05-26;"Košický kraj";35;8118;27;8145;NA;346390;62;2021-05-26;96492
2021-05-25;"Košický kraj";33;9296;29;9325;NA;346390;62;2021-05-25;96430
2021-05-24;"Košický kraj";10;10855;27;10882;NA;346390;37;2021-05-24;96368
2021-05-23;"Košický kraj";4;12151;15;12166;NA;346390;19;2021-05-23;96331
2021-05-22;"Košický kraj";27;12601;19;12620;NA;346390;46;2021-05-22;96312
2021-05-21;"Košický kraj";24;14910;27;14937;NA;346390;51;2021-05-21;96266
2021-05-20;"Košický kraj";20;9422;28;9450;NA;346390;48;2021-05-20;96215
2021-05-19;"Košický kraj";30;10421;21;10442;NA;346390;51;2021-05-19;96167
2021-05-18;"Košický kraj";34;10254;36;10290;NA;346390;70;2021-05-18;96116
2021-05-17;"Košický kraj";20;12686;38;12724;NA;346390;58;2021-05-17;96046
2021-05-16;"Košický kraj";37;17865;20;17885;NA;346390;57;2021-05-16;95988
2021-05-15;"Košický kraj";22;25602;28;25630;NA;346390;50;2021-05-15;95931
2021-05-14;"Košický kraj";32;21824;42;21866;NA;346390;74;2021-05-14;95881
2021-05-13;"Košický kraj";39;10172;32;10204;NA;346390;71;2021-05-13;95807
2021-05-12;"Košický kraj";85;10868;33;10901;NA;346390;118;2021-05-12;95736
2021-05-11;"Košický kraj";68;11166;32;11198;NA;346390;100;2021-05-11;95618
2021-05-10;"Košický kraj";25;17044;42;17086;NA;346390;67;2021-05-10;95518
2021-05-09;"Košický kraj";84;25594;55;25649;NA;346390;139;2021-05-09;95451
2021-05-08;"Košický kraj";18;23399;23;23422;NA;346390;41;2021-05-08;95312
2021-05-07;"Košický kraj";51;24497;57;24554;NA;346390;108;2021-05-07;95271
2021-05-06;"Košický kraj";55;11847;43;11890;NA;346390;98;2021-05-06;95163
2021-05-05;"Košický kraj";23;12124;35;12159;NA;346390;58;2021-05-05;95065
2021-05-04;"Košický kraj";143;13562;38;13600;NA;346390;181;2021-05-04;95007
2021-05-03;"Košický kraj";37;16944;68;17012;NA;346390;105;2021-05-03;94826
2021-05-02;"Košický kraj";45;36096;56;36152;NA;346390;101;2021-05-02;94721
2021-05-01;"Košický kraj";54;52075;76;52151;NA;346390;130;2021-05-01;94620
2021-04-30;"Košický kraj";59;44602;94;44696;NA;346390;153;2021-04-30;94490
2021-04-29;"Košický kraj";76;17014;53;17067;NA;346390;129;2021-04-29;94337
2021-04-28;"Košický kraj";99;17970;52;18022;NA;346390;151;2021-04-28;94208
2021-04-27;"Košický kraj";108;20670;43;20713;NA;346390;151;2021-04-27;94057
2021-04-26;"Košický kraj";39;25915;96;26011;NA;346390;135;2021-04-26;93906
2021-04-25;"Košický kraj";23;48355;57;48412;NA;346390;80;2021-04-25;93771
2021-04-24;"Košický kraj";68;90124;114;90238;NA;346390;182;2021-04-24;93691
2021-04-23;"Košický kraj";110;41232;72;41304;NA;346390;182;2021-04-23;93509
2021-04-22;"Košický kraj";56;16772;44;16816;NA;346390;100;2021-04-22;93327
2021-04-21;"Košický kraj";114;19519;61;19580;NA;346390;175;2021-04-21;93227
2021-04-20;"Košický kraj";81;25432;63;25495;NA;346390;144;2021-04-20;93052
2021-04-19;"Košický kraj";93;29950;108;30058;NA;346390;201;2021-04-19;92908
2021-04-18;"Košický kraj";10;48913;82;48995;NA;346390;92;2021-04-18;92707
2021-04-17;"Košický kraj";187;83856;103;83959;NA;346390;290;2021-04-17;92615
2021-04-16;"Košický kraj";83;41568;127;41695;NA;346390;210;2021-04-16;92325
2021-04-15;"Košický kraj";104;18522;93;18615;NA;346390;197;2021-04-15;92115
2021-04-14;"Košický kraj";119;20089;64;20153;NA;346390;183;2021-04-14;91918
2021-04-13;"Košický kraj";81;23175;120;23295;NA;346390;201;2021-04-13;91735
2021-04-12;"Košický kraj";129;26573;124;26697;NA;346390;253;2021-04-12;91534
2021-04-11;"Košický kraj";29;46949;80;47029;NA;346390;109;2021-04-11;91281
2021-04-10;"Košický kraj";138;100114;183;100297;NA;346390;321;2021-04-10;91172
2021-04-09;"Košický kraj";168;35206;133;35339;NA;346390;301;2021-04-09;90851
2021-04-08;"Košický kraj";81;18530;90;18620;NA;346390;171;2021-04-08;90550
2021-04-07;"Košický kraj";232;28027;194;28221;NA;346390;426;2021-04-07;90379
2021-04-06;"Košický kraj";121;36495;164;36659;NA;346390;285;2021-04-06;89953
2021-04-05;"Košický kraj";19;14361;66;14427;NA;346390;85;2021-04-05;89668
2021-04-04;"Košický kraj";33;15089;66;15155;NA;346390;99;2021-04-04;89583
2021-04-03;"Košický kraj";138;97664;241;97905;NA;346390;379;2021-04-03;89484
2021-04-02;"Košický kraj";128;24515;76;24591;NA;346390;204;2021-04-02;89105
2021-04-01;"Košický kraj";165;46151;156;46307;NA;346390;321;2021-04-01;88901
2021-03-31;"Košický kraj";160;29659;124;29783;NA;346390;284;2021-03-31;88580
2021-03-30;"Košický kraj";229;24038;163;24201;NA;346390;392;2021-03-30;88296
2021-03-29;"Košický kraj";78;28843;194;29037;NA;346390;272;2021-03-29;87904
2021-03-28;"Košický kraj";39;44263;128;44391;NA;346390;167;2021-03-28;87632
2021-03-27;"Košický kraj";222;96602;265;96867;NA;346390;487;2021-03-27;87465
2021-03-26;"Košický kraj";233;45252;202;45454;NA;346390;435;2021-03-26;86978
2021-03-25;"Košický kraj";133;23804;175;23979;NA;346390;308;2021-03-25;86543
2021-03-24;"Košický kraj";165;20696;155;20851;NA;346390;320;2021-03-24;86235
2021-03-23;"Košický kraj";202;22434;192;22626;NA;346390;394;2021-03-23;85915
2021-03-22;"Košický kraj";169;26890;228;27118;NA;346390;397;2021-03-22;85521
2021-03-21;"Košický kraj";109;46746;167;46913;NA;346390;276;2021-03-21;85124
2021-03-20;"Košický kraj";126;101334;311;101645;NA;346390;437;2021-03-20;84848
2021-03-19;"Košický kraj";205;45632;260;45892;NA;346390;465;2021-03-19;84411
2021-03-18;"Košický kraj";274;23827;212;24039;NA;346390;486;2021-03-18;83946
2021-03-17;"Košický kraj";177;21548;195;21743;NA;346390;372;2021-03-17;83460
2021-03-16;"Košický kraj";386;23454;226;23680;NA;346390;612;2021-03-16;83088
2021-03-15;"Košický kraj";173;27900;297;28197;NA;346390;470;2021-03-15;82476
2021-03-14;"Košický kraj";145;44354;220;44574;NA;346390;365;2021-03-14;82006
2021-03-13;"Košický kraj";146;103790;483;104273;NA;346390;629;2021-03-13;81641
2021-03-12;"Košický kraj";366;47871;321;48192;NA;346390;687;2021-03-12;81012
2021-03-11;"Košický kraj";396;23229;263;23492;NA;346390;659;2021-03-11;80325
2021-03-10;"Košický kraj";121;22205;269;22474;NA;346390;390;2021-03-10;79666
2021-03-09;"Košický kraj";676;24509;300;24809;NA;346390;976;2021-03-09;79276
2021-03-08;"Košický kraj";559;29852;344;30196;NA;346390;903;2021-03-08;78300
2021-03-07;"Košický kraj";45;44230;299;44529;NA;346390;344;2021-03-07;77397
2021-03-06;"Košický kraj";177;105598;532;106130;NA;346390;709;2021-03-06;77053
2021-03-05;"Košický kraj";439;45567;424;45991;NA;346390;863;2021-03-05;76344
2021-03-04;"Košický kraj";417;23862;320;24182;NA;346390;737;2021-03-04;75481
2021-03-03;"Košický kraj";390;23169;298;23467;NA;346390;688;2021-03-03;74744
2021-03-02;"Košický kraj";464;24158;368;24526;NA;346390;832;2021-03-02;74056
2021-03-01;"Košický kraj";389;30013;514;30527;NA;346390;903;2021-03-01;73224
2021-02-28;"Košický kraj";265;43053;334;43387;NA;346390;599;2021-02-28;72321
2021-02-27;"Košický kraj";301;100559;784;101343;NA;346390;1085;2021-02-27;71722
2021-02-26;"Košický kraj";440;45466;492;45958;NA;346390;932;2021-02-26;70637
2021-02-25;"Košický kraj";331;19872;342;20214;NA;346390;673;2021-02-25;69705
2021-02-24;"Košický kraj";263;18751;505;19256;NA;346390;768;2021-02-24;69032
2021-02-23;"Košický kraj";642;21605;341;21946;NA;346390;983;2021-02-23;68264
2021-02-22;"Košický kraj";362;30858;434;31292;NA;346390;796;2021-02-22;67281
2021-02-21;"Košický kraj";170;40464;385;40849;NA;346390;555;2021-02-21;66485
2021-02-20;"Košický kraj";283;92550;770;93320;NA;346390;1053;2021-02-20;65930
2021-02-19;"Košický kraj";507;41579;583;42162;NA;346390;1090;2021-02-19;64877
2021-02-18;"Košický kraj";397;18442;345;18787;NA;346390;742;2021-02-18;63787
2021-02-17;"Košický kraj";322;18080;387;18467;NA;346390;709;2021-02-17;63045
2021-02-16;"Košický kraj";600;22111;463;22574;NA;346390;1063;2021-02-16;62336
2021-02-15;"Košický kraj";216;27633;419;28052;NA;346390;635;2021-02-15;61273
2021-02-14;"Košický kraj";241;56743;524;57267;NA;346390;765;2021-02-14;60638
2021-02-13;"Košický kraj";206;93745;765;94510;NA;346390;971;2021-02-13;59873
2021-02-12;"Košický kraj";448;49924;611;50535;NA;346390;1059;2021-02-12;58902
2021-02-11;"Košický kraj";435;14524;323;14847;NA;346390;758;2021-02-11;57843
2021-02-10;"Košický kraj";360;18475;431;18906;NA;346390;791;2021-02-10;57085
2021-02-09;"Košický kraj";544;24841;463;25304;NA;346390;1007;2021-02-09;56294
2021-02-08;"Košický kraj";237;24836;392;25228;NA;346390;629;2021-02-08;55287
2021-02-07;"Košický kraj";208;56897;612;57509;NA;346390;820;2021-02-07;54658
2021-02-06;"Košický kraj";318;104357;884;105241;NA;346390;1202;2021-02-06;53838
2021-02-05;"Košický kraj";384;43186;494;43680;NA;346390;878;2021-02-05;52636
2021-02-04;"Košický kraj";391;14512;371;14883;NA;346390;762;2021-02-04;51758
2021-02-03;"Košický kraj";296;12599;339;12938;NA;346390;635;2021-02-03;50996
2021-02-02;"Košický kraj";473;43883;1212;45095;NA;346390;1685;2021-02-02;50361
2021-02-01;"Košický kraj";415;21984;362;22346;NA;346390;777;2021-02-01;48676
2021-01-31;"Košický kraj";142;54690;617;55307;NA;346390;759;2021-01-31;47899
2021-01-30;"Košický kraj";320;76722;661;77383;NA;346390;981;2021-01-30;47140
2021-01-29;"Košický kraj";311;37164;466;37630;NA;346390;777;2021-01-29;46159
2021-01-28;"Košický kraj";540;9006;244;9250;NA;346390;784;2021-01-28;45382
2021-01-27;"Košický kraj";265;7575;211;7786;NA;346390;476;2021-01-27;44598
2021-01-26;"Košický kraj";530;14210;245;14455;NA;346390;775;2021-01-26;44122
2021-01-25;"Košický kraj";226;26431;413;26844;NA;346390;639;2021-01-25;43347
2021-01-24;"Košický kraj";150;44419;581;45000;NA;346390;731;2021-01-24;42708
2021-01-23;"Košický kraj";232;82705;857;83562;NA;346390;1089;2021-01-23;41977
2021-01-22;"Košický kraj";316;19997;265;20262;NA;346390;581;2021-01-22;40888
2021-01-21;"Košický kraj";274;14053;159;14212;NA;346390;433;2021-01-21;40307
2021-01-20;"Košický kraj";374;10844;201;11045;NA;346390;575;2021-01-20;39874
2021-01-19;"Košický kraj";248;9717;181;9898;NA;346390;429;2021-01-19;39299
2021-01-18;"Košický kraj";333;7659;262;7921;NA;346390;595;2021-01-18;38870
2021-01-17;"Košický kraj";155;535;14;549;NA;346390;169;2021-01-17;38275
2021-01-16;"Košický kraj";153;1403;47;1450;NA;346390;200;2021-01-16;38106
2021-01-15;"Košický kraj";308;6443;213;6656;NA;346390;521;2021-01-15;37906
2021-01-14;"Košický kraj";358;5471;221;5692;NA;346390;579;2021-01-14;37385
2021-01-13;"Košický kraj";421;4897;226;5123;NA;346390;647;2021-01-13;36806
2021-01-12;"Košický kraj";482;6473;237;6710;NA;346390;719;2021-01-12;36159
2021-01-11;"Košický kraj";309;7553;286;7839;NA;346390;595;2021-01-11;35440
2021-01-10;"Košický kraj";193;136;6;142;NA;346390;199;2021-01-10;34845
2021-01-09;"Košický kraj";469;1134;45;1179;NA;346390;514;2021-01-09;34646
2021-01-08;"Košický kraj";551;7106;348;7454;NA;346390;899;2021-01-08;34132
2021-01-07;"Košický kraj";251;5853;398;6251;NA;346390;649;2021-01-07;33233
2021-01-06;"Košický kraj";442;429;33;462;NA;346390;475;2021-01-06;32584
2021-01-05;"Košický kraj";584;7633;527;8160;NA;346390;1111;2021-01-05;32109
2021-01-04;"Košický kraj";407;6479;660;7139;NA;346390;1067;2021-01-04;30998
2021-01-03;"Košický kraj";118;661;22;683;NA;346390;140;2021-01-03;29931
2021-01-02;"Košický kraj";88;440;52;492;NA;346390;140;2021-01-02;29791
2021-01-01;"Košický kraj";398;725;49;774;NA;346390;447;2021-01-01;29651
2020-12-31;"Košický kraj";625;7509;453;7962;NA;346390;1078;2020-12-31;29204
2020-12-30;"Košický kraj";590;6076;395;6471;NA;346390;985;2020-12-30;28126
2020-12-29;"Košický kraj";419;7454;596;8050;NA;346390;1015;2020-12-29;27141
2020-12-28;"Košický kraj";356;7933;756;8689;NA;346390;1112;2020-12-28;26126
2020-12-27;"Košický kraj";159;147;16;163;NA;346390;175;2020-12-27;25014
2020-12-26;"Košický kraj";163;274;23;297;NA;346390;186;2020-12-26;24839
2020-12-25;"Košický kraj";237;140;10;150;NA;346390;247;2020-12-25;24653
2020-12-24;"Košický kraj";564;1470;90;1560;NA;346390;654;2020-12-24;24406
2020-12-23;"Košický kraj";304;7339;327;7666;NA;346390;631;2020-12-23;23752
2020-12-22;"Košický kraj";438;7284;429;7713;NA;346390;867;2020-12-22;23121
2020-12-21;"Košický kraj";405;6703;504;7207;NA;346390;909;2020-12-21;22254
2020-12-20;"Košický kraj";215;73;11;84;NA;346390;226;2020-12-20;21345
2020-12-19;"Košický kraj";207;1309;63;1372;NA;346390;270;2020-12-19;21119
2020-12-18;"Košický kraj";310;7707;292;7999;NA;346390;602;2020-12-18;20849
2020-12-17;"Košický kraj";463;5101;253;5354;NA;346390;716;2020-12-17;20247
2020-12-16;"Košický kraj";455;5725;295;6020;NA;346390;750;2020-12-16;19531
2020-12-15;"Košický kraj";319;4787;327;5114;NA;346390;646;2020-12-15;18781
2020-12-14;"Košický kraj";256;2905;225;3130;NA;346390;481;2020-12-14;18135
2020-12-13;"Košický kraj";47;181;2;183;NA;346390;49;2020-12-13;17654
2020-12-12;"Košický kraj";369;1587;118;1705;NA;346390;487;2020-12-12;17605
2020-12-11;"Košický kraj";354;5328;256;5584;NA;346390;610;2020-12-11;17118
2020-12-10;"Košický kraj";283;3987;174;4161;NA;346390;457;2020-12-10;16508
2020-12-09;"Košický kraj";279;3786;166;3952;NA;346390;445;2020-12-09;16051
2020-12-08;"Košický kraj";226;4105;355;4460;NA;346390;581;2020-12-08;15606
2020-12-07;"Košický kraj";270;2383;106;2489;NA;346390;376;2020-12-07;15025
2020-12-06;"Košický kraj";121;482;33;515;NA;346390;154;2020-12-06;14649
2020-12-05;"Košický kraj";90;1096;48;1144;NA;346390;138;2020-12-05;14495
2020-12-04;"Košický kraj";224;2680;82;2762;NA;346390;306;2020-12-04;14357
2020-12-03;"Košický kraj";211;7717;173;7890;NA;346390;384;2020-12-03;14051
2020-12-02;"Košický kraj";193;8132;496;8628;NA;346390;689;2020-12-02;13667
2020-12-01;"Košický kraj";178;2237;124;2361;NA;346390;302;2020-12-01;12978
2020-11-30;"Košický kraj";171;3598;59;3657;NA;346390;230;2020-11-30;12676
2020-11-29;"Košický kraj";31;325;17;342;NA;346390;48;2020-11-29;12446
2020-11-28;"Košický kraj";69;721;52;773;NA;346390;121;2020-11-28;12398
2020-11-27;"Košický kraj";149;2921;78;2999;NA;346390;227;2020-11-27;12277
2020-11-26;"Košický kraj";239;1234;60;1294;NA;346390;299;2020-11-26;12050
2020-11-25;"Košický kraj";237;1785;123;1908;NA;346390;360;2020-11-25;11751
2020-11-24;"Košický kraj";196;1976;67;2043;NA;346390;263;2020-11-24;11391
2020-11-23;"Košický kraj";51;4115;63;4178;NA;346390;114;2020-11-23;11128
2020-11-22;"Košický kraj";57;57;5;62;NA;346390;62;2020-11-22;11014
2020-11-21;"Košický kraj";87;858;36;894;NA;346390;123;2020-11-21;10952
2020-11-20;"Košický kraj";176;3084;49;3133;NA;346390;225;2020-11-20;10829
2020-11-19;"Košický kraj";206;1736;48;1784;NA;346390;254;2020-11-19;10604
2020-11-18;"Košický kraj";122;532;17;549;NA;346390;139;2020-11-18;10350
2020-11-17;"Košický kraj";152;82;9;91;NA;346390;161;2020-11-17;10211
2020-11-16;"Košický kraj";114;596;27;623;NA;346390;141;2020-11-16;10050
2020-11-15;"Košický kraj";15;338;7;345;NA;346390;22;2020-11-15;9909
2020-11-14;"Košický kraj";234;520;12;532;NA;346390;246;2020-11-14;9887
2020-11-13;"Košický kraj";207;664;29;693;NA;346390;236;2020-11-13;9641
2020-11-12;"Košický kraj";192;736;13;749;NA;346390;205;2020-11-12;9405
2020-11-11;"Košický kraj";301;593;7;600;NA;346390;308;2020-11-11;9200
2020-11-10;"Košický kraj";190;541;11;552;NA;346390;201;2020-11-10;8892
2020-11-09;"Košický kraj";129;380;17;397;NA;346390;146;2020-11-09;8691
2020-11-08;"Košický kraj";78;1306;8;1314;NA;346390;86;2020-11-08;8545
2020-11-07;"Košický kraj";192;3909;22;3931;NA;346390;214;2020-11-07;8459
2020-11-06;"Košický kraj";195;5310;34;5344;NA;346390;229;2020-11-06;8245
2020-11-05;"Košický kraj";342;330;31;361;NA;346390;373;2020-11-05;8016
2020-11-04;"Košický kraj";101;154;6;160;NA;346390;107;2020-11-04;7643
2020-11-03;"Košický kraj";358;1122;13;1135;NA;346390;371;2020-11-03;7536
2020-11-02;"Košický kraj";111;6125;56;6181;NA;346390;167;2020-11-02;7165
2020-11-01;"Košický kraj";346;6522;34;6556;NA;346390;380;2020-11-01;6998
2020-10-31;"Košický kraj";82;14035;106;14141;NA;346390;188;2020-10-31;6618
2020-10-30;"Košický kraj";379;2835;27;2862;NA;346390;406;2020-10-30;6430
2020-10-29;"Košický kraj";333;983;13;996;NA;346390;346;2020-10-29;6024
2020-10-28;"Košický kraj";224;305;13;318;NA;346390;237;2020-10-28;5678
2020-10-27;"Košický kraj";386;439;21;460;NA;346390;407;2020-10-27;5441
2020-10-26;"Košický kraj";56;212;12;224;NA;346390;68;2020-10-26;5034
2020-10-25;"Košický kraj";154;79;2;81;NA;346390;156;2020-10-25;4966
2020-10-24;"Košický kraj";313;118;16;134;NA;346390;329;2020-10-24;4810
2020-10-23;"Košický kraj";315;331;8;339;NA;346390;323;2020-10-23;4481
2020-10-22;"Košický kraj";349;530;16;546;NA;346390;365;2020-10-22;4158
2020-10-21;"Košický kraj";129;84;2;86;NA;346390;131;2020-10-21;3793
2020-10-20;"Košický kraj";181;14;1;15;NA;346390;182;2020-10-20;3662
2020-10-19;"Košický kraj";64;38;1;39;NA;346390;65;2020-10-19;3480
2020-10-18;"Košický kraj";158;0;0;0;NA;346390;158;2020-10-18;3415
2020-10-17;"Košický kraj";142;0;0;0;NA;346390;142;2020-10-17;3257
2020-10-16;"Košický kraj";206;19;0;19;NA;346390;206;2020-10-16;3115
2020-10-15;"Košický kraj";177;19;5;24;NA;346390;182;2020-10-15;2909
2020-10-14;"Košický kraj";211;8;0;8;NA;346390;211;2020-10-14;2727
2020-10-13;"Košický kraj";179;80;3;83;NA;346390;182;2020-10-13;2516
2020-10-12;"Košický kraj";74;0;0;0;NA;346390;74;2020-10-12;2334
2020-10-11;"Košický kraj";121;0;0;0;NA;346390;121;2020-10-11;2260
2020-10-10;"Košický kraj";70;0;0;0;NA;346390;70;2020-10-10;2139
2020-10-09;"Košický kraj";188;0;0;0;NA;346390;188;2020-10-09;2069
2020-10-08;"Košický kraj";102;0;0;0;NA;346390;102;2020-10-08;1881
2020-10-07;"Košický kraj";158;0;0;0;NA;346390;158;2020-10-07;1779
2020-10-06;"Košický kraj";70;0;0;0;NA;346390;70;2020-10-06;1621
2020-10-05;"Košický kraj";39;0;0;0;NA;346390;39;2020-10-05;1551
2020-10-04;"Košický kraj";45;0;0;0;NA;346390;45;2020-10-04;1512
2020-10-03;"Košický kraj";105;0;0;0;NA;346390;105;2020-10-03;1467
2020-10-02;"Košický kraj";57;0;0;0;NA;346390;57;2020-10-02;1362
2020-10-01;"Košický kraj";69;0;0;0;NA;346390;69;2020-10-01;1305
2020-09-30;"Košický kraj";95;0;0;0;NA;346390;95;2020-09-30;1236
2020-09-29;"Košický kraj";75;0;0;0;NA;346390;75;2020-09-29;1141
2020-09-28;"Košický kraj";19;0;0;0;NA;346390;19;2020-09-28;1066
2020-09-27;"Košický kraj";21;0;0;0;NA;346390;21;2020-09-27;1047
2020-09-26;"Košický kraj";53;0;0;0;NA;346390;53;2020-09-26;1026
2020-09-25;"Košický kraj";72;0;0;0;NA;346390;72;2020-09-25;973
2020-09-24;"Košický kraj";35;0;0;0;NA;346390;35;2020-09-24;901
2020-09-23;"Košický kraj";23;0;0;0;NA;346390;23;2020-09-23;866
2020-09-22;"Košický kraj";39;0;0;0;NA;346390;39;2020-09-22;843
2020-09-21;"Košický kraj";5;0;0;0;NA;346390;5;2020-09-21;804
2020-09-20;"Košický kraj";3;0;0;0;NA;346390;3;2020-09-20;799
2020-09-19;"Košický kraj";13;0;0;0;NA;346390;13;2020-09-19;796
2020-09-18;"Košický kraj";20;0;0;0;NA;346390;20;2020-09-18;783
2020-09-17;"Košický kraj";22;0;0;0;NA;346390;22;2020-09-17;763
2020-09-16;"Košický kraj";12;0;0;0;NA;346390;12;2020-09-16;741
2020-09-15;"Košický kraj";10;0;0;0;NA;346390;10;2020-09-15;729
2020-09-14;"Košický kraj";6;0;0;0;NA;346390;6;2020-09-14;719
2020-09-13;"Košický kraj";3;0;0;0;NA;346390;3;2020-09-13;713
2020-09-12;"Košický kraj";16;0;0;0;NA;346390;16;2020-09-12;710
2020-09-11;"Košický kraj";20;0;0;0;NA;346390;20;2020-09-11;694
2020-09-10;"Košický kraj";11;0;0;0;NA;346390;11;2020-09-10;674
2020-09-09;"Košický kraj";37;0;0;0;NA;346390;37;2020-09-09;663
2020-09-08;"Košický kraj";10;0;0;0;NA;346390;10;2020-09-08;626
2020-09-07;"Košický kraj";4;0;0;0;NA;346390;4;2020-09-07;616
2020-09-06;"Košický kraj";2;0;0;0;NA;346390;2;2020-09-06;612
2020-09-05;"Košický kraj";10;0;0;0;NA;346390;10;2020-09-05;610
2020-09-04;"Košický kraj";14;0;0;0;NA;346390;14;2020-09-04;600
2020-09-03;"Košický kraj";22;0;0;0;NA;346390;22;2020-09-03;586
2020-09-02;"Košický kraj";13;0;0;0;NA;346390;13;2020-09-02;564
2020-09-01;"Košický kraj";21;0;0;0;NA;346390;21;2020-09-01;551
2020-08-31;"Košický kraj";9;0;0;0;NA;346390;9;2020-08-31;530
2020-08-30;"Košický kraj";21;0;0;0;NA;346390;21;2020-08-30;521
2020-08-29;"Košický kraj";1;0;0;0;NA;346390;1;2020-08-29;500
2020-08-28;"Košický kraj";19;0;0;0;NA;346390;19;2020-08-28;499
2020-08-27;"Košický kraj";15;0;0;0;NA;346390;15;2020-08-27;480
2020-08-26;"Košický kraj";8;0;0;0;NA;346390;8;2020-08-26;465
2020-08-25;"Košický kraj";23;0;0;0;NA;346390;23;2020-08-25;457
2020-08-24;"Košický kraj";6;0;0;0;NA;346390;6;2020-08-24;434
2020-08-23;"Košický kraj";8;0;0;0;NA;346390;8;2020-08-23;428
2020-08-22;"Košický kraj";13;0;0;0;NA;346390;13;2020-08-22;420
2020-08-21;"Košický kraj";10;0;0;0;NA;346390;10;2020-08-21;407
2020-08-20;"Košický kraj";10;0;0;0;NA;346390;10;2020-08-20;397
2020-08-19;"Košický kraj";3;0;0;0;NA;346390;3;2020-08-19;387
2020-08-18;"Košický kraj";7;0;0;0;NA;346390;7;2020-08-18;384
2020-08-17;"Košický kraj";2;0;0;0;NA;346390;2;2020-08-17;377
2020-08-16;"Košický kraj";2;0;0;0;NA;346390;2;2020-08-16;375
2020-08-15;"Košický kraj";3;0;0;0;NA;346390;3;2020-08-15;373
2020-08-14;"Košický kraj";1;0;0;0;NA;346390;1;2020-08-14;370
2020-08-13;"Košický kraj";3;0;0;0;NA;346390;3;2020-08-13;369
2020-08-12;"Košický kraj";12;0;0;0;NA;346390;12;2020-08-12;366
2020-08-11;"Košický kraj";5;0;0;0;NA;346390;5;2020-08-11;354
2020-08-10;"Košický kraj";1;0;0;0;NA;346390;1;2020-08-10;349
2020-08-09;"Košický kraj";0;0;0;0;NA;346390;0;2020-08-09;348
2020-08-08;"Košický kraj";5;0;0;0;NA;346390;5;2020-08-08;348
2020-08-07;"Košický kraj";7;0;0;0;NA;346390;7;2020-08-07;343
2020-08-06;"Košický kraj";3;0;0;0;NA;346390;3;2020-08-06;336
2020-08-05;"Košický kraj";4;0;0;0;NA;346390;4;2020-08-05;333
2020-08-04;"Košický kraj";1;0;0;0;NA;346390;1;2020-08-04;329
2020-08-03;"Košický kraj";1;0;0;0;NA;346390;1;2020-08-03;328
2020-08-02;"Košický kraj";0;0;0;0;NA;346390;0;2020-08-02;327
2020-08-01;"Košický kraj";0;0;0;0;NA;346390;0;2020-08-01;327
2020-07-31;"Košický kraj";0;0;0;0;NA;346390;0;2020-07-31;327
2020-07-30;"Košický kraj";2;0;0;0;NA;346390;2;2020-07-30;327
2020-07-29;"Košický kraj";1;0;0;0;NA;346390;1;2020-07-29;325
2020-07-28;"Košický kraj";9;0;0;0;NA;346390;9;2020-07-28;324
2020-07-27;"Košický kraj";4;0;0;0;NA;346390;4;2020-07-27;315
2020-07-26;"Košický kraj";0;0;0;0;NA;346390;0;2020-07-26;311
2020-07-25;"Košický kraj";2;0;0;0;NA;346390;2;2020-07-25;311
2020-07-24;"Košický kraj";2;0;0;0;NA;346390;2;2020-07-24;309
2020-07-23;"Košický kraj";1;0;0;0;NA;346390;1;2020-07-23;307
2020-07-22;"Košický kraj";1;0;0;0;NA;346390;1;2020-07-22;306
2020-07-21;"Košický kraj";0;0;0;0;NA;346390;0;2020-07-21;305
2020-07-20;"Košický kraj";0;0;0;0;NA;346390;0;2020-07-20;305
2020-07-19;"Košický kraj";0;0;0;0;NA;346390;0;2020-07-19;305
2020-07-18;"Košický kraj";1;0;0;0;NA;346390;1;2020-07-18;305
2020-07-17;"Košický kraj";1;0;0;0;NA;346390;1;2020-07-17;304
2020-07-16;"Košický kraj";0;0;0;0;NA;346390;0;2020-07-16;303
2020-07-15;"Košický kraj";2;0;0;0;NA;346390;2;2020-07-15;303
2020-07-14;"Košický kraj";1;0;0;0;NA;346390;1;2020-07-14;301
2020-07-13;"Košický kraj";1;0;0;0;NA;346390;1;2020-07-13;300
2020-07-12;"Košický kraj";0;0;0;0;NA;346390;0;2020-07-12;299
2020-07-11;"Košický kraj";0;0;0;0;NA;346390;0;2020-07-11;299
2020-07-10;"Košický kraj";1;0;0;0;NA;346390;1;2020-07-10;299
2020-07-09;"Košický kraj";1;0;0;0;NA;346390;1;2020-07-09;298
2020-07-08;"Košický kraj";12;0;0;0;NA;346390;12;2020-07-08;297
2020-07-07;"Košický kraj";0;0;0;0;NA;346390;0;2020-07-07;285
2020-07-06;"Košický kraj";0;0;0;0;NA;346390;0;2020-07-06;285
2020-07-05;"Košický kraj";0;0;0;0;NA;346390;0;2020-07-05;285
2020-07-04;"Košický kraj";0;0;0;0;NA;346390;0;2020-07-04;285
2020-07-03;"Košický kraj";1;0;0;0;NA;346390;1;2020-07-03;285
2020-07-02;"Košický kraj";0;0;0;0;NA;346390;0;2020-07-02;284
2020-07-01;"Košický kraj";1;0;0;0;NA;346390;1;2020-07-01;284
2020-06-30;"Košický kraj";0;0;0;0;NA;346390;0;2020-06-30;283
2020-06-29;"Košický kraj";0;0;0;0;NA;346390;0;2020-06-29;283
2020-06-28;"Košický kraj";0;0;0;0;NA;346390;0;2020-06-28;283
2020-06-27;"Košický kraj";0;0;0;0;NA;346390;0;2020-06-27;283
2020-06-26;"Košický kraj";0;0;0;0;NA;346390;0;2020-06-26;283
2020-06-25;"Košický kraj";3;0;0;0;NA;346390;3;2020-06-25;283
2020-06-24;"Košický kraj";3;0;0;0;NA;346390;3;2020-06-24;280
2020-06-23;"Košický kraj";3;0;0;0;NA;346390;3;2020-06-23;277
2020-06-22;"Košický kraj";0;0;0;0;NA;346390;0;2020-06-22;274
2020-06-21;"Košický kraj";0;0;0;0;NA;346390;0;2020-06-21;274
2020-06-20;"Košický kraj";0;0;0;0;NA;346390;0;2020-06-20;274
2020-06-19;"Košický kraj";0;0;0;0;NA;346390;0;2020-06-19;274
2020-06-18;"Košický kraj";1;0;0;0;NA;346390;1;2020-06-18;274
2020-06-17;"Košický kraj";0;0;0;0;NA;346390;0;2020-06-17;273
2020-06-16;"Košický kraj";2;0;0;0;NA;346390;2;2020-06-16;273
2020-06-14;"Košický kraj";0;0;0;0;NA;346390;0;2020-06-14;271
2020-06-13;"Košický kraj";0;0;0;0;NA;346390;0;2020-06-13;271
2020-06-12;"Košický kraj";0;0;0;0;NA;346390;0;2020-06-12;271
2020-06-11;"Košický kraj";0;0;0;0;NA;346390;0;2020-06-11;271
2020-06-10;"Košický kraj";6;0;0;0;NA;346390;6;2020-06-10;271
2020-06-09;"Košický kraj";0;0;0;0;NA;346390;0;2020-06-09;265
2020-06-08;"Košický kraj";0;0;0;0;NA;346390;0;2020-06-08;265
2020-06-07;"Košický kraj";2;0;0;0;NA;346390;2;2020-06-07;265
2020-06-05;"Košický kraj";0;0;0;0;NA;346390;0;2020-06-05;263
2020-06-03;"Košický kraj";0;0;0;0;NA;346390;0;2020-06-03;263
2020-06-02;"Košický kraj";1;0;0;0;NA;346390;1;2020-06-02;263
2020-05-31;"Košický kraj";0;0;0;0;NA;346390;0;2020-05-31;262
2020-05-29;"Košický kraj";1;0;0;0;NA;346390;1;2020-05-29;262
2020-05-27;"Košický kraj";0;0;0;0;NA;346390;0;2020-05-27;261
2020-05-26;"Košický kraj";1;0;0;0;NA;346390;1;2020-05-26;261
2020-05-25;"Košický kraj";1;0;0;0;NA;346390;1;2020-05-25;260
2020-05-24;"Košický kraj";0;0;0;0;NA;346390;0;2020-05-24;259
2020-05-23;"Košický kraj";0;0;0;0;NA;346390;0;2020-05-23;259
2020-05-22;"Košický kraj";0;0;0;0;NA;346390;0;2020-05-22;259
2020-05-21;"Košický kraj";0;0;0;0;NA;346390;0;2020-05-21;259
2020-05-20;"Košický kraj";3;0;0;0;NA;346390;3;2020-05-20;259
2020-05-19;"Košický kraj";0;0;0;0;NA;346390;0;2020-05-19;256
2020-05-17;"Košický kraj";1;0;0;0;NA;346390;1;2020-05-17;256
2020-05-16;"Košický kraj";1;0;0;0;NA;346390;1;2020-05-16;255
2020-05-15;"Košický kraj";10;0;0;0;NA;346390;10;2020-05-15;254
2020-05-14;"Košický kraj";1;0;0;0;NA;346390;1;2020-05-14;244
2020-05-13;"Košický kraj";6;0;0;0;NA;346390;6;2020-05-13;243
2020-05-12;"Košický kraj";0;0;0;0;NA;346390;0;2020-05-12;237
2020-05-11;"Košický kraj";0;0;0;0;NA;346390;0;2020-05-11;237
2020-05-09;"Košický kraj";0;0;0;0;NA;346390;0;2020-05-09;237
2020-05-07;"Košický kraj";0;0;0;0;NA;346390;0;2020-05-07;237
2020-05-06;"Košický kraj";1;0;0;0;NA;346390;1;2020-05-06;237
2020-05-05;"Košický kraj";0;0;0;0;NA;346390;0;2020-05-05;236
2020-05-04;"Košický kraj";0;0;0;0;NA;346390;0;2020-05-04;236
2020-05-03;"Košický kraj";0;0;0;0;NA;346390;0;2020-05-03;236
2020-05-02;"Košický kraj";1;0;0;0;NA;346390;1;2020-05-02;236
2020-05-01;"Košický kraj";0;0;0;0;NA;346390;0;2020-05-01;235
2020-04-30;"Košický kraj";1;0;0;0;NA;346390;1;2020-04-30;235
2020-04-29;"Košický kraj";1;0;0;0;NA;346390;1;2020-04-29;234
2020-04-28;"Košický kraj";1;0;0;0;NA;346390;1;2020-04-28;233
2020-04-27;"Košický kraj";1;0;0;0;NA;346390;1;2020-04-27;232
2020-04-26;"Košický kraj";0;0;0;0;NA;346390;0;2020-04-26;231
2020-04-25;"Košický kraj";0;0;0;0;NA;346390;0;2020-04-25;231
2020-04-24;"Košický kraj";3;0;0;0;NA;346390;3;2020-04-24;231
2020-04-23;"Košický kraj";4;0;0;0;NA;346390;4;2020-04-23;228
2020-04-22;"Košický kraj";21;0;0;0;NA;346390;21;2020-04-22;224
2020-04-21;"Košický kraj";4;0;0;0;NA;346390;4;2020-04-21;203
2020-04-20;"Košický kraj";0;0;0;0;NA;346390;0;2020-04-20;199
2020-04-19;"Košický kraj";1;0;0;0;NA;346390;1;2020-04-19;199
2020-04-18;"Košický kraj";2;0;0;0;NA;346390;2;2020-04-18;198
2020-04-17;"Košický kraj";7;0;0;0;NA;346390;7;2020-04-17;196
2020-04-16;"Košický kraj";29;0;0;0;NA;346390;29;2020-04-16;189
2020-04-15;"Košický kraj";50;0;0;0;NA;346390;50;2020-04-15;160
2020-04-14;"Košický kraj";4;0;0;0;NA;346390;4;2020-04-14;110
2020-04-13;"Košický kraj";5;0;0;0;NA;346390;5;2020-04-13;106
2020-04-12;"Košický kraj";4;0;0;0;NA;346390;4;2020-04-12;101
2020-04-11;"Košický kraj";2;0;0;0;NA;346390;2;2020-04-11;97
2020-04-10;"Košický kraj";1;0;0;0;NA;346390;1;2020-04-10;95
2020-04-09;"Košický kraj";4;0;0;0;NA;346390;4;2020-04-09;94
2020-04-08;"Košický kraj";5;0;0;0;NA;346390;5;2020-04-08;90
2020-04-07;"Košický kraj";34;0;0;0;NA;346390;34;2020-04-07;85
2020-04-06;"Košický kraj";6;0;0;0;NA;346390;6;2020-04-06;51
2020-04-05;"Košický kraj";4;0;0;0;NA;346390;4;2020-04-05;45
2020-04-04;"Košický kraj";5;0;0;0;NA;346390;5;2020-04-04;41
2020-04-03;"Košický kraj";4;0;0;0;NA;346390;4;2020-04-03;36
2020-04-02;"Košický kraj";3;0;0;0;NA;346390;3;2020-04-02;32
2020-04-01;"Košický kraj";3;0;0;0;NA;346390;3;2020-04-01;29
2020-03-31;"Košický kraj";1;0;0;0;NA;346390;1;2020-03-31;26
2020-03-30;"Košický kraj";5;0;0;0;NA;346390;5;2020-03-30;25
2020-03-29;"Košický kraj";0;0;0;0;NA;346390;0;2020-03-29;20
2020-03-28;"Košický kraj";1;0;0;0;NA;346390;1;2020-03-28;20
2020-03-27;"Košický kraj";1;0;0;0;NA;346390;1;2020-03-27;19
2020-03-26;"Košický kraj";3;0;0;0;NA;346390;3;2020-03-26;18
2020-03-25;"Košický kraj";2;0;0;0;NA;346390;2;2020-03-25;15
2020-03-24;"Košický kraj";0;0;0;0;NA;346390;0;2020-03-24;13
2020-03-23;"Košický kraj";2;0;0;0;NA;346390;2;2020-03-23;13
2020-03-22;"Košický kraj";0;0;0;0;NA;346390;0;2020-03-22;11
2020-03-21;"Košický kraj";3;0;0;0;NA;346390;3;2020-03-21;11
2020-03-20;"Košický kraj";1;0;0;0;NA;346390;1;2020-03-20;8
2020-03-19;"Košický kraj";0;0;0;0;NA;346390;0;2020-03-19;7
2020-03-18;"Košický kraj";0;0;0;0;NA;346390;0;2020-03-18;7
2020-03-17;"Košický kraj";0;0;0;0;NA;346390;0;2020-03-17;7
2020-03-16;"Košický kraj";3;0;0;0;NA;346390;3;2020-03-16;7
2020-03-15;"Košický kraj";1;0;0;0;NA;346390;1;2020-03-15;4
2020-03-14;"Košický kraj";0;0;0;0;NA;346390;0;2020-03-14;3
2020-03-13;"Košický kraj";2;0;0;0;NA;346390;2;2020-03-13;3
2020-03-12;"Košický kraj";0;0;0;0;NA;346390;0;2020-03-12;1
2020-03-11;"Košický kraj";0;0;0;0;NA;346390;0;2020-03-11;1
2020-03-09;"Košický kraj";1;0;0;0;NA;346390;1;2020-03-09;1
2020-03-08;"Košický kraj";0;0;0;0;NA;346390;0;2020-03-08;0
2020-03-07;"Košický kraj";0;0;0;0;NA;346390;0;2020-03-07;0
2020-03-06;"Košický kraj";0;0;0;0;NA;346390;0;2020-03-06;0
2022-05-24;"Nitriansky kraj";14;0;0;0;185724;284395;14;2022-05-24;284395
2022-05-23;"Nitriansky kraj";10;0;0;0;NA;284395;10;2022-05-23;284381
2022-05-22;"Nitriansky kraj";1;0;0;0;NA;284395;1;2022-05-22;284371
2022-05-21;"Nitriansky kraj";9;90;6;96;NA;284395;15;2022-05-21;284370
2022-05-20;"Nitriansky kraj";19;46;1;47;NA;284395;20;2022-05-20;284355
2022-05-19;"Nitriansky kraj";16;120;1;121;NA;284395;17;2022-05-19;284335
2022-05-18;"Nitriansky kraj";18;245;5;250;NA;284395;23;2022-05-18;284318
2022-05-17;"Nitriansky kraj";25;173;3;176;NA;284395;28;2022-05-17;284295
2022-05-16;"Nitriansky kraj";39;242;7;249;NA;284395;46;2022-05-16;284267
2022-05-15;"Nitriansky kraj";8;62;3;65;NA;284395;11;2022-05-15;284221
2022-05-14;"Nitriansky kraj";12;26;1;27;NA;284395;13;2022-05-14;284210
2022-05-13;"Nitriansky kraj";39;142;10;152;NA;284395;49;2022-05-13;284197
2022-05-12;"Nitriansky kraj";18;150;10;160;NA;284395;28;2022-05-12;284148
2022-05-11;"Nitriansky kraj";35;199;9;208;NA;284395;44;2022-05-11;284120
2022-05-10;"Nitriansky kraj";26;201;5;206;NA;284395;31;2022-05-10;284076
2022-05-09;"Nitriansky kraj";38;279;11;290;NA;284395;49;2022-05-09;284045
2022-05-08;"Nitriansky kraj";0;95;8;103;NA;284395;8;2022-05-08;283996
2022-05-07;"Nitriansky kraj";11;27;1;28;NA;284395;12;2022-05-07;283988
2022-05-06;"Nitriansky kraj";47;182;8;190;NA;284395;55;2022-05-06;283976
2022-05-05;"Nitriansky kraj";45;261;8;269;NA;284395;53;2022-05-05;283921
2022-05-04;"Nitriansky kraj";59;295;18;313;NA;284395;77;2022-05-04;283868
2022-05-03;"Nitriansky kraj";65;319;9;328;NA;284395;74;2022-05-03;283791
2022-05-02;"Nitriansky kraj";69;644;30;674;NA;284395;99;2022-05-02;283717
2022-05-01;"Nitriansky kraj";12;194;8;202;NA;284395;20;2022-05-01;283618
2022-04-30;"Nitriansky kraj";64;206;10;216;NA;284395;74;2022-04-30;283598
2022-04-29;"Nitriansky kraj";93;578;14;592;NA;284395;107;2022-04-29;283524
2022-04-28;"Nitriansky kraj";93;835;19;854;NA;284395;112;2022-04-28;283417
2022-04-27;"Nitriansky kraj";126;727;24;751;NA;284395;150;2022-04-27;283305
2022-04-26;"Nitriansky kraj";156;881;29;910;NA;284395;185;2022-04-26;283155
2022-04-25;"Nitriansky kraj";136;1115;52;1167;NA;284395;188;2022-04-25;282970
2022-04-24;"Nitriansky kraj";48;296;12;308;NA;284395;60;2022-04-24;282782
2022-04-23;"Nitriansky kraj";79;250;5;255;NA;284395;84;2022-04-23;282722
2022-04-22;"Nitriansky kraj";101;744;26;770;NA;284395;127;2022-04-22;282638
2022-04-21;"Nitriansky kraj";219;803;15;818;NA;284395;234;2022-04-21;282511
2022-04-20;"Nitriansky kraj";194;1007;33;1040;NA;284395;227;2022-04-20;282277
2022-04-19;"Nitriansky kraj";234;2106;83;2189;NA;284395;317;2022-04-19;282050
2022-04-18;"Nitriansky kraj";111;516;14;530;NA;284395;125;2022-04-18;281733
2022-04-17;"Nitriansky kraj";136;258;8;266;NA;284395;144;2022-04-17;281608
2022-04-16;"Nitriansky kraj";87;362;24;386;NA;284395;111;2022-04-16;281464
2022-04-15;"Nitriansky kraj";105;395;10;405;NA;284395;115;2022-04-15;281353
2022-04-14;"Nitriansky kraj";255;721;32;753;NA;284395;287;2022-04-14;281238
2022-04-13;"Nitriansky kraj";223;906;60;966;NA;284395;283;2022-04-13;280951
2022-04-12;"Nitriansky kraj";291;1043;60;1103;NA;284395;351;2022-04-12;280668
2022-04-11;"Nitriansky kraj";278;1668;101;1769;NA;284395;379;2022-04-11;280317
2022-04-10;"Nitriansky kraj";154;512;43;555;NA;284395;197;2022-04-10;279938
2022-04-09;"Nitriansky kraj";176;391;29;420;NA;284395;205;2022-04-09;279741
2022-04-08;"Nitriansky kraj";363;1066;76;1142;NA;284395;439;2022-04-08;279536
2022-04-07;"Nitriansky kraj";427;1293;115;1408;NA;284395;542;2022-04-07;279097
2022-04-06;"Nitriansky kraj";406;1191;98;1289;NA;284395;504;2022-04-06;278555
2022-04-05;"Nitriansky kraj";783;1195;110;1305;NA;284395;893;2022-04-05;278051
2022-04-04;"Nitriansky kraj";572;1570;152;1722;NA;284395;724;2022-04-04;277158
2022-04-03;"Nitriansky kraj";199;918;98;1016;NA;284395;297;2022-04-03;276434
2022-04-02;"Nitriansky kraj";362;450;45;495;NA;284395;407;2022-04-02;276137
2022-04-01;"Nitriansky kraj";614;1283;129;1412;NA;284395;743;2022-04-01;275730
2022-03-31;"Nitriansky kraj";685;1558;159;1717;NA;284395;844;2022-03-31;274987
2022-03-30;"Nitriansky kraj";751;1233;132;1365;NA;284395;883;2022-03-30;274143
2022-03-29;"Nitriansky kraj";1187;1523;175;1698;NA;284395;1362;2022-03-29;273260
2022-03-28;"Nitriansky kraj";711;1954;288;2242;NA;284395;999;2022-03-28;271898
2022-03-27;"Nitriansky kraj";463;790;148;938;NA;284395;611;2022-03-27;270899
2022-03-26;"Nitriansky kraj";653;408;83;491;NA;284395;736;2022-03-26;270288
2022-03-25;"Nitriansky kraj";918;1128;220;1348;NA;284395;1138;2022-03-25;269552
2022-03-24;"Nitriansky kraj";1391;1262;194;1456;NA;284395;1585;2022-03-24;268414
2022-03-23;"Nitriansky kraj";1401;1456;232;1688;NA;284395;1633;2022-03-23;266829
2022-03-22;"Nitriansky kraj";1360;1553;199;1752;NA;284395;1559;2022-03-22;265196
2022-03-21;"Nitriansky kraj";1304;2135;351;2486;NA;284395;1655;2022-03-21;263637
2022-03-20;"Nitriansky kraj";552;933;226;1159;NA;284395;778;2022-03-20;261982
2022-03-19;"Nitriansky kraj";839;424;146;570;NA;284395;985;2022-03-19;261204
2022-03-18;"Nitriansky kraj";1205;1201;271;1472;NA;284395;1476;2022-03-18;260219
2022-03-17;"Nitriansky kraj";1734;1473;236;1709;NA;284395;1970;2022-03-17;258743
2022-03-16;"Nitriansky kraj";1214;1472;232;1704;NA;284395;1446;2022-03-16;256773
2022-03-15;"Nitriansky kraj";1590;1566;256;1822;NA;284395;1846;2022-03-15;255327
2022-03-14;"Nitriansky kraj";1325;2630;384;3014;NA;284395;1709;2022-03-14;253481
2022-03-13;"Nitriansky kraj";527;992;202;1194;NA;284395;729;2022-03-13;251772
2022-03-12;"Nitriansky kraj";711;739;169;908;NA;284395;880;2022-03-12;251043
2022-03-11;"Nitriansky kraj";1085;1890;365;2255;NA;284395;1450;2022-03-11;250163
2022-03-10;"Nitriansky kraj";1403;2015;313;2328;NA;284395;1716;2022-03-10;248713
2022-03-09;"Nitriansky kraj";1452;2118;323;2441;NA;284395;1775;2022-03-09;246997
2022-03-08;"Nitriansky kraj";1695;2542;350;2892;NA;284395;2045;2022-03-08;245222
2022-03-07;"Nitriansky kraj";1115;3386;521;3907;NA;284395;1636;2022-03-07;243177
2022-03-06;"Nitriansky kraj";566;1509;350;1859;NA;284395;916;2022-03-06;241541
2022-03-05;"Nitriansky kraj";614;1239;214;1453;NA;284395;828;2022-03-05;240625
2022-03-04;"Nitriansky kraj";1315;1597;323;1920;NA;284395;1638;2022-03-04;239797
2022-03-03;"Nitriansky kraj";1405;2944;379;3323;NA;284395;1784;2022-03-03;238159
2022-03-02;"Nitriansky kraj";1417;2717;422;3139;NA;284395;1839;2022-03-02;236375
2022-03-01;"Nitriansky kraj";1380;2422;412;2834;NA;284395;1792;2022-03-01;234536
2022-02-28;"Nitriansky kraj";1577;4819;599;5418;NA;284395;2176;2022-02-28;232744
2022-02-27;"Nitriansky kraj";797;1271;294;1565;NA;284395;1091;2022-02-27;230568
2022-02-26;"Nitriansky kraj";895;799;217;1016;NA;284395;1112;2022-02-26;229477
2022-02-25;"Nitriansky kraj";1400;2314;339;2653;NA;284395;1739;2022-02-25;228365
2022-02-24;"Nitriansky kraj";1592;3586;389;3975;NA;284395;1981;2022-02-24;226626
2022-02-23;"Nitriansky kraj";1885;3930;476;4406;NA;284395;2361;2022-02-23;224645
2022-02-22;"Nitriansky kraj";2323;3849;502;4351;NA;284395;2825;2022-02-22;222284
2022-02-21;"Nitriansky kraj";1593;6250;816;7066;NA;284395;2409;2022-02-21;219459
2022-02-20;"Nitriansky kraj";1049;1987;439;2426;NA;284395;1488;2022-02-20;217050
2022-02-19;"Nitriansky kraj";1084;1341;336;1677;NA;284395;1420;2022-02-19;215562
2022-02-18;"Nitriansky kraj";2021;3277;583;3860;NA;284395;2604;2022-02-18;214142
2022-02-17;"Nitriansky kraj";2134;3890;480;4370;NA;284395;2614;2022-02-17;211538
2022-02-16;"Nitriansky kraj";2152;3945;532;4477;NA;284395;2684;2022-02-16;208924
2022-02-15;"Nitriansky kraj";2093;4069;780;4849;NA;284395;2873;2022-02-15;206240
2022-02-14;"Nitriansky kraj";2094;6253;921;7174;NA;284395;3015;2022-02-14;203367
2022-02-13;"Nitriansky kraj";1146;2832;547;3379;NA;284395;1693;2022-02-13;200352
2022-02-12;"Nitriansky kraj";1301;1171;343;1514;NA;284395;1644;2022-02-12;198659
2022-02-11;"Nitriansky kraj";2042;2942;561;3503;NA;284395;2603;2022-02-11;197015
2022-02-10;"Nitriansky kraj";2374;3366;537;3903;NA;284395;2911;2022-02-10;194412
2022-02-09;"Nitriansky kraj";2133;4802;653;5455;NA;284395;2786;2022-02-09;191501
2022-02-08;"Nitriansky kraj";1801;4935;736;5671;NA;284395;2537;2022-02-08;188715
2022-02-07;"Nitriansky kraj";2240;6803;762;7565;NA;284395;3002;2022-02-07;186178
2022-02-06;"Nitriansky kraj";1309;2690;494;3184;NA;284395;1803;2022-02-06;183176
2022-02-05;"Nitriansky kraj";1609;1504;358;1862;NA;284395;1967;2022-02-05;181373
2022-02-04;"Nitriansky kraj";1848;4185;510;4695;NA;284395;2358;2022-02-04;179406
2022-02-03;"Nitriansky kraj";2425;4186;491;4677;NA;284395;2916;2022-02-03;177048
2022-02-02;"Nitriansky kraj";1903;5318;766;6084;NA;284395;2669;2022-02-02;174132
2022-02-01;"Nitriansky kraj";2288;4717;597;5314;NA;284395;2885;2022-02-01;171463
2022-01-31;"Nitriansky kraj";1329;8991;746;9737;NA;284395;2075;2022-01-31;168578
2022-01-30;"Nitriansky kraj";777;3498;471;3969;NA;284395;1248;2022-01-30;166503
2022-01-29;"Nitriansky kraj";1099;1670;298;1968;NA;284395;1397;2022-01-29;165255
2022-01-28;"Nitriansky kraj";1610;4217;374;4591;NA;284395;1984;2022-01-28;163858
2022-01-27;"Nitriansky kraj";1429;3796;289;4085;NA;284395;1718;2022-01-27;161874
2022-01-26;"Nitriansky kraj";1392;4444;306;4750;NA;284395;1698;2022-01-26;160156
2022-01-25;"Nitriansky kraj";1591;4624;426;5050;NA;284395;2017;2022-01-25;158458
2022-01-24;"Nitriansky kraj";770;7459;359;7818;NA;284395;1129;2022-01-24;156441
2022-01-23;"Nitriansky kraj";327;3109;205;3314;NA;284395;532;2022-01-23;155312
2022-01-22;"Nitriansky kraj";596;1974;153;2127;NA;284395;749;2022-01-22;154780
2022-01-21;"Nitriansky kraj";532;3472;141;3613;NA;284395;673;2022-01-21;154031
2022-01-20;"Nitriansky kraj";737;3537;129;3666;NA;284395;866;2022-01-20;153358
2022-01-19;"Nitriansky kraj";614;4581;121;4702;NA;284395;735;2022-01-19;152492
2022-01-18;"Nitriansky kraj";650;3329;125;3454;NA;284395;775;2022-01-18;151757
2022-01-17;"Nitriansky kraj";439;7781;152;7933;NA;284395;591;2022-01-17;150982
2022-01-16;"Nitriansky kraj";140;3191;71;3262;NA;284395;211;2022-01-16;150391
2022-01-15;"Nitriansky kraj";268;1651;50;1701;NA;284395;318;2022-01-15;150180
2022-01-14;"Nitriansky kraj";167;2900;68;2968;NA;284395;235;2022-01-14;149862
2022-01-13;"Nitriansky kraj";244;3297;53;3350;NA;284395;297;2022-01-13;149627
2022-01-12;"Nitriansky kraj";298;4325;66;4391;NA;284395;364;2022-01-12;149330
2022-01-11;"Nitriansky kraj";424;3990;50;4040;NA;284395;474;2022-01-11;148966
2022-01-10;"Nitriansky kraj";292;7648;71;7719;NA;284395;363;2022-01-10;148492
2022-01-09;"Nitriansky kraj";100;3419;48;3467;NA;284395;148;2022-01-09;148129
2022-01-08;"Nitriansky kraj";206;1352;47;1399;NA;284395;253;2022-01-08;147981
2022-01-07;"Nitriansky kraj";326;2970;74;3044;NA;284395;400;2022-01-07;147728
2022-01-06;"Nitriansky kraj";125;910;33;943;NA;284395;158;2022-01-06;147328
2022-01-05;"Nitriansky kraj";357;4227;66;4293;NA;284395;423;2022-01-05;147170
2022-01-04;"Nitriansky kraj";453;3697;85;3782;NA;284395;538;2022-01-04;146747
2022-01-03;"Nitriansky kraj";353;7361;117;7478;NA;284395;470;2022-01-03;146209
2022-01-02;"Nitriansky kraj";25;3035;95;3130;NA;284395;120;2022-01-02;145739
2022-01-01;"Nitriansky kraj";71;177;9;186;NA;284395;80;2022-01-01;145619
2021-12-31;"Nitriansky kraj";382;1506;69;1575;NA;284395;451;2021-12-31;145539
2021-12-30;"Nitriansky kraj";325;3330;89;3419;NA;284395;414;2021-12-30;145088
2021-12-29;"Nitriansky kraj";347;2371;61;2432;NA;284395;408;2021-12-29;144674
2021-12-28;"Nitriansky kraj";628;2501;88;2589;NA;284395;716;2021-12-28;144266
2021-12-27;"Nitriansky kraj";402;4253;169;4422;NA;284395;571;2021-12-27;143550
2021-12-26;"Nitriansky kraj";84;1039;53;1092;NA;284395;137;2021-12-26;142979
2021-12-25;"Nitriansky kraj";22;499;31;530;NA;284395;53;2021-12-25;142842
2021-12-24;"Nitriansky kraj";175;448;26;474;NA;284395;201;2021-12-24;142789
2021-12-23;"Nitriansky kraj";472;3420;110;3530;NA;284395;582;2021-12-23;142588
2021-12-22;"Nitriansky kraj";398;3517;95;3612;NA;284395;493;2021-12-22;142006
2021-12-21;"Nitriansky kraj";735;2913;93;3006;NA;284395;828;2021-12-21;141513
2021-12-20;"Nitriansky kraj";407;6754;169;6923;NA;284395;576;2021-12-20;140685
2021-12-19;"Nitriansky kraj";198;3587;98;3685;NA;284395;296;2021-12-19;140109
2021-12-18;"Nitriansky kraj";361;1456;96;1552;NA;284395;457;2021-12-18;139813
2021-12-17;"Nitriansky kraj";409;4934;153;5087;NA;284395;562;2021-12-17;139356
2021-12-16;"Nitriansky kraj";429;4230;144;4374;NA;284395;573;2021-12-16;138794
2021-12-15;"Nitriansky kraj";639;5682;143;5825;NA;284395;782;2021-12-15;138221
2021-12-14;"Nitriansky kraj";907;4720;200;4920;NA;284395;1107;2021-12-14;137439
2021-12-13;"Nitriansky kraj";524;7388;291;7679;NA;284395;815;2021-12-13;136332
2021-12-12;"Nitriansky kraj";289;3893;174;4067;NA;284395;463;2021-12-12;135517
2021-12-11;"Nitriansky kraj";458;1754;121;1875;NA;284395;579;2021-12-11;135054
2021-12-10;"Nitriansky kraj";591;4868;177;5045;NA;284395;768;2021-12-10;134475
2021-12-09;"Nitriansky kraj";741;3428;202;3630;NA;284395;943;2021-12-09;133707
2021-12-08;"Nitriansky kraj";954;5136;200;5336;NA;284395;1154;2021-12-08;132764
2021-12-07;"Nitriansky kraj";900;4045;197;4242;NA;284395;1097;2021-12-07;131610
2021-12-06;"Nitriansky kraj";699;8196;339;8535;NA;284395;1038;2021-12-06;130513
2021-12-05;"Nitriansky kraj";337;4314;192;4506;NA;284395;529;2021-12-05;129475
2021-12-04;"Nitriansky kraj";758;2045;180;2225;NA;284395;938;2021-12-04;128946
2021-12-03;"Nitriansky kraj";920;5783;237;6020;NA;284395;1157;2021-12-03;128008
2021-12-02;"Nitriansky kraj";1388;3898;267;4165;NA;284395;1655;2021-12-02;126851
2021-12-01;"Nitriansky kraj";982;4107;261;4368;NA;284395;1243;2021-12-01;125196
2021-11-30;"Nitriansky kraj";751;5575;241;5816;NA;284395;992;2021-11-30;123953
2021-11-29;"Nitriansky kraj";665;10167;500;10667;NA;284395;1165;2021-11-29;122961
2021-11-28;"Nitriansky kraj";357;6214;300;6514;NA;284395;657;2021-11-28;121796
2021-11-27;"Nitriansky kraj";560;2879;281;3160;NA;284395;841;2021-11-27;121139
2021-11-26;"Nitriansky kraj";824;5529;290;5819;NA;284395;1114;2021-11-26;120298
2021-11-25;"Nitriansky kraj";847;4154;342;4496;NA;284395;1189;2021-11-25;119184
2021-11-24;"Nitriansky kraj";875;4422;325;4747;NA;284395;1200;2021-11-24;117995
2021-11-23;"Nitriansky kraj";1103;5148;353;5501;NA;284395;1456;2021-11-23;116795
2021-11-22;"Nitriansky kraj";545;7126;465;7591;NA;284395;1010;2021-11-22;115339
2021-11-21;"Nitriansky kraj";345;3410;314;3724;NA;284395;659;2021-11-21;114329
2021-11-20;"Nitriansky kraj";579;1865;252;2117;NA;284395;831;2021-11-20;113670
2021-11-19;"Nitriansky kraj";571;4256;349;4605;NA;284395;920;2021-11-19;112839
2021-11-18;"Nitriansky kraj";677;4883;420;5303;NA;284395;1097;2021-11-18;111919
2021-11-17;"Nitriansky kraj";479;1622;207;1829;NA;284395;686;2021-11-17;110822
2021-11-16;"Nitriansky kraj";668;3882;266;4148;NA;284395;934;2021-11-16;110136
2021-11-15;"Nitriansky kraj";556;6033;440;6473;NA;284395;996;2021-11-15;109202
2021-11-14;"Nitriansky kraj";229;2796;259;3055;NA;284395;488;2021-11-14;108206
2021-11-13;"Nitriansky kraj";387;1473;201;1674;NA;284395;588;2021-11-13;107718
2021-11-12;"Nitriansky kraj";552;3096;270;3366;NA;284395;822;2021-11-12;107130
2021-11-11;"Nitriansky kraj";539;3545;238;3783;NA;284395;777;2021-11-11;106308
2021-11-10;"Nitriansky kraj";411;3494;234;3728;NA;284395;645;2021-11-10;105531
2021-11-09;"Nitriansky kraj";413;3313;210;3523;NA;284395;623;2021-11-09;104886
2021-11-08;"Nitriansky kraj";464;4936;331;5267;NA;284395;795;2021-11-08;104263
2021-11-07;"Nitriansky kraj";209;2074;161;2235;NA;284395;370;2021-11-07;103468
2021-11-06;"Nitriansky kraj";236;1407;114;1521;NA;284395;350;2021-11-06;103098
2021-11-05;"Nitriansky kraj";407;2583;185;2768;NA;284395;592;2021-11-05;102748
2021-11-04;"Nitriansky kraj";437;3083;168;3251;NA;284395;605;2021-11-04;102156
2021-11-03;"Nitriansky kraj";525;2891;157;3048;NA;284395;682;2021-11-03;101551
2021-11-02;"Nitriansky kraj";320;4279;239;4518;NA;284395;559;2021-11-02;100869
2021-11-01;"Nitriansky kraj";136;712;61;773;NA;284395;197;2021-11-01;100310
2021-10-31;"Nitriansky kraj";109;1234;114;1348;NA;284395;223;2021-10-31;100113
2021-10-30;"Nitriansky kraj";202;1218;82;1300;NA;284395;284;2021-10-30;99890
2021-10-29;"Nitriansky kraj";347;2481;120;2601;NA;284395;467;2021-10-29;99606
2021-10-28;"Nitriansky kraj";281;2603;95;2698;NA;284395;376;2021-10-28;99139
2021-10-27;"Nitriansky kraj";340;2923;112;3035;NA;284395;452;2021-10-27;98763
2021-10-26;"Nitriansky kraj";297;2926;117;3043;NA;284395;414;2021-10-26;98311
2021-10-25;"Nitriansky kraj";171;3599;124;3723;NA;284395;295;2021-10-25;97897
2021-10-24;"Nitriansky kraj";58;1914;74;1988;NA;284395;132;2021-10-24;97602
2021-10-23;"Nitriansky kraj";173;1815;77;1892;NA;284395;250;2021-10-23;97470
2021-10-22;"Nitriansky kraj";202;2216;68;2284;NA;284395;270;2021-10-22;97220
2021-10-21;"Nitriansky kraj";214;2793;65;2858;NA;284395;279;2021-10-21;96950
2021-10-20;"Nitriansky kraj";218;2328;74;2402;NA;284395;292;2021-10-20;96671
2021-10-19;"Nitriansky kraj";250;2929;65;2994;NA;284395;315;2021-10-19;96379
2021-10-18;"Nitriansky kraj";81;3259;90;3349;NA;284395;171;2021-10-18;96064
2021-10-17;"Nitriansky kraj";36;3010;92;3102;NA;284395;128;2021-10-17;95893
2021-10-16;"Nitriansky kraj";37;1477;38;1515;NA;284395;75;2021-10-16;95765
2021-10-15;"Nitriansky kraj";145;2653;34;2687;NA;284395;179;2021-10-15;95690
2021-10-14;"Nitriansky kraj";95;2389;30;2419;NA;284395;125;2021-10-14;95511
2021-10-13;"Nitriansky kraj";91;2248;36;2284;NA;284395;127;2021-10-13;95386
2021-10-12;"Nitriansky kraj";119;2905;34;2939;NA;284395;153;2021-10-12;95259
2021-10-11;"Nitriansky kraj";91;2703;42;2745;NA;284395;133;2021-10-11;95106
2021-10-10;"Nitriansky kraj";33;1527;22;1549;NA;284395;55;2021-10-10;94973
2021-10-09;"Nitriansky kraj";17;1395;17;1412;NA;284395;34;2021-10-09;94918
2021-10-08;"Nitriansky kraj";61;3004;37;3041;NA;284395;98;2021-10-08;94884
2021-10-07;"Nitriansky kraj";59;2829;30;2859;NA;284395;89;2021-10-07;94786
2021-10-06;"Nitriansky kraj";66;2657;28;2685;NA;284395;94;2021-10-06;94697
2021-10-05;"Nitriansky kraj";97;2536;32;2568;NA;284395;129;2021-10-05;94603
2021-10-04;"Nitriansky kraj";56;3263;49;3312;NA;284395;105;2021-10-04;94474
2021-10-03;"Nitriansky kraj";10;1591;24;1615;NA;284395;34;2021-10-03;94369
2021-10-02;"Nitriansky kraj";46;1567;20;1587;NA;284395;66;2021-10-02;94335
2021-10-01;"Nitriansky kraj";26;2860;34;2894;NA;284395;60;2021-10-01;94269
2021-09-30;"Nitriansky kraj";66;2468;15;2483;NA;284395;81;2021-09-30;94209
2021-09-29;"Nitriansky kraj";92;2266;16;2282;NA;284395;108;2021-09-29;94128
2021-09-28;"Nitriansky kraj";86;2893;27;2920;NA;284395;113;2021-09-28;94020
2021-09-27;"Nitriansky kraj";50;3633;41;3674;NA;284395;91;2021-09-27;93907
2021-09-26;"Nitriansky kraj";12;1635;20;1655;NA;284395;32;2021-09-26;93816
2021-09-25;"Nitriansky kraj";43;1456;20;1476;NA;284395;63;2021-09-25;93784
2021-09-24;"Nitriansky kraj";35;2783;15;2798;NA;284395;50;2021-09-24;93721
2021-09-23;"Nitriansky kraj";69;2503;20;2523;NA;284395;89;2021-09-23;93671
2021-09-22;"Nitriansky kraj";68;2380;17;2397;NA;284395;85;2021-09-22;93582
2021-09-21;"Nitriansky kraj";70;2684;30;2714;NA;284395;100;2021-09-21;93497
2021-09-20;"Nitriansky kraj";41;2497;21;2518;NA;284395;62;2021-09-20;93397
2021-09-19;"Nitriansky kraj";16;1553;20;1573;NA;284395;36;2021-09-19;93335
2021-09-18;"Nitriansky kraj";42;1421;19;1440;NA;284395;61;2021-09-18;93299
2021-09-17;"Nitriansky kraj";54;2757;30;2787;NA;284395;84;2021-09-17;93238
2021-09-16;"Nitriansky kraj";55;2499;44;2543;NA;284395;99;2021-09-16;93154
2021-09-15;"Nitriansky kraj";34;538;12;550;NA;284395;46;2021-09-15;93055
2021-09-14;"Nitriansky kraj";52;1821;20;1841;NA;284395;72;2021-09-14;93009
2021-09-13;"Nitriansky kraj";27;2373;27;2400;NA;284395;54;2021-09-13;92937
2021-09-12;"Nitriansky kraj";4;1182;17;1199;NA;284395;21;2021-09-12;92883
2021-09-11;"Nitriansky kraj";36;1181;8;1189;NA;284395;44;2021-09-11;92862
2021-09-10;"Nitriansky kraj";25;2133;12;2145;NA;284395;37;2021-09-10;92818
2021-09-09;"Nitriansky kraj";15;1611;20;1631;NA;284395;35;2021-09-09;92781
2021-09-08;"Nitriansky kraj";30;1463;22;1485;NA;284395;52;2021-09-08;92746
2021-09-07;"Nitriansky kraj";35;1460;9;1469;NA;284395;44;2021-09-07;92694
2021-09-06;"Nitriansky kraj";19;1668;27;1695;NA;284395;46;2021-09-06;92650
2021-09-05;"Nitriansky kraj";10;1007;8;1015;NA;284395;18;2021-09-05;92604
2021-09-04;"Nitriansky kraj";18;1119;10;1129;NA;284395;28;2021-09-04;92586
2021-09-03;"Nitriansky kraj";20;1743;17;1760;NA;284395;37;2021-09-03;92558
2021-09-02;"Nitriansky kraj";16;1389;14;1403;NA;284395;30;2021-09-02;92521
2021-09-01;"Nitriansky kraj";9;337;2;339;NA;284395;11;2021-09-01;92491
2021-08-31;"Nitriansky kraj";10;1360;6;1366;NA;284395;16;2021-08-31;92480
2021-08-30;"Nitriansky kraj";8;1381;10;1391;NA;284395;18;2021-08-30;92464
2021-08-29;"Nitriansky kraj";2;450;1;451;NA;284395;3;2021-08-29;92446
2021-08-28;"Nitriansky kraj";5;1071;3;1074;NA;284395;8;2021-08-28;92443
2021-08-27;"Nitriansky kraj";7;1804;4;1808;NA;284395;11;2021-08-27;92435
2021-08-26;"Nitriansky kraj";2;1255;6;1261;NA;284395;8;2021-08-26;92424
2021-08-25;"Nitriansky kraj";15;1087;3;1090;NA;284395;18;2021-08-25;92416
2021-08-24;"Nitriansky kraj";6;990;2;992;NA;284395;8;2021-08-24;92398
2021-08-23;"Nitriansky kraj";13;1271;4;1275;NA;284395;17;2021-08-23;92390
2021-08-22;"Nitriansky kraj";0;1167;3;1170;NA;284395;3;2021-08-22;92373
2021-08-21;"Nitriansky kraj";1;853;2;855;NA;284395;3;2021-08-21;92370
2021-08-20;"Nitriansky kraj";8;1580;5;1585;NA;284395;13;2021-08-20;92367
2021-08-19;"Nitriansky kraj";11;1167;4;1171;NA;284395;15;2021-08-19;92354
2021-08-18;"Nitriansky kraj";8;1180;7;1187;NA;284395;15;2021-08-18;92339
2021-08-17;"Nitriansky kraj";4;1035;3;1038;NA;284395;7;2021-08-17;92324
2021-08-16;"Nitriansky kraj";7;1129;4;1133;NA;284395;11;2021-08-16;92317
2021-08-15;"Nitriansky kraj";2;662;1;663;NA;284395;3;2021-08-15;92306
2021-08-14;"Nitriansky kraj";1;878;5;883;NA;284395;6;2021-08-14;92303
2021-08-13;"Nitriansky kraj";0;957;1;958;NA;284395;1;2021-08-13;92297
2021-08-12;"Nitriansky kraj";5;765;0;765;NA;284395;5;2021-08-12;92296
2021-08-11;"Nitriansky kraj";3;527;1;528;NA;284395;4;2021-08-11;92291
2021-08-10;"Nitriansky kraj";3;570;1;571;NA;284395;4;2021-08-10;92287
2021-08-09;"Nitriansky kraj";3;992;1;993;NA;284395;4;2021-08-09;92283
2021-08-08;"Nitriansky kraj";0;668;1;669;NA;284395;1;2021-08-08;92279
2021-08-07;"Nitriansky kraj";0;557;1;558;NA;284395;1;2021-08-07;92278
2021-08-06;"Nitriansky kraj";5;799;0;799;NA;284395;5;2021-08-06;92277
2021-08-05;"Nitriansky kraj";6;612;0;612;NA;284395;6;2021-08-05;92272
2021-08-04;"Nitriansky kraj";1;497;2;499;NA;284395;3;2021-08-04;92266
2021-08-03;"Nitriansky kraj";5;1455;0;1455;NA;284395;5;2021-08-03;92263
2021-08-02;"Nitriansky kraj";1;683;4;687;NA;284395;5;2021-08-02;92258
2021-08-01;"Nitriansky kraj";1;606;0;606;NA;284395;1;2021-08-01;92253
2021-07-31;"Nitriansky kraj";1;514;1;515;NA;284395;2;2021-07-31;92252
2021-07-30;"Nitriansky kraj";2;827;0;827;NA;284395;2;2021-07-30;92250
2021-07-29;"Nitriansky kraj";3;720;2;722;NA;284395;5;2021-07-29;92248
2021-07-28;"Nitriansky kraj";4;598;0;598;NA;284395;4;2021-07-28;92243
2021-07-27;"Nitriansky kraj";12;602;1;603;NA;284395;13;2021-07-27;92239
2021-07-26;"Nitriansky kraj";7;970;1;971;NA;284395;8;2021-07-26;92226
2021-07-25;"Nitriansky kraj";1;654;1;655;NA;284395;2;2021-07-25;92218
2021-07-24;"Nitriansky kraj";0;620;0;620;NA;284395;0;2021-07-24;92216
2021-07-23;"Nitriansky kraj";3;851;1;852;NA;284395;4;2021-07-23;92216
2021-07-22;"Nitriansky kraj";5;689;0;689;NA;284395;5;2021-07-22;92212
2021-07-21;"Nitriansky kraj";6;650;2;652;NA;284395;8;2021-07-21;92207
2021-07-20;"Nitriansky kraj";1;527;1;528;NA;284395;2;2021-07-20;92199
2021-07-19;"Nitriansky kraj";2;965;0;965;NA;284395;2;2021-07-19;92197
2021-07-18;"Nitriansky kraj";1;747;0;747;NA;284395;1;2021-07-18;92195
2021-07-17;"Nitriansky kraj";5;612;0;612;NA;284395;5;2021-07-17;92194
2021-07-16;"Nitriansky kraj";2;876;0;876;NA;284395;2;2021-07-16;92189
2021-07-15;"Nitriansky kraj";11;708;0;708;NA;284395;11;2021-07-15;92187
2021-07-14;"Nitriansky kraj";4;646;0;646;NA;284395;4;2021-07-14;92176
2021-07-13;"Nitriansky kraj";2;697;2;699;NA;284395;4;2021-07-13;92172
2021-07-12;"Nitriansky kraj";1;819;0;819;NA;284395;1;2021-07-12;92168
2021-07-11;"Nitriansky kraj";1;961;0;961;NA;284395;1;2021-07-11;92167
2021-07-10;"Nitriansky kraj";1;630;0;630;NA;284395;1;2021-07-10;92166
2021-07-09;"Nitriansky kraj";3;1000;0;1000;NA;284395;3;2021-07-09;92165
2021-07-08;"Nitriansky kraj";0;683;0;683;NA;284395;0;2021-07-08;92162
2021-07-07;"Nitriansky kraj";2;935;2;937;NA;284395;4;2021-07-07;92162
2021-07-06;"Nitriansky kraj";1;1269;1;1270;NA;284395;2;2021-07-06;92158
2021-07-05;"Nitriansky kraj";1;507;0;507;NA;284395;1;2021-07-05;92156
2021-07-04;"Nitriansky kraj";0;821;1;822;NA;284395;1;2021-07-04;92155
2021-07-03;"Nitriansky kraj";0;611;0;611;NA;284395;0;2021-07-03;92154
2021-07-02;"Nitriansky kraj";0;1259;0;1259;NA;284395;0;2021-07-02;92154
2021-07-01;"Nitriansky kraj";0;369;1;370;NA;284395;1;2021-07-01;92154
2021-06-30;"Nitriansky kraj";1;6777;2;6779;NA;284395;3;2021-06-30;92153
2021-06-29;"Nitriansky kraj";1;3536;0;3536;NA;284395;1;2021-06-29;92150
2021-06-28;"Nitriansky kraj";3;4393;0;4393;NA;284395;3;2021-06-28;92149
2021-06-27;"Nitriansky kraj";0;3263;0;3263;NA;284395;0;2021-06-27;92146
2021-06-26;"Nitriansky kraj";1;4979;3;4982;NA;284395;4;2021-06-26;92146
2021-06-25;"Nitriansky kraj";8;5182;1;5183;NA;284395;9;2021-06-25;92142
2021-06-24;"Nitriansky kraj";1;3354;0;3354;NA;284395;1;2021-06-24;92133
2021-06-23;"Nitriansky kraj";1;3033;0;3033;NA;284395;1;2021-06-23;92132
2021-06-22;"Nitriansky kraj";1;3240;3;3243;NA;284395;4;2021-06-22;92131
2021-06-21;"Nitriansky kraj";8;5362;8;5370;NA;284395;16;2021-06-21;92127
2021-06-20;"Nitriansky kraj";0;4437;6;4443;NA;284395;6;2021-06-20;92111
2021-06-19;"Nitriansky kraj";0;5983;4;5987;NA;284395;4;2021-06-19;92105
2021-06-18;"Nitriansky kraj";4;6453;3;6456;NA;284395;7;2021-06-18;92101
2021-06-17;"Nitriansky kraj";5;4152;1;4153;NA;284395;6;2021-06-17;92094
2021-06-16;"Nitriansky kraj";4;3694;3;3697;NA;284395;7;2021-06-16;92088
2021-06-15;"Nitriansky kraj";1;3995;0;3995;NA;284395;1;2021-06-15;92081
2021-06-14;"Nitriansky kraj";0;5875;3;5878;NA;284395;3;2021-06-14;92080
2021-06-13;"Nitriansky kraj";0;6073;3;6076;NA;284395;3;2021-06-13;92077
2021-06-12;"Nitriansky kraj";1;8293;1;8294;NA;284395;2;2021-06-12;92074
2021-06-11;"Nitriansky kraj";3;6891;4;6895;NA;284395;7;2021-06-11;92072
2021-06-10;"Nitriansky kraj";7;4539;1;4540;NA;284395;8;2021-06-10;92065
2021-06-09;"Nitriansky kraj";2;4706;2;4708;NA;284395;4;2021-06-09;92057
2021-06-08;"Nitriansky kraj";8;4239;3;4242;NA;284395;11;2021-06-08;92053
2021-06-07;"Nitriansky kraj";6;5841;8;5849;NA;284395;14;2021-06-07;92042
2021-06-06;"Nitriansky kraj";0;6981;4;6985;NA;284395;4;2021-06-06;92028
2021-06-05;"Nitriansky kraj";6;9089;9;9098;NA;284395;15;2021-06-05;92024
2021-06-04;"Nitriansky kraj";9;7639;5;7644;NA;284395;14;2021-06-04;92009
2021-06-03;"Nitriansky kraj";2;5064;6;5070;NA;284395;8;2021-06-03;91995
2021-06-02;"Nitriansky kraj";11;5119;11;5130;NA;284395;22;2021-06-02;91987
2021-06-01;"Nitriansky kraj";3;4862;2;4864;NA;284395;5;2021-06-01;91965
2021-05-31;"Nitriansky kraj";8;8933;8;8941;NA;284395;16;2021-05-31;91960
2021-05-30;"Nitriansky kraj";1;9067;8;9075;NA;284395;9;2021-05-30;91944
2021-05-29;"Nitriansky kraj";2;13610;7;13617;NA;284395;9;2021-05-29;91935
2021-05-28;"Nitriansky kraj";10;8872;6;8878;NA;284395;16;2021-05-28;91926
2021-05-27;"Nitriansky kraj";4;6164;5;6169;NA;284395;9;2021-05-27;91910
2021-05-26;"Nitriansky kraj";11;8509;10;8519;NA;284395;21;2021-05-26;91901
2021-05-25;"Nitriansky kraj";15;7350;8;7358;NA;284395;23;2021-05-25;91880
2021-05-24;"Nitriansky kraj";14;9816;17;9833;NA;284395;31;2021-05-24;91857
2021-05-23;"Nitriansky kraj";1;9456;13;9469;NA;284395;14;2021-05-23;91826
2021-05-22;"Nitriansky kraj";7;16939;11;16950;NA;284395;18;2021-05-22;91812
2021-05-21;"Nitriansky kraj";18;10632;15;10647;NA;284395;33;2021-05-21;91794
2021-05-20;"Nitriansky kraj";8;7185;7;7192;NA;284395;15;2021-05-20;91761
2021-05-19;"Nitriansky kraj";20;6787;14;6801;NA;284395;34;2021-05-19;91746
2021-05-18;"Nitriansky kraj";23;7797;18;7815;NA;284395;41;2021-05-18;91712
2021-05-17;"Nitriansky kraj";22;9774;20;9794;NA;284395;42;2021-05-17;91671
2021-05-16;"Nitriansky kraj";4;13830;15;13845;NA;284395;19;2021-05-16;91629
2021-05-15;"Nitriansky kraj";5;25389;23;25412;NA;284395;28;2021-05-15;91610
2021-05-14;"Nitriansky kraj";18;13385;23;13408;NA;284395;41;2021-05-14;91582
2021-05-13;"Nitriansky kraj";24;8289;19;8308;NA;284395;43;2021-05-13;91541
2021-05-12;"Nitriansky kraj";10;7682;26;7708;NA;284395;36;2021-05-12;91498
2021-05-11;"Nitriansky kraj";36;8169;13;8182;NA;284395;49;2021-05-11;91462
2021-05-10;"Nitriansky kraj";16;13800;42;13842;NA;284395;58;2021-05-10;91413
2021-05-09;"Nitriansky kraj";8;21879;35;21914;NA;284395;43;2021-05-09;91355
2021-05-08;"Nitriansky kraj";0;24318;29;24347;NA;284395;29;2021-05-08;91312
2021-05-07;"Nitriansky kraj";32;14915;20;14935;NA;284395;52;2021-05-07;91283
2021-05-06;"Nitriansky kraj";30;9463;20;9483;NA;284395;50;2021-05-06;91231
2021-05-05;"Nitriansky kraj";19;8527;23;8550;NA;284395;42;2021-05-05;91181
2021-05-04;"Nitriansky kraj";46;9385;27;9412;NA;284395;73;2021-05-04;91139
2021-05-03;"Nitriansky kraj";32;14490;44;14534;NA;284395;76;2021-05-03;91066
2021-05-02;"Nitriansky kraj";4;31751;46;31797;NA;284395;50;2021-05-02;90990
2021-05-01;"Nitriansky kraj";23;60451;43;60494;NA;284395;66;2021-05-01;90940
2021-04-30;"Nitriansky kraj";28;31803;53;31856;NA;284395;81;2021-04-30;90874
2021-04-29;"Nitriansky kraj";27;14265;34;14299;NA;284395;61;2021-04-29;90793
2021-04-28;"Nitriansky kraj";36;14716;45;14761;NA;284395;81;2021-04-28;90732
2021-04-27;"Nitriansky kraj";51;13154;35;13189;NA;284395;86;2021-04-27;90651
2021-04-26;"Nitriansky kraj";38;21029;44;21073;NA;284395;82;2021-04-26;90565
2021-04-25;"Nitriansky kraj";7;44312;46;44358;NA;284395;53;2021-04-25;90483
2021-04-24;"Nitriansky kraj";23;93455;72;93527;NA;284395;95;2021-04-24;90430
2021-04-23;"Nitriansky kraj";54;35145;51;35196;NA;284395;105;2021-04-23;90335
2021-04-22;"Nitriansky kraj";32;15435;44;15479;NA;284395;76;2021-04-22;90230
2021-04-21;"Nitriansky kraj";38;14228;45;14273;NA;284395;83;2021-04-21;90154
2021-04-20;"Nitriansky kraj";67;16058;51;16109;NA;284395;118;2021-04-20;90071
2021-04-19;"Nitriansky kraj";35;24819;59;24878;NA;284395;94;2021-04-19;89953
2021-04-18;"Nitriansky kraj";0;39569;27;39596;NA;284395;27;2021-04-18;89859
2021-04-17;"Nitriansky kraj";34;92102;82;92184;NA;284395;116;2021-04-17;89832
2021-04-16;"Nitriansky kraj";46;32348;37;32385;NA;284395;83;2021-04-16;89716
2021-04-15;"Nitriansky kraj";75;16215;52;16267;NA;284395;127;2021-04-15;89633
2021-04-14;"Nitriansky kraj";43;15303;42;15345;NA;284395;85;2021-04-14;89506
2021-04-13;"Nitriansky kraj";110;15104;44;15148;NA;284395;154;2021-04-13;89421
2021-04-12;"Nitriansky kraj";29;22817;50;22867;NA;284395;79;2021-04-12;89267
2021-04-11;"Nitriansky kraj";1;37537;31;37568;NA;284395;32;2021-04-11;89188
2021-04-10;"Nitriansky kraj";35;95851;115;95966;NA;284395;150;2021-04-10;89156
2021-04-09;"Nitriansky kraj";69;30669;58;30727;NA;284395;127;2021-04-09;89006
2021-04-08;"Nitriansky kraj";71;15361;36;15397;NA;284395;107;2021-04-08;88879
2021-04-07;"Nitriansky kraj";64;18541;47;18588;NA;284395;111;2021-04-07;88772
2021-04-06;"Nitriansky kraj";65;33218;112;33330;NA;284395;177;2021-04-06;88661
2021-04-05;"Nitriansky kraj";37;12673;48;12721;NA;284395;85;2021-04-05;88484
2021-04-04;"Nitriansky kraj";5;17887;35;17922;NA;284395;40;2021-04-04;88399
2021-04-03;"Nitriansky kraj";26;85465;153;85618;NA;284395;179;2021-04-03;88359
2021-04-02;"Nitriansky kraj";32;18743;46;18789;NA;284395;78;2021-04-02;88180
2021-04-01;"Nitriansky kraj";63;24640;83;24723;NA;284395;146;2021-04-01;88102
2021-03-31;"Nitriansky kraj";73;21752;94;21846;NA;284395;167;2021-03-31;87956
2021-03-30;"Nitriansky kraj";125;17122;83;17205;NA;284395;208;2021-03-30;87789
2021-03-29;"Nitriansky kraj";81;25139;100;25239;NA;284395;181;2021-03-29;87581
2021-03-28;"Nitriansky kraj";6;45581;106;45687;NA;284395;112;2021-03-28;87400
2021-03-27;"Nitriansky kraj";39;104104;174;104278;NA;284395;213;2021-03-27;87288
2021-03-26;"Nitriansky kraj";90;40444;115;40559;NA;284395;205;2021-03-26;87075
2021-03-25;"Nitriansky kraj";95;19219;94;19313;NA;284395;189;2021-03-25;86870
2021-03-24;"Nitriansky kraj";90;14787;91;14878;NA;284395;181;2021-03-24;86681
2021-03-23;"Nitriansky kraj";167;16753;66;16819;NA;284395;233;2021-03-23;86500
2021-03-22;"Nitriansky kraj";101;24886;125;25011;NA;284395;226;2021-03-22;86267
2021-03-21;"Nitriansky kraj";27;42773;99;42872;NA;284395;126;2021-03-21;86041
2021-03-20;"Nitriansky kraj";36;100640;207;100847;NA;284395;243;2021-03-20;85915
2021-03-19;"Nitriansky kraj";76;37312;102;37414;NA;284395;178;2021-03-19;85672
2021-03-18;"Nitriansky kraj";103;20051;113;20164;NA;284395;216;2021-03-18;85494
2021-03-17;"Nitriansky kraj";87;15839;127;15966;NA;284395;214;2021-03-17;85278
2021-03-16;"Nitriansky kraj";172;18085;121;18206;NA;284395;293;2021-03-16;85064
2021-03-15;"Nitriansky kraj";130;24481;165;24646;NA;284395;295;2021-03-15;84771
2021-03-14;"Nitriansky kraj";3;45770;107;45877;NA;284395;110;2021-03-14;84476
2021-03-13;"Nitriansky kraj";65;112573;242;112815;NA;284395;307;2021-03-13;84366
2021-03-12;"Nitriansky kraj";127;40777;159;40936;NA;284395;286;2021-03-12;84059
2021-03-11;"Nitriansky kraj";131;18686;130;18816;NA;284395;261;2021-03-11;83773
2021-03-10;"Nitriansky kraj";96;17422;143;17565;NA;284395;239;2021-03-10;83512
2021-03-09;"Nitriansky kraj";260;17635;149;17784;NA;284395;409;2021-03-09;83273
2021-03-08;"Nitriansky kraj";145;27214;172;27386;NA;284395;317;2021-03-08;82864
2021-03-07;"Nitriansky kraj";48;46867;185;47052;NA;284395;233;2021-03-07;82547
2021-03-06;"Nitriansky kraj";86;112027;327;112354;NA;284395;413;2021-03-06;82314
2021-03-05;"Nitriansky kraj";133;39068;200;39268;NA;284395;333;2021-03-05;81901
2021-03-04;"Nitriansky kraj";176;18340;173;18513;NA;284395;349;2021-03-04;81568
2021-03-03;"Nitriansky kraj";172;17210;177;17387;NA;284395;349;2021-03-03;81219
2021-03-02;"Nitriansky kraj";274;21003;366;21369;NA;284395;640;2021-03-02;80870
2021-03-01;"Nitriansky kraj";133;27881;279;28160;NA;284395;412;2021-03-01;80230
2021-02-28;"Nitriansky kraj";80;40866;218;41084;NA;284395;298;2021-02-28;79818
2021-02-27;"Nitriansky kraj";101;106352;496;106848;NA;284395;597;2021-02-27;79520
2021-02-26;"Nitriansky kraj";109;36788;308;37096;NA;284395;417;2021-02-26;78923
2021-02-25;"Nitriansky kraj";188;15243;212;15455;NA;284395;400;2021-02-25;78506
2021-02-24;"Nitriansky kraj";125;13833;260;14093;NA;284395;385;2021-02-24;78106
2021-02-23;"Nitriansky kraj";273;15402;273;15675;NA;284395;546;2021-02-23;77721
2021-02-22;"Nitriansky kraj";154;26478;330;26808;NA;284395;484;2021-02-22;77175
2021-02-21;"Nitriansky kraj";22;43664;320;43984;NA;284395;342;2021-02-21;76691
2021-02-20;"Nitriansky kraj";128;109038;586;109624;NA;284395;714;2021-02-20;76349
2021-02-19;"Nitriansky kraj";173;36849;328;37177;NA;284395;501;2021-02-19;75635
2021-02-18;"Nitriansky kraj";202;17045;275;17320;NA;284395;477;2021-02-18;75134
2021-02-17;"Nitriansky kraj";198;12080;310;12390;NA;284395;508;2021-02-17;74657
2021-02-16;"Nitriansky kraj";284;16066;288;16354;NA;284395;572;2021-02-16;74149
2021-02-15;"Nitriansky kraj";122;28636;474;29110;NA;284395;596;2021-02-15;73577
2021-02-14;"Nitriansky kraj";8;49392;315;49707;NA;284395;323;2021-02-14;72981
2021-02-13;"Nitriansky kraj";127;110294;690;110984;NA;284395;817;2021-02-13;72658
2021-02-12;"Nitriansky kraj";162;33405;407;33812;NA;284395;569;2021-02-12;71841
2021-02-11;"Nitriansky kraj";195;12406;270;12676;NA;284395;465;2021-02-11;71272
2021-02-10;"Nitriansky kraj";186;17770;644;18414;NA;284395;830;2021-02-10;70807
2021-02-09;"Nitriansky kraj";260;18530;385;18915;NA;284395;645;2021-02-09;69977
2021-02-08;"Nitriansky kraj";177;37530;569;38099;NA;284395;746;2021-02-08;69332
2021-02-07;"Nitriansky kraj";20;52307;513;52820;NA;284395;533;2021-02-07;68586
2021-02-06;"Nitriansky kraj";129;101439;764;102203;NA;284395;893;2021-02-06;68053
2021-02-05;"Nitriansky kraj";244;26137;491;26628;NA;284395;735;2021-02-05;67160
2021-02-04;"Nitriansky kraj";308;15681;512;16193;NA;284395;820;2021-02-04;66425
2021-02-03;"Nitriansky kraj";191;13459;382;13841;NA;284395;573;2021-02-03;65605
2021-02-02;"Nitriansky kraj";327;17880;382;18262;NA;284395;709;2021-02-02;65032
2021-02-01;"Nitriansky kraj";221;24002;460;24462;NA;284395;681;2021-02-01;64323
2021-01-31;"Nitriansky kraj";9;46215;507;46722;NA;284395;516;2021-01-31;63642
2021-01-30;"Nitriansky kraj";152;99241;1090;100331;NA;284395;1242;2021-01-30;63126
2021-01-29;"Nitriansky kraj";302;22461;477;22938;NA;284395;779;2021-01-29;61884
2021-01-28;"Nitriansky kraj";269;11370;398;11768;NA;284395;667;2021-01-28;61105
2021-01-27;"Nitriansky kraj";235;6758;299;7057;NA;284395;534;2021-01-27;60438
2021-01-26;"Nitriansky kraj";345;16015;454;16469;NA;284395;799;2021-01-26;59904
2021-01-25;"Nitriansky kraj";201;21909;434;22343;NA;284395;635;2021-01-25;59105
2021-01-24;"Nitriansky kraj";12;79041;897;79938;NA;284395;909;2021-01-24;58470
2021-01-23;"Nitriansky kraj";277;97845;1446;99291;NA;284395;1723;2021-01-23;57561
2021-01-22;"Nitriansky kraj";139;35924;619;36543;NA;284395;758;2021-01-22;55838
2021-01-21;"Nitriansky kraj";305;14649;412;15061;NA;284395;717;2021-01-21;55080
2021-01-20;"Nitriansky kraj";326;11991;625;12616;NA;284395;951;2021-01-20;54363
2021-01-19;"Nitriansky kraj";344;11015;633;11648;NA;284395;977;2021-01-19;53412
2021-01-18;"Nitriansky kraj";367;8901;519;9420;NA;284395;886;2021-01-18;52435
2021-01-17;"Nitriansky kraj";97;15061;275;15336;NA;284395;372;2021-01-17;51549
2021-01-16;"Nitriansky kraj";64;36838;679;37517;NA;284395;743;2021-01-16;51177
2021-01-15;"Nitriansky kraj";373;15940;474;16414;NA;284395;847;2021-01-15;50434
2021-01-14;"Nitriansky kraj";627;10577;452;11029;NA;284395;1079;2021-01-14;49587
2021-01-13;"Nitriansky kraj";663;9234;484;9718;NA;284395;1147;2021-01-13;48508
2021-01-12;"Nitriansky kraj";642;8805;545;9350;NA;284395;1187;2021-01-12;47361
2021-01-11;"Nitriansky kraj";422;8347;513;8860;NA;284395;935;2021-01-11;46174
2021-01-10;"Nitriansky kraj";44;19841;730;20571;NA;284395;774;2021-01-10;45239
2021-01-09;"Nitriansky kraj";532;36823;1071;37894;NA;284395;1603;2021-01-09;44465
2021-01-08;"Nitriansky kraj";817;14001;691;14692;NA;284395;1508;2021-01-08;42862
2021-01-07;"Nitriansky kraj";438;10121;795;10916;NA;284395;1233;2021-01-07;41354
2021-01-06;"Nitriansky kraj";259;3192;197;3389;NA;284395;456;2021-01-06;40121
2021-01-05;"Nitriansky kraj";732;8918;1208;10126;NA;284395;1940;2021-01-05;39665
2021-01-04;"Nitriansky kraj";362;8409;1287;9696;NA;284395;1649;2021-01-04;37725
2021-01-03;"Nitriansky kraj";42;84;20;104;NA;284395;62;2021-01-03;36076
2021-01-02;"Nitriansky kraj";249;1090;26;1116;NA;284395;275;2021-01-02;36014
2021-01-01;"Nitriansky kraj";119;781;95;876;NA;284395;214;2021-01-01;35739
2020-12-31;"Nitriansky kraj";786;7646;962;8608;NA;284395;1748;2020-12-31;35525
2020-12-30;"Nitriansky kraj";1094;9619;1165;10784;NA;284395;2259;2020-12-30;33777
2020-12-29;"Nitriansky kraj";607;8028;1245;9273;NA;284395;1852;2020-12-29;31518
2020-12-28;"Nitriansky kraj";83;6804;1220;8024;NA;284395;1303;2020-12-28;29666
2020-12-27;"Nitriansky kraj";22;60;8;68;NA;284395;30;2020-12-27;28363
2020-12-26;"Nitriansky kraj";54;297;56;353;NA;284395;110;2020-12-26;28333
2020-12-25;"Nitriansky kraj";35;60;11;71;NA;284395;46;2020-12-25;28223
2020-12-24;"Nitriansky kraj";514;1861;176;2037;NA;284395;690;2020-12-24;28177
2020-12-23;"Nitriansky kraj";349;14679;782;15461;NA;284395;1131;2020-12-23;27487
2020-12-22;"Nitriansky kraj";673;10623;949;11572;NA;284395;1622;2020-12-22;26356
2020-12-21;"Nitriansky kraj";128;7587;931;8518;NA;284395;1059;2020-12-21;24734
2020-12-20;"Nitriansky kraj";77;50;10;60;NA;284395;87;2020-12-20;23675
2020-12-19;"Nitriansky kraj";262;2259;159;2418;NA;284395;421;2020-12-19;23588
2020-12-18;"Nitriansky kraj";512;7946;518;8464;NA;284395;1030;2020-12-18;23167
2020-12-17;"Nitriansky kraj";586;6519;486;7005;NA;284395;1072;2020-12-17;22137
2020-12-16;"Nitriansky kraj";357;8097;500;8597;NA;284395;857;2020-12-16;21065
2020-12-15;"Nitriansky kraj";461;9084;750;9834;NA;284395;1211;2020-12-15;20208
2020-12-14;"Nitriansky kraj";217;7816;797;8613;NA;284395;1014;2020-12-14;18997
2020-12-13;"Nitriansky kraj";12;69;6;75;NA;284395;18;2020-12-13;17983
2020-12-12;"Nitriansky kraj";341;1832;125;1957;NA;284395;466;2020-12-12;17965
2020-12-11;"Nitriansky kraj";409;5117;384;5501;NA;284395;793;2020-12-11;17499
2020-12-10;"Nitriansky kraj";360;5239;345;5584;NA;284395;705;2020-12-10;16706
2020-12-09;"Nitriansky kraj";362;5494;529;6023;NA;284395;891;2020-12-09;16001
2020-12-08;"Nitriansky kraj";340;8168;548;8716;NA;284395;888;2020-12-08;15110
2020-12-07;"Nitriansky kraj";139;6243;573;6816;NA;284395;712;2020-12-07;14222
2020-12-06;"Nitriansky kraj";15;89;4;93;NA;284395;19;2020-12-06;13510
2020-12-05;"Nitriansky kraj";136;1388;19;1407;NA;284395;155;2020-12-05;13491
2020-12-04;"Nitriansky kraj";232;2884;74;2958;NA;284395;306;2020-12-04;13336
2020-12-03;"Nitriansky kraj";248;2471;110;2581;NA;284395;358;2020-12-03;13030
2020-12-02;"Nitriansky kraj";252;2580;151;2731;NA;284395;403;2020-12-02;12672
2020-12-01;"Nitriansky kraj";331;2891;131;3022;NA;284395;462;2020-12-01;12269
2020-11-30;"Nitriansky kraj";91;4228;188;4416;NA;284395;279;2020-11-30;11807
2020-11-29;"Nitriansky kraj";3;634;42;676;NA;284395;45;2020-11-29;11528
2020-11-28;"Nitriansky kraj";135;892;31;923;NA;284395;166;2020-11-28;11483
2020-11-27;"Nitriansky kraj";177;2069;73;2142;NA;284395;250;2020-11-27;11317
2020-11-26;"Nitriansky kraj";191;2813;80;2893;NA;284395;271;2020-11-26;11067
2020-11-25;"Nitriansky kraj";325;2478;91;2569;NA;284395;416;2020-11-25;10796
2020-11-24;"Nitriansky kraj";147;1641;64;1705;NA;284395;211;2020-11-24;10380
2020-11-23;"Nitriansky kraj";102;9891;212;10103;NA;284395;314;2020-11-23;10169
2020-11-22;"Nitriansky kraj";7;1176;25;1201;NA;284395;32;2020-11-22;9855
2020-11-21;"Nitriansky kraj";86;1083;38;1121;NA;284395;124;2020-11-21;9823
2020-11-20;"Nitriansky kraj";264;4180;103;4283;NA;284395;367;2020-11-20;9699
2020-11-19;"Nitriansky kraj";185;3065;134;3199;NA;284395;319;2020-11-19;9332
2020-11-18;"Nitriansky kraj";188;2214;79;2293;NA;284395;267;2020-11-18;9013
2020-11-17;"Nitriansky kraj";178;596;29;625;NA;284395;207;2020-11-17;8746
2020-11-16;"Nitriansky kraj";139;1877;75;1952;NA;284395;214;2020-11-16;8539
2020-11-15;"Nitriansky kraj";14;180;5;185;NA;284395;19;2020-11-15;8325
2020-11-14;"Nitriansky kraj";114;1131;32;1163;NA;284395;146;2020-11-14;8306
2020-11-13;"Nitriansky kraj";210;936;46;982;NA;284395;256;2020-11-13;8160
2020-11-12;"Nitriansky kraj";256;1195;35;1230;NA;284395;291;2020-11-12;7904
2020-11-11;"Nitriansky kraj";279;1247;22;1269;NA;284395;301;2020-11-11;7613
2020-11-10;"Nitriansky kraj";192;2623;39;2662;NA;284395;231;2020-11-10;7312
2020-11-09;"Nitriansky kraj";128;3136;43;3179;NA;284395;171;2020-11-09;7081
2020-11-08;"Nitriansky kraj";43;1462;32;1494;NA;284395;75;2020-11-08;6910
2020-11-07;"Nitriansky kraj";130;1046;4;1050;NA;284395;134;2020-11-07;6835
2020-11-06;"Nitriansky kraj";210;2264;32;2296;NA;284395;242;2020-11-06;6701
2020-11-05;"Nitriansky kraj";178;313;14;327;NA;284395;192;2020-11-05;6459
2020-11-04;"Nitriansky kraj";211;297;16;313;NA;284395;227;2020-11-04;6267
2020-11-03;"Nitriansky kraj";216;435;25;460;NA;284395;241;2020-11-03;6040
2020-11-02;"Nitriansky kraj";171;4208;46;4254;NA;284395;217;2020-11-02;5799
2020-11-01;"Nitriansky kraj";130;2546;27;2573;NA;284395;157;2020-11-01;5582
2020-10-31;"Nitriansky kraj";261;10466;134;10600;NA;284395;395;2020-10-31;5425
2020-10-30;"Nitriansky kraj";204;2593;42;2635;NA;284395;246;2020-10-30;5030
2020-10-29;"Nitriansky kraj";293;841;39;880;NA;284395;332;2020-10-29;4784
2020-10-28;"Nitriansky kraj";216;608;59;667;NA;284395;275;2020-10-28;4452
2020-10-27;"Nitriansky kraj";296;550;47;597;NA;284395;343;2020-10-27;4177
2020-10-26;"Nitriansky kraj";69;633;56;689;NA;284395;125;2020-10-26;3834
2020-10-25;"Nitriansky kraj";50;62;8;70;NA;284395;58;2020-10-25;3709
2020-10-24;"Nitriansky kraj";169;237;11;248;NA;284395;180;2020-10-24;3651
2020-10-23;"Nitriansky kraj";282;762;41;803;NA;284395;323;2020-10-23;3471
2020-10-22;"Nitriansky kraj";137;444;39;483;NA;284395;176;2020-10-22;3148
2020-10-21;"Nitriansky kraj";146;208;3;211;NA;284395;149;2020-10-21;2972
2020-10-20;"Nitriansky kraj";197;78;6;84;NA;284395;203;2020-10-20;2823
2020-10-19;"Nitriansky kraj";148;79;1;80;NA;284395;149;2020-10-19;2620
2020-10-18;"Nitriansky kraj";22;0;0;0;NA;284395;22;2020-10-18;2471
2020-10-17;"Nitriansky kraj";67;0;0;0;NA;284395;67;2020-10-17;2449
2020-10-16;"Nitriansky kraj";133;28;3;31;NA;284395;136;2020-10-16;2382
2020-10-15;"Nitriansky kraj";106;31;2;33;NA;284395;108;2020-10-15;2246
2020-10-14;"Nitriansky kraj";80;22;4;26;NA;284395;84;2020-10-14;2138
2020-10-13;"Nitriansky kraj";101;82;2;84;NA;284395;103;2020-10-13;2054
2020-10-12;"Nitriansky kraj";36;0;0;0;NA;284395;36;2020-10-12;1951
2020-10-11;"Nitriansky kraj";8;0;0;0;NA;284395;8;2020-10-11;1915
2020-10-10;"Nitriansky kraj";107;0;0;0;NA;284395;107;2020-10-10;1907
2020-10-09;"Nitriansky kraj";120;0;0;0;NA;284395;120;2020-10-09;1800
2020-10-08;"Nitriansky kraj";132;0;0;0;NA;284395;132;2020-10-08;1680
2020-10-07;"Nitriansky kraj";81;0;0;0;NA;284395;81;2020-10-07;1548
2020-10-06;"Nitriansky kraj";48;0;0;0;NA;284395;48;2020-10-06;1467
2020-10-05;"Nitriansky kraj";20;0;0;0;NA;284395;20;2020-10-05;1419
2020-10-04;"Nitriansky kraj";17;0;0;0;NA;284395;17;2020-10-04;1399
2020-10-03;"Nitriansky kraj";96;0;0;0;NA;284395;96;2020-10-03;1382
2020-10-02;"Nitriansky kraj";108;0;0;0;NA;284395;108;2020-10-02;1286
2020-10-01;"Nitriansky kraj";95;0;0;0;NA;284395;95;2020-10-01;1178
2020-09-30;"Nitriansky kraj";100;0;0;0;NA;284395;100;2020-09-30;1083
2020-09-29;"Nitriansky kraj";50;0;0;0;NA;284395;50;2020-09-29;983
2020-09-28;"Nitriansky kraj";22;0;0;0;NA;284395;22;2020-09-28;933
2020-09-27;"Nitriansky kraj";16;0;0;0;NA;284395;16;2020-09-27;911
2020-09-26;"Nitriansky kraj";64;0;0;0;NA;284395;64;2020-09-26;895
2020-09-25;"Nitriansky kraj";90;0;0;0;NA;284395;90;2020-09-25;831
2020-09-24;"Nitriansky kraj";51;0;0;0;NA;284395;51;2020-09-24;741
2020-09-23;"Nitriansky kraj";70;0;0;0;NA;284395;70;2020-09-23;690
2020-09-22;"Nitriansky kraj";18;0;0;0;NA;284395;18;2020-09-22;620
2020-09-21;"Nitriansky kraj";10;0;0;0;NA;284395;10;2020-09-21;602
2020-09-20;"Nitriansky kraj";4;0;0;0;NA;284395;4;2020-09-20;592
2020-09-19;"Nitriansky kraj";14;0;0;0;NA;284395;14;2020-09-19;588
2020-09-18;"Nitriansky kraj";19;0;0;0;NA;284395;19;2020-09-18;574
2020-09-17;"Nitriansky kraj";30;0;0;0;NA;284395;30;2020-09-17;555
2020-09-16;"Nitriansky kraj";6;0;0;0;NA;284395;6;2020-09-16;525
2020-09-15;"Nitriansky kraj";19;0;0;0;NA;284395;19;2020-09-15;519
2020-09-14;"Nitriansky kraj";28;0;0;0;NA;284395;28;2020-09-14;500
2020-09-13;"Nitriansky kraj";3;0;0;0;NA;284395;3;2020-09-13;472
2020-09-12;"Nitriansky kraj";12;0;0;0;NA;284395;12;2020-09-12;469
2020-09-11;"Nitriansky kraj";23;0;0;0;NA;284395;23;2020-09-11;457
2020-09-10;"Nitriansky kraj";29;0;0;0;NA;284395;29;2020-09-10;434
2020-09-09;"Nitriansky kraj";19;0;0;0;NA;284395;19;2020-09-09;405
2020-09-08;"Nitriansky kraj";17;0;0;0;NA;284395;17;2020-09-08;386
2020-09-07;"Nitriansky kraj";17;0;0;0;NA;284395;17;2020-09-07;369
2020-09-06;"Nitriansky kraj";0;0;0;0;NA;284395;0;2020-09-06;352
2020-09-05;"Nitriansky kraj";22;0;0;0;NA;284395;22;2020-09-05;352
2020-09-04;"Nitriansky kraj";34;0;0;0;NA;284395;34;2020-09-04;330
2020-09-03;"Nitriansky kraj";15;0;0;0;NA;284395;15;2020-09-03;296
2020-09-02;"Nitriansky kraj";15;0;0;0;NA;284395;15;2020-09-02;281
2020-09-01;"Nitriansky kraj";2;0;0;0;NA;284395;2;2020-09-01;266
2020-08-31;"Nitriansky kraj";12;0;0;0;NA;284395;12;2020-08-31;264
2020-08-30;"Nitriansky kraj";1;0;0;0;NA;284395;1;2020-08-30;252
2020-08-29;"Nitriansky kraj";7;46;0;46;NA;284395;7;2020-08-29;251
2020-08-28;"Nitriansky kraj";12;0;0;0;NA;284395;12;2020-08-28;244
2020-08-27;"Nitriansky kraj";12;0;0;0;NA;284395;12;2020-08-27;232
2020-08-26;"Nitriansky kraj";4;0;0;0;NA;284395;4;2020-08-26;220
2020-08-25;"Nitriansky kraj";8;0;0;0;NA;284395;8;2020-08-25;216
2020-08-24;"Nitriansky kraj";1;0;0;0;NA;284395;1;2020-08-24;208
2020-08-23;"Nitriansky kraj";1;0;0;0;NA;284395;1;2020-08-23;207
2020-08-22;"Nitriansky kraj";2;0;0;0;NA;284395;2;2020-08-22;206
2020-08-21;"Nitriansky kraj";0;0;0;0;NA;284395;0;2020-08-21;204
2020-08-20;"Nitriansky kraj";7;0;0;0;NA;284395;7;2020-08-20;204
2020-08-19;"Nitriansky kraj";1;0;0;0;NA;284395;1;2020-08-19;197
2020-08-18;"Nitriansky kraj";2;0;0;0;NA;284395;2;2020-08-18;196
2020-08-17;"Nitriansky kraj";1;0;0;0;NA;284395;1;2020-08-17;194
2020-08-16;"Nitriansky kraj";0;0;0;0;NA;284395;0;2020-08-16;193
2020-08-15;"Nitriansky kraj";2;0;0;0;NA;284395;2;2020-08-15;193
2020-08-14;"Nitriansky kraj";1;0;0;0;NA;284395;1;2020-08-14;191
2020-08-13;"Nitriansky kraj";4;0;0;0;NA;284395;4;2020-08-13;190
2020-08-12;"Nitriansky kraj";0;0;0;0;NA;284395;0;2020-08-12;186
2020-08-11;"Nitriansky kraj";1;0;0;0;NA;284395;1;2020-08-11;186
2020-08-10;"Nitriansky kraj";0;0;0;0;NA;284395;0;2020-08-10;185
2020-08-09;"Nitriansky kraj";0;0;0;0;NA;284395;0;2020-08-09;185
2020-08-08;"Nitriansky kraj";0;0;0;0;NA;284395;0;2020-08-08;185
2020-08-07;"Nitriansky kraj";4;0;0;0;NA;284395;4;2020-08-07;185
2020-08-06;"Nitriansky kraj";4;0;0;0;NA;284395;4;2020-08-06;181
2020-08-05;"Nitriansky kraj";0;0;0;0;NA;284395;0;2020-08-05;177
2020-08-04;"Nitriansky kraj";7;0;0;0;NA;284395;7;2020-08-04;177
2020-08-03;"Nitriansky kraj";0;0;0;0;NA;284395;0;2020-08-03;170
2020-08-02;"Nitriansky kraj";0;0;0;0;NA;284395;0;2020-08-02;170
2020-08-01;"Nitriansky kraj";0;0;0;0;NA;284395;0;2020-08-01;170
2020-07-31;"Nitriansky kraj";0;0;0;0;NA;284395;0;2020-07-31;170
2020-07-30;"Nitriansky kraj";0;0;0;0;NA;284395;0;2020-07-30;170
2020-07-29;"Nitriansky kraj";0;0;0;0;NA;284395;0;2020-07-29;170
2020-07-28;"Nitriansky kraj";0;0;0;0;NA;284395;0;2020-07-28;170
2020-07-27;"Nitriansky kraj";0;0;0;0;NA;284395;0;2020-07-27;170
2020-07-26;"Nitriansky kraj";0;0;0;0;NA;284395;0;2020-07-26;170
2020-07-25;"Nitriansky kraj";0;0;0;0;NA;284395;0;2020-07-25;170
2020-07-24;"Nitriansky kraj";1;0;0;0;NA;284395;1;2020-07-24;170
2020-07-23;"Nitriansky kraj";3;0;0;0;NA;284395;3;2020-07-23;169
2020-07-22;"Nitriansky kraj";2;0;0;0;NA;284395;2;2020-07-22;166
2020-07-21;"Nitriansky kraj";14;0;0;0;NA;284395;14;2020-07-21;164
2020-07-20;"Nitriansky kraj";11;0;0;0;NA;284395;11;2020-07-20;150
2020-07-19;"Nitriansky kraj";0;0;0;0;NA;284395;0;2020-07-19;139
2020-07-18;"Nitriansky kraj";0;0;0;0;NA;284395;0;2020-07-18;139
2020-07-17;"Nitriansky kraj";0;0;0;0;NA;284395;0;2020-07-17;139
2020-07-16;"Nitriansky kraj";4;0;0;0;NA;284395;4;2020-07-16;139
2020-07-15;"Nitriansky kraj";5;0;0;0;NA;284395;5;2020-07-15;135
2020-07-14;"Nitriansky kraj";0;0;0;0;NA;284395;0;2020-07-14;130
2020-07-13;"Nitriansky kraj";0;0;0;0;NA;284395;0;2020-07-13;130
2020-07-12;"Nitriansky kraj";0;0;0;0;NA;284395;0;2020-07-12;130
2020-07-11;"Nitriansky kraj";0;0;0;0;NA;284395;0;2020-07-11;130
2020-07-10;"Nitriansky kraj";0;0;0;0;NA;284395;0;2020-07-10;130
2020-07-09;"Nitriansky kraj";1;0;0;0;NA;284395;1;2020-07-09;130
2020-07-08;"Nitriansky kraj";2;0;0;0;NA;284395;2;2020-07-08;129
2020-07-07;"Nitriansky kraj";0;0;0;0;NA;284395;0;2020-07-07;127
2020-07-06;"Nitriansky kraj";0;0;0;0;NA;284395;0;2020-07-06;127
2020-07-05;"Nitriansky kraj";0;0;0;0;NA;284395;0;2020-07-05;127
2020-07-04;"Nitriansky kraj";0;0;0;0;NA;284395;0;2020-07-04;127
2020-07-03;"Nitriansky kraj";0;0;0;0;NA;284395;0;2020-07-03;127
2020-07-02;"Nitriansky kraj";0;0;0;0;NA;284395;0;2020-07-02;127
2020-07-01;"Nitriansky kraj";3;0;0;0;NA;284395;3;2020-07-01;127
2020-06-30;"Nitriansky kraj";0;0;0;0;NA;284395;0;2020-06-30;124
2020-06-29;"Nitriansky kraj";0;0;0;0;NA;284395;0;2020-06-29;124
2020-06-28;"Nitriansky kraj";0;0;0;0;NA;284395;0;2020-06-28;124
2020-06-27;"Nitriansky kraj";0;0;0;0;NA;284395;0;2020-06-27;124
2020-06-26;"Nitriansky kraj";0;0;0;0;NA;284395;0;2020-06-26;124
2020-06-25;"Nitriansky kraj";0;0;0;0;NA;284395;0;2020-06-25;124
2020-06-24;"Nitriansky kraj";1;0;0;0;NA;284395;1;2020-06-24;124
2020-06-23;"Nitriansky kraj";0;0;0;0;NA;284395;0;2020-06-23;123
2020-06-22;"Nitriansky kraj";0;0;0;0;NA;284395;0;2020-06-22;123
2020-06-21;"Nitriansky kraj";0;0;0;0;NA;284395;0;2020-06-21;123
2020-06-20;"Nitriansky kraj";0;0;0;0;NA;284395;0;2020-06-20;123
2020-06-19;"Nitriansky kraj";0;0;0;0;NA;284395;0;2020-06-19;123
2020-06-18;"Nitriansky kraj";0;0;0;0;NA;284395;0;2020-06-18;123
2020-06-17;"Nitriansky kraj";0;0;0;0;NA;284395;0;2020-06-17;123
2020-06-16;"Nitriansky kraj";0;0;0;0;NA;284395;0;2020-06-16;123
2020-06-14;"Nitriansky kraj";0;0;0;0;NA;284395;0;2020-06-14;123
2020-06-13;"Nitriansky kraj";0;0;0;0;NA;284395;0;2020-06-13;123
2020-06-12;"Nitriansky kraj";0;0;0;0;NA;284395;0;2020-06-12;123
2020-06-11;"Nitriansky kraj";0;0;0;0;NA;284395;0;2020-06-11;123
2020-06-10;"Nitriansky kraj";1;0;0;0;NA;284395;1;2020-06-10;123
2020-06-09;"Nitriansky kraj";1;0;0;0;NA;284395;1;2020-06-09;122
2020-06-08;"Nitriansky kraj";0;0;0;0;NA;284395;0;2020-06-08;121
2020-06-07;"Nitriansky kraj";0;0;0;0;NA;284395;0;2020-06-07;121
2020-06-05;"Nitriansky kraj";0;0;0;0;NA;284395;0;2020-06-05;121
2020-06-03;"Nitriansky kraj";0;0;0;0;NA;284395;0;2020-06-03;121
2020-06-02;"Nitriansky kraj";1;0;0;0;NA;284395;1;2020-06-02;121
2020-05-31;"Nitriansky kraj";0;0;0;0;NA;284395;0;2020-05-31;120
2020-05-29;"Nitriansky kraj";0;0;0;0;NA;284395;0;2020-05-29;120
2020-05-27;"Nitriansky kraj";0;0;0;0;NA;284395;0;2020-05-27;120
2020-05-26;"Nitriansky kraj";0;0;0;0;NA;284395;0;2020-05-26;120
2020-05-25;"Nitriansky kraj";0;0;0;0;NA;284395;0;2020-05-25;120
2020-05-24;"Nitriansky kraj";2;0;0;0;NA;284395;2;2020-05-24;120
2020-05-23;"Nitriansky kraj";0;0;0;0;NA;284395;0;2020-05-23;118
2020-05-22;"Nitriansky kraj";1;0;0;0;NA;284395;1;2020-05-22;118
2020-05-21;"Nitriansky kraj";0;0;0;0;NA;284395;0;2020-05-21;117
2020-05-20;"Nitriansky kraj";0;0;0;0;NA;284395;0;2020-05-20;117
2020-05-19;"Nitriansky kraj";0;0;0;0;NA;284395;0;2020-05-19;117
2020-05-17;"Nitriansky kraj";0;0;0;0;NA;284395;0;2020-05-17;117
2020-05-16;"Nitriansky kraj";0;0;0;0;NA;284395;0;2020-05-16;117
2020-05-15;"Nitriansky kraj";1;0;0;0;NA;284395;1;2020-05-15;117
2020-05-14;"Nitriansky kraj";0;0;0;0;NA;284395;0;2020-05-14;116
2020-05-13;"Nitriansky kraj";0;0;0;0;NA;284395;0;2020-05-13;116
2020-05-12;"Nitriansky kraj";0;0;0;0;NA;284395;0;2020-05-12;116
2020-05-11;"Nitriansky kraj";2;0;0;0;NA;284395;2;2020-05-11;116
2020-05-09;"Nitriansky kraj";0;0;0;0;NA;284395;0;2020-05-09;114
2020-05-07;"Nitriansky kraj";1;0;0;0;NA;284395;1;2020-05-07;114
2020-05-06;"Nitriansky kraj";9;0;0;0;NA;284395;9;2020-05-06;113
2020-05-05;"Nitriansky kraj";0;0;0;0;NA;284395;0;2020-05-05;104
2020-05-04;"Nitriansky kraj";5;0;0;0;NA;284395;5;2020-05-04;104
2020-05-03;"Nitriansky kraj";2;0;0;0;NA;284395;2;2020-05-03;99
2020-05-02;"Nitriansky kraj";0;0;0;0;NA;284395;0;2020-05-02;97
2020-05-01;"Nitriansky kraj";1;0;0;0;NA;284395;1;2020-05-01;97
2020-04-30;"Nitriansky kraj";0;0;0;0;NA;284395;0;2020-04-30;96
2020-04-29;"Nitriansky kraj";0;0;0;0;NA;284395;0;2020-04-29;96
2020-04-28;"Nitriansky kraj";1;0;0;0;NA;284395;1;2020-04-28;96
2020-04-27;"Nitriansky kraj";0;0;0;0;NA;284395;0;2020-04-27;95
2020-04-26;"Nitriansky kraj";0;0;0;0;NA;284395;0;2020-04-26;95
2020-04-25;"Nitriansky kraj";0;0;0;0;NA;284395;0;2020-04-25;95
2020-04-24;"Nitriansky kraj";0;0;0;0;NA;284395;0;2020-04-24;95
2020-04-23;"Nitriansky kraj";3;0;0;0;NA;284395;3;2020-04-23;95
2020-04-22;"Nitriansky kraj";16;0;0;0;NA;284395;16;2020-04-22;92
2020-04-21;"Nitriansky kraj";6;0;0;0;NA;284395;6;2020-04-21;76
2020-04-20;"Nitriansky kraj";5;0;0;0;NA;284395;5;2020-04-20;70
2020-04-19;"Nitriansky kraj";0;0;0;0;NA;284395;0;2020-04-19;65
2020-04-18;"Nitriansky kraj";0;0;0;0;NA;284395;0;2020-04-18;65
2020-04-17;"Nitriansky kraj";7;0;0;0;NA;284395;7;2020-04-17;65
2020-04-16;"Nitriansky kraj";0;0;0;0;NA;284395;0;2020-04-16;58
2020-04-15;"Nitriansky kraj";6;0;0;0;NA;284395;6;2020-04-15;58
2020-04-14;"Nitriansky kraj";2;0;0;0;NA;284395;2;2020-04-14;52
2020-04-13;"Nitriansky kraj";1;0;0;0;NA;284395;1;2020-04-13;50
2020-04-12;"Nitriansky kraj";3;0;0;0;NA;284395;3;2020-04-12;49
2020-04-11;"Nitriansky kraj";1;0;0;0;NA;284395;1;2020-04-11;46
2020-04-10;"Nitriansky kraj";1;0;0;0;NA;284395;1;2020-04-10;45
2020-04-09;"Nitriansky kraj";0;0;0;0;NA;284395;0;2020-04-09;44
2020-04-08;"Nitriansky kraj";2;0;0;0;NA;284395;2;2020-04-08;44
2020-04-07;"Nitriansky kraj";3;0;0;0;NA;284395;3;2020-04-07;42
2020-04-06;"Nitriansky kraj";4;0;0;0;NA;284395;4;2020-04-06;39
2020-04-05;"Nitriansky kraj";5;0;0;0;NA;284395;5;2020-04-05;35
2020-04-04;"Nitriansky kraj";0;0;0;0;NA;284395;0;2020-04-04;30
2020-04-03;"Nitriansky kraj";0;0;0;0;NA;284395;0;2020-04-03;30
2020-04-02;"Nitriansky kraj";1;0;0;0;NA;284395;1;2020-04-02;30
2020-04-01;"Nitriansky kraj";0;0;0;0;NA;284395;0;2020-04-01;29
2020-03-31;"Nitriansky kraj";3;0;0;0;NA;284395;3;2020-03-31;29
2020-03-30;"Nitriansky kraj";3;0;0;0;NA;284395;3;2020-03-30;26
2020-03-29;"Nitriansky kraj";3;0;0;0;NA;284395;3;2020-03-29;23
2020-03-28;"Nitriansky kraj";1;0;0;0;NA;284395;1;2020-03-28;20
2020-03-27;"Nitriansky kraj";1;0;0;0;NA;284395;1;2020-03-27;19
2020-03-26;"Nitriansky kraj";1;0;0;0;NA;284395;1;2020-03-26;18
2020-03-25;"Nitriansky kraj";1;0;0;0;NA;284395;1;2020-03-25;17
2020-03-24;"Nitriansky kraj";0;0;0;0;NA;284395;0;2020-03-24;16
2020-03-23;"Nitriansky kraj";2;0;0;0;NA;284395;2;2020-03-23;16
2020-03-22;"Nitriansky kraj";2;0;0;0;NA;284395;2;2020-03-22;14
2020-03-21;"Nitriansky kraj";2;0;0;0;NA;284395;2;2020-03-21;12
2020-03-20;"Nitriansky kraj";1;0;0;0;NA;284395;1;2020-03-20;10
2020-03-19;"Nitriansky kraj";1;0;0;0;NA;284395;1;2020-03-19;9
2020-03-18;"Nitriansky kraj";2;0;0;0;NA;284395;2;2020-03-18;8
2020-03-17;"Nitriansky kraj";1;0;0;0;NA;284395;1;2020-03-17;6
2020-03-16;"Nitriansky kraj";0;0;0;0;NA;284395;0;2020-03-16;5
2020-03-15;"Nitriansky kraj";4;0;0;0;NA;284395;4;2020-03-15;5
2020-03-14;"Nitriansky kraj";1;0;0;0;NA;284395;1;2020-03-14;1
2020-03-13;"Nitriansky kraj";0;0;0;0;NA;284395;0;2020-03-13;0
2020-03-12;"Nitriansky kraj";0;0;0;0;NA;284395;0;2020-03-12;0
2020-03-11;"Nitriansky kraj";0;0;0;0;NA;284395;0;2020-03-11;0
2020-03-09;"Nitriansky kraj";0;0;0;0;NA;284395;0;2020-03-09;0
2020-03-08;"Nitriansky kraj";0;0;0;0;NA;284395;0;2020-03-08;0
2020-03-07;"Nitriansky kraj";0;0;0;0;NA;284395;0;2020-03-07;0
2020-03-06;"Nitriansky kraj";0;0;0;0;NA;284395;0;2020-03-06;0
2022-05-24;"Prešovský kraj";31;0;0;0;262755;365516;31;2022-05-24;365516
2022-05-23;"Prešovský kraj";27;0;0;0;NA;365516;27;2022-05-23;365485
2022-05-22;"Prešovský kraj";4;9;1;10;NA;365516;5;2022-05-22;365458
2022-05-21;"Prešovský kraj";19;53;0;53;NA;365516;19;2022-05-21;365453
2022-05-20;"Prešovský kraj";31;284;20;304;NA;365516;51;2022-05-20;365434
2022-05-19;"Prešovský kraj";21;267;7;274;NA;365516;28;2022-05-19;365383
2022-05-18;"Prešovský kraj";42;277;8;285;NA;365516;50;2022-05-18;365355
2022-05-17;"Prešovský kraj";31;281;13;294;NA;365516;44;2022-05-17;365305
2022-05-16;"Prešovský kraj";28;541;57;598;NA;365516;85;2022-05-16;365261
2022-05-15;"Prešovský kraj";4;84;6;90;NA;365516;10;2022-05-15;365176
2022-05-14;"Prešovský kraj";30;134;4;138;NA;365516;34;2022-05-14;365166
2022-05-13;"Prešovský kraj";33;303;13;316;NA;365516;46;2022-05-13;365132
2022-05-12;"Prešovský kraj";38;327;19;346;NA;365516;57;2022-05-12;365086
2022-05-11;"Prešovský kraj";51;347;16;363;NA;365516;67;2022-05-11;365029
2022-05-10;"Prešovský kraj";80;625;43;668;NA;365516;123;2022-05-10;364962
2022-05-09;"Prešovský kraj";28;546;45;591;NA;365516;73;2022-05-09;364839
2022-05-08;"Prešovský kraj";3;95;5;100;NA;365516;8;2022-05-08;364766
2022-05-07;"Prešovský kraj";27;122;8;130;NA;365516;35;2022-05-07;364758
2022-05-06;"Prešovský kraj";52;469;32;501;NA;365516;84;2022-05-06;364723
2022-05-05;"Prešovský kraj";58;395;15;410;NA;365516;73;2022-05-05;364639
2022-05-04;"Prešovský kraj";61;576;48;624;NA;365516;109;2022-05-04;364566
2022-05-03;"Prešovský kraj";96;834;28;862;NA;365516;124;2022-05-03;364457
2022-05-02;"Prešovský kraj";112;839;42;881;NA;365516;154;2022-05-02;364333
2022-05-01;"Prešovský kraj";13;164;12;176;NA;365516;25;2022-05-01;364179
2022-04-30;"Prešovský kraj";117;287;13;300;NA;365516;130;2022-04-30;364154
2022-04-29;"Prešovský kraj";150;841;31;872;NA;365516;181;2022-04-29;364024
2022-04-28;"Prešovský kraj";96;856;34;890;NA;365516;130;2022-04-28;363843
2022-04-27;"Prešovský kraj";177;1061;32;1093;NA;365516;209;2022-04-27;363713
2022-04-26;"Prešovský kraj";197;1106;38;1144;NA;365516;235;2022-04-26;363504
2022-04-25;"Prešovský kraj";229;1343;54;1397;NA;365516;283;2022-04-25;363269
2022-04-24;"Prešovský kraj";56;279;8;287;NA;365516;64;2022-04-24;362986
2022-04-23;"Prešovský kraj";121;277;11;288;NA;365516;132;2022-04-23;362922
2022-04-22;"Prešovský kraj";226;908;41;949;NA;365516;267;2022-04-22;362790
2022-04-21;"Prešovský kraj";193;1340;38;1378;NA;365516;231;2022-04-21;362523
2022-04-20;"Prešovský kraj";305;1236;40;1276;NA;365516;345;2022-04-20;362292
2022-04-19;"Prešovský kraj";332;1489;68;1557;NA;365516;400;2022-04-19;361947
2022-04-18;"Prešovský kraj";74;299;43;342;NA;365516;117;2022-04-18;361547
2022-04-17;"Prešovský kraj";117;172;10;182;NA;365516;127;2022-04-17;361430
2022-04-16;"Prešovský kraj";93;285;30;315;NA;365516;123;2022-04-16;361303
2022-04-15;"Prešovský kraj";125;207;1;208;NA;365516;126;2022-04-15;361180
2022-04-14;"Prešovský kraj";303;934;47;981;NA;365516;350;2022-04-14;361054
2022-04-13;"Prešovský kraj";352;1093;54;1147;NA;365516;406;2022-04-13;360704
2022-04-12;"Prešovský kraj";208;1222;58;1280;NA;365516;266;2022-04-12;360298
2022-04-11;"Prešovský kraj";437;1983;104;2087;NA;365516;541;2022-04-11;360032
2022-04-10;"Prešovský kraj";97;421;40;461;NA;365516;137;2022-04-10;359491
2022-04-09;"Prešovský kraj";234;346;42;388;NA;365516;276;2022-04-09;359354
2022-04-08;"Prešovský kraj";368;1290;86;1376;NA;365516;454;2022-04-08;359078
2022-04-07;"Prešovský kraj";442;1324;82;1406;NA;365516;524;2022-04-07;358624
2022-04-06;"Prešovský kraj";582;1297;96;1393;NA;365516;678;2022-04-06;358100
2022-04-05;"Prešovský kraj";596;1734;99;1833;NA;365516;695;2022-04-05;357422
2022-04-04;"Prešovský kraj";804;2064;169;2233;NA;365516;973;2022-04-04;356727
2022-04-03;"Prešovský kraj";159;579;76;655;NA;365516;235;2022-04-03;355754
2022-04-02;"Prešovský kraj";359;408;41;449;NA;365516;400;2022-04-02;355519
2022-04-01;"Prešovský kraj";621;1407;120;1527;NA;365516;741;2022-04-01;355119
2022-03-31;"Prešovský kraj";717;2187;132;2319;NA;365516;849;2022-03-31;354378
2022-03-30;"Prešovský kraj";973;2061;154;2215;NA;365516;1127;2022-03-30;353529
2022-03-29;"Prešovský kraj";645;2078;164;2242;NA;365516;809;2022-03-29;352402
2022-03-28;"Prešovský kraj";946;3199;256;3455;NA;365516;1202;2022-03-28;351593
2022-03-27;"Prešovský kraj";256;793;101;894;NA;365516;357;2022-03-27;350391
2022-03-26;"Prešovský kraj";719;663;80;743;NA;365516;799;2022-03-26;350034
2022-03-25;"Prešovský kraj";895;1956;227;2183;NA;365516;1122;2022-03-25;349235
2022-03-24;"Prešovský kraj";909;2153;200;2353;NA;365516;1109;2022-03-24;348113
2022-03-23;"Prešovský kraj";1291;2147;209;2356;NA;365516;1500;2022-03-23;347004
2022-03-22;"Prešovský kraj";1398;2251;192;2443;NA;365516;1590;2022-03-22;345504
2022-03-21;"Prešovský kraj";1234;3002;290;3292;NA;365516;1524;2022-03-21;343914
2022-03-20;"Prešovský kraj";262;813;130;943;NA;365516;392;2022-03-20;342390
2022-03-19;"Prešovský kraj";802;902;115;1017;NA;365516;917;2022-03-19;341998
2022-03-18;"Prešovský kraj";1217;2105;225;2330;NA;365516;1442;2022-03-18;341081
2022-03-17;"Prešovský kraj";1118;2446;182;2628;NA;365516;1300;2022-03-17;339639
2022-03-16;"Prešovský kraj";1585;2084;222;2306;NA;365516;1807;2022-03-16;338339
2022-03-15;"Prešovský kraj";1460;2329;217;2546;NA;365516;1677;2022-03-15;336532
2022-03-14;"Prešovský kraj";1438;3310;380;3690;NA;365516;1818;2022-03-14;334855
2022-03-13;"Prešovský kraj";432;1045;190;1235;NA;365516;622;2022-03-13;333037
2022-03-12;"Prešovský kraj";1150;857;117;974;NA;365516;1267;2022-03-12;332415
2022-03-11;"Prešovský kraj";1271;2553;287;2840;NA;365516;1558;2022-03-11;331148
2022-03-10;"Prešovský kraj";1114;2577;278;2855;NA;365516;1392;2022-03-10;329590
2022-03-09;"Prešovský kraj";1477;2815;345;3160;NA;365516;1822;2022-03-09;328198
2022-03-08;"Prešovský kraj";1716;2999;308;3307;NA;365516;2024;2022-03-08;326376
2022-03-07;"Prešovský kraj";1326;4197;509;4706;NA;365516;1835;2022-03-07;324352
2022-03-06;"Prešovský kraj";278;1650;232;1882;NA;365516;510;2022-03-06;322517
2022-03-05;"Prešovský kraj";785;1194;136;1330;NA;365516;921;2022-03-05;322007
2022-03-04;"Prešovský kraj";1263;2812;303;3115;NA;365516;1566;2022-03-04;321086
2022-03-03;"Prešovský kraj";1049;3016;373;3389;NA;365516;1422;2022-03-03;319520
2022-03-02;"Prešovský kraj";1526;2955;335;3290;NA;365516;1861;2022-03-02;318098
2022-03-01;"Prešovský kraj";1612;3302;338;3640;NA;365516;1950;2022-03-01;316237
2022-02-28;"Prešovský kraj";1234;4963;538;5501;NA;365516;1772;2022-02-28;314287
2022-02-27;"Prešovský kraj";523;1467;278;1745;NA;365516;801;2022-02-27;312515
2022-02-26;"Prešovský kraj";867;1317;167;1484;NA;365516;1034;2022-02-26;311714
2022-02-25;"Prešovský kraj";1740;2768;346;3114;NA;365516;2086;2022-02-25;310680
2022-02-24;"Prešovský kraj";1435;3301;399;3700;NA;365516;1834;2022-02-24;308594
2022-02-23;"Prešovský kraj";1837;3516;404;3920;NA;365516;2241;2022-02-23;306760
2022-02-22;"Prešovský kraj";2294;3893;407;4300;NA;365516;2701;2022-02-22;304519
2022-02-21;"Prešovský kraj";1609;5165;618;5783;NA;365516;2227;2022-02-21;301818
2022-02-20;"Prešovský kraj";759;1877;319;2196;NA;365516;1078;2022-02-20;299591
2022-02-19;"Prešovský kraj";1535;1556;247;1803;NA;365516;1782;2022-02-19;298513
2022-02-18;"Prešovský kraj";2332;3580;393;3973;NA;365516;2725;2022-02-18;296731
2022-02-17;"Prešovský kraj";2293;3740;457;4197;NA;365516;2750;2022-02-17;294006
2022-02-16;"Prešovský kraj";2494;4049;484;4533;NA;365516;2978;2022-02-16;291256
2022-02-15;"Prešovský kraj";2992;4583;551;5134;NA;365516;3543;2022-02-15;288278
2022-02-14;"Prešovský kraj";2122;6203;845;7048;NA;365516;2967;2022-02-14;284735
2022-02-13;"Prešovský kraj";1338;2452;434;2886;NA;365516;1772;2022-02-13;281768
2022-02-12;"Prešovský kraj";2333;1867;352;2219;NA;365516;2685;2022-02-12;279996
2022-02-11;"Prešovský kraj";2666;3931;520;4451;NA;365516;3186;2022-02-11;277311
2022-02-10;"Prešovský kraj";2977;4518;599;5117;NA;365516;3576;2022-02-10;274125
2022-02-09;"Prešovský kraj";2644;4502;634;5136;NA;365516;3278;2022-02-09;270549
2022-02-08;"Prešovský kraj";3387;4890;651;5541;NA;365516;4038;2022-02-08;267271
2022-02-07;"Prešovský kraj";2132;6920;941;7861;NA;365516;3073;2022-02-07;263233
2022-02-06;"Prešovský kraj";1360;2884;490;3374;NA;365516;1850;2022-02-06;260160
2022-02-05;"Prešovský kraj";2813;1993;334;2327;NA;365516;3147;2022-02-05;258310
2022-02-04;"Prešovský kraj";2944;4556;573;5129;NA;365516;3517;2022-02-04;255163
2022-02-03;"Prešovský kraj";3375;5205;487;5692;NA;365516;3862;2022-02-03;251646
2022-02-02;"Prešovský kraj";3150;5686;562;6248;NA;365516;3712;2022-02-02;247784
2022-02-01;"Prešovský kraj";2791;5694;631;6325;NA;365516;3422;2022-02-01;244072
2022-01-31;"Prešovský kraj";2444;9142;929;10071;NA;365516;3373;2022-01-31;240650
2022-01-30;"Prešovský kraj";1311;3437;495;3932;NA;365516;1806;2022-01-30;237277
2022-01-29;"Prešovský kraj";2291;1949;282;2231;NA;365516;2573;2022-01-29;235471
2022-01-28;"Prešovský kraj";2473;4784;486;5270;NA;365516;2959;2022-01-28;232898
2022-01-27;"Prešovský kraj";2353;4558;412;4970;NA;365516;2765;2022-01-27;229939
2022-01-26;"Prešovský kraj";2311;5628;405;6033;NA;365516;2716;2022-01-26;227174
2022-01-25;"Prešovský kraj";2127;5284;346;5630;NA;365516;2473;2022-01-25;224458
2022-01-24;"Prešovský kraj";1324;7619;410;8029;NA;365516;1734;2022-01-24;221985
2022-01-23;"Prešovský kraj";262;3584;218;3802;NA;365516;480;2022-01-23;220251
2022-01-22;"Prešovský kraj";1448;1764;157;1921;NA;365516;1605;2022-01-22;219771
2022-01-21;"Prešovský kraj";1128;4312;196;4508;NA;365516;1324;2022-01-21;218166
2022-01-20;"Prešovský kraj";1184;4012;156;4168;NA;365516;1340;2022-01-20;216842
2022-01-19;"Prešovský kraj";822;4781;173;4954;NA;365516;995;2022-01-19;215502
2022-01-18;"Prešovský kraj";1032;4918;163;5081;NA;365516;1195;2022-01-18;214507
2022-01-17;"Prešovský kraj";784;7143;150;7293;NA;365516;934;2022-01-17;213312
2022-01-16;"Prešovský kraj";113;3113;98;3211;NA;365516;211;2022-01-16;212378
2022-01-15;"Prešovský kraj";675;1546;64;1610;NA;365516;739;2022-01-15;212167
2022-01-14;"Prešovský kraj";202;3792;78;3870;NA;365516;280;2022-01-14;211428
2022-01-13;"Prešovský kraj";252;3550;89;3639;NA;365516;341;2022-01-13;211148
2022-01-12;"Prešovský kraj";431;4183;77;4260;NA;365516;508;2022-01-12;210807
2022-01-11;"Prešovský kraj";438;4812;80;4892;NA;365516;518;2022-01-11;210299
2022-01-10;"Prešovský kraj";469;7561;135;7696;NA;365516;604;2022-01-10;209781
2022-01-09;"Prešovský kraj";114;4129;78;4207;NA;365516;192;2022-01-09;209177
2022-01-08;"Prešovský kraj";291;2097;39;2136;NA;365516;330;2022-01-08;208985
2022-01-07;"Prešovský kraj";370;3882;106;3988;NA;365516;476;2022-01-07;208655
2022-01-06;"Prešovský kraj";104;1000;43;1043;NA;365516;147;2022-01-06;208179
2022-01-05;"Prešovský kraj";373;4752;100;4852;NA;365516;473;2022-01-05;208032
2022-01-04;"Prešovský kraj";428;4558;77;4635;NA;365516;505;2022-01-04;207559
2022-01-03;"Prešovský kraj";390;6868;105;6973;NA;365516;495;2022-01-03;207054
2022-01-02;"Prešovský kraj";158;3180;75;3255;NA;365516;233;2022-01-02;206559
2022-01-01;"Prešovský kraj";55;379;8;387;NA;365516;63;2022-01-01;206326
2021-12-31;"Prešovský kraj";220;2217;77;2294;NA;365516;297;2021-12-31;206263
2021-12-30;"Prešovský kraj";230;2985;81;3066;NA;365516;311;2021-12-30;205966
2021-12-29;"Prešovský kraj";298;3924;73;3997;NA;365516;371;2021-12-29;205655
2021-12-28;"Prešovský kraj";365;3625;60;3685;NA;365516;425;2021-12-28;205284
2021-12-27;"Prešovský kraj";593;5336;93;5429;NA;365516;686;2021-12-27;204859
2021-12-26;"Prešovský kraj";112;1584;62;1646;NA;365516;174;2021-12-26;204173
2021-12-25;"Prešovský kraj";12;600;29;629;NA;365516;41;2021-12-25;203999
2021-12-24;"Prešovský kraj";27;463;26;489;NA;365516;53;2021-12-24;203958
2021-12-23;"Prešovský kraj";623;3125;76;3201;NA;365516;699;2021-12-23;203905
2021-12-22;"Prešovský kraj";234;3600;86;3686;NA;365516;320;2021-12-22;203206
2021-12-21;"Prešovský kraj";520;4571;78;4649;NA;365516;598;2021-12-21;202886
2021-12-20;"Prešovský kraj";371;7190;107;7297;NA;365516;478;2021-12-20;202288
2021-12-19;"Prešovský kraj";110;3166;74;3240;NA;365516;184;2021-12-19;201810
2021-12-18;"Prešovský kraj";313;1562;61;1623;NA;365516;374;2021-12-18;201626
2021-12-17;"Prešovský kraj";429;4482;96;4578;NA;365516;525;2021-12-17;201252
2021-12-16;"Prešovský kraj";401;4557;95;4652;NA;365516;496;2021-12-16;200727
2021-12-15;"Prešovský kraj";473;4499;79;4578;NA;365516;552;2021-12-15;200231
2021-12-14;"Prešovský kraj";662;5468;125;5593;NA;365516;787;2021-12-14;199679
2021-12-13;"Prešovský kraj";588;8085;175;8260;NA;365516;763;2021-12-13;198892
2021-12-12;"Prešovský kraj";160;3852;106;3958;NA;365516;266;2021-12-12;198129
2021-12-11;"Prešovský kraj";483;2040;91;2131;NA;365516;574;2021-12-11;197863
2021-12-10;"Prešovský kraj";649;5018;140;5158;NA;365516;789;2021-12-10;197289
2021-12-09;"Prešovský kraj";669;4702;135;4837;NA;365516;804;2021-12-09;196500
2021-12-08;"Prešovský kraj";944;4794;167;4961;NA;365516;1111;2021-12-08;195696
2021-12-07;"Prešovský kraj";1217;5853;188;6041;NA;365516;1405;2021-12-07;194585
2021-12-06;"Prešovský kraj";784;8604;247;8851;NA;365516;1031;2021-12-06;193180
2021-12-05;"Prešovský kraj";145;4439;133;4572;NA;365516;278;2021-12-05;192149
2021-12-04;"Prešovský kraj";1025;2290;127;2417;NA;365516;1152;2021-12-04;191871
2021-12-03;"Prešovský kraj";1040;5268;231;5499;NA;365516;1271;2021-12-03;190719
2021-12-02;"Prešovský kraj";2255;5291;183;5474;NA;365516;2438;2021-12-02;189448
2021-12-01;"Prešovský kraj";826;5267;239;5506;NA;365516;1065;2021-12-01;187010
2021-11-30;"Prešovský kraj";1123;6651;265;6916;NA;365516;1388;2021-11-30;185945
2021-11-29;"Prešovský kraj";583;11478;473;11951;NA;365516;1056;2021-11-29;184557
2021-11-28;"Prešovský kraj";919;5898;234;6132;NA;365516;1153;2021-11-28;183501
2021-11-27;"Prešovský kraj";884;2977;219;3196;NA;365516;1103;2021-11-27;182348
2021-11-26;"Prešovský kraj";1311;5890;328;6218;NA;365516;1639;2021-11-26;181245
2021-11-25;"Prešovský kraj";1285;5051;307;5358;NA;365516;1592;2021-11-25;179606
2021-11-24;"Prešovský kraj";1209;6120;357;6477;NA;365516;1566;2021-11-24;178014
2021-11-23;"Prešovský kraj";1099;6631;314;6945;NA;365516;1413;2021-11-23;176448
2021-11-22;"Prešovský kraj";905;8209;529;8738;NA;365516;1434;2021-11-22;175035
2021-11-21;"Prešovský kraj";950;3766;316;4082;NA;365516;1266;2021-11-21;173601
2021-11-20;"Prešovský kraj";1372;2193;222;2415;NA;365516;1594;2021-11-20;172335
2021-11-19;"Prešovský kraj";1629;5864;452;6316;NA;365516;2081;2021-11-19;170741
2021-11-18;"Prešovský kraj";823;6696;518;7214;NA;365516;1341;2021-11-18;168660
2021-11-17;"Prešovský kraj";1648;1336;148;1484;NA;365516;1796;2021-11-17;167319
2021-11-16;"Prešovský kraj";1346;5511;398;5909;NA;365516;1744;2021-11-16;165523
2021-11-15;"Prešovský kraj";897;7804;577;8381;NA;365516;1474;2021-11-15;163779
2021-11-14;"Prešovský kraj";603;3168;311;3479;NA;365516;914;2021-11-14;162305
2021-11-13;"Prešovský kraj";1255;2068;262;2330;NA;365516;1517;2021-11-13;161391
2021-11-12;"Prešovský kraj";1358;5236;371;5607;NA;365516;1729;2021-11-12;159874
2021-11-11;"Prešovský kraj";1218;5087;438;5525;NA;365516;1656;2021-11-11;158145
2021-11-10;"Prešovský kraj";1278;4966;380;5346;NA;365516;1658;2021-11-10;156489
2021-11-09;"Prešovský kraj";1038;5431;407;5838;NA;365516;1445;2021-11-09;154831
2021-11-08;"Prešovský kraj";1068;6987;574;7561;NA;365516;1642;2021-11-08;153386
2021-11-07;"Prešovský kraj";421;2500;242;2742;NA;365516;663;2021-11-07;151744
2021-11-06;"Prešovský kraj";1389;1899;234;2133;NA;365516;1623;2021-11-06;151081
2021-11-05;"Prešovský kraj";1080;4974;367;5341;NA;365516;1447;2021-11-05;149458
2021-11-04;"Prešovský kraj";1743;5162;322;5484;NA;365516;2065;2021-11-04;148011
2021-11-03;"Prešovský kraj";1326;5337;387;5724;NA;365516;1713;2021-11-03;145946
2021-11-02;"Prešovský kraj";1002;7553;556;8109;NA;365516;1558;2021-11-02;144233
2021-11-01;"Prešovský kraj";347;1402;131;1533;NA;365516;478;2021-11-01;142675
2021-10-31;"Prešovský kraj";447;2045;210;2255;NA;365516;657;2021-10-31;142197
2021-10-30;"Prešovský kraj";1148;1928;183;2111;NA;365516;1331;2021-10-30;141540
2021-10-29;"Prešovský kraj";1360;4460;253;4713;NA;365516;1613;2021-10-29;140209
2021-10-28;"Prešovský kraj";960;4500;300;4800;NA;365516;1260;2021-10-28;138596
2021-10-27;"Prešovský kraj";1444;4325;221;4546;NA;365516;1665;2021-10-27;137336
2021-10-26;"Prešovský kraj";940;5125;217;5342;NA;365516;1157;2021-10-26;135671
2021-10-25;"Prešovský kraj";673;6077;348;6425;NA;365516;1021;2021-10-25;134514
2021-10-24;"Prešovský kraj";110;2180;149;2329;NA;365516;259;2021-10-24;133493
2021-10-23;"Prešovský kraj";1145;1928;141;2069;NA;365516;1286;2021-10-23;133234
2021-10-22;"Prešovský kraj";792;4876;177;5053;NA;365516;969;2021-10-22;131948
2021-10-21;"Prešovský kraj";901;4738;191;4929;NA;365516;1092;2021-10-21;130979
2021-10-20;"Prešovský kraj";833;4199;195;4394;NA;365516;1028;2021-10-20;129887
2021-10-19;"Prešovský kraj";830;4728;175;4903;NA;365516;1005;2021-10-19;128859
2021-10-18;"Prešovský kraj";454;5752;240;5992;NA;365516;694;2021-10-18;127854
2021-10-17;"Prešovský kraj";181;2430;131;2561;NA;365516;312;2021-10-17;127160
2021-10-16;"Prešovský kraj";561;1924;94;2018;NA;365516;655;2021-10-16;126848
2021-10-15;"Prešovský kraj";533;4735;107;4842;NA;365516;640;2021-10-15;126193
2021-10-14;"Prešovský kraj";506;3948;85;4033;NA;365516;591;2021-10-14;125553
2021-10-13;"Prešovský kraj";549;3794;98;3892;NA;365516;647;2021-10-13;124962
2021-10-12;"Prešovský kraj";520;3966;101;4067;NA;365516;621;2021-10-12;124315
2021-10-11;"Prešovský kraj";433;5421;131;5552;NA;365516;564;2021-10-11;123694
2021-10-10;"Prešovský kraj";78;2099;64;2163;NA;365516;142;2021-10-10;123130
2021-10-09;"Prešovský kraj";311;2077;47;2124;NA;365516;358;2021-10-09;122988
2021-10-08;"Prešovský kraj";636;4934;94;5028;NA;365516;730;2021-10-08;122630
2021-10-07;"Prešovský kraj";487;3919;101;4020;NA;365516;588;2021-10-07;121900
2021-10-06;"Prešovský kraj";296;3851;104;3955;NA;365516;400;2021-10-06;121312
2021-10-05;"Prešovský kraj";430;4151;90;4241;NA;365516;520;2021-10-05;120912
2021-10-04;"Prešovský kraj";353;5569;125;5694;NA;365516;478;2021-10-04;120392
2021-10-03;"Prešovský kraj";19;2324;47;2371;NA;365516;66;2021-10-03;119914
2021-10-02;"Prešovský kraj";269;2238;58;2296;NA;365516;327;2021-10-02;119848
2021-10-01;"Prešovský kraj";325;4997;63;5060;NA;365516;388;2021-10-01;119521
2021-09-30;"Prešovský kraj";265;4044;83;4127;NA;365516;348;2021-09-30;119133
2021-09-29;"Prešovský kraj";381;3825;55;3880;NA;365516;436;2021-09-29;118785
2021-09-28;"Prešovský kraj";312;4714;69;4783;NA;365516;381;2021-09-28;118349
2021-09-27;"Prešovský kraj";257;5062;104;5166;NA;365516;361;2021-09-27;117968
2021-09-26;"Prešovský kraj";8;2422;67;2489;NA;365516;75;2021-09-26;117607
2021-09-25;"Prešovský kraj";134;2540;46;2586;NA;365516;180;2021-09-25;117532
2021-09-24;"Prešovský kraj";297;4822;61;4883;NA;365516;358;2021-09-24;117352
2021-09-23;"Prešovský kraj";109;4105;45;4150;NA;365516;154;2021-09-23;116994
2021-09-22;"Prešovský kraj";177;3836;41;3877;NA;365516;218;2021-09-22;116840
2021-09-21;"Prešovský kraj";219;5059;66;5125;NA;365516;285;2021-09-21;116622
2021-09-20;"Prešovský kraj";180;5183;68;5251;NA;365516;248;2021-09-20;116337
2021-09-19;"Prešovský kraj";7;2726;30;2756;NA;365516;37;2021-09-19;116089
2021-09-18;"Prešovský kraj";169;2406;37;2443;NA;365516;206;2021-09-18;116052
2021-09-17;"Prešovský kraj";157;4402;52;4454;NA;365516;209;2021-09-17;115846
2021-09-16;"Prešovský kraj";146;4371;71;4442;NA;365516;217;2021-09-16;115637
2021-09-15;"Prešovský kraj";68;701;19;720;NA;365516;87;2021-09-15;115420
2021-09-14;"Prešovský kraj";133;3369;38;3407;NA;365516;171;2021-09-14;115333
2021-09-13;"Prešovský kraj";105;4225;37;4262;NA;365516;142;2021-09-13;115162
2021-09-12;"Prešovský kraj";4;1776;29;1805;NA;365516;33;2021-09-12;115020
2021-09-11;"Prešovský kraj";65;2012;24;2036;NA;365516;89;2021-09-11;114987
2021-09-10;"Prešovský kraj";105;3241;30;3271;NA;365516;135;2021-09-10;114898
2021-09-09;"Prešovský kraj";29;3090;27;3117;NA;365516;56;2021-09-09;114763
2021-09-08;"Prešovský kraj";73;2444;20;2464;NA;365516;93;2021-09-08;114707
2021-09-07;"Prešovský kraj";82;2449;24;2473;NA;365516;106;2021-09-07;114614
2021-09-06;"Prešovský kraj";61;3282;20;3302;NA;365516;81;2021-09-06;114508
2021-09-05;"Prešovský kraj";5;1338;11;1349;NA;365516;16;2021-09-05;114427
2021-09-04;"Prešovský kraj";27;1864;14;1878;NA;365516;41;2021-09-04;114411
2021-09-03;"Prešovský kraj";39;2976;15;2991;NA;365516;54;2021-09-03;114370
2021-09-02;"Prešovský kraj";39;2558;20;2578;NA;365516;59;2021-09-02;114316
2021-09-01;"Prešovský kraj";14;575;6;581;NA;365516;20;2021-09-01;114257
2021-08-31;"Prešovský kraj";47;2438;13;2451;NA;365516;60;2021-08-31;114237
2021-08-30;"Prešovský kraj";23;2827;19;2846;NA;365516;42;2021-08-30;114177
2021-08-29;"Prešovský kraj";3;781;1;782;NA;365516;4;2021-08-29;114135
2021-08-28;"Prešovský kraj";5;2101;8;2109;NA;365516;13;2021-08-28;114131
2021-08-27;"Prešovský kraj";32;3084;8;3092;NA;365516;40;2021-08-27;114118
2021-08-26;"Prešovský kraj";13;2094;8;2102;NA;365516;21;2021-08-26;114078
2021-08-25;"Prešovský kraj";18;1947;4;1951;NA;365516;22;2021-08-25;114057
2021-08-24;"Prešovský kraj";10;2138;5;2143;NA;365516;15;2021-08-24;114035
2021-08-23;"Prešovský kraj";16;2576;6;2582;NA;365516;22;2021-08-23;114020
2021-08-22;"Prešovský kraj";0;1440;6;1446;NA;365516;6;2021-08-22;113998
2021-08-21;"Prešovský kraj";28;2018;4;2022;NA;365516;32;2021-08-21;113992
2021-08-20;"Prešovský kraj";15;2906;7;2913;NA;365516;22;2021-08-20;113960
2021-08-19;"Prešovský kraj";22;2242;8;2250;NA;365516;30;2021-08-19;113938
2021-08-18;"Prešovský kraj";6;1752;11;1763;NA;365516;17;2021-08-18;113908
2021-08-17;"Prešovský kraj";29;1829;6;1835;NA;365516;35;2021-08-17;113891
2021-08-16;"Prešovský kraj";11;2524;7;2531;NA;365516;18;2021-08-16;113856
2021-08-15;"Prešovský kraj";0;896;2;898;NA;365516;2;2021-08-15;113838
2021-08-14;"Prešovský kraj";14;1662;1;1663;NA;365516;15;2021-08-14;113836
2021-08-13;"Prešovský kraj";24;1646;12;1658;NA;365516;36;2021-08-13;113821
2021-08-12;"Prešovský kraj";9;1752;3;1755;NA;365516;12;2021-08-12;113785
2021-08-11;"Prešovský kraj";15;1193;3;1196;NA;365516;18;2021-08-11;113773
2021-08-10;"Prešovský kraj";10;1102;4;1106;NA;365516;14;2021-08-10;113755
2021-08-09;"Prešovský kraj";13;2156;4;2160;NA;365516;17;2021-08-09;113741
2021-08-08;"Prešovský kraj";2;675;2;677;NA;365516;4;2021-08-08;113724
2021-08-07;"Prešovský kraj";5;1114;3;1117;NA;365516;8;2021-08-07;113720
2021-08-06;"Prešovský kraj";9;1459;4;1463;NA;365516;13;2021-08-06;113712
2021-08-05;"Prešovský kraj";9;1370;2;1372;NA;365516;11;2021-08-05;113699
2021-08-04;"Prešovský kraj";6;1007;1;1008;NA;365516;7;2021-08-04;113688
2021-08-03;"Prešovský kraj";8;976;1;977;NA;365516;9;2021-08-03;113681
2021-08-02;"Prešovský kraj";5;1477;6;1483;NA;365516;11;2021-08-02;113672
2021-08-01;"Prešovský kraj";0;738;2;740;NA;365516;2;2021-08-01;113661
2021-07-31;"Prešovský kraj";20;1080;0;1080;NA;365516;20;2021-07-31;113659
2021-07-30;"Prešovský kraj";2;1518;1;1519;NA;365516;3;2021-07-30;113639
2021-07-29;"Prešovský kraj";6;1302;1;1303;NA;365516;7;2021-07-29;113636
2021-07-28;"Prešovský kraj";6;1106;1;1107;NA;365516;7;2021-07-28;113629
2021-07-27;"Prešovský kraj";5;1140;2;1142;NA;365516;7;2021-07-27;113622
2021-07-26;"Prešovský kraj";12;1583;1;1584;NA;365516;13;2021-07-26;113615
2021-07-25;"Prešovský kraj";0;687;1;688;NA;365516;1;2021-07-25;113602
2021-07-24;"Prešovský kraj";8;1040;0;1040;NA;365516;8;2021-07-24;113601
2021-07-23;"Prešovský kraj";8;1608;1;1609;NA;365516;9;2021-07-23;113593
2021-07-22;"Prešovský kraj";13;1431;10;1441;NA;365516;23;2021-07-22;113584
2021-07-21;"Prešovský kraj";5;1076;1;1077;NA;365516;6;2021-07-21;113561
2021-07-20;"Prešovský kraj";4;1064;0;1064;NA;365516;4;2021-07-20;113555
2021-07-19;"Prešovský kraj";2;1644;4;1648;NA;365516;6;2021-07-19;113551
2021-07-18;"Prešovský kraj";1;647;0;647;NA;365516;1;2021-07-18;113545
2021-07-17;"Prešovský kraj";6;1245;1;1246;NA;365516;7;2021-07-17;113544
2021-07-16;"Prešovský kraj";4;1558;2;1560;NA;365516;6;2021-07-16;113537
2021-07-15;"Prešovský kraj";5;1310;4;1314;NA;365516;9;2021-07-15;113531
2021-07-14;"Prešovský kraj";1;1051;2;1053;NA;365516;3;2021-07-14;113522
2021-07-13;"Prešovský kraj";1;1071;2;1073;NA;365516;3;2021-07-13;113519
2021-07-12;"Prešovský kraj";1;1949;2;1951;NA;365516;3;2021-07-12;113516
2021-07-11;"Prešovský kraj";0;660;1;661;NA;365516;1;2021-07-11;113513
2021-07-10;"Prešovský kraj";4;1229;2;1231;NA;365516;6;2021-07-10;113512
2021-07-09;"Prešovský kraj";6;1957;1;1958;NA;365516;7;2021-07-09;113506
2021-07-08;"Prešovský kraj";5;1192;0;1192;NA;365516;5;2021-07-08;113499
2021-07-07;"Prešovský kraj";7;1468;3;1471;NA;365516;10;2021-07-07;113494
2021-07-06;"Prešovský kraj";5;1423;2;1425;NA;365516;7;2021-07-06;113484
2021-07-05;"Prešovský kraj";2;645;0;645;NA;365516;2;2021-07-05;113477
2021-07-04;"Prešovský kraj";0;788;0;788;NA;365516;0;2021-07-04;113475
2021-07-03;"Prešovský kraj";2;1391;0;1391;NA;365516;2;2021-07-03;113475
2021-07-02;"Prešovský kraj";4;1796;0;1796;NA;365516;4;2021-07-02;113473
2021-07-01;"Prešovský kraj";2;1590;1;1591;NA;365516;3;2021-07-01;113469
2021-06-30;"Prešovský kraj";3;8829;4;8833;NA;365516;7;2021-06-30;113466
2021-06-29;"Prešovský kraj";1;4935;3;4938;NA;365516;4;2021-06-29;113459
2021-06-28;"Prešovský kraj";5;6109;2;6111;NA;365516;7;2021-06-28;113455
2021-06-27;"Prešovský kraj";0;3852;1;3853;NA;365516;1;2021-06-27;113448
2021-06-26;"Prešovský kraj";4;5815;1;5816;NA;365516;5;2021-06-26;113447
2021-06-25;"Prešovský kraj";7;7321;4;7325;NA;365516;11;2021-06-25;113442
2021-06-24;"Prešovský kraj";10;5406;5;5411;NA;365516;15;2021-06-24;113431
2021-06-23;"Prešovský kraj";4;5124;2;5126;NA;365516;6;2021-06-23;113416
2021-06-22;"Prešovský kraj";5;5143;1;5144;NA;365516;6;2021-06-22;113410
2021-06-21;"Prešovský kraj";13;7033;6;7039;NA;365516;19;2021-06-21;113404
2021-06-20;"Prešovský kraj";0;5204;3;5207;NA;365516;3;2021-06-20;113385
2021-06-19;"Prešovský kraj";1;7349;5;7354;NA;365516;6;2021-06-19;113382
2021-06-18;"Prešovský kraj";9;8682;10;8692;NA;365516;19;2021-06-18;113376
2021-06-17;"Prešovský kraj";9;6548;5;6553;NA;365516;14;2021-06-17;113357
2021-06-16;"Prešovský kraj";6;6422;3;6425;NA;365516;9;2021-06-16;113343
2021-06-15;"Prešovský kraj";2;5709;4;5713;NA;365516;6;2021-06-15;113334
2021-06-14;"Prešovský kraj";5;8229;13;8242;NA;365516;18;2021-06-14;113328
2021-06-13;"Prešovský kraj";1;6455;7;6462;NA;365516;8;2021-06-13;113310
2021-06-12;"Prešovský kraj";3;8904;9;8913;NA;365516;12;2021-06-12;113302
2021-06-11;"Prešovský kraj";21;9877;9;9886;NA;365516;30;2021-06-11;113290
2021-06-10;"Prešovský kraj";11;6512;10;6522;NA;365516;21;2021-06-10;113260
2021-06-09;"Prešovský kraj";16;6375;3;6378;NA;365516;19;2021-06-09;113239
2021-06-08;"Prešovský kraj";31;6495;12;6507;NA;365516;43;2021-06-08;113220
2021-06-07;"Prešovský kraj";11;9111;15;9126;NA;365516;26;2021-06-07;113177
2021-06-06;"Prešovský kraj";0;8016;5;8021;NA;365516;5;2021-06-06;113151
2021-06-05;"Prešovský kraj";17;10248;15;10263;NA;365516;32;2021-06-05;113146
2021-06-04;"Prešovský kraj";26;10375;18;10393;NA;365516;44;2021-06-04;113114
2021-06-03;"Prešovský kraj";14;6820;16;6836;NA;365516;30;2021-06-03;113070
2021-06-02;"Prešovský kraj";47;7372;14;7386;NA;365516;61;2021-06-02;113040
2021-06-01;"Prešovský kraj";15;6926;14;6940;NA;365516;29;2021-06-01;112979
2021-05-31;"Prešovský kraj";27;9951;22;9973;NA;365516;49;2021-05-31;112950
2021-05-30;"Prešovský kraj";2;9717;14;9731;NA;365516;16;2021-05-30;112901
2021-05-29;"Prešovský kraj";23;12733;24;12757;NA;365516;47;2021-05-29;112885
2021-05-28;"Prešovský kraj";30;12468;19;12487;NA;365516;49;2021-05-28;112838
2021-05-27;"Prešovský kraj";16;7653;37;7690;NA;365516;53;2021-05-27;112789
2021-05-26;"Prešovský kraj";32;8140;23;8163;NA;365516;55;2021-05-26;112736
2021-05-25;"Prešovský kraj";38;8690;20;8710;NA;365516;58;2021-05-25;112681
2021-05-24;"Prešovský kraj";17;13298;37;13335;NA;365516;54;2021-05-24;112623
2021-05-23;"Prešovský kraj";3;11947;20;11967;NA;365516;23;2021-05-23;112569
2021-05-22;"Prešovský kraj";11;14422;44;14466;NA;365516;55;2021-05-22;112546
2021-05-21;"Prešovský kraj";44;13803;24;13827;NA;365516;68;2021-05-21;112491
2021-05-20;"Prešovský kraj";13;9437;29;9466;NA;365516;42;2021-05-20;112423
2021-05-19;"Prešovský kraj";60;10756;36;10792;NA;365516;96;2021-05-19;112381
2021-05-18;"Prešovský kraj";44;9062;27;9089;NA;365516;71;2021-05-18;112285
2021-05-17;"Prešovský kraj";60;12856;47;12903;NA;365516;107;2021-05-17;112214
2021-05-16;"Prešovský kraj";20;16302;66;16368;NA;365516;86;2021-05-16;112107
2021-05-15;"Prešovský kraj";20;24604;81;24685;NA;365516;101;2021-05-15;112021
2021-05-14;"Prešovský kraj";49;18671;68;18739;NA;365516;117;2021-05-14;111920
2021-05-13;"Prešovský kraj";54;11166;71;11237;NA;365516;125;2021-05-13;111803
2021-05-12;"Prešovský kraj";59;10822;39;10861;NA;365516;98;2021-05-12;111678
2021-05-11;"Prešovský kraj";61;10728;48;10776;NA;365516;109;2021-05-11;111580
2021-05-10;"Prešovský kraj";79;15726;67;15793;NA;365516;146;2021-05-10;111471
2021-05-09;"Prešovský kraj";54;21658;82;21740;NA;365516;136;2021-05-09;111325
2021-05-08;"Prešovský kraj";39;23050;52;23102;NA;365516;91;2021-05-08;111189
2021-05-07;"Prešovský kraj";81;23543;66;23609;NA;365516;147;2021-05-07;111098
2021-05-06;"Prešovský kraj";107;12924;66;12990;NA;365516;173;2021-05-06;110951
2021-05-05;"Prešovský kraj";60;12808;84;12892;NA;365516;144;2021-05-05;110778
2021-05-04;"Prešovský kraj";203;13470;67;13537;NA;365516;270;2021-05-04;110634
2021-05-03;"Prešovský kraj";68;18458;109;18567;NA;365516;177;2021-05-03;110364
2021-05-02;"Prešovský kraj";29;36676;102;36778;NA;365516;131;2021-05-02;110187
2021-05-01;"Prešovský kraj";70;57153;183;57336;NA;365516;253;2021-05-01;110056
2021-04-30;"Prešovský kraj";135;39333;118;39451;NA;365516;253;2021-04-30;109803
2021-04-29;"Prešovský kraj";110;16635;97;16732;NA;365516;207;2021-04-29;109550
2021-04-28;"Prešovský kraj";122;18671;89;18760;NA;365516;211;2021-04-28;109343
2021-04-27;"Prešovský kraj";154;19994;120;20114;NA;365516;274;2021-04-27;109132
2021-04-26;"Prešovský kraj";99;27241;123;27364;NA;365516;222;2021-04-26;108858
2021-04-25;"Prešovský kraj";9;52776;156;52932;NA;365516;165;2021-04-25;108636
2021-04-24;"Prešovský kraj";61;85698;243;85941;NA;365516;304;2021-04-24;108471
2021-04-23;"Prešovský kraj";171;40365;137;40502;NA;365516;308;2021-04-23;108167
2021-04-22;"Prešovský kraj";86;18104;125;18229;NA;365516;211;2021-04-22;107859
2021-04-21;"Prešovský kraj";144;21550;139;21689;NA;365516;283;2021-04-21;107648
2021-04-20;"Prešovský kraj";115;23346;128;23474;NA;365516;243;2021-04-20;107365
2021-04-19;"Prešovský kraj";106;29133;145;29278;NA;365516;251;2021-04-19;107122
2021-04-18;"Prešovský kraj";4;51824;129;51953;NA;365516;133;2021-04-18;106871
2021-04-17;"Prešovský kraj";119;97970;238;98208;NA;365516;357;2021-04-17;106738
2021-04-16;"Prešovský kraj";135;40989;146;41135;NA;365516;281;2021-04-16;106381
2021-04-15;"Prešovský kraj";112;20179;137;20316;NA;365516;249;2021-04-15;106100
2021-04-14;"Prešovský kraj";199;23332;130;23462;NA;365516;329;2021-04-14;105851
2021-04-13;"Prešovský kraj";180;23907;116;24023;NA;365516;296;2021-04-13;105522
2021-04-12;"Prešovský kraj";172;30152;175;30327;NA;365516;347;2021-04-12;105226
2021-04-11;"Prešovský kraj";11;49955;187;50142;NA;365516;198;2021-04-11;104879
2021-04-10;"Prešovský kraj";94;90181;297;90478;NA;365516;391;2021-04-10;104681
2021-04-09;"Prešovský kraj";255;37163;200;37363;NA;365516;455;2021-04-09;104290
2021-04-08;"Prešovský kraj";192;18893;157;19050;NA;365516;349;2021-04-08;103835
2021-04-07;"Prešovský kraj";314;27797;154;27951;NA;365516;468;2021-04-07;103486
2021-04-06;"Prešovský kraj";231;41711;268;41979;NA;365516;499;2021-04-06;103018
2021-04-05;"Prešovský kraj";54;18454;132;18586;NA;365516;186;2021-04-05;102519
2021-04-04;"Prešovský kraj";31;18569;91;18660;NA;365516;122;2021-04-04;102333
2021-04-03;"Prešovský kraj";104;90664;321;90985;NA;365516;425;2021-04-03;102211
2021-04-02;"Prešovský kraj";194;23381;134;23515;NA;365516;328;2021-04-02;101786
2021-04-01;"Prešovský kraj";256;42879;195;43074;NA;365516;451;2021-04-01;101458
2021-03-31;"Prešovský kraj";311;30176;227;30403;NA;365516;538;2021-03-31;101007
2021-03-30;"Prešovský kraj";374;20751;203;20954;NA;365516;577;2021-03-30;100469
2021-03-29;"Prešovský kraj";219;28188;229;28417;NA;365516;448;2021-03-29;99892
2021-03-28;"Prešovský kraj";26;46811;256;47067;NA;365516;282;2021-03-28;99444
2021-03-27;"Prešovský kraj";181;88673;372;89045;NA;365516;553;2021-03-27;99162
2021-03-26;"Prešovský kraj";310;47751;299;48050;NA;365516;609;2021-03-26;98609
2021-03-25;"Prešovský kraj";248;22281;213;22494;NA;365516;461;2021-03-25;98000
2021-03-24;"Prešovský kraj";381;19590;213;19803;NA;365516;594;2021-03-24;97539
2021-03-23;"Prešovský kraj";241;20351;255;20606;NA;365516;496;2021-03-23;96945
2021-03-22;"Prešovský kraj";299;28634;287;28921;NA;365516;586;2021-03-22;96449
2021-03-21;"Prešovský kraj";32;49439;266;49705;NA;365516;298;2021-03-21;95863
2021-03-20;"Prešovský kraj";180;92529;426;92955;NA;365516;606;2021-03-20;95565
2021-03-19;"Prešovský kraj";373;46582;326;46908;NA;365516;699;2021-03-19;94959
2021-03-18;"Prešovský kraj";251;21721;217;21938;NA;365516;468;2021-03-18;94260
2021-03-17;"Prešovský kraj";331;20887;231;21118;NA;365516;562;2021-03-17;93792
2021-03-16;"Prešovský kraj";461;21094;278;21372;NA;365516;739;2021-03-16;93230
2021-03-15;"Prešovský kraj";370;28813;324;29137;NA;365516;694;2021-03-15;92491
2021-03-14;"Prešovský kraj";52;50410;356;50766;NA;365516;408;2021-03-14;91797
2021-03-13;"Prešovský kraj";200;94768;531;95299;NA;365516;731;2021-03-13;91389
2021-03-12;"Prešovský kraj";425;47691;368;48059;NA;365516;793;2021-03-12;90658
2021-03-11;"Prešovský kraj";463;22059;253;22312;NA;365516;716;2021-03-11;89865
2021-03-10;"Prešovský kraj";325;20821;293;21114;NA;365516;618;2021-03-10;89149
2021-03-09;"Prešovský kraj";505;21496;288;21784;NA;365516;793;2021-03-09;88531
2021-03-08;"Prešovský kraj";314;28903;333;29236;NA;365516;647;2021-03-08;87738
2021-03-07;"Prešovský kraj";19;48328;388;48716;NA;365516;407;2021-03-07;87091
2021-03-06;"Prešovský kraj";193;97527;591;98118;NA;365516;784;2021-03-06;86684
2021-03-05;"Prešovský kraj";497;46054;397;46451;NA;365516;894;2021-03-05;85900
2021-03-04;"Prešovský kraj";372;22670;359;23029;NA;365516;731;2021-03-04;85006
2021-03-03;"Prešovský kraj";397;21623;333;21956;NA;365516;730;2021-03-03;84275
2021-03-02;"Prešovský kraj";421;22682;357;23039;NA;365516;778;2021-03-02;83545
2021-03-01;"Prešovský kraj";303;27716;406;28122;NA;365516;709;2021-03-01;82767
2021-02-28;"Prešovský kraj";75;45000;387;45387;NA;365516;462;2021-02-28;82058
2021-02-27;"Prešovský kraj";273;90231;734;90965;NA;365516;1007;2021-02-27;81596
2021-02-26;"Prešovský kraj";455;41340;438;41778;NA;365516;893;2021-02-26;80589
2021-02-25;"Prešovský kraj";270;19496;337;19833;NA;365516;607;2021-02-25;79696
2021-02-24;"Prešovský kraj";328;19026;377;19403;NA;365516;705;2021-02-24;79089
2021-02-23;"Prešovský kraj";430;21277;345;21622;NA;365516;775;2021-02-23;78384
2021-02-22;"Prešovský kraj";351;27180;356;27536;NA;365516;707;2021-02-22;77609
2021-02-21;"Prešovský kraj";66;31453;301;31754;NA;365516;367;2021-02-21;76902
2021-02-20;"Prešovský kraj";129;71413;517;71930;NA;365516;646;2021-02-20;76535
2021-02-19;"Prešovský kraj";381;38995;430;39425;NA;365516;811;2021-02-19;75889
2021-02-18;"Prešovský kraj";268;16960;322;17282;NA;365516;590;2021-02-18;75078
2021-02-17;"Prešovský kraj";293;17392;246;17638;NA;365516;539;2021-02-17;74488
2021-02-16;"Prešovský kraj";422;18862;265;19127;NA;365516;687;2021-02-16;73949
2021-02-15;"Prešovský kraj";211;31366;303;31669;NA;365516;514;2021-02-15;73262
2021-02-14;"Prešovský kraj";27;39387;321;39708;NA;365516;348;2021-02-14;72748
2021-02-13;"Prešovský kraj";157;74747;402;75149;NA;365516;559;2021-02-13;72400
2021-02-12;"Prešovský kraj";308;38758;365;39123;NA;365516;673;2021-02-12;71841
2021-02-11;"Prešovský kraj";218;16218;239;16457;NA;365516;457;2021-02-11;71168
2021-02-10;"Prešovský kraj";220;18542;282;18824;NA;365516;502;2021-02-10;70711
2021-02-09;"Prešovský kraj";323;21497;370;21867;NA;365516;693;2021-02-09;70209
2021-02-08;"Prešovský kraj";161;36924;261;37185;NA;365516;422;2021-02-08;69516
2021-02-07;"Prešovský kraj";21;34227;209;34436;NA;365516;230;2021-02-07;69094
2021-02-06;"Prešovský kraj";176;69164;360;69524;NA;365516;536;2021-02-06;68864
2021-02-05;"Prešovský kraj";177;31271;262;31533;NA;365516;439;2021-02-05;68328
2021-02-04;"Prešovský kraj";176;13080;237;13317;NA;365516;413;2021-02-04;67889
2021-02-03;"Prešovský kraj";251;8421;236;8657;NA;365516;487;2021-02-03;67476
2021-02-02;"Prešovský kraj";249;11769;264;12033;NA;365516;513;2021-02-02;66989
2021-02-01;"Prešovský kraj";220;16059;316;16375;NA;365516;536;2021-02-01;66476
2021-01-31;"Prešovský kraj";42;10587;107;10694;NA;365516;149;2021-01-31;65940
2021-01-30;"Prešovský kraj";142;23939;215;24154;NA;365516;357;2021-01-30;65791
2021-01-29;"Prešovský kraj";185;17924;326;18250;NA;365516;511;2021-01-29;65434
2021-01-28;"Prešovský kraj";311;7348;150;7498;NA;365516;461;2021-01-28;64923
2021-01-27;"Prešovský kraj";153;9730;147;9877;NA;365516;300;2021-01-27;64462
2021-01-26;"Prešovský kraj";252;16653;151;16804;NA;365516;403;2021-01-26;64162
2021-01-25;"Prešovský kraj";196;30092;253;30345;NA;365516;449;2021-01-25;63759
2021-01-24;"Prešovský kraj";12;45706;304;46010;NA;365516;316;2021-01-24;63310
2021-01-23;"Prešovský kraj";189;96883;487;97370;NA;365516;676;2021-01-23;62994
2021-01-22;"Prešovský kraj";187;35383;261;35644;NA;365516;448;2021-01-22;62318
2021-01-21;"Prešovský kraj";187;20434;212;20646;NA;365516;399;2021-01-21;61870
2021-01-20;"Prešovský kraj";253;14782;195;14977;NA;365516;448;2021-01-20;61471
2021-01-19;"Prešovský kraj";281;12329;305;12634;NA;365516;586;2021-01-19;61023
2021-01-18;"Prešovský kraj";203;10422;336;10758;NA;365516;539;2021-01-18;60437
2021-01-17;"Prešovský kraj";107;14391;1008;15399;NA;365516;1115;2021-01-17;59898
2021-01-16;"Prešovský kraj";72;1838;81;1919;NA;365516;153;2021-01-16;58783
2021-01-15;"Prešovský kraj";159;7033;257;7290;NA;365516;416;2021-01-15;58630
2021-01-14;"Prešovský kraj";268;5534;256;5790;NA;365516;524;2021-01-14;58214
2021-01-13;"Prešovský kraj";342;5649;226;5875;NA;365516;568;2021-01-13;57690
2021-01-12;"Prešovský kraj";455;8251;386;8637;NA;365516;841;2021-01-12;57122
2021-01-11;"Prešovský kraj";343;8149;471;8620;NA;365516;814;2021-01-11;56281
2021-01-10;"Prešovský kraj";63;476;23;499;NA;365516;86;2021-01-10;55467
2021-01-09;"Prešovský kraj";439;2248;125;2373;NA;365516;564;2021-01-09;55381
2021-01-08;"Prešovský kraj";430;10416;561;10977;NA;365516;991;2021-01-08;54817
2021-01-07;"Prešovský kraj";268;7432;622;8054;NA;365516;890;2021-01-07;53826
2021-01-06;"Prešovský kraj";315;1484;134;1618;NA;365516;449;2021-01-06;52936
2021-01-05;"Prešovský kraj";655;11275;976;12251;NA;365516;1631;2021-01-05;52487
2021-01-04;"Prešovský kraj";371;16845;1789;18634;NA;365516;2160;2021-01-04;50856
2021-01-03;"Prešovský kraj";89;459;41;500;NA;365516;130;2021-01-03;48696
2021-01-02;"Prešovský kraj";65;1556;160;1716;NA;365516;225;2021-01-02;48566
2021-01-01;"Prešovský kraj";174;956;71;1027;NA;365516;245;2021-01-01;48341
2020-12-31;"Prešovský kraj";640;11959;783;12742;NA;365516;1423;2020-12-31;48096
2020-12-30;"Prešovský kraj";729;8729;769;9498;NA;365516;1498;2020-12-30;46673
2020-12-29;"Prešovský kraj";435;9273;949;10222;NA;365516;1384;2020-12-29;45175
2020-12-28;"Prešovský kraj";393;9046;1079;10125;NA;365516;1472;2020-12-28;43791
2020-12-27;"Prešovský kraj";40;613;45;658;NA;365516;85;2020-12-27;42319
2020-12-26;"Prešovský kraj";64;176;12;188;NA;365516;76;2020-12-26;42234
2020-12-25;"Prešovský kraj";208;274;11;285;NA;365516;219;2020-12-25;42158
2020-12-24;"Prešovský kraj";452;1214;85;1299;NA;365516;537;2020-12-24;41939
2020-12-23;"Prešovský kraj";361;11006;618;11624;NA;365516;979;2020-12-23;41402
2020-12-22;"Prešovský kraj";439;9023;695;9718;NA;365516;1134;2020-12-22;40423
2020-12-21;"Prešovský kraj";432;9577;847;10424;NA;365516;1279;2020-12-21;39289
2020-12-20;"Prešovský kraj";184;396;20;416;NA;365516;204;2020-12-20;38010
2020-12-19;"Prešovský kraj";276;1658;151;1809;NA;365516;427;2020-12-19;37806
2020-12-18;"Prešovský kraj";396;8246;566;8812;NA;365516;962;2020-12-18;37379
2020-12-17;"Prešovský kraj";427;10505;866;11371;NA;365516;1293;2020-12-17;36417
2020-12-16;"Prešovský kraj";466;5613;473;6086;NA;365516;939;2020-12-16;35124
2020-12-15;"Prešovský kraj";411;5406;574;5980;NA;365516;985;2020-12-15;34185
2020-12-14;"Prešovský kraj";334;5538;477;6015;NA;365516;811;2020-12-14;33200
2020-12-13;"Prešovský kraj";89;29;8;37;NA;365516;97;2020-12-13;32389
2020-12-12;"Prešovský kraj";319;2474;166;2640;NA;365516;485;2020-12-12;32292
2020-12-11;"Prešovský kraj";560;5602;402;6004;NA;365516;962;2020-12-11;31807
2020-12-10;"Prešovský kraj";337;5019;423;5442;NA;365516;760;2020-12-10;30845
2020-12-09;"Prešovský kraj";358;4357;314;4671;NA;365516;672;2020-12-09;30085
2020-12-08;"Prešovský kraj";350;6629;651;7280;NA;365516;1001;2020-12-08;29413
2020-12-07;"Prešovský kraj";309;4345;327;4672;NA;365516;636;2020-12-07;28412
2020-12-06;"Prešovský kraj";59;655;26;681;NA;365516;85;2020-12-06;27776
2020-12-05;"Prešovský kraj";218;984;87;1071;NA;365516;305;2020-12-05;27691
2020-12-04;"Prešovský kraj";352;5070;293;5363;NA;365516;645;2020-12-04;27386
2020-12-03;"Prešovský kraj";284;2456;179;2635;NA;365516;463;2020-12-03;26741
2020-12-02;"Prešovský kraj";232;2830;225;3055;NA;365516;457;2020-12-02;26278
2020-12-01;"Prešovský kraj";281;1884;196;2080;NA;365516;477;2020-12-01;25821
2020-11-30;"Prešovský kraj";196;5333;97;5430;NA;365516;293;2020-11-30;25344
2020-11-29;"Prešovský kraj";27;379;42;421;NA;365516;69;2020-11-29;25051
2020-11-28;"Prešovský kraj";199;772;77;849;NA;365516;276;2020-11-28;24982
2020-11-27;"Prešovský kraj";232;2350;130;2480;NA;365516;362;2020-11-27;24706
2020-11-26;"Prešovský kraj";263;3014;329;3343;NA;365516;592;2020-11-26;24344
2020-11-25;"Prešovský kraj";302;2174;103;2277;NA;365516;405;2020-11-25;23752
2020-11-24;"Prešovský kraj";365;1777;156;1933;NA;365516;521;2020-11-24;23347
2020-11-23;"Prešovský kraj";164;1099;60;1159;NA;365516;224;2020-11-23;22826
2020-11-22;"Prešovský kraj";46;44;1;45;NA;365516;47;2020-11-22;22602
2020-11-21;"Prešovský kraj";205;754;62;816;NA;365516;267;2020-11-21;22555
2020-11-20;"Prešovský kraj";363;2258;102;2360;NA;365516;465;2020-11-20;22288
2020-11-19;"Prešovský kraj";359;2096;238;2334;NA;365516;597;2020-11-19;21823
2020-11-18;"Prešovský kraj";270;488;43;531;NA;365516;313;2020-11-18;21226
2020-11-17;"Prešovský kraj";347;205;23;228;NA;365516;370;2020-11-17;20913
2020-11-16;"Prešovský kraj";226;540;58;598;NA;365516;284;2020-11-16;20543
2020-11-15;"Prešovský kraj";186;39;4;43;NA;365516;190;2020-11-15;20259
2020-11-14;"Prešovský kraj";261;54;4;58;NA;365516;265;2020-11-14;20069
2020-11-13;"Prešovský kraj";395;166;8;174;NA;365516;403;2020-11-13;19804
2020-11-12;"Prešovský kraj";397;229;50;279;NA;365516;447;2020-11-12;19401
2020-11-11;"Prešovský kraj";516;161;15;176;NA;365516;531;2020-11-11;18954
2020-11-10;"Prešovský kraj";437;197;9;206;NA;365516;446;2020-11-10;18423
2020-11-09;"Prešovský kraj";190;4110;945;5055;NA;365516;1135;2020-11-09;17977
2020-11-08;"Prešovský kraj";97;2817;32;2849;NA;365516;129;2020-11-08;16842
2020-11-07;"Prešovský kraj";416;8578;81;8659;NA;365516;497;2020-11-07;16713
2020-11-06;"Prešovský kraj";520;4791;76;4867;NA;365516;596;2020-11-06;16216
2020-11-05;"Prešovský kraj";397;180;5;185;NA;365516;402;2020-11-05;15620
2020-11-04;"Prešovský kraj";350;807;8;815;NA;365516;358;2020-11-04;15218
2020-11-03;"Prešovský kraj";565;98;12;110;NA;365516;577;2020-11-03;14860
2020-11-02;"Prešovský kraj";203;4158;1004;5162;NA;365516;1207;2020-11-02;14283
2020-11-01;"Prešovský kraj";386;2906;53;2959;NA;365516;439;2020-11-01;13076
2020-10-31;"Prešovský kraj";315;10497;170;10667;NA;365516;485;2020-10-31;12637
2020-10-30;"Prešovský kraj";552;2949;65;3014;NA;365516;617;2020-10-30;12152
2020-10-29;"Prešovský kraj";594;301;38;339;NA;365516;632;2020-10-29;11535
2020-10-28;"Prešovský kraj";617;291;46;337;NA;365516;663;2020-10-28;10903
2020-10-27;"Prešovský kraj";656;268;34;302;NA;365516;690;2020-10-27;10240
2020-10-26;"Prešovský kraj";137;363;57;420;NA;365516;194;2020-10-26;9550
2020-10-25;"Prešovský kraj";237;346;11;357;NA;365516;248;2020-10-25;9356
2020-10-24;"Prešovský kraj";719;200;12;212;NA;365516;731;2020-10-24;9108
2020-10-23;"Prešovský kraj";750;218;8;226;NA;365516;758;2020-10-23;8377
2020-10-22;"Prešovský kraj";646;396;30;426;NA;365516;676;2020-10-22;7619
2020-10-21;"Prešovský kraj";383;58;8;66;NA;365516;391;2020-10-21;6943
2020-10-20;"Prešovský kraj";493;65;7;72;NA;365516;500;2020-10-20;6552
2020-10-19;"Prešovský kraj";140;235;15;250;NA;365516;155;2020-10-19;6052
2020-10-18;"Prešovský kraj";209;0;0;0;NA;365516;209;2020-10-18;5897
2020-10-17;"Prešovský kraj";342;0;0;0;NA;365516;342;2020-10-17;5688
2020-10-16;"Prešovský kraj";388;57;3;60;NA;365516;391;2020-10-16;5346
2020-10-15;"Prešovský kraj";435;85;18;103;NA;365516;453;2020-10-15;4955
2020-10-14;"Prešovský kraj";451;54;10;64;NA;365516;461;2020-10-14;4502
2020-10-13;"Prešovský kraj";264;50;6;56;NA;365516;270;2020-10-13;4041
2020-10-12;"Prešovský kraj";214;334;35;369;NA;365516;249;2020-10-12;3771
2020-10-11;"Prešovský kraj";127;0;0;0;NA;365516;127;2020-10-11;3522
2020-10-10;"Prešovský kraj";248;0;0;0;NA;365516;248;2020-10-10;3395
2020-10-09;"Prešovský kraj";406;0;0;0;NA;365516;406;2020-10-09;3147
2020-10-08;"Prešovský kraj";245;0;0;0;NA;365516;245;2020-10-08;2741
2020-10-07;"Prešovský kraj";244;0;0;0;NA;365516;244;2020-10-07;2496
2020-10-06;"Prešovský kraj";166;0;0;0;NA;365516;166;2020-10-06;2252
2020-10-05;"Prešovský kraj";84;0;0;0;NA;365516;84;2020-10-05;2086
2020-10-04;"Prešovský kraj";118;0;0;0;NA;365516;118;2020-10-04;2002
2020-10-03;"Prešovský kraj";204;0;0;0;NA;365516;204;2020-10-03;1884
2020-10-02;"Prešovský kraj";149;0;0;0;NA;365516;149;2020-10-02;1680
2020-10-01;"Prešovský kraj";136;0;0;0;NA;365516;136;2020-10-01;1531
2020-09-30;"Prešovský kraj";121;0;0;0;NA;365516;121;2020-09-30;1395
2020-09-29;"Prešovský kraj";156;0;0;0;NA;365516;156;2020-09-29;1274
2020-09-28;"Prešovský kraj";51;0;0;0;NA;365516;51;2020-09-28;1118
2020-09-27;"Prešovský kraj";10;0;0;0;NA;365516;10;2020-09-27;1067
2020-09-26;"Prešovský kraj";72;0;0;0;NA;365516;72;2020-09-26;1057
2020-09-25;"Prešovský kraj";91;0;0;0;NA;365516;91;2020-09-25;985
2020-09-24;"Prešovský kraj";52;0;0;0;NA;365516;52;2020-09-24;894
2020-09-23;"Prešovský kraj";55;0;0;0;NA;365516;55;2020-09-23;842
2020-09-22;"Prešovský kraj";29;0;0;0;NA;365516;29;2020-09-22;787
2020-09-21;"Prešovský kraj";14;0;0;0;NA;365516;14;2020-09-21;758
2020-09-20;"Prešovský kraj";5;0;0;0;NA;365516;5;2020-09-20;744
2020-09-19;"Prešovský kraj";12;0;0;0;NA;365516;12;2020-09-19;739
2020-09-18;"Prešovský kraj";29;0;0;0;NA;365516;29;2020-09-18;727
2020-09-17;"Prešovský kraj";25;0;0;0;NA;365516;25;2020-09-17;698
2020-09-16;"Prešovský kraj";8;0;0;0;NA;365516;8;2020-09-16;673
2020-09-15;"Prešovský kraj";10;0;0;0;NA;365516;10;2020-09-15;665
2020-09-14;"Prešovský kraj";47;0;0;0;NA;365516;47;2020-09-14;655
2020-09-13;"Prešovský kraj";3;0;0;0;NA;365516;3;2020-09-13;608
2020-09-12;"Prešovský kraj";4;0;0;0;NA;365516;4;2020-09-12;605
2020-09-11;"Prešovský kraj";15;0;0;0;NA;365516;15;2020-09-11;601
2020-09-10;"Prešovský kraj";10;0;0;0;NA;365516;10;2020-09-10;586
2020-09-09;"Prešovský kraj";21;0;0;0;NA;365516;21;2020-09-09;576
2020-09-08;"Prešovský kraj";23;0;0;0;NA;365516;23;2020-09-08;555
2020-09-07;"Prešovský kraj";5;0;0;0;NA;365516;5;2020-09-07;532
2020-09-06;"Prešovský kraj";3;0;0;0;NA;365516;3;2020-09-06;527
2020-09-05;"Prešovský kraj";7;0;0;0;NA;365516;7;2020-09-05;524
2020-09-04;"Prešovský kraj";24;0;0;0;NA;365516;24;2020-09-04;517
2020-09-03;"Prešovský kraj";8;0;0;0;NA;365516;8;2020-09-03;493
2020-09-02;"Prešovský kraj";9;0;0;0;NA;365516;9;2020-09-02;485
2020-09-01;"Prešovský kraj";6;0;0;0;NA;365516;6;2020-09-01;476
2020-08-31;"Prešovský kraj";3;0;0;0;NA;365516;3;2020-08-31;470
2020-08-30;"Prešovský kraj";6;0;0;0;NA;365516;6;2020-08-30;467
2020-08-29;"Prešovský kraj";4;0;0;0;NA;365516;4;2020-08-29;461
2020-08-28;"Prešovský kraj";6;0;0;0;NA;365516;6;2020-08-28;457
2020-08-27;"Prešovský kraj";7;0;0;0;NA;365516;7;2020-08-27;451
2020-08-26;"Prešovský kraj";22;0;0;0;NA;365516;22;2020-08-26;444
2020-08-25;"Prešovský kraj";1;0;0;0;NA;365516;1;2020-08-25;422
2020-08-24;"Prešovský kraj";5;0;0;0;NA;365516;5;2020-08-24;421
2020-08-23;"Prešovský kraj";3;0;0;0;NA;365516;3;2020-08-23;416
2020-08-22;"Prešovský kraj";3;0;0;0;NA;365516;3;2020-08-22;413
2020-08-21;"Prešovský kraj";11;0;0;0;NA;365516;11;2020-08-21;410
2020-08-20;"Prešovský kraj";8;0;0;0;NA;365516;8;2020-08-20;399
2020-08-19;"Prešovský kraj";8;0;0;0;NA;365516;8;2020-08-19;391
2020-08-18;"Prešovský kraj";6;0;0;0;NA;365516;6;2020-08-18;383
2020-08-17;"Prešovský kraj";1;0;0;0;NA;365516;1;2020-08-17;377
2020-08-16;"Prešovský kraj";0;0;0;0;NA;365516;0;2020-08-16;376
2020-08-15;"Prešovský kraj";8;0;0;0;NA;365516;8;2020-08-15;376
2020-08-14;"Prešovský kraj";6;0;0;0;NA;365516;6;2020-08-14;368
2020-08-13;"Prešovský kraj";8;0;0;0;NA;365516;8;2020-08-13;362
2020-08-12;"Prešovský kraj";19;0;0;0;NA;365516;19;2020-08-12;354
2020-08-11;"Prešovský kraj";3;0;0;0;NA;365516;3;2020-08-11;335
2020-08-10;"Prešovský kraj";0;0;0;0;NA;365516;0;2020-08-10;332
2020-08-09;"Prešovský kraj";0;0;0;0;NA;365516;0;2020-08-09;332
2020-08-08;"Prešovský kraj";2;0;0;0;NA;365516;2;2020-08-08;332
2020-08-07;"Prešovský kraj";6;0;0;0;NA;365516;6;2020-08-07;330
2020-08-06;"Prešovský kraj";2;0;0;0;NA;365516;2;2020-08-06;324
2020-08-05;"Prešovský kraj";8;0;0;0;NA;365516;8;2020-08-05;322
2020-08-04;"Prešovský kraj";5;0;0;0;NA;365516;5;2020-08-04;314
2020-08-03;"Prešovský kraj";4;0;0;0;NA;365516;4;2020-08-03;309
2020-08-02;"Prešovský kraj";6;0;0;0;NA;365516;6;2020-08-02;305
2020-08-01;"Prešovský kraj";0;0;0;0;NA;365516;0;2020-08-01;299
2020-07-31;"Prešovský kraj";2;0;0;0;NA;365516;2;2020-07-31;299
2020-07-30;"Prešovský kraj";6;0;0;0;NA;365516;6;2020-07-30;297
2020-07-29;"Prešovský kraj";5;0;0;0;NA;365516;5;2020-07-29;291
2020-07-28;"Prešovský kraj";0;0;0;0;NA;365516;0;2020-07-28;286
2020-07-27;"Prešovský kraj";1;0;0;0;NA;365516;1;2020-07-27;286
2020-07-26;"Prešovský kraj";1;0;0;0;NA;365516;1;2020-07-26;285
2020-07-25;"Prešovský kraj";21;0;0;0;NA;365516;21;2020-07-25;284
2020-07-24;"Prešovský kraj";1;0;0;0;NA;365516;1;2020-07-24;263
2020-07-23;"Prešovský kraj";5;0;0;0;NA;365516;5;2020-07-23;262
2020-07-22;"Prešovský kraj";1;0;0;0;NA;365516;1;2020-07-22;257
2020-07-21;"Prešovský kraj";2;0;0;0;NA;365516;2;2020-07-21;256
2020-07-20;"Prešovský kraj";1;0;0;0;NA;365516;1;2020-07-20;254
2020-07-19;"Prešovský kraj";0;0;0;0;NA;365516;0;2020-07-19;253
2020-07-18;"Prešovský kraj";0;0;0;0;NA;365516;0;2020-07-18;253
2020-07-17;"Prešovský kraj";3;0;0;0;NA;365516;3;2020-07-17;253
2020-07-16;"Prešovský kraj";1;0;0;0;NA;365516;1;2020-07-16;250
2020-07-15;"Prešovský kraj";5;0;0;0;NA;365516;5;2020-07-15;249
2020-07-14;"Prešovský kraj";5;0;0;0;NA;365516;5;2020-07-14;244
2020-07-13;"Prešovský kraj";1;0;0;0;NA;365516;1;2020-07-13;239
2020-07-12;"Prešovský kraj";1;0;0;0;NA;365516;1;2020-07-12;238
2020-07-11;"Prešovský kraj";6;0;0;0;NA;365516;6;2020-07-11;237
2020-07-10;"Prešovský kraj";5;0;0;0;NA;365516;5;2020-07-10;231
2020-07-09;"Prešovský kraj";2;0;0;0;NA;365516;2;2020-07-09;226
2020-07-08;"Prešovský kraj";14;0;0;0;NA;365516;14;2020-07-08;224
2020-07-07;"Prešovský kraj";2;0;0;0;NA;365516;2;2020-07-07;210
2020-07-06;"Prešovský kraj";0;0;0;0;NA;365516;0;2020-07-06;208
2020-07-05;"Prešovský kraj";0;0;0;0;NA;365516;0;2020-07-05;208
2020-07-04;"Prešovský kraj";1;0;0;0;NA;365516;1;2020-07-04;208
2020-07-03;"Prešovský kraj";3;0;0;0;NA;365516;3;2020-07-03;207
2020-07-02;"Prešovský kraj";0;0;0;0;NA;365516;0;2020-07-02;204
2020-07-01;"Prešovský kraj";0;0;0;0;NA;365516;0;2020-07-01;204
2020-06-30;"Prešovský kraj";7;0;0;0;NA;365516;7;2020-06-30;204
2020-06-29;"Prešovský kraj";0;0;0;0;NA;365516;0;2020-06-29;197
2020-06-28;"Prešovský kraj";0;0;0;0;NA;365516;0;2020-06-28;197
2020-06-27;"Prešovský kraj";3;0;0;0;NA;365516;3;2020-06-27;197
2020-06-26;"Prešovský kraj";3;0;0;0;NA;365516;3;2020-06-26;194
2020-06-25;"Prešovský kraj";0;0;0;0;NA;365516;0;2020-06-25;191
2020-06-24;"Prešovský kraj";4;0;0;0;NA;365516;4;2020-06-24;191
2020-06-23;"Prešovský kraj";0;0;0;0;NA;365516;0;2020-06-23;187
2020-06-22;"Prešovský kraj";0;0;0;0;NA;365516;0;2020-06-22;187
2020-06-21;"Prešovský kraj";0;0;0;0;NA;365516;0;2020-06-21;187
2020-06-20;"Prešovský kraj";0;0;0;0;NA;365516;0;2020-06-20;187
2020-06-19;"Prešovský kraj";1;0;0;0;NA;365516;1;2020-06-19;187
2020-06-18;"Prešovský kraj";0;0;0;0;NA;365516;0;2020-06-18;186
2020-06-17;"Prešovský kraj";0;0;0;0;NA;365516;0;2020-06-17;186
2020-06-16;"Prešovský kraj";6;0;0;0;NA;365516;6;2020-06-16;186
2020-06-14;"Prešovský kraj";0;0;0;0;NA;365516;0;2020-06-14;180
2020-06-13;"Prešovský kraj";0;0;0;0;NA;365516;0;2020-06-13;180
2020-06-12;"Prešovský kraj";1;0;0;0;NA;365516;1;2020-06-12;180
2020-06-11;"Prešovský kraj";0;0;0;0;NA;365516;0;2020-06-11;179
2020-06-10;"Prešovský kraj";0;0;0;0;NA;365516;0;2020-06-10;179
2020-06-09;"Prešovský kraj";0;0;0;0;NA;365516;0;2020-06-09;179
2020-06-08;"Prešovský kraj";0;0;0;0;NA;365516;0;2020-06-08;179
2020-06-07;"Prešovský kraj";0;0;0;0;NA;365516;0;2020-06-07;179
2020-06-05;"Prešovský kraj";0;0;0;0;NA;365516;0;2020-06-05;179
2020-06-03;"Prešovský kraj";0;0;0;0;NA;365516;0;2020-06-03;179
2020-06-02;"Prešovský kraj";1;0;0;0;NA;365516;1;2020-06-02;179
2020-05-31;"Prešovský kraj";1;0;0;0;NA;365516;1;2020-05-31;178
2020-05-29;"Prešovský kraj";0;0;0;0;NA;365516;0;2020-05-29;177
2020-05-27;"Prešovský kraj";0;0;0;0;NA;365516;0;2020-05-27;177
2020-05-26;"Prešovský kraj";0;0;0;0;NA;365516;0;2020-05-26;177
2020-05-25;"Prešovský kraj";0;0;0;0;NA;365516;0;2020-05-25;177
2020-05-24;"Prešovský kraj";0;0;0;0;NA;365516;0;2020-05-24;177
2020-05-23;"Prešovský kraj";0;0;0;0;NA;365516;0;2020-05-23;177
2020-05-22;"Prešovský kraj";0;0;0;0;NA;365516;0;2020-05-22;177
2020-05-21;"Prešovský kraj";1;0;0;0;NA;365516;1;2020-05-21;177
2020-05-20;"Prešovský kraj";0;0;0;0;NA;365516;0;2020-05-20;176
2020-05-19;"Prešovský kraj";0;0;0;0;NA;365516;0;2020-05-19;176
2020-05-17;"Prešovský kraj";0;0;0;0;NA;365516;0;2020-05-17;176
2020-05-16;"Prešovský kraj";0;0;0;0;NA;365516;0;2020-05-16;176
2020-05-15;"Prešovský kraj";0;0;0;0;NA;365516;0;2020-05-15;176
2020-05-14;"Prešovský kraj";0;0;0;0;NA;365516;0;2020-05-14;176
2020-05-13;"Prešovský kraj";1;0;0;0;NA;365516;1;2020-05-13;176
2020-05-12;"Prešovský kraj";0;0;0;0;NA;365516;0;2020-05-12;175
2020-05-11;"Prešovský kraj";1;0;0;0;NA;365516;1;2020-05-11;175
2020-05-09;"Prešovský kraj";0;0;0;0;NA;365516;0;2020-05-09;174
2020-05-07;"Prešovský kraj";0;0;0;0;NA;365516;0;2020-05-07;174
2020-05-06;"Prešovský kraj";0;0;0;0;NA;365516;0;2020-05-06;174
2020-05-05;"Prešovský kraj";1;0;0;0;NA;365516;1;2020-05-05;174
2020-05-04;"Prešovský kraj";0;0;0;0;NA;365516;0;2020-05-04;173
2020-05-03;"Prešovský kraj";0;0;0;0;NA;365516;0;2020-05-03;173
2020-05-02;"Prešovský kraj";0;0;0;0;NA;365516;0;2020-05-02;173
2020-05-01;"Prešovský kraj";2;0;0;0;NA;365516;2;2020-05-01;173
2020-04-30;"Prešovský kraj";0;0;0;0;NA;365516;0;2020-04-30;171
2020-04-29;"Prešovský kraj";1;0;0;0;NA;365516;1;2020-04-29;171
2020-04-28;"Prešovský kraj";1;0;0;0;NA;365516;1;2020-04-28;170
2020-04-27;"Prešovský kraj";2;0;0;0;NA;365516;2;2020-04-27;169
2020-04-26;"Prešovský kraj";0;0;0;0;NA;365516;0;2020-04-26;167
2020-04-25;"Prešovský kraj";0;0;0;0;NA;365516;0;2020-04-25;167
2020-04-24;"Prešovský kraj";0;0;0;0;NA;365516;0;2020-04-24;167
2020-04-23;"Prešovský kraj";2;0;0;0;NA;365516;2;2020-04-23;167
2020-04-22;"Prešovský kraj";11;0;0;0;NA;365516;11;2020-04-22;165
2020-04-21;"Prešovský kraj";12;0;0;0;NA;365516;12;2020-04-21;154
2020-04-20;"Prešovský kraj";2;0;0;0;NA;365516;2;2020-04-20;142
2020-04-19;"Prešovský kraj";4;0;0;0;NA;365516;4;2020-04-19;140
2020-04-18;"Prešovský kraj";1;0;0;0;NA;365516;1;2020-04-18;136
2020-04-17;"Prešovský kraj";4;0;0;0;NA;365516;4;2020-04-17;135
2020-04-16;"Prešovský kraj";9;0;0;0;NA;365516;9;2020-04-16;131
2020-04-15;"Prešovský kraj";21;0;0;0;NA;365516;21;2020-04-15;122
2020-04-14;"Prešovský kraj";1;0;0;0;NA;365516;1;2020-04-14;101
2020-04-13;"Prešovský kraj";2;0;0;0;NA;365516;2;2020-04-13;100
2020-04-12;"Prešovský kraj";6;0;0;0;NA;365516;6;2020-04-12;98
2020-04-11;"Prešovský kraj";4;0;0;0;NA;365516;4;2020-04-11;92
2020-04-10;"Prešovský kraj";0;0;0;0;NA;365516;0;2020-04-10;88
2020-04-09;"Prešovský kraj";1;0;0;0;NA;365516;1;2020-04-09;88
2020-04-08;"Prešovský kraj";0;0;0;0;NA;365516;0;2020-04-08;87
2020-04-07;"Prešovský kraj";7;0;0;0;NA;365516;7;2020-04-07;87
2020-04-06;"Prešovský kraj";10;0;0;0;NA;365516;10;2020-04-06;80
2020-04-05;"Prešovský kraj";13;0;0;0;NA;365516;13;2020-04-05;70
2020-04-04;"Prešovský kraj";1;0;0;0;NA;365516;1;2020-04-04;57
2020-04-03;"Prešovský kraj";4;0;0;0;NA;365516;4;2020-04-03;56
2020-04-02;"Prešovský kraj";6;0;0;0;NA;365516;6;2020-04-02;52
2020-04-01;"Prešovský kraj";6;0;0;0;NA;365516;6;2020-04-01;46
2020-03-31;"Prešovský kraj";6;0;0;0;NA;365516;6;2020-03-31;40
2020-03-30;"Prešovský kraj";2;0;0;0;NA;365516;2;2020-03-30;34
2020-03-29;"Prešovský kraj";2;0;0;0;NA;365516;2;2020-03-29;32
2020-03-28;"Prešovský kraj";2;0;0;0;NA;365516;2;2020-03-28;30
2020-03-27;"Prešovský kraj";1;0;0;0;NA;365516;1;2020-03-27;28
2020-03-26;"Prešovský kraj";8;0;0;0;NA;365516;8;2020-03-26;27
2020-03-25;"Prešovský kraj";1;0;0;0;NA;365516;1;2020-03-25;19
2020-03-24;"Prešovský kraj";4;0;0;0;NA;365516;4;2020-03-24;18
2020-03-23;"Prešovský kraj";0;0;0;0;NA;365516;0;2020-03-23;14
2020-03-22;"Prešovský kraj";1;0;0;0;NA;365516;1;2020-03-22;14
2020-03-21;"Prešovský kraj";2;0;0;0;NA;365516;2;2020-03-21;13
2020-03-20;"Prešovský kraj";3;0;0;0;NA;365516;3;2020-03-20;11
2020-03-19;"Prešovský kraj";2;0;0;0;NA;365516;2;2020-03-19;8
2020-03-18;"Prešovský kraj";1;0;0;0;NA;365516;1;2020-03-18;6
2020-03-17;"Prešovský kraj";1;0;0;0;NA;365516;1;2020-03-17;5
2020-03-16;"Prešovský kraj";4;0;0;0;NA;365516;4;2020-03-16;4
2020-03-15;"Prešovský kraj";0;0;0;0;NA;365516;0;2020-03-15;0
2020-03-14;"Prešovský kraj";1;0;0;0;NA;365516;1;2020-03-14;0
2020-03-13;"Prešovský kraj";0;0;0;0;NA;365516;0;2020-03-13;-1
2020-03-12;"Prešovský kraj";0;0;0;0;NA;365516;0;2020-03-12;-1
2020-03-11;"Prešovský kraj";0;0;0;0;NA;365516;0;2020-03-11;-1
2020-03-09;"Prešovský kraj";0;0;0;0;NA;365516;0;2020-03-09;-1
2020-03-08;"Prešovský kraj";0;0;0;0;NA;365516;0;2020-03-08;-1
2020-03-07;"Prešovský kraj";0;0;0;0;NA;365516;0;2020-03-07;-1
2020-03-06;"Prešovský kraj";0;0;0;0;NA;365516;0;2020-03-06;-1
2022-05-24;"Trenčiansky kraj";21;0;0;0;212585;302769;21;2022-05-24;302769
2022-05-23;"Trenčiansky kraj";15;0;0;0;NA;302769;15;2022-05-23;302748
2022-05-22;"Trenčiansky kraj";1;14;1;15;NA;302769;2;2022-05-22;302733
2022-05-21;"Trenčiansky kraj";10;26;3;29;NA;302769;13;2022-05-21;302731
2022-05-20;"Trenčiansky kraj";26;119;8;127;NA;302769;34;2022-05-20;302718
2022-05-19;"Trenčiansky kraj";46;156;9;165;NA;302769;55;2022-05-19;302684
2022-05-18;"Trenčiansky kraj";24;154;9;163;NA;302769;33;2022-05-18;302629
2022-05-17;"Trenčiansky kraj";31;152;8;160;NA;302769;39;2022-05-17;302596
2022-05-16;"Trenčiansky kraj";19;235;20;255;NA;302769;39;2022-05-16;302557
2022-05-15;"Trenčiansky kraj";1;64;0;64;NA;302769;1;2022-05-15;302518
2022-05-14;"Trenčiansky kraj";31;63;4;67;NA;302769;35;2022-05-14;302517
2022-05-13;"Trenčiansky kraj";24;174;12;186;NA;302769;36;2022-05-13;302482
2022-05-12;"Trenčiansky kraj";29;189;13;202;NA;302769;42;2022-05-12;302446
2022-05-11;"Trenčiansky kraj";30;166;14;180;NA;302769;44;2022-05-11;302404
2022-05-10;"Trenčiansky kraj";46;171;19;190;NA;302769;65;2022-05-10;302360
2022-05-09;"Trenčiansky kraj";39;289;21;310;NA;302769;60;2022-05-09;302295
2022-05-08;"Trenčiansky kraj";3;82;7;89;NA;302769;10;2022-05-08;302235
2022-05-07;"Trenčiansky kraj";22;72;5;77;NA;302769;27;2022-05-07;302225
2022-05-06;"Trenčiansky kraj";52;297;17;314;NA;302769;69;2022-05-06;302198
2022-05-05;"Trenčiansky kraj";53;149;8;157;NA;302769;61;2022-05-05;302129
2022-05-04;"Trenčiansky kraj";43;247;12;259;NA;302769;55;2022-05-04;302068
2022-05-03;"Trenčiansky kraj";79;207;15;222;NA;302769;94;2022-05-03;302013
2022-05-02;"Trenčiansky kraj";57;585;19;604;NA;302769;76;2022-05-02;301919
2022-05-01;"Trenčiansky kraj";14;162;5;167;NA;302769;19;2022-05-01;301843
2022-04-30;"Trenčiansky kraj";75;173;4;177;NA;302769;79;2022-04-30;301824
2022-04-29;"Trenčiansky kraj";106;273;16;289;NA;302769;122;2022-04-29;301745
2022-04-28;"Trenčiansky kraj";87;502;12;514;NA;302769;99;2022-04-28;301623
2022-04-27;"Trenčiansky kraj";115;408;34;442;NA;302769;149;2022-04-27;301524
2022-04-26;"Trenčiansky kraj";151;375;10;385;NA;302769;161;2022-04-26;301375
2022-04-25;"Trenčiansky kraj";106;611;29;640;NA;302769;135;2022-04-25;301214
2022-04-24;"Trenčiansky kraj";32;215;13;228;NA;302769;45;2022-04-24;301079
2022-04-23;"Trenčiansky kraj";104;210;11;221;NA;302769;115;2022-04-23;301034
2022-04-22;"Trenčiansky kraj";122;456;32;488;NA;302769;154;2022-04-22;300919
2022-04-21;"Trenčiansky kraj";191;516;18;534;NA;302769;209;2022-04-21;300765
2022-04-20;"Trenčiansky kraj";269;460;23;483;NA;302769;292;2022-04-20;300556
2022-04-19;"Trenčiansky kraj";180;802;39;841;NA;302769;219;2022-04-19;300264
2022-04-18;"Trenčiansky kraj";107;242;15;257;NA;302769;122;2022-04-18;300045
2022-04-17;"Trenčiansky kraj";154;314;14;328;NA;302769;168;2022-04-17;299923
2022-04-16;"Trenčiansky kraj";51;297;10;307;NA;302769;61;2022-04-16;299755
2022-04-15;"Trenčiansky kraj";71;313;12;325;NA;302769;83;2022-04-15;299694
2022-04-14;"Trenčiansky kraj";235;702;36;738;NA;302769;271;2022-04-14;299611
2022-04-13;"Trenčiansky kraj";288;512;39;551;NA;302769;327;2022-04-13;299340
2022-04-12;"Trenčiansky kraj";293;744;52;796;NA;302769;345;2022-04-12;299013
2022-04-11;"Trenčiansky kraj";349;634;61;695;NA;302769;410;2022-04-11;298668
2022-04-10;"Trenčiansky kraj";110;440;28;468;NA;302769;138;2022-04-10;298258
2022-04-09;"Trenčiansky kraj";234;269;24;293;NA;302769;258;2022-04-09;298120
2022-04-08;"Trenčiansky kraj";301;475;27;502;NA;302769;328;2022-04-08;297862
2022-04-07;"Trenčiansky kraj";381;592;68;660;NA;302769;449;2022-04-07;297534
2022-04-06;"Trenčiansky kraj";416;680;78;758;NA;302769;494;2022-04-06;297085
2022-04-05;"Trenčiansky kraj";499;614;65;679;NA;302769;564;2022-04-05;296591
2022-04-04;"Trenčiansky kraj";468;948;95;1043;NA;302769;563;2022-04-04;296027
2022-04-03;"Trenčiansky kraj";127;373;46;419;NA;302769;173;2022-04-03;295464
2022-04-02;"Trenčiansky kraj";368;404;59;463;NA;302769;427;2022-04-02;295291
2022-04-01;"Trenčiansky kraj";510;630;65;695;NA;302769;575;2022-04-01;294864
2022-03-31;"Trenčiansky kraj";520;1013;97;1110;NA;302769;617;2022-03-31;294289
2022-03-30;"Trenčiansky kraj";706;1494;87;1581;NA;302769;793;2022-03-30;293672
2022-03-29;"Trenčiansky kraj";682;1077;97;1174;NA;302769;779;2022-03-29;292879
2022-03-28;"Trenčiansky kraj";673;1727;140;1867;NA;302769;813;2022-03-28;292100
2022-03-27;"Trenčiansky kraj";167;596;86;682;NA;302769;253;2022-03-27;291287
2022-03-26;"Trenčiansky kraj";513;395;43;438;NA;302769;556;2022-03-26;291034
2022-03-25;"Trenčiansky kraj";534;937;93;1030;NA;302769;627;2022-03-25;290478
2022-03-24;"Trenčiansky kraj";712;1266;106;1372;NA;302769;818;2022-03-24;289851
2022-03-23;"Trenčiansky kraj";903;1047;97;1144;NA;302769;1000;2022-03-23;289033
2022-03-22;"Trenčiansky kraj";918;1078;116;1194;NA;302769;1034;2022-03-22;288033
2022-03-21;"Trenčiansky kraj";745;1753;219;1972;NA;302769;964;2022-03-21;286999
2022-03-20;"Trenčiansky kraj";334;826;89;915;NA;302769;423;2022-03-20;286035
2022-03-19;"Trenčiansky kraj";560;510;77;587;NA;302769;637;2022-03-19;285612
2022-03-18;"Trenčiansky kraj";884;972;135;1107;NA;302769;1019;2022-03-18;284975
2022-03-17;"Trenčiansky kraj";863;1156;137;1293;NA;302769;1000;2022-03-17;283956
2022-03-16;"Trenčiansky kraj";1147;1303;129;1432;NA;302769;1276;2022-03-16;282956
2022-03-15;"Trenčiansky kraj";1054;1325;124;1449;NA;302769;1178;2022-03-15;281680
2022-03-14;"Trenčiansky kraj";934;2642;273;2915;NA;302769;1207;2022-03-14;280502
2022-03-13;"Trenčiansky kraj";373;698;97;795;NA;302769;470;2022-03-13;279295
2022-03-12;"Trenčiansky kraj";674;550;94;644;NA;302769;768;2022-03-12;278825
2022-03-11;"Trenčiansky kraj";1131;1379;222;1601;NA;302769;1353;2022-03-11;278057
2022-03-10;"Trenčiansky kraj";1087;1363;226;1589;NA;302769;1313;2022-03-10;276704
2022-03-09;"Trenčiansky kraj";1515;1517;240;1757;NA;302769;1755;2022-03-09;275391
2022-03-08;"Trenčiansky kraj";1059;1755;253;2008;NA;302769;1312;2022-03-08;273636
2022-03-07;"Trenčiansky kraj";1079;2457;360;2817;NA;302769;1439;2022-03-07;272324
2022-03-06;"Trenčiansky kraj";354;832;134;966;NA;302769;488;2022-03-06;270885
2022-03-05;"Trenčiansky kraj";583;700;138;838;NA;302769;721;2022-03-05;270397
2022-03-04;"Trenčiansky kraj";1125;1337;210;1547;NA;302769;1335;2022-03-04;269676
2022-03-03;"Trenčiansky kraj";1346;1710;223;1933;NA;302769;1569;2022-03-03;268341
2022-03-02;"Trenčiansky kraj";1345;1739;245;1984;NA;302769;1590;2022-03-02;266772
2022-03-01;"Trenčiansky kraj";1409;1805;309;2114;NA;302769;1718;2022-03-01;265182
2022-02-28;"Trenčiansky kraj";1390;2932;468;3400;NA;302769;1858;2022-02-28;263464
2022-02-27;"Trenčiansky kraj";573;1043;218;1261;NA;302769;791;2022-02-27;261606
2022-02-26;"Trenčiansky kraj";934;784;147;931;NA;302769;1081;2022-02-26;260815
2022-02-25;"Trenčiansky kraj";1460;1788;341;2129;NA;302769;1801;2022-02-25;259734
2022-02-24;"Trenčiansky kraj";1372;2468;309;2777;NA;302769;1681;2022-02-24;257933
2022-02-23;"Trenčiansky kraj";1677;2084;322;2406;NA;302769;1999;2022-02-23;256252
2022-02-22;"Trenčiansky kraj";2073;2270;451;2721;NA;302769;2524;2022-02-22;254253
2022-02-21;"Trenčiansky kraj";2172;4194;645;4839;NA;302769;2817;2022-02-21;251729
2022-02-20;"Trenčiansky kraj";1079;1436;322;1758;NA;302769;1401;2022-02-20;248912
2022-02-19;"Trenčiansky kraj";1168;1008;244;1252;NA;302769;1412;2022-02-19;247511
2022-02-18;"Trenčiansky kraj";2456;2369;477;2846;NA;302769;2933;2022-02-18;246099
2022-02-17;"Trenčiansky kraj";2090;2733;427;3160;NA;302769;2517;2022-02-17;243166
2022-02-16;"Trenčiansky kraj";2928;2478;512;2990;NA;302769;3440;2022-02-16;240649
2022-02-15;"Trenčiansky kraj";2372;2603;572;3175;NA;302769;2944;2022-02-15;237209
2022-02-14;"Trenčiansky kraj";2401;4489;728;5217;NA;302769;3129;2022-02-14;234265
2022-02-13;"Trenčiansky kraj";1357;1777;454;2231;NA;302769;1811;2022-02-13;231136
2022-02-12;"Trenčiansky kraj";1802;1448;277;1725;NA;302769;2079;2022-02-12;229325
2022-02-11;"Trenčiansky kraj";2863;2567;495;3062;NA;302769;3358;2022-02-11;227246
2022-02-10;"Trenčiansky kraj";2853;2717;504;3221;NA;302769;3357;2022-02-10;223888
2022-02-09;"Trenčiansky kraj";2788;4356;600;4956;NA;302769;3388;2022-02-09;220531
2022-02-08;"Trenčiansky kraj";2592;3182;660;3842;NA;302769;3252;2022-02-08;217143
2022-02-07;"Trenčiansky kraj";2787;5303;981;6284;NA;302769;3768;2022-02-07;213891
2022-02-06;"Trenčiansky kraj";1431;2181;472;2653;NA;302769;1903;2022-02-06;210123
2022-02-05;"Trenčiansky kraj";1458;1689;323;2012;NA;302769;1781;2022-02-05;208220
2022-02-04;"Trenčiansky kraj";2480;3226;524;3750;NA;302769;3004;2022-02-04;206439
2022-02-03;"Trenčiansky kraj";2391;3566;500;4066;NA;302769;2891;2022-02-03;203435
2022-02-02;"Trenčiansky kraj";2486;4591;602;5193;NA;302769;3088;2022-02-02;200544
2022-02-01;"Trenčiansky kraj";2359;3754;552;4306;NA;302769;2911;2022-02-01;197456
2022-01-31;"Trenčiansky kraj";1823;7493;752;8245;NA;302769;2575;2022-01-31;194545
2022-01-30;"Trenčiansky kraj";680;2463;319;2782;NA;302769;999;2022-01-30;191970
2022-01-29;"Trenčiansky kraj";1227;1772;227;1999;NA;302769;1454;2022-01-29;190971
2022-01-28;"Trenčiansky kraj";1709;3747;366;4113;NA;302769;2075;2022-01-28;189517
2022-01-27;"Trenčiansky kraj";1533;3562;368;3930;NA;302769;1901;2022-01-27;187442
2022-01-26;"Trenčiansky kraj";1415;4674;356;5030;NA;302769;1771;2022-01-26;185541
2022-01-25;"Trenčiansky kraj";1553;3307;299;3606;NA;302769;1852;2022-01-25;183770
2022-01-24;"Trenčiansky kraj";755;7090;328;7418;NA;302769;1083;2022-01-24;181918
2022-01-23;"Trenčiansky kraj";337;2409;179;2588;NA;302769;516;2022-01-23;180835
2022-01-22;"Trenčiansky kraj";683;1675;103;1778;NA;302769;786;2022-01-22;180319
2022-01-21;"Trenčiansky kraj";576;3522;174;3696;NA;302769;750;2022-01-21;179533
2022-01-20;"Trenčiansky kraj";710;2713;137;2850;NA;302769;847;2022-01-20;178783
2022-01-19;"Trenčiansky kraj";621;3765;142;3907;NA;302769;763;2022-01-19;177936
2022-01-18;"Trenčiansky kraj";579;3596;135;3731;NA;302769;714;2022-01-18;177173
2022-01-17;"Trenčiansky kraj";380;6550;210;6760;NA;302769;590;2022-01-17;176459
2022-01-16;"Trenčiansky kraj";89;2319;72;2391;NA;302769;161;2022-01-16;175869
2022-01-15;"Trenčiansky kraj";194;1345;40;1385;NA;302769;234;2022-01-15;175708
2022-01-14;"Trenčiansky kraj";189;2890;79;2969;NA;302769;268;2022-01-14;175474
2022-01-13;"Trenčiansky kraj";134;3329;87;3416;NA;302769;221;2022-01-13;175206
2022-01-12;"Trenčiansky kraj";346;3073;82;3155;NA;302769;428;2022-01-12;174985
2022-01-11;"Trenčiansky kraj";300;3028;80;3108;NA;302769;380;2022-01-11;174557
2022-01-10;"Trenčiansky kraj";218;7272;150;7422;NA;302769;368;2022-01-10;174177
2022-01-09;"Trenčiansky kraj";40;2808;52;2860;NA;302769;92;2022-01-09;173809
2022-01-08;"Trenčiansky kraj";267;1601;45;1646;NA;302769;312;2022-01-08;173717
2022-01-07;"Trenčiansky kraj";334;2968;103;3071;NA;302769;437;2022-01-07;173405
2022-01-06;"Trenčiansky kraj";75;1111;45;1156;NA;302769;120;2022-01-06;172968
2022-01-05;"Trenčiansky kraj";496;3004;84;3088;NA;302769;580;2022-01-05;172848
2022-01-04;"Trenčiansky kraj";521;3890;91;3981;NA;302769;612;2022-01-04;172268
2022-01-03;"Trenčiansky kraj";357;5970;144;6114;NA;302769;501;2022-01-03;171656
2022-01-02;"Trenčiansky kraj";179;2403;74;2477;NA;302769;253;2022-01-02;171155
2022-01-01;"Trenčiansky kraj";4;526;28;554;NA;302769;32;2022-01-01;170902
2021-12-31;"Trenčiansky kraj";443;1478;82;1560;NA;302769;525;2021-12-31;170870
2021-12-30;"Trenčiansky kraj";370;2400;129;2529;NA;302769;499;2021-12-30;170345
2021-12-29;"Trenčiansky kraj";429;2483;87;2570;NA;302769;516;2021-12-29;169846
2021-12-28;"Trenčiansky kraj";609;2741;111;2852;NA;302769;720;2021-12-28;169330
2021-12-27;"Trenčiansky kraj";546;3348;115;3463;NA;302769;661;2021-12-27;168610
2021-12-26;"Trenčiansky kraj";147;1098;78;1176;NA;302769;225;2021-12-26;167949
2021-12-25;"Trenčiansky kraj";52;503;27;530;NA;302769;79;2021-12-25;167724
2021-12-24;"Trenčiansky kraj";176;652;37;689;NA;302769;213;2021-12-24;167645
2021-12-23;"Trenčiansky kraj";532;2431;108;2539;NA;302769;640;2021-12-23;167432
2021-12-22;"Trenčiansky kraj";512;2595;119;2714;NA;302769;631;2021-12-22;166792
2021-12-21;"Trenčiansky kraj";694;3266;123;3389;NA;302769;817;2021-12-21;166161
2021-12-20;"Trenčiansky kraj";488;6754;210;6964;NA;302769;698;2021-12-20;165344
2021-12-19;"Trenčiansky kraj";202;2574;118;2692;NA;302769;320;2021-12-19;164646
2021-12-18;"Trenčiansky kraj";438;1752;108;1860;NA;302769;546;2021-12-18;164326
2021-12-17;"Trenčiansky kraj";427;4054;137;4191;NA;302769;564;2021-12-17;163780
2021-12-16;"Trenčiansky kraj";649;3214;180;3394;NA;302769;829;2021-12-16;163216
2021-12-15;"Trenčiansky kraj";791;4645;167;4812;NA;302769;958;2021-12-15;162387
2021-12-14;"Trenčiansky kraj";885;3640;142;3782;NA;302769;1027;2021-12-14;161429
2021-12-13;"Trenčiansky kraj";573;7458;256;7714;NA;302769;829;2021-12-13;160402
2021-12-12;"Trenčiansky kraj";306;3156;156;3312;NA;302769;462;2021-12-12;159573
2021-12-11;"Trenčiansky kraj";706;1876;138;2014;NA;302769;844;2021-12-11;159111
2021-12-10;"Trenčiansky kraj";789;3694;201;3895;NA;302769;990;2021-12-10;158267
2021-12-09;"Trenčiansky kraj";967;3897;203;4100;NA;302769;1170;2021-12-09;157277
2021-12-08;"Trenčiansky kraj";1020;4475;203;4678;NA;302769;1223;2021-12-08;156107
2021-12-07;"Trenčiansky kraj";1241;6281;217;6498;NA;302769;1458;2021-12-07;154884
2021-12-06;"Trenčiansky kraj";751;8923;430;9353;NA;302769;1181;2021-12-06;153426
2021-12-05;"Trenčiansky kraj";510;3610;210;3820;NA;302769;720;2021-12-05;152245
2021-12-04;"Trenčiansky kraj";1058;2043;156;2199;NA;302769;1214;2021-12-04;151525
2021-12-03;"Trenčiansky kraj";1272;4427;306;4733;NA;302769;1578;2021-12-03;150311
2021-12-02;"Trenčiansky kraj";2007;4132;265;4397;NA;302769;2272;2021-12-02;148733
2021-12-01;"Trenčiansky kraj";1000;4977;299;5276;NA;302769;1299;2021-12-01;146461
2021-11-30;"Trenčiansky kraj";1086;4743;332;5075;NA;302769;1418;2021-11-30;145162
2021-11-29;"Trenčiansky kraj";1165;10434;551;10985;NA;302769;1716;2021-11-29;143744
2021-11-28;"Trenčiansky kraj";664;5566;308;5874;NA;302769;972;2021-11-28;142028
2021-11-27;"Trenčiansky kraj";1080;2782;301;3083;NA;302769;1381;2021-11-27;141056
2021-11-26;"Trenčiansky kraj";1238;4529;350;4879;NA;302769;1588;2021-11-26;139675
2021-11-25;"Trenčiansky kraj";1018;3622;348;3970;NA;302769;1366;2021-11-25;138087
2021-11-24;"Trenčiansky kraj";1362;5596;472;6068;NA;302769;1834;2021-11-24;136721
2021-11-23;"Trenčiansky kraj";1140;3755;351;4106;NA;302769;1491;2021-11-23;134887
2021-11-22;"Trenčiansky kraj";920;6562;568;7130;NA;302769;1488;2021-11-22;133396
2021-11-21;"Trenčiansky kraj";413;3233;377;3610;NA;302769;790;2021-11-21;131908
2021-11-20;"Trenčiansky kraj";914;2379;341;2720;NA;302769;1255;2021-11-20;131118
2021-11-19;"Trenčiansky kraj";1261;3817;448;4265;NA;302769;1709;2021-11-19;129863
2021-11-18;"Trenčiansky kraj";810;5085;529;5614;NA;302769;1339;2021-11-18;128154
2021-11-17;"Trenčiansky kraj";796;1852;237;2089;NA;302769;1033;2021-11-17;126815
2021-11-16;"Trenčiansky kraj";859;4095;403;4498;NA;302769;1262;2021-11-16;125782
2021-11-15;"Trenčiansky kraj";720;5206;557;5763;NA;302769;1277;2021-11-15;124520
2021-11-14;"Trenčiansky kraj";447;2462;343;2805;NA;302769;790;2021-11-14;123243
2021-11-13;"Trenčiansky kraj";478;1879;254;2133;NA;302769;732;2021-11-13;122453
2021-11-12;"Trenčiansky kraj";784;3884;341;4225;NA;302769;1125;2021-11-12;121721
2021-11-11;"Trenčiansky kraj";805;3594;347;3941;NA;302769;1152;2021-11-11;120596
2021-11-10;"Trenčiansky kraj";647;3389;282;3671;NA;302769;929;2021-11-10;119444
2021-11-09;"Trenčiansky kraj";752;2915;306;3221;NA;302769;1058;2021-11-09;118515
2021-11-08;"Trenčiansky kraj";489;4724;355;5079;NA;302769;844;2021-11-08;117457
2021-11-07;"Trenčiansky kraj";405;2043;220;2263;NA;302769;625;2021-11-07;116613
2021-11-06;"Trenčiansky kraj";542;1755;176;1931;NA;302769;718;2021-11-06;115988
2021-11-05;"Trenčiansky kraj";677;3108;240;3348;NA;302769;917;2021-11-05;115270
2021-11-04;"Trenčiansky kraj";563;2741;232;2973;NA;302769;795;2021-11-04;114353
2021-11-03;"Trenčiansky kraj";619;2981;225;3206;NA;302769;844;2021-11-03;113558
2021-11-02;"Trenčiansky kraj";663;3884;313;4197;NA;302769;976;2021-11-02;112714
2021-11-01;"Trenčiansky kraj";219;1029;101;1130;NA;302769;320;2021-11-01;111738
2021-10-31;"Trenčiansky kraj";151;1462;152;1614;NA;302769;303;2021-10-31;111418
2021-10-30;"Trenčiansky kraj";345;1770;130;1900;NA;302769;475;2021-10-30;111115
2021-10-29;"Trenčiansky kraj";415;2885;130;3015;NA;302769;545;2021-10-29;110640
2021-10-28;"Trenčiansky kraj";429;2682;159;2841;NA;302769;588;2021-10-28;110095
2021-10-27;"Trenčiansky kraj";463;2640;94;2734;NA;302769;557;2021-10-27;109507
2021-10-26;"Trenčiansky kraj";419;2657;135;2792;NA;302769;554;2021-10-26;108950
2021-10-25;"Trenčiansky kraj";192;3431;134;3565;NA;302769;326;2021-10-25;108396
2021-10-24;"Trenčiansky kraj";121;1643;79;1722;NA;302769;200;2021-10-24;108070
2021-10-23;"Trenčiansky kraj";326;1737;64;1801;NA;302769;390;2021-10-23;107870
2021-10-22;"Trenčiansky kraj";358;2722;80;2802;NA;302769;438;2021-10-22;107480
2021-10-21;"Trenčiansky kraj";247;2369;76;2445;NA;302769;323;2021-10-21;107042
2021-10-20;"Trenčiansky kraj";302;2124;71;2195;NA;302769;373;2021-10-20;106719
2021-10-19;"Trenčiansky kraj";227;2866;61;2927;NA;302769;288;2021-10-19;106346
2021-10-18;"Trenčiansky kraj";143;2522;73;2595;NA;302769;216;2021-10-18;106058
2021-10-17;"Trenčiansky kraj";46;1457;31;1488;NA;302769;77;2021-10-17;105842
2021-10-16;"Trenčiansky kraj";76;1671;35;1706;NA;302769;111;2021-10-16;105765
2021-10-15;"Trenčiansky kraj";126;2970;52;3022;NA;302769;178;2021-10-15;105654
2021-10-14;"Trenčiansky kraj";103;1717;27;1744;NA;302769;130;2021-10-14;105476
2021-10-13;"Trenčiansky kraj";171;2672;28;2700;NA;302769;199;2021-10-13;105346
2021-10-12;"Trenčiansky kraj";114;2364;33;2397;NA;302769;147;2021-10-12;105147
2021-10-11;"Trenčiansky kraj";109;2571;50;2621;NA;302769;159;2021-10-11;105000
2021-10-10;"Trenčiansky kraj";17;1487;23;1510;NA;302769;40;2021-10-10;104841
2021-10-09;"Trenčiansky kraj";157;1809;16;1825;NA;302769;173;2021-10-09;104801
2021-10-08;"Trenčiansky kraj";82;3100;38;3138;NA;302769;120;2021-10-08;104628
2021-10-07;"Trenčiansky kraj";107;2054;32;2086;NA;302769;139;2021-10-07;104508
2021-10-06;"Trenčiansky kraj";193;2300;37;2337;NA;302769;230;2021-10-06;104369
2021-10-05;"Trenčiansky kraj";119;2236;42;2278;NA;302769;161;2021-10-05;104139
2021-10-04;"Trenčiansky kraj";105;2775;53;2828;NA;302769;158;2021-10-04;103978
2021-10-03;"Trenčiansky kraj";30;1558;27;1585;NA;302769;57;2021-10-03;103820
2021-10-02;"Trenčiansky kraj";107;1794;35;1829;NA;302769;142;2021-10-02;103763
2021-10-01;"Trenčiansky kraj";119;2692;37;2729;NA;302769;156;2021-10-01;103621
2021-09-30;"Trenčiansky kraj";74;2329;50;2379;NA;302769;124;2021-09-30;103465
2021-09-29;"Trenčiansky kraj";170;2151;30;2181;NA;302769;200;2021-09-29;103341
2021-09-28;"Trenčiansky kraj";95;2270;31;2301;NA;302769;126;2021-09-28;103141
2021-09-27;"Trenčiansky kraj";56;2819;57;2876;NA;302769;113;2021-09-27;103015
2021-09-26;"Trenčiansky kraj";20;1675;33;1708;NA;302769;53;2021-09-26;102902
2021-09-25;"Trenčiansky kraj";76;1674;21;1695;NA;302769;97;2021-09-25;102849
2021-09-24;"Trenčiansky kraj";104;3222;35;3257;NA;302769;139;2021-09-24;102752
2021-09-23;"Trenčiansky kraj";91;2252;27;2279;NA;302769;118;2021-09-23;102613
2021-09-22;"Trenčiansky kraj";90;2147;24;2171;NA;302769;114;2021-09-22;102495
2021-09-21;"Trenčiansky kraj";79;2309;29;2338;NA;302769;108;2021-09-21;102381
2021-09-20;"Trenčiansky kraj";78;2615;37;2652;NA;302769;115;2021-09-20;102273
2021-09-19;"Trenčiansky kraj";11;1571;20;1591;NA;302769;31;2021-09-19;102158
2021-09-18;"Trenčiansky kraj";53;2099;14;2113;NA;302769;67;2021-09-18;102127
2021-09-17;"Trenčiansky kraj";55;3144;26;3170;NA;302769;81;2021-09-17;102060
2021-09-16;"Trenčiansky kraj";52;2164;20;2184;NA;302769;72;2021-09-16;101979
2021-09-15;"Trenčiansky kraj";63;1043;7;1050;NA;302769;70;2021-09-15;101907
2021-09-14;"Trenčiansky kraj";67;2450;25;2475;NA;302769;92;2021-09-14;101837
2021-09-13;"Trenčiansky kraj";33;2276;35;2311;NA;302769;68;2021-09-13;101745
2021-09-12;"Trenčiansky kraj";3;1411;11;1422;NA;302769;14;2021-09-12;101677
2021-09-11;"Trenčiansky kraj";55;1729;6;1735;NA;302769;61;2021-09-11;101663
2021-09-10;"Trenčiansky kraj";49;2248;15;2263;NA;302769;64;2021-09-10;101602
2021-09-09;"Trenčiansky kraj";24;1685;30;1715;NA;302769;54;2021-09-09;101538
2021-09-08;"Trenčiansky kraj";54;1773;15;1788;NA;302769;69;2021-09-08;101484
2021-09-07;"Trenčiansky kraj";43;1395;18;1413;NA;302769;61;2021-09-07;101415
2021-09-06;"Trenčiansky kraj";47;1401;15;1416;NA;302769;62;2021-09-06;101354
2021-09-05;"Trenčiansky kraj";2;966;23;989;NA;302769;25;2021-09-05;101292
2021-09-04;"Trenčiansky kraj";41;925;4;929;NA;302769;45;2021-09-04;101267
2021-09-03;"Trenčiansky kraj";53;1422;15;1437;NA;302769;68;2021-09-03;101222
2021-09-02;"Trenčiansky kraj";7;1001;14;1015;NA;302769;21;2021-09-02;101154
2021-09-01;"Trenčiansky kraj";27;431;8;439;NA;302769;35;2021-09-01;101133
2021-08-31;"Trenčiansky kraj";21;1146;15;1161;NA;302769;36;2021-08-31;101098
2021-08-30;"Trenčiansky kraj";32;1168;10;1178;NA;302769;42;2021-08-30;101062
2021-08-29;"Trenčiansky kraj";1;482;11;493;NA;302769;12;2021-08-29;101020
2021-08-28;"Trenčiansky kraj";9;976;10;986;NA;302769;19;2021-08-28;101008
2021-08-27;"Trenčiansky kraj";21;1599;1;1600;NA;302769;22;2021-08-27;100989
2021-08-26;"Trenčiansky kraj";8;993;6;999;NA;302769;14;2021-08-26;100967
2021-08-25;"Trenčiansky kraj";40;875;7;882;NA;302769;47;2021-08-25;100953
2021-08-24;"Trenčiansky kraj";4;822;4;826;NA;302769;8;2021-08-24;100906
2021-08-23;"Trenčiansky kraj";6;1165;17;1182;NA;302769;23;2021-08-23;100898
2021-08-22;"Trenčiansky kraj";0;726;10;736;NA;302769;10;2021-08-22;100875
2021-08-21;"Trenčiansky kraj";5;964;7;971;NA;302769;12;2021-08-21;100865
2021-08-20;"Trenčiansky kraj";15;1538;2;1540;NA;302769;17;2021-08-20;100853
2021-08-19;"Trenčiansky kraj";2;986;2;988;NA;302769;4;2021-08-19;100836
2021-08-18;"Trenčiansky kraj";6;816;7;823;NA;302769;13;2021-08-18;100832
2021-08-17;"Trenčiansky kraj";9;634;1;635;NA;302769;10;2021-08-17;100819
2021-08-16;"Trenčiansky kraj";5;929;3;932;NA;302769;8;2021-08-16;100809
2021-08-15;"Trenčiansky kraj";0;558;1;559;NA;302769;1;2021-08-15;100801
2021-08-14;"Trenčiansky kraj";12;574;6;580;NA;302769;18;2021-08-14;100800
2021-08-13;"Trenčiansky kraj";2;934;0;934;NA;302769;2;2021-08-13;100782
2021-08-12;"Trenčiansky kraj";2;566;3;569;NA;302769;5;2021-08-12;100780
2021-08-11;"Trenčiansky kraj";1;683;0;683;NA;302769;1;2021-08-11;100775
2021-08-10;"Trenčiansky kraj";8;532;1;533;NA;302769;9;2021-08-10;100774
2021-08-09;"Trenčiansky kraj";8;698;1;699;NA;302769;9;2021-08-09;100765
2021-08-08;"Trenčiansky kraj";0;468;0;468;NA;302769;0;2021-08-08;100756
2021-08-07;"Trenčiansky kraj";3;464;0;464;NA;302769;3;2021-08-07;100756
2021-08-06;"Trenčiansky kraj";3;956;1;957;NA;302769;4;2021-08-06;100753
2021-08-05;"Trenčiansky kraj";3;582;1;583;NA;302769;4;2021-08-05;100749
2021-08-04;"Trenčiansky kraj";14;549;3;552;NA;302769;17;2021-08-04;100745
2021-08-03;"Trenčiansky kraj";9;510;5;515;NA;302769;14;2021-08-03;100728
2021-08-02;"Trenčiansky kraj";1;811;2;813;NA;302769;3;2021-08-02;100714
2021-08-01;"Trenčiansky kraj";0;514;1;515;NA;302769;1;2021-08-01;100711
2021-07-31;"Trenčiansky kraj";4;525;2;527;NA;302769;6;2021-07-31;100710
2021-07-30;"Trenčiansky kraj";2;1071;0;1071;NA;302769;2;2021-07-30;100704
2021-07-29;"Trenčiansky kraj";5;710;0;710;NA;302769;5;2021-07-29;100702
2021-07-28;"Trenčiansky kraj";3;521;2;523;NA;302769;5;2021-07-28;100697
2021-07-27;"Trenčiansky kraj";6;553;1;554;NA;302769;7;2021-07-27;100692
2021-07-26;"Trenčiansky kraj";7;781;1;782;NA;302769;8;2021-07-26;100685
2021-07-25;"Trenčiansky kraj";0;487;2;489;NA;302769;2;2021-07-25;100677
2021-07-24;"Trenčiansky kraj";3;643;1;644;NA;302769;4;2021-07-24;100675
2021-07-23;"Trenčiansky kraj";3;1154;0;1154;NA;302769;3;2021-07-23;100671
2021-07-22;"Trenčiansky kraj";2;849;2;851;NA;302769;4;2021-07-22;100668
2021-07-21;"Trenčiansky kraj";8;667;2;669;NA;302769;10;2021-07-21;100664
2021-07-20;"Trenčiansky kraj";4;530;1;531;NA;302769;5;2021-07-20;100654
2021-07-19;"Trenčiansky kraj";0;878;4;882;NA;302769;4;2021-07-19;100649
2021-07-18;"Trenčiansky kraj";0;526;0;526;NA;302769;0;2021-07-18;100645
2021-07-17;"Trenčiansky kraj";3;673;0;673;NA;302769;3;2021-07-17;100645
2021-07-16;"Trenčiansky kraj";4;1126;0;1126;NA;302769;4;2021-07-16;100642
2021-07-15;"Trenčiansky kraj";2;830;0;830;NA;302769;2;2021-07-15;100638
2021-07-14;"Trenčiansky kraj";8;665;1;666;NA;302769;9;2021-07-14;100636
2021-07-13;"Trenčiansky kraj";1;528;3;531;NA;302769;4;2021-07-13;100627
2021-07-12;"Trenčiansky kraj";9;827;3;830;NA;302769;12;2021-07-12;100623
2021-07-11;"Trenčiansky kraj";0;611;2;613;NA;302769;2;2021-07-11;100611
2021-07-10;"Trenčiansky kraj";2;535;0;535;NA;302769;2;2021-07-10;100609
2021-07-09;"Trenčiansky kraj";7;1387;2;1389;NA;302769;9;2021-07-09;100607
2021-07-08;"Trenčiansky kraj";2;824;1;825;NA;302769;3;2021-07-08;100598
2021-07-07;"Trenčiansky kraj";2;943;1;944;NA;302769;3;2021-07-07;100595
2021-07-06;"Trenčiansky kraj";4;1046;2;1048;NA;302769;6;2021-07-06;100592
2021-07-05;"Trenčiansky kraj";1;516;0;516;NA;302769;1;2021-07-05;100586
2021-07-04;"Trenčiansky kraj";0;612;1;613;NA;302769;1;2021-07-04;100585
2021-07-03;"Trenčiansky kraj";3;815;1;816;NA;302769;4;2021-07-03;100584
2021-07-02;"Trenčiansky kraj";5;1590;2;1592;NA;302769;7;2021-07-02;100580
2021-07-01;"Trenčiansky kraj";4;1173;1;1174;NA;302769;5;2021-07-01;100573
2021-06-30;"Trenčiansky kraj";2;7021;6;7027;NA;302769;8;2021-06-30;100568
2021-06-29;"Trenčiansky kraj";4;2773;5;2778;NA;302769;9;2021-06-29;100560
2021-06-28;"Trenčiansky kraj";5;3672;9;3681;NA;302769;14;2021-06-28;100551
2021-06-27;"Trenčiansky kraj";0;2861;1;2862;NA;302769;1;2021-06-27;100537
2021-06-26;"Trenčiansky kraj";1;3547;4;3551;NA;302769;5;2021-06-26;100536
2021-06-25;"Trenčiansky kraj";2;4635;2;4637;NA;302769;4;2021-06-25;100531
2021-06-24;"Trenčiansky kraj";3;3320;4;3324;NA;302769;7;2021-06-24;100527
2021-06-23;"Trenčiansky kraj";4;2808;2;2810;NA;302769;6;2021-06-23;100520
2021-06-22;"Trenčiansky kraj";7;3137;4;3141;NA;302769;11;2021-06-22;100514
2021-06-21;"Trenčiansky kraj";10;3891;4;3895;NA;302769;14;2021-06-21;100503
2021-06-20;"Trenčiansky kraj";0;3579;5;3584;NA;302769;5;2021-06-20;100489
2021-06-19;"Trenčiansky kraj";5;4528;1;4529;NA;302769;6;2021-06-19;100484
2021-06-18;"Trenčiansky kraj";7;6725;7;6732;NA;302769;14;2021-06-18;100478
2021-06-17;"Trenčiansky kraj";0;3469;6;3475;NA;302769;6;2021-06-17;100464
2021-06-16;"Trenčiansky kraj";4;3183;3;3186;NA;302769;7;2021-06-16;100458
2021-06-15;"Trenčiansky kraj";10;3697;2;3699;NA;302769;12;2021-06-15;100451
2021-06-14;"Trenčiansky kraj";10;4805;15;4820;NA;302769;25;2021-06-14;100439
2021-06-13;"Trenčiansky kraj";0;4643;4;4647;NA;302769;4;2021-06-13;100414
2021-06-12;"Trenčiansky kraj";4;5260;8;5268;NA;302769;12;2021-06-12;100410
2021-06-11;"Trenčiansky kraj";10;7365;11;7376;NA;302769;21;2021-06-11;100398
2021-06-10;"Trenčiansky kraj";5;4345;7;4352;NA;302769;12;2021-06-10;100377
2021-06-09;"Trenčiansky kraj";7;3693;7;3700;NA;302769;14;2021-06-09;100365
2021-06-08;"Trenčiansky kraj";21;3965;7;3972;NA;302769;28;2021-06-08;100351
2021-06-07;"Trenčiansky kraj";13;5560;10;5570;NA;302769;23;2021-06-07;100323
2021-06-06;"Trenčiansky kraj";0;5500;10;5510;NA;302769;10;2021-06-06;100300
2021-06-05;"Trenčiansky kraj";7;6511;5;6516;NA;302769;12;2021-06-05;100290
2021-06-04;"Trenčiansky kraj";16;7653;3;7656;NA;302769;19;2021-06-04;100278
2021-06-03;"Trenčiansky kraj";9;4485;10;4495;NA;302769;19;2021-06-03;100259
2021-06-02;"Trenčiansky kraj";28;4329;8;4337;NA;302769;36;2021-06-02;100240
2021-06-01;"Trenčiansky kraj";22;5396;18;5414;NA;302769;40;2021-06-01;100204
2021-05-31;"Trenčiansky kraj";30;6117;24;6141;NA;302769;54;2021-05-31;100164
2021-05-30;"Trenčiansky kraj";0;8258;16;8274;NA;302769;16;2021-05-30;100110
2021-05-29;"Trenčiansky kraj";13;7915;14;7929;NA;302769;27;2021-05-29;100094
2021-05-28;"Trenčiansky kraj";22;8995;25;9020;NA;302769;47;2021-05-28;100067
2021-05-27;"Trenčiansky kraj";6;5205;12;5217;NA;302769;18;2021-05-27;100020
2021-05-26;"Trenčiansky kraj";26;5069;15;5084;NA;302769;41;2021-05-26;100002
2021-05-25;"Trenčiansky kraj";18;6168;24;6192;NA;302769;42;2021-05-25;99961
2021-05-24;"Trenčiansky kraj";19;9292;37;9329;NA;302769;56;2021-05-24;99919
2021-05-23;"Trenčiansky kraj";0;9083;26;9109;NA;302769;26;2021-05-23;99863
2021-05-22;"Trenčiansky kraj";11;11314;21;11335;NA;302769;32;2021-05-22;99837
2021-05-21;"Trenčiansky kraj";23;11572;26;11598;NA;302769;49;2021-05-21;99805
2021-05-20;"Trenčiansky kraj";23;6320;25;6345;NA;302769;48;2021-05-20;99756
2021-05-19;"Trenčiansky kraj";16;5694;32;5726;NA;302769;48;2021-05-19;99708
2021-05-18;"Trenčiansky kraj";26;7779;28;7807;NA;302769;54;2021-05-18;99660
2021-05-17;"Trenčiansky kraj";37;7671;43;7714;NA;302769;80;2021-05-17;99606
2021-05-16;"Trenčiansky kraj";25;15615;41;15656;NA;302769;66;2021-05-16;99526
2021-05-15;"Trenčiansky kraj";3;21237;32;21269;NA;302769;35;2021-05-15;99460
2021-05-14;"Trenčiansky kraj";41;18676;42;18718;NA;302769;83;2021-05-14;99425
2021-05-13;"Trenčiansky kraj";41;8195;24;8219;NA;302769;65;2021-05-13;99342
2021-05-12;"Trenčiansky kraj";41;7409;31;7440;NA;302769;72;2021-05-12;99277
2021-05-11;"Trenčiansky kraj";66;10507;32;10539;NA;302769;98;2021-05-11;99205
2021-05-10;"Trenčiansky kraj";48;12989;55;13044;NA;302769;103;2021-05-10;99107
2021-05-09;"Trenčiansky kraj";52;17737;39;17776;NA;302769;91;2021-05-09;99004
2021-05-08;"Trenčiansky kraj";3;23822;33;23855;NA;302769;36;2021-05-08;98913
2021-05-07;"Trenčiansky kraj";45;23549;56;23605;NA;302769;101;2021-05-07;98877
2021-05-06;"Trenčiansky kraj";26;10771;44;10815;NA;302769;70;2021-05-06;98776
2021-05-05;"Trenčiansky kraj";73;9377;41;9418;NA;302769;114;2021-05-05;98706
2021-05-04;"Trenčiansky kraj";55;12733;53;12786;NA;302769;108;2021-05-04;98592
2021-05-03;"Trenčiansky kraj";60;15331;51;15382;NA;302769;111;2021-05-03;98484
2021-05-02;"Trenčiansky kraj";0;31152;65;31217;NA;302769;65;2021-05-02;98373
2021-05-01;"Trenčiansky kraj";71;56982;60;57042;NA;302769;131;2021-05-01;98308
2021-04-30;"Trenčiansky kraj";77;29427;61;29488;NA;302769;138;2021-04-30;98177
2021-04-29;"Trenčiansky kraj";49;13184;59;13243;NA;302769;108;2021-04-29;98039
2021-04-28;"Trenčiansky kraj";79;12537;52;12589;NA;302769;131;2021-04-28;97931
2021-04-27;"Trenčiansky kraj";107;15527;40;15567;NA;302769;147;2021-04-27;97800
2021-04-26;"Trenčiansky kraj";52;21070;63;21133;NA;302769;115;2021-04-26;97653
2021-04-25;"Trenčiansky kraj";0;34560;48;34608;NA;302769;48;2021-04-25;97538
2021-04-24;"Trenčiansky kraj";76;72398;100;72498;NA;302769;176;2021-04-24;97490
2021-04-23;"Trenčiansky kraj";143;29959;79;30038;NA;302769;222;2021-04-23;97314
2021-04-22;"Trenčiansky kraj";71;13847;64;13911;NA;302769;135;2021-04-22;97092
2021-04-21;"Trenčiansky kraj";79;13000;67;13067;NA;302769;146;2021-04-21;96957
2021-04-20;"Trenčiansky kraj";142;17740;80;17820;NA;302769;222;2021-04-20;96811
2021-04-19;"Trenčiansky kraj";102;22631;103;22734;NA;302769;205;2021-04-19;96589
2021-04-18;"Trenčiansky kraj";3;40879;97;40976;NA;302769;100;2021-04-18;96384
2021-04-17;"Trenčiansky kraj";77;81498;136;81634;NA;302769;213;2021-04-17;96284
2021-04-16;"Trenčiansky kraj";100;31961;90;32051;NA;302769;190;2021-04-16;96071
2021-04-15;"Trenčiansky kraj";71;14479;69;14548;NA;302769;140;2021-04-15;95881
2021-04-14;"Trenčiansky kraj";135;15563;72;15635;NA;302769;207;2021-04-14;95741
2021-04-13;"Trenčiansky kraj";189;18721;75;18796;NA;302769;264;2021-04-13;95534
2021-04-12;"Trenčiansky kraj";97;23743;91;23834;NA;302769;188;2021-04-12;95270
2021-04-11;"Trenčiansky kraj";1;34735;75;34810;NA;302769;76;2021-04-11;95082
2021-04-10;"Trenčiansky kraj";81;83093;145;83238;NA;302769;226;2021-04-10;95006
2021-04-09;"Trenčiansky kraj";120;28014;91;28105;NA;302769;211;2021-04-09;94780
2021-04-08;"Trenčiansky kraj";112;13283;85;13368;NA;302769;197;2021-04-08;94569
2021-04-07;"Trenčiansky kraj";204;17688;123;17811;NA;302769;327;2021-04-07;94372
2021-04-06;"Trenčiansky kraj";157;28567;178;28745;NA;302769;335;2021-04-06;94045
2021-04-05;"Trenčiansky kraj";15;9227;64;9291;NA;302769;79;2021-04-05;93710
2021-04-04;"Trenčiansky kraj";2;20291;85;20376;NA;302769;87;2021-04-04;93631
2021-04-03;"Trenčiansky kraj";86;80473;221;80694;NA;302769;307;2021-04-03;93544
2021-04-02;"Trenčiansky kraj";126;21620;81;21701;NA;302769;207;2021-04-02;93237
2021-04-01;"Trenčiansky kraj";159;32376;139;32515;NA;302769;298;2021-04-01;93030
2021-03-31;"Trenčiansky kraj";198;20100;130;20230;NA;302769;328;2021-03-31;92732
2021-03-30;"Trenčiansky kraj";272;17305;136;17441;NA;302769;408;2021-03-30;92404
2021-03-29;"Trenčiansky kraj";142;19479;170;19649;NA;302769;312;2021-03-29;91996
2021-03-28;"Trenčiansky kraj";3;34759;116;34875;NA;302769;119;2021-03-28;91684
2021-03-27;"Trenčiansky kraj";130;77314;293;77607;NA;302769;423;2021-03-27;91565
2021-03-26;"Trenčiansky kraj";211;35095;157;35252;NA;302769;368;2021-03-26;91142
2021-03-25;"Trenčiansky kraj";184;16580;176;16756;NA;302769;360;2021-03-25;90774
2021-03-24;"Trenčiansky kraj";259;13102;171;13273;NA;302769;430;2021-03-24;90414
2021-03-23;"Trenčiansky kraj";349;17589;174;17763;NA;302769;523;2021-03-23;89984
2021-03-22;"Trenčiansky kraj";141;21116;213;21329;NA;302769;354;2021-03-22;89461
2021-03-21;"Trenčiansky kraj";85;32711;164;32875;NA;302769;249;2021-03-21;89107
2021-03-20;"Trenčiansky kraj";128;80035;322;80357;NA;302769;450;2021-03-20;88858
2021-03-19;"Trenčiansky kraj";231;34783;232;35015;NA;302769;463;2021-03-19;88408
2021-03-18;"Trenčiansky kraj";262;16105;178;16283;NA;302769;440;2021-03-18;87945
2021-03-17;"Trenčiansky kraj";366;13435;164;13599;NA;302769;530;2021-03-17;87505
2021-03-16;"Trenčiansky kraj";450;15282;241;15523;NA;302769;691;2021-03-16;86975
2021-03-15;"Trenčiansky kraj";162;21235;261;21496;NA;302769;423;2021-03-15;86284
2021-03-14;"Trenčiansky kraj";42;34416;238;34654;NA;302769;280;2021-03-14;85861
2021-03-13;"Trenčiansky kraj";270;79186;453;79639;NA;302769;723;2021-03-13;85581
2021-03-12;"Trenčiansky kraj";366;34795;307;35102;NA;302769;673;2021-03-12;84858
2021-03-11;"Trenčiansky kraj";302;15558;213;15771;NA;302769;515;2021-03-11;84185
2021-03-10;"Trenčiansky kraj";402;13585;237;13822;NA;302769;639;2021-03-10;83670
2021-03-09;"Trenčiansky kraj";586;17982;285;18267;NA;302769;871;2021-03-09;83031
2021-03-08;"Trenčiansky kraj";174;21704;363;22067;NA;302769;537;2021-03-08;82160
2021-03-07;"Trenčiansky kraj";4;33660;313;33973;NA;302769;317;2021-03-07;81623
2021-03-06;"Trenčiansky kraj";260;79661;529;80190;NA;302769;789;2021-03-06;81306
2021-03-05;"Trenčiansky kraj";326;32969;415;33384;NA;302769;741;2021-03-05;80517
2021-03-04;"Trenčiansky kraj";323;16821;317;17138;NA;302769;640;2021-03-04;79776
2021-03-03;"Trenčiansky kraj";413;13960;347;14307;NA;302769;760;2021-03-03;79136
2021-03-02;"Trenčiansky kraj";612;17794;344;18138;NA;302769;956;2021-03-02;78376
2021-03-01;"Trenčiansky kraj";217;21104;445;21549;NA;302769;662;2021-03-01;77420
2021-02-28;"Trenčiansky kraj";45;30238;376;30614;NA;302769;421;2021-02-28;76758
2021-02-27;"Trenčiansky kraj";277;78735;686;79421;NA;302769;963;2021-02-27;76337
2021-02-26;"Trenčiansky kraj";420;32940;434;33374;NA;302769;854;2021-02-26;75374
2021-02-25;"Trenčiansky kraj";424;14029;328;14357;NA;302769;752;2021-02-25;74520
2021-02-24;"Trenčiansky kraj";427;12014;399;12413;NA;302769;826;2021-02-24;73768
2021-02-23;"Trenčiansky kraj";577;14904;390;15294;NA;302769;967;2021-02-23;72942
2021-02-22;"Trenčiansky kraj";160;19969;468;20437;NA;302769;628;2021-02-22;71975
2021-02-21;"Trenčiansky kraj";64;29478;392;29870;NA;302769;456;2021-02-21;71347
2021-02-20;"Trenčiansky kraj";274;77840;745;78585;NA;302769;1019;2021-02-20;70891
2021-02-19;"Trenčiansky kraj";272;30260;523;30783;NA;302769;795;2021-02-19;69872
2021-02-18;"Trenčiansky kraj";355;14094;403;14497;NA;302769;758;2021-02-18;69077
2021-02-17;"Trenčiansky kraj";363;11412;376;11788;NA;302769;739;2021-02-17;68319
2021-02-16;"Trenčiansky kraj";488;17761;406;18167;NA;302769;894;2021-02-16;67580
2021-02-15;"Trenčiansky kraj";151;21846;463;22309;NA;302769;614;2021-02-15;66686
2021-02-14;"Trenčiansky kraj";2;31255;324;31579;NA;302769;326;2021-02-14;66072
2021-02-13;"Trenčiansky kraj";274;63006;522;63528;NA;302769;796;2021-02-13;65746
2021-02-12;"Trenčiansky kraj";276;27979;412;28391;NA;302769;688;2021-02-12;64950
2021-02-11;"Trenčiansky kraj";291;11567;323;11890;NA;302769;614;2021-02-11;64262
2021-02-10;"Trenčiansky kraj";304;11408;317;11725;NA;302769;621;2021-02-10;63648
2021-02-09;"Trenčiansky kraj";514;18412;360;18772;NA;302769;874;2021-02-09;63027
2021-02-08;"Trenčiansky kraj";182;26832;430;27262;NA;302769;612;2021-02-08;62153
2021-02-07;"Trenčiansky kraj";31;36781;341;37122;NA;302769;372;2021-02-07;61541
2021-02-06;"Trenčiansky kraj";216;63931;560;64491;NA;302769;776;2021-02-06;61169
2021-02-05;"Trenčiansky kraj";202;18164;367;18531;NA;302769;569;2021-02-05;60393
2021-02-04;"Trenčiansky kraj";266;7253;311;7564;NA;302769;577;2021-02-04;59824
2021-02-03;"Trenčiansky kraj";162;6723;320;7043;NA;302769;482;2021-02-03;59247
2021-02-02;"Trenčiansky kraj";347;8074;381;8455;NA;302769;728;2021-02-02;58765
2021-02-01;"Trenčiansky kraj";167;8921;311;9232;NA;302769;478;2021-02-01;58037
2021-01-31;"Trenčiansky kraj";7;19103;159;19262;NA;302769;166;2021-01-31;57559
2021-01-30;"Trenčiansky kraj";228;38167;332;38499;NA;302769;560;2021-01-30;57393
2021-01-29;"Trenčiansky kraj";214;7590;235;7825;NA;302769;449;2021-01-29;56833
2021-01-28;"Trenčiansky kraj";307;5442;158;5600;NA;302769;465;2021-01-28;56384
2021-01-27;"Trenčiansky kraj";166;4842;181;5023;NA;302769;347;2021-01-27;55919
2021-01-26;"Trenčiansky kraj";303;14589;250;14839;NA;302769;553;2021-01-26;55572
2021-01-25;"Trenčiansky kraj";160;24310;207;24517;NA;302769;367;2021-01-25;55019
2021-01-24;"Trenčiansky kraj";51;38369;282;38651;NA;302769;333;2021-01-24;54652
2021-01-23;"Trenčiansky kraj";206;114125;749;114874;NA;302769;955;2021-01-23;54319
2021-01-22;"Trenčiansky kraj";148;21831;241;22072;NA;302769;389;2021-01-22;53364
2021-01-21;"Trenčiansky kraj";143;8586;166;8752;NA;302769;309;2021-01-21;52975
2021-01-20;"Trenčiansky kraj";181;8189;227;8416;NA;302769;408;2021-01-20;52666
2021-01-19;"Trenčiansky kraj";363;6600;262;6862;NA;302769;625;2021-01-19;52258
2021-01-18;"Trenčiansky kraj";72;4970;321;5291;NA;302769;393;2021-01-18;51633
2021-01-17;"Trenčiansky kraj";124;156;11;167;NA;302769;135;2021-01-17;51240
2021-01-16;"Trenčiansky kraj";39;1288;53;1341;NA;302769;92;2021-01-16;51105
2021-01-15;"Trenčiansky kraj";264;4031;214;4245;NA;302769;478;2021-01-15;51013
2021-01-14;"Trenčiansky kraj";275;3193;189;3382;NA;302769;464;2021-01-14;50535
2021-01-13;"Trenčiansky kraj";222;3893;215;4108;NA;302769;437;2021-01-13;50071
2021-01-12;"Trenčiansky kraj";508;4604;261;4865;NA;302769;769;2021-01-12;49634
2021-01-11;"Trenčiansky kraj";142;4367;354;4721;NA;302769;496;2021-01-11;48865
2021-01-10;"Trenčiansky kraj";89;4969;77;5046;NA;302769;166;2021-01-10;48369
2021-01-09;"Trenčiansky kraj";276;8280;128;8408;NA;302769;404;2021-01-09;48203
2021-01-08;"Trenčiansky kraj";489;6435;484;6919;NA;302769;973;2021-01-08;47799
2021-01-07;"Trenčiansky kraj";420;6138;577;6715;NA;302769;997;2021-01-07;46826
2021-01-06;"Trenčiansky kraj";221;1021;64;1085;NA;302769;285;2021-01-06;45829
2021-01-05;"Trenčiansky kraj";669;5753;706;6459;NA;302769;1375;2021-01-05;45544
2021-01-04;"Trenčiansky kraj";337;5248;782;6030;NA;302769;1119;2021-01-04;44169
2021-01-03;"Trenčiansky kraj";38;114;15;129;NA;302769;53;2021-01-03;43050
2021-01-02;"Trenčiansky kraj";129;196;23;219;NA;302769;152;2021-01-02;42997
2021-01-01;"Trenčiansky kraj";329;347;23;370;NA;302769;352;2021-01-01;42845
2020-12-31;"Trenčiansky kraj";597;4943;557;5500;NA;302769;1154;2020-12-31;42493
2020-12-30;"Trenčiansky kraj";836;7012;762;7774;NA;302769;1598;2020-12-30;41339
2020-12-29;"Trenčiansky kraj";459;6121;1009;7130;NA;302769;1468;2020-12-29;39741
2020-12-28;"Trenčiansky kraj";258;4195;777;4972;NA;302769;1035;2020-12-28;38273
2020-12-27;"Trenčiansky kraj";5;208;36;244;NA;302769;41;2020-12-27;37238
2020-12-26;"Trenčiansky kraj";174;74;10;84;NA;302769;184;2020-12-26;37197
2020-12-25;"Trenčiansky kraj";251;325;47;372;NA;302769;298;2020-12-25;37013
2020-12-24;"Trenčiansky kraj";552;2194;256;2450;NA;302769;808;2020-12-24;36715
2020-12-23;"Trenčiansky kraj";421;6552;661;7213;NA;302769;1082;2020-12-23;35907
2020-12-22;"Trenčiansky kraj";673;5760;694;6454;NA;302769;1367;2020-12-22;34825
2020-12-21;"Trenčiansky kraj";248;13395;979;14374;NA;302769;1227;2020-12-21;33458
2020-12-20;"Trenčiansky kraj";238;12504;292;12796;NA;302769;530;2020-12-20;32231
2020-12-19;"Trenčiansky kraj";341;1611;150;1761;NA;302769;491;2020-12-19;31701
2020-12-18;"Trenčiansky kraj";521;5199;615;5814;NA;302769;1136;2020-12-18;31210
2020-12-17;"Trenčiansky kraj";670;3843;524;4367;NA;302769;1194;2020-12-17;30074
2020-12-16;"Trenčiansky kraj";461;4474;648;5122;NA;302769;1109;2020-12-16;28880
2020-12-15;"Trenčiansky kraj";595;3805;670;4475;NA;302769;1265;2020-12-15;27771
2020-12-14;"Trenčiansky kraj";318;2907;552;3459;NA;302769;870;2020-12-14;26506
2020-12-13;"Trenčiansky kraj";77;49;6;55;NA;302769;83;2020-12-13;25636
2020-12-12;"Trenčiansky kraj";314;1191;136;1327;NA;302769;450;2020-12-12;25553
2020-12-11;"Trenčiansky kraj";751;3773;453;4226;NA;302769;1204;2020-12-11;25103
2020-12-10;"Trenčiansky kraj";271;3354;473;3827;NA;302769;744;2020-12-10;23899
2020-12-09;"Trenčiansky kraj";508;3788;466;4254;NA;302769;974;2020-12-09;23155
2020-12-08;"Trenčiansky kraj";546;3440;522;3962;NA;302769;1068;2020-12-08;22181
2020-12-07;"Trenčiansky kraj";258;3832;468;4300;NA;302769;726;2020-12-07;21113
2020-12-06;"Trenčiansky kraj";114;179;10;189;NA;302769;124;2020-12-06;20387
2020-12-05;"Trenčiansky kraj";223;610;56;666;NA;302769;279;2020-12-05;20263
2020-12-04;"Trenčiansky kraj";253;2943;273;3216;NA;302769;526;2020-12-04;19984
2020-12-03;"Trenčiansky kraj";503;1714;178;1892;NA;302769;681;2020-12-03;19458
2020-12-02;"Trenčiansky kraj";418;1844;232;2076;NA;302769;650;2020-12-02;18777
2020-12-01;"Trenčiansky kraj";321;5642;351;5993;NA;302769;672;2020-12-01;18127
2020-11-30;"Trenčiansky kraj";167;11514;520;12034;NA;302769;687;2020-11-30;17455
2020-11-29;"Trenčiansky kraj";29;30;5;35;NA;302769;34;2020-11-29;16768
2020-11-28;"Trenčiansky kraj";202;1051;93;1144;NA;302769;295;2020-11-28;16734
2020-11-27;"Trenčiansky kraj";330;1888;186;2074;NA;302769;516;2020-11-27;16439
2020-11-26;"Trenčiansky kraj";395;1252;122;1374;NA;302769;517;2020-11-26;15923
2020-11-25;"Trenčiansky kraj";322;1444;160;1604;NA;302769;482;2020-11-25;15406
2020-11-24;"Trenčiansky kraj";348;2553;308;2861;NA;302769;656;2020-11-24;14924
2020-11-23;"Trenčiansky kraj";159;1186;122;1308;NA;302769;281;2020-11-23;14268
2020-11-22;"Trenčiansky kraj";26;30;7;37;NA;302769;33;2020-11-22;13987
2020-11-21;"Trenčiansky kraj";255;1376;69;1445;NA;302769;324;2020-11-21;13954
2020-11-20;"Trenčiansky kraj";316;861;93;954;NA;302769;409;2020-11-20;13630
2020-11-19;"Trenčiansky kraj";316;740;113;853;NA;302769;429;2020-11-19;13221
2020-11-18;"Trenčiansky kraj";233;379;66;445;NA;302769;299;2020-11-18;12792
2020-11-17;"Trenčiansky kraj";222;106;15;121;NA;302769;237;2020-11-17;12493
2020-11-16;"Trenčiansky kraj";245;236;45;281;NA;302769;290;2020-11-16;12256
2020-11-15;"Trenčiansky kraj";109;29;6;35;NA;302769;115;2020-11-15;11966
2020-11-14;"Trenčiansky kraj";190;74;11;85;NA;302769;201;2020-11-14;11851
2020-11-13;"Trenčiansky kraj";308;131;13;144;NA;302769;321;2020-11-13;11650
2020-11-12;"Trenčiansky kraj";324;124;5;129;NA;302769;329;2020-11-12;11329
2020-11-11;"Trenčiansky kraj";366;113;10;123;NA;302769;376;2020-11-11;11000
2020-11-10;"Trenčiansky kraj";277;106;6;112;NA;302769;283;2020-11-10;10624
2020-11-09;"Trenčiansky kraj";115;1407;48;1455;NA;302769;163;2020-11-09;10341
2020-11-08;"Trenčiansky kraj";81;1271;8;1279;NA;302769;89;2020-11-08;10178
2020-11-07;"Trenčiansky kraj";319;3662;59;3721;NA;302769;378;2020-11-07;10089
2020-11-06;"Trenčiansky kraj";383;6893;84;6977;NA;302769;467;2020-11-06;9711
2020-11-05;"Trenčiansky kraj";399;98;15;113;NA;302769;414;2020-11-05;9244
2020-11-04;"Trenčiansky kraj";370;91;9;100;NA;302769;379;2020-11-04;8830
2020-11-03;"Trenčiansky kraj";575;97;8;105;NA;302769;583;2020-11-03;8451
2020-11-02;"Trenčiansky kraj";197;1833;68;1901;NA;302769;265;2020-11-02;7868
2020-11-01;"Trenčiansky kraj";257;808;24;832;NA;302769;281;2020-11-01;7603
2020-10-31;"Trenčiansky kraj";332;4719;82;4801;NA;302769;414;2020-10-31;7322
2020-10-30;"Trenčiansky kraj";299;5283;102;5385;NA;302769;401;2020-10-30;6908
2020-10-29;"Trenčiansky kraj";496;764;68;832;NA;302769;564;2020-10-29;6507
2020-10-28;"Trenčiansky kraj";269;192;33;225;NA;302769;302;2020-10-28;5943
2020-10-27;"Trenčiansky kraj";473;127;27;154;NA;302769;500;2020-10-27;5641
2020-10-26;"Trenčiansky kraj";177;107;36;143;NA;302769;213;2020-10-26;5141
2020-10-25;"Trenčiansky kraj";138;9;5;14;NA;302769;143;2020-10-25;4928
2020-10-24;"Trenčiansky kraj";395;128;6;134;NA;302769;401;2020-10-24;4785
2020-10-23;"Trenčiansky kraj";301;154;8;162;NA;302769;309;2020-10-23;4384
2020-10-22;"Trenčiansky kraj";273;82;12;94;NA;302769;285;2020-10-22;4075
2020-10-21;"Trenčiansky kraj";183;53;9;62;NA;302769;192;2020-10-21;3790
2020-10-20;"Trenčiansky kraj";212;47;6;53;NA;302769;218;2020-10-20;3598
2020-10-19;"Trenčiansky kraj";41;83;25;108;NA;302769;66;2020-10-19;3380
2020-10-18;"Trenčiansky kraj";104;0;0;0;NA;302769;104;2020-10-18;3314
2020-10-17;"Trenčiansky kraj";157;0;0;0;NA;302769;157;2020-10-17;3210
2020-10-16;"Trenčiansky kraj";225;42;6;48;NA;302769;231;2020-10-16;3053
2020-10-15;"Trenčiansky kraj";255;39;4;43;NA;302769;259;2020-10-15;2822
2020-10-14;"Trenčiansky kraj";162;42;7;49;NA;302769;169;2020-10-14;2563
2020-10-13;"Trenčiansky kraj";124;105;12;117;NA;302769;136;2020-10-13;2394
2020-10-12;"Trenčiansky kraj";55;0;0;0;NA;302769;55;2020-10-12;2258
2020-10-11;"Trenčiansky kraj";73;0;0;0;NA;302769;73;2020-10-11;2203
2020-10-10;"Trenčiansky kraj";180;0;0;0;NA;302769;180;2020-10-10;2130
2020-10-09;"Trenčiansky kraj";198;0;0;0;NA;302769;198;2020-10-09;1950
2020-10-08;"Trenčiansky kraj";115;0;0;0;NA;302769;115;2020-10-08;1752
2020-10-07;"Trenčiansky kraj";75;0;0;0;NA;302769;75;2020-10-07;1637
2020-10-06;"Trenčiansky kraj";72;0;0;0;NA;302769;72;2020-10-06;1562
2020-10-05;"Trenčiansky kraj";32;0;0;0;NA;302769;32;2020-10-05;1490
2020-10-04;"Trenčiansky kraj";37;0;0;0;NA;302769;37;2020-10-04;1458
2020-10-03;"Trenčiansky kraj";79;0;0;0;NA;302769;79;2020-10-03;1421
2020-10-02;"Trenčiansky kraj";69;0;0;0;NA;302769;69;2020-10-02;1342
2020-10-01;"Trenčiansky kraj";58;0;0;0;NA;302769;58;2020-10-01;1273
2020-09-30;"Trenčiansky kraj";76;0;0;0;NA;302769;76;2020-09-30;1215
2020-09-29;"Trenčiansky kraj";43;0;0;0;NA;302769;43;2020-09-29;1139
2020-09-28;"Trenčiansky kraj";7;0;0;0;NA;302769;7;2020-09-28;1096
2020-09-27;"Trenčiansky kraj";12;0;0;0;NA;302769;12;2020-09-27;1089
2020-09-26;"Trenčiansky kraj";37;0;0;0;NA;302769;37;2020-09-26;1077
2020-09-25;"Trenčiansky kraj";72;0;0;0;NA;302769;72;2020-09-25;1040
2020-09-24;"Trenčiansky kraj";41;0;0;0;NA;302769;41;2020-09-24;968
2020-09-23;"Trenčiansky kraj";32;0;0;0;NA;302769;32;2020-09-23;927
2020-09-22;"Trenčiansky kraj";26;0;0;0;NA;302769;26;2020-09-22;895
2020-09-21;"Trenčiansky kraj";23;0;0;0;NA;302769;23;2020-09-21;869
2020-09-20;"Trenčiansky kraj";21;0;0;0;NA;302769;21;2020-09-20;846
2020-09-19;"Trenčiansky kraj";20;0;0;0;NA;302769;20;2020-09-19;825
2020-09-18;"Trenčiansky kraj";41;0;0;0;NA;302769;41;2020-09-18;805
2020-09-17;"Trenčiansky kraj";20;0;0;0;NA;302769;20;2020-09-17;764
2020-09-16;"Trenčiansky kraj";14;0;0;0;NA;302769;14;2020-09-16;744
2020-09-15;"Trenčiansky kraj";8;0;0;0;NA;302769;8;2020-09-15;730
2020-09-14;"Trenčiansky kraj";5;0;0;0;NA;302769;5;2020-09-14;722
2020-09-13;"Trenčiansky kraj";12;0;0;0;NA;302769;12;2020-09-13;717
2020-09-12;"Trenčiansky kraj";2;0;0;0;NA;302769;2;2020-09-12;705
2020-09-11;"Trenčiansky kraj";27;0;0;0;NA;302769;27;2020-09-11;703
2020-09-10;"Trenčiansky kraj";15;0;0;0;NA;302769;15;2020-09-10;676
2020-09-09;"Trenčiansky kraj";11;0;0;0;NA;302769;11;2020-09-09;661
2020-09-08;"Trenčiansky kraj";12;0;0;0;NA;302769;12;2020-09-08;650
2020-09-07;"Trenčiansky kraj";6;0;0;0;NA;302769;6;2020-09-07;638
2020-09-06;"Trenčiansky kraj";1;0;0;0;NA;302769;1;2020-09-06;632
2020-09-05;"Trenčiansky kraj";3;0;0;0;NA;302769;3;2020-09-05;631
2020-09-04;"Trenčiansky kraj";9;0;0;0;NA;302769;9;2020-09-04;628
2020-09-03;"Trenčiansky kraj";10;0;0;0;NA;302769;10;2020-09-03;619
2020-09-02;"Trenčiansky kraj";5;0;0;0;NA;302769;5;2020-09-02;609
2020-09-01;"Trenčiansky kraj";1;0;0;0;NA;302769;1;2020-09-01;604
2020-08-31;"Trenčiansky kraj";12;0;0;0;NA;302769;12;2020-08-31;603
2020-08-30;"Trenčiansky kraj";0;0;0;0;NA;302769;0;2020-08-30;591
2020-08-29;"Trenčiansky kraj";1;0;0;0;NA;302769;1;2020-08-29;591
2020-08-28;"Trenčiansky kraj";12;0;0;0;NA;302769;12;2020-08-28;590
2020-08-27;"Trenčiansky kraj";10;0;0;0;NA;302769;10;2020-08-27;578
2020-08-26;"Trenčiansky kraj";15;0;0;0;NA;302769;15;2020-08-26;568
2020-08-25;"Trenčiansky kraj";12;0;0;0;NA;302769;12;2020-08-25;553
2020-08-24;"Trenčiansky kraj";4;0;0;0;NA;302769;4;2020-08-24;541
2020-08-23;"Trenčiansky kraj";5;0;0;0;NA;302769;5;2020-08-23;537
2020-08-22;"Trenčiansky kraj";6;0;0;0;NA;302769;6;2020-08-22;532
2020-08-21;"Trenčiansky kraj";6;0;0;0;NA;302769;6;2020-08-21;526
2020-08-20;"Trenčiansky kraj";20;0;0;0;NA;302769;20;2020-08-20;520
2020-08-19;"Trenčiansky kraj";17;0;0;0;NA;302769;17;2020-08-19;500
2020-08-18;"Trenčiansky kraj";9;0;0;0;NA;302769;9;2020-08-18;483
2020-08-17;"Trenčiansky kraj";4;0;0;0;NA;302769;4;2020-08-17;474
2020-08-16;"Trenčiansky kraj";0;0;0;0;NA;302769;0;2020-08-16;470
2020-08-15;"Trenčiansky kraj";9;0;0;0;NA;302769;9;2020-08-15;470
2020-08-14;"Trenčiansky kraj";15;0;0;0;NA;302769;15;2020-08-14;461
2020-08-13;"Trenčiansky kraj";23;0;0;0;NA;302769;23;2020-08-13;446
2020-08-12;"Trenčiansky kraj";6;0;0;0;NA;302769;6;2020-08-12;423
2020-08-11;"Trenčiansky kraj";7;0;0;0;NA;302769;7;2020-08-11;417
2020-08-10;"Trenčiansky kraj";9;0;0;0;NA;302769;9;2020-08-10;410
2020-08-09;"Trenčiansky kraj";1;0;0;0;NA;302769;1;2020-08-09;401
2020-08-08;"Trenčiansky kraj";4;0;0;0;NA;302769;4;2020-08-08;400
2020-08-07;"Trenčiansky kraj";4;0;0;0;NA;302769;4;2020-08-07;396
2020-08-06;"Trenčiansky kraj";13;0;0;0;NA;302769;13;2020-08-06;392
2020-08-05;"Trenčiansky kraj";39;0;0;0;NA;302769;39;2020-08-05;379
2020-08-04;"Trenčiansky kraj";9;0;0;0;NA;302769;9;2020-08-04;340
2020-08-03;"Trenčiansky kraj";0;0;0;0;NA;302769;0;2020-08-03;331
2020-08-02;"Trenčiansky kraj";2;0;0;0;NA;302769;2;2020-08-02;331
2020-08-01;"Trenčiansky kraj";6;0;0;0;NA;302769;6;2020-08-01;329
2020-07-31;"Trenčiansky kraj";16;0;0;0;NA;302769;16;2020-07-31;323
2020-07-30;"Trenčiansky kraj";4;0;0;0;NA;302769;4;2020-07-30;307
2020-07-29;"Trenčiansky kraj";5;0;0;0;NA;302769;5;2020-07-29;303
2020-07-28;"Trenčiansky kraj";11;0;0;0;NA;302769;11;2020-07-28;298
2020-07-27;"Trenčiansky kraj";4;0;0;0;NA;302769;4;2020-07-27;287
2020-07-26;"Trenčiansky kraj";1;0;0;0;NA;302769;1;2020-07-26;283
2020-07-25;"Trenčiansky kraj";7;0;0;0;NA;302769;7;2020-07-25;282
2020-07-24;"Trenčiansky kraj";5;0;0;0;NA;302769;5;2020-07-24;275
2020-07-23;"Trenčiansky kraj";10;0;0;0;NA;302769;10;2020-07-23;270
2020-07-22;"Trenčiansky kraj";11;0;0;0;NA;302769;11;2020-07-22;260
2020-07-21;"Trenčiansky kraj";6;0;0;0;NA;302769;6;2020-07-21;249
2020-07-20;"Trenčiansky kraj";13;0;0;0;NA;302769;13;2020-07-20;243
2020-07-19;"Trenčiansky kraj";0;0;0;0;NA;302769;0;2020-07-19;230
2020-07-18;"Trenčiansky kraj";0;0;0;0;NA;302769;0;2020-07-18;230
2020-07-17;"Trenčiansky kraj";1;0;0;0;NA;302769;1;2020-07-17;230
2020-07-16;"Trenčiansky kraj";0;0;0;0;NA;302769;0;2020-07-16;229
2020-07-15;"Trenčiansky kraj";2;0;0;0;NA;302769;2;2020-07-15;229
2020-07-14;"Trenčiansky kraj";8;0;0;0;NA;302769;8;2020-07-14;227
2020-07-13;"Trenčiansky kraj";1;0;0;0;NA;302769;1;2020-07-13;219
2020-07-12;"Trenčiansky kraj";0;0;0;0;NA;302769;0;2020-07-12;218
2020-07-11;"Trenčiansky kraj";0;0;0;0;NA;302769;0;2020-07-11;218
2020-07-10;"Trenčiansky kraj";3;0;0;0;NA;302769;3;2020-07-10;218
2020-07-09;"Trenčiansky kraj";2;0;0;0;NA;302769;2;2020-07-09;215
2020-07-08;"Trenčiansky kraj";1;0;0;0;NA;302769;1;2020-07-08;213
2020-07-07;"Trenčiansky kraj";9;0;0;0;NA;302769;9;2020-07-07;212
2020-07-06;"Trenčiansky kraj";1;0;0;0;NA;302769;1;2020-07-06;203
2020-07-05;"Trenčiansky kraj";1;0;0;0;NA;302769;1;2020-07-05;202
2020-07-04;"Trenčiansky kraj";0;0;0;0;NA;302769;0;2020-07-04;201
2020-07-03;"Trenčiansky kraj";2;0;0;0;NA;302769;2;2020-07-03;201
2020-07-02;"Trenčiansky kraj";10;0;0;0;NA;302769;10;2020-07-02;199
2020-07-01;"Trenčiansky kraj";1;0;0;0;NA;302769;1;2020-07-01;189
2020-06-30;"Trenčiansky kraj";6;0;0;0;NA;302769;6;2020-06-30;188
2020-06-29;"Trenčiansky kraj";1;0;0;0;NA;302769;1;2020-06-29;182
2020-06-28;"Trenčiansky kraj";0;0;0;0;NA;302769;0;2020-06-28;181
2020-06-27;"Trenčiansky kraj";0;0;0;0;NA;302769;0;2020-06-27;181
2020-06-26;"Trenčiansky kraj";0;0;0;0;NA;302769;0;2020-06-26;181
2020-06-25;"Trenčiansky kraj";2;0;0;0;NA;302769;2;2020-06-25;181
2020-06-24;"Trenčiansky kraj";1;0;0;0;NA;302769;1;2020-06-24;179
2020-06-23;"Trenčiansky kraj";0;0;0;0;NA;302769;0;2020-06-23;178
2020-06-22;"Trenčiansky kraj";0;0;0;0;NA;302769;0;2020-06-22;178
2020-06-21;"Trenčiansky kraj";0;0;0;0;NA;302769;0;2020-06-21;178
2020-06-20;"Trenčiansky kraj";0;0;0;0;NA;302769;0;2020-06-20;178
2020-06-19;"Trenčiansky kraj";0;0;0;0;NA;302769;0;2020-06-19;178
2020-06-18;"Trenčiansky kraj";0;0;0;0;NA;302769;0;2020-06-18;178
2020-06-17;"Trenčiansky kraj";0;0;0;0;NA;302769;0;2020-06-17;178
2020-06-16;"Trenčiansky kraj";0;0;0;0;NA;302769;0;2020-06-16;178
2020-06-14;"Trenčiansky kraj";0;0;0;0;NA;302769;0;2020-06-14;178
2020-06-13;"Trenčiansky kraj";0;0;0;0;NA;302769;0;2020-06-13;178
2020-06-12;"Trenčiansky kraj";0;0;0;0;NA;302769;0;2020-06-12;178
2020-06-11;"Trenčiansky kraj";0;0;0;0;NA;302769;0;2020-06-11;178
2020-06-10;"Trenčiansky kraj";1;0;0;0;NA;302769;1;2020-06-10;178
2020-06-09;"Trenčiansky kraj";0;0;0;0;NA;302769;0;2020-06-09;177
2020-06-08;"Trenčiansky kraj";0;0;0;0;NA;302769;0;2020-06-08;177
2020-06-07;"Trenčiansky kraj";0;0;0;0;NA;302769;0;2020-06-07;177
2020-06-05;"Trenčiansky kraj";0;0;0;0;NA;302769;0;2020-06-05;177
2020-06-03;"Trenčiansky kraj";0;0;0;0;NA;302769;0;2020-06-03;177
2020-06-02;"Trenčiansky kraj";0;0;0;0;NA;302769;0;2020-06-02;177
2020-05-31;"Trenčiansky kraj";0;0;0;0;NA;302769;0;2020-05-31;177
2020-05-29;"Trenčiansky kraj";0;0;0;0;NA;302769;0;2020-05-29;177
2020-05-27;"Trenčiansky kraj";2;0;0;0;NA;302769;2;2020-05-27;177
2020-05-26;"Trenčiansky kraj";0;0;0;0;NA;302769;0;2020-05-26;175
2020-05-25;"Trenčiansky kraj";0;0;0;0;NA;302769;0;2020-05-25;175
2020-05-24;"Trenčiansky kraj";0;0;0;0;NA;302769;0;2020-05-24;175
2020-05-23;"Trenčiansky kraj";0;0;0;0;NA;302769;0;2020-05-23;175
2020-05-22;"Trenčiansky kraj";0;0;0;0;NA;302769;0;2020-05-22;175
2020-05-21;"Trenčiansky kraj";0;0;0;0;NA;302769;0;2020-05-21;175
2020-05-20;"Trenčiansky kraj";0;0;0;0;NA;302769;0;2020-05-20;175
2020-05-19;"Trenčiansky kraj";0;0;0;0;NA;302769;0;2020-05-19;175
2020-05-17;"Trenčiansky kraj";0;0;0;0;NA;302769;0;2020-05-17;175
2020-05-16;"Trenčiansky kraj";0;0;0;0;NA;302769;0;2020-05-16;175
2020-05-15;"Trenčiansky kraj";1;0;0;0;NA;302769;1;2020-05-15;175
2020-05-14;"Trenčiansky kraj";2;0;0;0;NA;302769;2;2020-05-14;174
2020-05-13;"Trenčiansky kraj";1;0;0;0;NA;302769;1;2020-05-13;172
2020-05-12;"Trenčiansky kraj";1;0;0;0;NA;302769;1;2020-05-12;171
2020-05-11;"Trenčiansky kraj";3;0;0;0;NA;302769;3;2020-05-11;170
2020-05-09;"Trenčiansky kraj";2;0;0;0;NA;302769;2;2020-05-09;167
2020-05-07;"Trenčiansky kraj";6;0;0;0;NA;302769;6;2020-05-07;165
2020-05-06;"Trenčiansky kraj";0;0;0;0;NA;302769;0;2020-05-06;159
2020-05-05;"Trenčiansky kraj";2;0;0;0;NA;302769;2;2020-05-05;159
2020-05-04;"Trenčiansky kraj";0;0;0;0;NA;302769;0;2020-05-04;157
2020-05-03;"Trenčiansky kraj";0;0;0;0;NA;302769;0;2020-05-03;157
2020-05-02;"Trenčiansky kraj";0;0;0;0;NA;302769;0;2020-05-02;157
2020-05-01;"Trenčiansky kraj";0;0;0;0;NA;302769;0;2020-05-01;157
2020-04-30;"Trenčiansky kraj";0;0;0;0;NA;302769;0;2020-04-30;157
2020-04-29;"Trenčiansky kraj";2;0;0;0;NA;302769;2;2020-04-29;157
2020-04-28;"Trenčiansky kraj";1;0;0;0;NA;302769;1;2020-04-28;155
2020-04-27;"Trenčiansky kraj";0;0;0;0;NA;302769;0;2020-04-27;154
2020-04-26;"Trenčiansky kraj";1;0;0;0;NA;302769;1;2020-04-26;154
2020-04-25;"Trenčiansky kraj";0;0;0;0;NA;302769;0;2020-04-25;153
2020-04-24;"Trenčiansky kraj";0;0;0;0;NA;302769;0;2020-04-24;153
2020-04-23;"Trenčiansky kraj";11;0;0;0;NA;302769;11;2020-04-23;153
2020-04-22;"Trenčiansky kraj";1;0;0;0;NA;302769;1;2020-04-22;142
2020-04-21;"Trenčiansky kraj";11;0;0;0;NA;302769;11;2020-04-21;141
2020-04-20;"Trenčiansky kraj";15;0;0;0;NA;302769;15;2020-04-20;130
2020-04-19;"Trenčiansky kraj";2;0;0;0;NA;302769;2;2020-04-19;115
2020-04-18;"Trenčiansky kraj";3;0;0;0;NA;302769;3;2020-04-18;113
2020-04-17;"Trenčiansky kraj";4;0;0;0;NA;302769;4;2020-04-17;110
2020-04-16;"Trenčiansky kraj";10;0;0;0;NA;302769;10;2020-04-16;106
2020-04-15;"Trenčiansky kraj";4;0;0;0;NA;302769;4;2020-04-15;96
2020-04-14;"Trenčiansky kraj";0;0;0;0;NA;302769;0;2020-04-14;92
2020-04-13;"Trenčiansky kraj";1;0;0;0;NA;302769;1;2020-04-13;92
2020-04-12;"Trenčiansky kraj";2;0;0;0;NA;302769;2;2020-04-12;91
2020-04-11;"Trenčiansky kraj";3;0;0;0;NA;302769;3;2020-04-11;89
2020-04-10;"Trenčiansky kraj";0;0;0;0;NA;302769;0;2020-04-10;86
2020-04-09;"Trenčiansky kraj";0;0;0;0;NA;302769;0;2020-04-09;86
2020-04-08;"Trenčiansky kraj";2;0;0;0;NA;302769;2;2020-04-08;86
2020-04-07;"Trenčiansky kraj";18;0;0;0;NA;302769;18;2020-04-07;84
2020-04-06;"Trenčiansky kraj";0;0;0;0;NA;302769;0;2020-04-06;66
2020-04-05;"Trenčiansky kraj";3;0;0;0;NA;302769;3;2020-04-05;66
2020-04-04;"Trenčiansky kraj";5;0;0;0;NA;302769;5;2020-04-04;63
2020-04-03;"Trenčiansky kraj";4;0;0;0;NA;302769;4;2020-04-03;58
2020-04-02;"Trenčiansky kraj";1;0;0;0;NA;302769;1;2020-04-02;54
2020-04-01;"Trenčiansky kraj";3;0;0;0;NA;302769;3;2020-04-01;53
2020-03-31;"Trenčiansky kraj";1;0;0;0;NA;302769;1;2020-03-31;50
2020-03-30;"Trenčiansky kraj";3;0;0;0;NA;302769;3;2020-03-30;49
2020-03-29;"Trenčiansky kraj";6;0;0;0;NA;302769;6;2020-03-29;46
2020-03-28;"Trenčiansky kraj";9;0;0;0;NA;302769;9;2020-03-28;40
2020-03-27;"Trenčiansky kraj";2;0;0;0;NA;302769;2;2020-03-27;31
2020-03-26;"Trenčiansky kraj";6;0;0;0;NA;302769;6;2020-03-26;29
2020-03-25;"Trenčiansky kraj";3;0;0;0;NA;302769;3;2020-03-25;23
2020-03-24;"Trenčiansky kraj";1;0;0;0;NA;302769;1;2020-03-24;20
2020-03-23;"Trenčiansky kraj";0;0;0;0;NA;302769;0;2020-03-23;19
2020-03-22;"Trenčiansky kraj";0;0;0;0;NA;302769;0;2020-03-22;19
2020-03-21;"Trenčiansky kraj";2;0;0;0;NA;302769;2;2020-03-21;19
2020-03-20;"Trenčiansky kraj";2;0;0;0;NA;302769;2;2020-03-20;17
2020-03-19;"Trenčiansky kraj";8;0;0;0;NA;302769;8;2020-03-19;15
2020-03-18;"Trenčiansky kraj";0;0;0;0;NA;302769;0;2020-03-18;7
2020-03-17;"Trenčiansky kraj";0;0;0;0;NA;302769;0;2020-03-17;7
2020-03-16;"Trenčiansky kraj";1;0;0;0;NA;302769;1;2020-03-16;7
2020-03-15;"Trenčiansky kraj";5;0;0;0;NA;302769;5;2020-03-15;6
2020-03-14;"Trenčiansky kraj";0;0;0;0;NA;302769;0;2020-03-14;1
2020-03-13;"Trenčiansky kraj";0;0;0;0;NA;302769;0;2020-03-13;1
2020-03-12;"Trenčiansky kraj";1;0;0;0;NA;302769;1;2020-03-12;1
2020-03-11;"Trenčiansky kraj";0;0;0;0;NA;302769;0;2020-03-11;0
2020-03-09;"Trenčiansky kraj";0;0;0;0;NA;302769;0;2020-03-09;0
2020-03-08;"Trenčiansky kraj";0;0;0;0;NA;302769;0;2020-03-08;0
2020-03-07;"Trenčiansky kraj";0;0;0;0;NA;302769;0;2020-03-07;0
2020-03-06;"Trenčiansky kraj";0;0;0;0;NA;302769;0;2020-03-06;0
2022-05-24;"Trnavský kraj";13;0;0;0;212585;281937;13;2022-05-24;281937
2022-05-23;"Trnavský kraj";17;0;0;0;NA;281937;17;2022-05-23;281924
2022-05-22;"Trnavský kraj";0;20;0;20;NA;281937;0;2022-05-22;281907
2022-05-21;"Trnavský kraj";7;27;1;28;NA;281937;8;2022-05-21;281907
2022-05-20;"Trnavský kraj";12;82;2;84;NA;281937;14;2022-05-20;281899
2022-05-19;"Trnavský kraj";18;108;1;109;NA;281937;19;2022-05-19;281885
2022-05-18;"Trnavský kraj";13;111;6;117;NA;281937;19;2022-05-18;281866
2022-05-17;"Trnavský kraj";16;179;6;185;NA;281937;22;2022-05-17;281847
2022-05-16;"Trnavský kraj";34;185;5;190;NA;281937;39;2022-05-16;281825
2022-05-15;"Trnavský kraj";5;31;2;33;NA;281937;7;2022-05-15;281786
2022-05-14;"Trnavský kraj";16;63;1;64;NA;281937;17;2022-05-14;281779
2022-05-13;"Trnavský kraj";41;196;4;200;NA;281937;45;2022-05-13;281762
2022-05-12;"Trnavský kraj";9;122;6;128;NA;281937;15;2022-05-12;281717
2022-05-11;"Trnavský kraj";41;183;7;190;NA;281937;48;2022-05-11;281702
2022-05-10;"Trnavský kraj";39;179;4;183;NA;281937;43;2022-05-10;281654
2022-05-09;"Trnavský kraj";35;255;15;270;NA;281937;50;2022-05-09;281611
2022-05-08;"Trnavský kraj";4;42;0;42;NA;281937;4;2022-05-08;281561
2022-05-07;"Trnavský kraj";26;39;6;45;NA;281937;32;2022-05-07;281557
2022-05-06;"Trnavský kraj";42;248;10;258;NA;281937;52;2022-05-06;281525
2022-05-05;"Trnavský kraj";49;182;9;191;NA;281937;58;2022-05-05;281473
2022-05-04;"Trnavský kraj";76;179;8;187;NA;281937;84;2022-05-04;281415
2022-05-03;"Trnavský kraj";97;186;4;190;NA;281937;101;2022-05-03;281331
2022-05-02;"Trnavský kraj";104;287;10;297;NA;281937;114;2022-05-02;281230
2022-05-01;"Trnavský kraj";14;60;1;61;NA;281937;15;2022-05-01;281116
2022-04-30;"Trnavský kraj";53;46;3;49;NA;281937;56;2022-04-30;281101
2022-04-29;"Trnavský kraj";84;172;7;179;NA;281937;91;2022-04-29;281045
2022-04-28;"Trnavský kraj";147;326;12;338;NA;281937;159;2022-04-28;280954
2022-04-27;"Trnavský kraj";125;457;24;481;NA;281937;149;2022-04-27;280795
2022-04-26;"Trnavský kraj";135;213;9;222;NA;281937;144;2022-04-26;280646
2022-04-25;"Trnavský kraj";154;354;15;369;NA;281937;169;2022-04-25;280502
2022-04-24;"Trnavský kraj";41;60;6;66;NA;281937;47;2022-04-24;280333
2022-04-23;"Trnavský kraj";130;119;8;127;NA;281937;138;2022-04-23;280286
2022-04-22;"Trnavský kraj";157;393;20;413;NA;281937;177;2022-04-22;280148
2022-04-21;"Trnavský kraj";238;540;16;556;NA;281937;254;2022-04-21;279971
2022-04-20;"Trnavský kraj";164;390;25;415;NA;281937;189;2022-04-20;279717
2022-04-19;"Trnavský kraj";223;536;31;567;NA;281937;254;2022-04-19;279528
2022-04-18;"Trnavský kraj";66;63;9;72;NA;281937;75;2022-04-18;279274
2022-04-17;"Trnavský kraj";116;65;4;69;NA;281937;120;2022-04-17;279199
2022-04-16;"Trnavský kraj";99;103;9;112;NA;281937;108;2022-04-16;279079
2022-04-15;"Trnavský kraj";193;113;2;115;NA;281937;195;2022-04-15;278971
2022-04-14;"Trnavský kraj";237;610;42;652;NA;281937;279;2022-04-14;278776
2022-04-13;"Trnavský kraj";298;385;26;411;NA;281937;324;2022-04-13;278497
2022-04-12;"Trnavský kraj";358;492;39;531;NA;281937;397;2022-04-12;278173
2022-04-11;"Trnavský kraj";265;601;37;638;NA;281937;302;2022-04-11;277776
2022-04-10;"Trnavský kraj";124;128;19;147;NA;281937;143;2022-04-10;277474
2022-04-09;"Trnavský kraj";324;66;5;71;NA;281937;329;2022-04-09;277331
2022-04-08;"Trnavský kraj";380;388;43;431;NA;281937;423;2022-04-08;277002
2022-04-07;"Trnavský kraj";405;363;33;396;NA;281937;438;2022-04-07;276579
2022-04-06;"Trnavský kraj";485;380;35;415;NA;281937;520;2022-04-06;276141
2022-04-05;"Trnavský kraj";549;401;49;450;NA;281937;598;2022-04-05;275621
2022-04-04;"Trnavský kraj";621;707;90;797;NA;281937;711;2022-04-04;275023
2022-04-03;"Trnavský kraj";35;126;22;148;NA;281937;57;2022-04-03;274312
2022-04-02;"Trnavský kraj";478;113;14;127;NA;281937;492;2022-04-02;274255
2022-04-01;"Trnavský kraj";630;643;65;708;NA;281937;695;2022-04-01;273763
2022-03-31;"Trnavský kraj";709;483;69;552;NA;281937;778;2022-03-31;273068
2022-03-30;"Trnavský kraj";885;483;74;557;NA;281937;959;2022-03-30;272290
2022-03-29;"Trnavský kraj";845;667;75;742;NA;281937;920;2022-03-29;271331
2022-03-28;"Trnavský kraj";623;795;117;912;NA;281937;740;2022-03-28;270411
2022-03-27;"Trnavský kraj";340;185;39;224;NA;281937;379;2022-03-27;269671
2022-03-26;"Trnavský kraj";762;214;36;250;NA;281937;798;2022-03-26;269292
2022-03-25;"Trnavský kraj";859;664;69;733;NA;281937;928;2022-03-25;268494
2022-03-24;"Trnavský kraj";920;638;73;711;NA;281937;993;2022-03-24;267566
2022-03-23;"Trnavský kraj";1112;794;96;890;NA;281937;1208;2022-03-23;266573
2022-03-22;"Trnavský kraj";1096;767;70;837;NA;281937;1166;2022-03-22;265365
2022-03-21;"Trnavský kraj";1096;1025;113;1138;NA;281937;1209;2022-03-21;264199
2022-03-20;"Trnavský kraj";229;262;46;308;NA;281937;275;2022-03-20;262990
2022-03-19;"Trnavský kraj";1000;237;57;294;NA;281937;1057;2022-03-19;262715
2022-03-18;"Trnavský kraj";1038;907;107;1014;NA;281937;1145;2022-03-18;261658
2022-03-17;"Trnavský kraj";1148;721;93;814;NA;281937;1241;2022-03-17;260513
2022-03-16;"Trnavský kraj";1344;602;87;689;NA;281937;1431;2022-03-16;259272
2022-03-15;"Trnavský kraj";1179;1037;122;1159;NA;281937;1301;2022-03-15;257841
2022-03-14;"Trnavský kraj";890;1545;177;1722;NA;281937;1067;2022-03-14;256540
2022-03-13;"Trnavský kraj";290;422;57;479;NA;281937;347;2022-03-13;255473
2022-03-12;"Trnavský kraj";958;589;113;702;NA;281937;1071;2022-03-12;255126
2022-03-11;"Trnavský kraj";961;1038;126;1164;NA;281937;1087;2022-03-11;254055
2022-03-10;"Trnavský kraj";1049;1247;150;1397;NA;281937;1199;2022-03-10;252968
2022-03-09;"Trnavský kraj";1271;1159;161;1320;NA;281937;1432;2022-03-09;251769
2022-03-08;"Trnavský kraj";1393;1361;179;1540;NA;281937;1572;2022-03-08;250337
2022-03-07;"Trnavský kraj";1005;2051;263;2314;NA;281937;1268;2022-03-07;248765
2022-03-06;"Trnavský kraj";395;565;118;683;NA;281937;513;2022-03-06;247497
2022-03-05;"Trnavský kraj";806;475;90;565;NA;281937;896;2022-03-05;246984
2022-03-04;"Trnavský kraj";1028;1063;126;1189;NA;281937;1154;2022-03-04;246088
2022-03-03;"Trnavský kraj";1513;1135;168;1303;NA;281937;1681;2022-03-03;244934
2022-03-02;"Trnavský kraj";1330;1513;194;1707;NA;281937;1524;2022-03-02;243253
2022-03-01;"Trnavský kraj";1527;1351;201;1552;NA;281937;1728;2022-03-01;241729
2022-02-28;"Trnavský kraj";1318;2105;264;2369;NA;281937;1582;2022-02-28;240001
2022-02-27;"Trnavský kraj";386;640;106;746;NA;281937;492;2022-02-27;238419
2022-02-26;"Trnavský kraj";1268;526;112;638;NA;281937;1380;2022-02-26;237927
2022-02-25;"Trnavský kraj";1439;1491;211;1702;NA;281937;1650;2022-02-25;236547
2022-02-24;"Trnavský kraj";1397;1421;183;1604;NA;281937;1580;2022-02-24;234897
2022-02-23;"Trnavský kraj";2032;1668;240;1908;NA;281937;2272;2022-02-23;233317
2022-02-22;"Trnavský kraj";2171;1891;271;2162;NA;281937;2442;2022-02-22;231045
2022-02-21;"Trnavský kraj";1983;2849;438;3287;NA;281937;2421;2022-02-21;228603
2022-02-20;"Trnavský kraj";888;830;187;1017;NA;281937;1075;2022-02-20;226182
2022-02-19;"Trnavský kraj";1838;712;149;861;NA;281937;1987;2022-02-19;225107
2022-02-18;"Trnavský kraj";2132;1733;269;2002;NA;281937;2401;2022-02-18;223120
2022-02-17;"Trnavský kraj";1987;1764;269;2033;NA;281937;2256;2022-02-17;220719
2022-02-16;"Trnavský kraj";2047;1809;317;2126;NA;281937;2364;2022-02-16;218463
2022-02-15;"Trnavský kraj";2228;2412;400;2812;NA;281937;2628;2022-02-15;216099
2022-02-14;"Trnavský kraj";2216;3425;492;3917;NA;281937;2708;2022-02-14;213471
2022-02-13;"Trnavský kraj";805;1129;247;1376;NA;281937;1052;2022-02-13;210763
2022-02-12;"Trnavský kraj";2081;966;175;1141;NA;281937;2256;2022-02-12;209711
2022-02-11;"Trnavský kraj";1665;2158;266;2424;NA;281937;1931;2022-02-11;207455
2022-02-10;"Trnavský kraj";2491;1942;256;2198;NA;281937;2747;2022-02-10;205524
2022-02-09;"Trnavský kraj";2205;2474;365;2839;NA;281937;2570;2022-02-09;202777
2022-02-08;"Trnavský kraj";1758;2352;353;2705;NA;281937;2111;2022-02-08;200207
2022-02-07;"Trnavský kraj";2581;3356;459;3815;NA;281937;3040;2022-02-07;198096
2022-02-06;"Trnavský kraj";1194;1309;276;1585;NA;281937;1470;2022-02-06;195056
2022-02-05;"Trnavský kraj";2165;1102;187;1289;NA;281937;2352;2022-02-05;193586
2022-02-04;"Trnavský kraj";2191;2179;253;2432;NA;281937;2444;2022-02-04;191234
2022-02-03;"Trnavský kraj";2124;3295;347;3642;NA;281937;2471;2022-02-03;188790
2022-02-02;"Trnavský kraj";1812;2684;281;2965;NA;281937;2093;2022-02-02;186319
2022-02-01;"Trnavský kraj";2344;2656;318;2974;NA;281937;2662;2022-02-01;184226
2022-01-31;"Trnavský kraj";1931;5001;489;5490;NA;281937;2420;2022-01-31;181564
2022-01-30;"Trnavský kraj";709;1672;176;1848;NA;281937;885;2022-01-30;179144
2022-01-29;"Trnavský kraj";2136;1174;159;1333;NA;281937;2295;2022-01-29;178259
2022-01-28;"Trnavský kraj";1734;2340;216;2556;NA;281937;1950;2022-01-28;175964
2022-01-27;"Trnavský kraj";1989;2333;246;2579;NA;281937;2235;2022-01-27;174014
2022-01-26;"Trnavský kraj";1906;2730;217;2947;NA;281937;2123;2022-01-26;171779
2022-01-25;"Trnavský kraj";1631;2422;195;2617;NA;281937;1826;2022-01-25;169656
2022-01-24;"Trnavský kraj";999;4194;236;4430;NA;281937;1235;2022-01-24;167830
2022-01-23;"Trnavský kraj";299;1897;105;2002;NA;281937;404;2022-01-23;166595
2022-01-22;"Trnavský kraj";1169;1197;81;1278;NA;281937;1250;2022-01-22;166191
2022-01-21;"Trnavský kraj";830;2134;104;2238;NA;281937;934;2022-01-21;164941
2022-01-20;"Trnavský kraj";917;2511;100;2611;NA;281937;1017;2022-01-20;164007
2022-01-19;"Trnavský kraj";832;2122;84;2206;NA;281937;916;2022-01-19;162990
2022-01-18;"Trnavský kraj";704;2051;74;2125;NA;281937;778;2022-01-18;162074
2022-01-17;"Trnavský kraj";366;3885;87;3972;NA;281937;453;2022-01-17;161296
2022-01-16;"Trnavský kraj";84;1696;44;1740;NA;281937;128;2022-01-16;160843
2022-01-15;"Trnavský kraj";421;1015;33;1048;NA;281937;454;2022-01-15;160715
2022-01-14;"Trnavský kraj";349;2040;50;2090;NA;281937;399;2022-01-14;160261
2022-01-13;"Trnavský kraj";234;2057;52;2109;NA;281937;286;2022-01-13;159862
2022-01-12;"Trnavský kraj";400;1927;35;1962;NA;281937;435;2022-01-12;159576
2022-01-11;"Trnavský kraj";384;2261;33;2294;NA;281937;417;2022-01-11;159141
2022-01-10;"Trnavský kraj";258;4357;71;4428;NA;281937;329;2022-01-10;158724
2022-01-09;"Trnavský kraj";35;1921;22;1943;NA;281937;57;2022-01-09;158395
2022-01-08;"Trnavský kraj";364;1005;29;1034;NA;281937;393;2022-01-08;158338
2022-01-07;"Trnavský kraj";332;1984;47;2031;NA;281937;379;2022-01-07;157945
2022-01-06;"Trnavský kraj";234;830;20;850;NA;281937;254;2022-01-06;157566
2022-01-05;"Trnavský kraj";416;1925;37;1962;NA;281937;453;2022-01-05;157312
2022-01-04;"Trnavský kraj";538;2337;37;2374;NA;281937;575;2022-01-04;156859
2022-01-03;"Trnavský kraj";441;3897;65;3962;NA;281937;506;2022-01-03;156284
2022-01-02;"Trnavský kraj";79;1561;21;1582;NA;281937;100;2022-01-02;155778
2022-01-01;"Trnavský kraj";4;190;7;197;NA;281937;11;2022-01-01;155678
2021-12-31;"Trnavský kraj";485;1246;60;1306;NA;281937;545;2021-12-31;155667
2021-12-30;"Trnavský kraj";401;1927;58;1985;NA;281937;459;2021-12-30;155122
2021-12-29;"Trnavský kraj";401;1756;70;1826;NA;281937;471;2021-12-29;154663
2021-12-28;"Trnavský kraj";633;1742;73;1815;NA;281937;706;2021-12-28;154192
2021-12-27;"Trnavský kraj";463;2814;134;2948;NA;281937;597;2021-12-27;153486
2021-12-26;"Trnavský kraj";253;1019;30;1049;NA;281937;283;2021-12-26;152889
2021-12-25;"Trnavský kraj";104;341;41;382;NA;281937;145;2021-12-25;152606
2021-12-24;"Trnavský kraj";216;369;27;396;NA;281937;243;2021-12-24;152461
2021-12-23;"Trnavský kraj";570;1825;102;1927;NA;281937;672;2021-12-23;152218
2021-12-22;"Trnavský kraj";545;1732;81;1813;NA;281937;626;2021-12-22;151546
2021-12-21;"Trnavský kraj";699;2577;89;2666;NA;281937;788;2021-12-21;150920
2021-12-20;"Trnavský kraj";438;3941;103;4044;NA;281937;541;2021-12-20;150132
2021-12-19;"Trnavský kraj";155;1762;63;1825;NA;281937;218;2021-12-19;149591
2021-12-18;"Trnavský kraj";627;1302;77;1379;NA;281937;704;2021-12-18;149373
2021-12-17;"Trnavský kraj";576;2276;109;2385;NA;281937;685;2021-12-17;148669
2021-12-16;"Trnavský kraj";653;2530;123;2653;NA;281937;776;2021-12-16;147984
2021-12-15;"Trnavský kraj";746;2198;120;2318;NA;281937;866;2021-12-15;147208
2021-12-14;"Trnavský kraj";976;2718;134;2852;NA;281937;1110;2021-12-14;146342
2021-12-13;"Trnavský kraj";521;4857;175;5032;NA;281937;696;2021-12-13;145232
2021-12-12;"Trnavský kraj";337;2117;87;2204;NA;281937;424;2021-12-12;144536
2021-12-11;"Trnavský kraj";720;1324;83;1407;NA;281937;803;2021-12-11;144112
2021-12-10;"Trnavský kraj";702;2909;136;3045;NA;281937;838;2021-12-10;143309
2021-12-09;"Trnavský kraj";926;2313;96;2409;NA;281937;1022;2021-12-09;142471
2021-12-08;"Trnavský kraj";1233;2547;137;2684;NA;281937;1370;2021-12-08;141449
2021-12-07;"Trnavský kraj";1159;3637;174;3811;NA;281937;1333;2021-12-07;140079
2021-12-06;"Trnavský kraj";911;3649;208;3857;NA;281937;1119;2021-12-06;138746
2021-12-05;"Trnavský kraj";269;2303;106;2409;NA;281937;375;2021-12-05;137627
2021-12-04;"Trnavský kraj";1225;1623;115;1738;NA;281937;1340;2021-12-04;137252
2021-12-03;"Trnavský kraj";1246;2998;201;3199;NA;281937;1447;2021-12-03;135912
2021-12-02;"Trnavský kraj";1809;2379;188;2567;NA;281937;1997;2021-12-02;134465
2021-12-01;"Trnavský kraj";738;3011;179;3190;NA;281937;917;2021-12-01;132468
2021-11-30;"Trnavský kraj";1166;4217;202;4419;NA;281937;1368;2021-11-30;131551
2021-11-29;"Trnavský kraj";814;5360;299;5659;NA;281937;1113;2021-11-29;130183
2021-11-28;"Trnavský kraj";482;3087;146;3233;NA;281937;628;2021-11-28;129070
2021-11-27;"Trnavský kraj";1186;2240;206;2446;NA;281937;1392;2021-11-27;128442
2021-11-26;"Trnavský kraj";880;2895;202;3097;NA;281937;1082;2021-11-26;127050
2021-11-25;"Trnavský kraj";1002;2680;158;2838;NA;281937;1160;2021-11-25;125968
2021-11-24;"Trnavský kraj";1060;3442;250;3692;NA;281937;1310;2021-11-24;124808
2021-11-23;"Trnavský kraj";1078;3714;273;3987;NA;281937;1351;2021-11-23;123498
2021-11-22;"Trnavský kraj";696;4028;295;4323;NA;281937;991;2021-11-22;122147
2021-11-21;"Trnavský kraj";298;2270;212;2482;NA;281937;510;2021-11-21;121156
2021-11-20;"Trnavský kraj";826;1529;196;1725;NA;281937;1022;2021-11-20;120646
2021-11-19;"Trnavský kraj";901;3369;315;3684;NA;281937;1216;2021-11-19;119624
2021-11-18;"Trnavský kraj";796;2872;240;3112;NA;281937;1036;2021-11-18;118408
2021-11-17;"Trnavský kraj";769;1201;139;1340;NA;281937;908;2021-11-17;117372
2021-11-16;"Trnavský kraj";591;2755;206;2961;NA;281937;797;2021-11-16;116464
2021-11-15;"Trnavský kraj";606;3350;239;3589;NA;281937;845;2021-11-15;115667
2021-11-14;"Trnavský kraj";236;1579;141;1720;NA;281937;377;2021-11-14;114822
2021-11-13;"Trnavský kraj";815;1314;132;1446;NA;281937;947;2021-11-13;114445
2021-11-12;"Trnavský kraj";563;2585;157;2742;NA;281937;720;2021-11-12;113498
2021-11-11;"Trnavský kraj";512;2426;161;2587;NA;281937;673;2021-11-11;112778
2021-11-10;"Trnavský kraj";590;2315;173;2488;NA;281937;763;2021-11-10;112105
2021-11-09;"Trnavský kraj";585;2538;187;2725;NA;281937;772;2021-11-09;111342
2021-11-08;"Trnavský kraj";357;2715;163;2878;NA;281937;520;2021-11-08;110570
2021-11-07;"Trnavský kraj";162;1349;111;1460;NA;281937;273;2021-11-07;110050
2021-11-06;"Trnavský kraj";391;1287;82;1369;NA;281937;473;2021-11-06;109777
2021-11-05;"Trnavský kraj";447;2202;102;2304;NA;281937;549;2021-11-05;109304
2021-11-04;"Trnavský kraj";432;2289;112;2401;NA;281937;544;2021-11-04;108755
2021-11-03;"Trnavský kraj";420;2091;97;2188;NA;281937;517;2021-11-03;108211
2021-11-02;"Trnavský kraj";365;2777;124;2901;NA;281937;489;2021-11-02;107694
2021-11-01;"Trnavský kraj";220;583;27;610;NA;281937;247;2021-11-01;107205
2021-10-31;"Trnavský kraj";61;887;62;949;NA;281937;123;2021-10-31;106958
2021-10-30;"Trnavský kraj";251;1099;50;1149;NA;281937;301;2021-10-30;106835
2021-10-29;"Trnavský kraj";312;2123;53;2176;NA;281937;365;2021-10-29;106534
2021-10-28;"Trnavský kraj";339;2034;65;2099;NA;281937;404;2021-10-28;106169
2021-10-27;"Trnavský kraj";232;1884;58;1942;NA;281937;290;2021-10-27;105765
2021-10-26;"Trnavský kraj";366;1964;54;2018;NA;281937;420;2021-10-26;105475
2021-10-25;"Trnavský kraj";142;2786;72;2858;NA;281937;214;2021-10-25;105055
2021-10-24;"Trnavský kraj";11;990;30;1020;NA;281937;41;2021-10-24;104841
2021-10-23;"Trnavský kraj";228;1126;27;1153;NA;281937;255;2021-10-23;104800
2021-10-22;"Trnavský kraj";204;2269;51;2320;NA;281937;255;2021-10-22;104545
2021-10-21;"Trnavský kraj";188;1671;46;1717;NA;281937;234;2021-10-21;104290
2021-10-20;"Trnavský kraj";212;1634;47;1681;NA;281937;259;2021-10-20;104056
2021-10-19;"Trnavský kraj";240;1848;30;1878;NA;281937;270;2021-10-19;103797
2021-10-18;"Trnavský kraj";95;2316;72;2388;NA;281937;167;2021-10-18;103527
2021-10-17;"Trnavský kraj";5;1218;17;1235;NA;281937;22;2021-10-17;103360
2021-10-16;"Trnavský kraj";129;1233;17;1250;NA;281937;146;2021-10-16;103338
2021-10-15;"Trnavský kraj";122;2121;24;2145;NA;281937;146;2021-10-15;103192
2021-10-14;"Trnavský kraj";131;1663;24;1687;NA;281937;155;2021-10-14;103046
2021-10-13;"Trnavský kraj";128;2072;23;2095;NA;281937;151;2021-10-13;102891
2021-10-12;"Trnavský kraj";189;2788;38;2826;NA;281937;227;2021-10-12;102740
2021-10-11;"Trnavský kraj";115;2621;35;2656;NA;281937;150;2021-10-11;102513
2021-10-10;"Trnavský kraj";2;993;15;1008;NA;281937;17;2021-10-10;102363
2021-10-09;"Trnavský kraj";151;1099;10;1109;NA;281937;161;2021-10-09;102346
2021-10-08;"Trnavský kraj";106;2326;34;2360;NA;281937;140;2021-10-08;102185
2021-10-07;"Trnavský kraj";151;1744;25;1769;NA;281937;176;2021-10-07;102045
2021-10-06;"Trnavský kraj";122;1929;27;1956;NA;281937;149;2021-10-06;101869
2021-10-05;"Trnavský kraj";220;3726;34;3760;NA;281937;254;2021-10-05;101720
2021-10-04;"Trnavský kraj";54;1963;47;2010;NA;281937;101;2021-10-04;101466
2021-10-03;"Trnavský kraj";1;1106;17;1123;NA;281937;18;2021-10-03;101365
2021-10-02;"Trnavský kraj";52;1055;12;1067;NA;281937;64;2021-10-02;101347
2021-10-01;"Trnavský kraj";113;2243;17;2260;NA;281937;130;2021-10-01;101283
2021-09-30;"Trnavský kraj";109;1872;18;1890;NA;281937;127;2021-09-30;101153
2021-09-29;"Trnavský kraj";83;1331;11;1342;NA;281937;94;2021-09-29;101026
2021-09-28;"Trnavský kraj";135;1934;31;1965;NA;281937;166;2021-09-28;100932
2021-09-27;"Trnavský kraj";80;2084;25;2109;NA;281937;105;2021-09-27;100766
2021-09-26;"Trnavský kraj";2;1048;12;1060;NA;281937;14;2021-09-26;100661
2021-09-25;"Trnavský kraj";61;1105;9;1114;NA;281937;70;2021-09-25;100647
2021-09-24;"Trnavský kraj";41;2229;15;2244;NA;281937;56;2021-09-24;100577
2021-09-23;"Trnavský kraj";89;1691;16;1707;NA;281937;105;2021-09-23;100521
2021-09-22;"Trnavský kraj";119;1706;28;1734;NA;281937;147;2021-09-22;100416
2021-09-21;"Trnavský kraj";108;1505;17;1522;NA;281937;125;2021-09-21;100269
2021-09-20;"Trnavský kraj";50;1652;20;1672;NA;281937;70;2021-09-20;100144
2021-09-19;"Trnavský kraj";2;924;8;932;NA;281937;10;2021-09-19;100074
2021-09-18;"Trnavský kraj";100;982;6;988;NA;281937;106;2021-09-18;100064
2021-09-17;"Trnavský kraj";77;1709;20;1729;NA;281937;97;2021-09-17;99958
2021-09-16;"Trnavský kraj";105;1279;32;1311;NA;281937;137;2021-09-16;99861
2021-09-15;"Trnavský kraj";59;841;5;846;NA;281937;64;2021-09-15;99724
2021-09-14;"Trnavský kraj";38;1583;12;1595;NA;281937;50;2021-09-14;99660
2021-09-13;"Trnavský kraj";56;1410;16;1426;NA;281937;72;2021-09-13;99610
2021-09-12;"Trnavský kraj";0;653;1;654;NA;281937;1;2021-09-12;99538
2021-09-11;"Trnavský kraj";37;971;10;981;NA;281937;47;2021-09-11;99537
2021-09-10;"Trnavský kraj";43;1441;9;1450;NA;281937;52;2021-09-10;99490
2021-09-09;"Trnavský kraj";42;954;13;967;NA;281937;55;2021-09-09;99438
2021-09-08;"Trnavský kraj";65;802;15;817;NA;281937;80;2021-09-08;99383
2021-09-07;"Trnavský kraj";29;844;5;849;NA;281937;34;2021-09-07;99303
2021-09-06;"Trnavský kraj";18;1234;14;1248;NA;281937;32;2021-09-06;99269
2021-09-05;"Trnavský kraj";2;580;4;584;NA;281937;6;2021-09-05;99237
2021-09-04;"Trnavský kraj";17;868;6;874;NA;281937;23;2021-09-04;99231
2021-09-03;"Trnavský kraj";14;1060;5;1065;NA;281937;19;2021-09-03;99208
2021-09-02;"Trnavský kraj";30;830;10;840;NA;281937;40;2021-09-02;99189
2021-09-01;"Trnavský kraj";6;409;4;413;NA;281937;10;2021-09-01;99149
2021-08-31;"Trnavský kraj";13;884;3;887;NA;281937;16;2021-08-31;99139
2021-08-30;"Trnavský kraj";7;904;1;905;NA;281937;8;2021-08-30;99123
2021-08-29;"Trnavský kraj";8;427;1;428;NA;281937;9;2021-08-29;99115
2021-08-28;"Trnavský kraj";17;694;2;696;NA;281937;19;2021-08-28;99106
2021-08-27;"Trnavský kraj";1;1186;4;1190;NA;281937;5;2021-08-27;99087
2021-08-26;"Trnavský kraj";8;713;3;716;NA;281937;11;2021-08-26;99082
2021-08-25;"Trnavský kraj";11;683;6;689;NA;281937;17;2021-08-25;99071
2021-08-24;"Trnavský kraj";7;801;1;802;NA;281937;8;2021-08-24;99054
2021-08-23;"Trnavský kraj";4;844;1;845;NA;281937;5;2021-08-23;99046
2021-08-22;"Trnavský kraj";0;474;0;474;NA;281937;0;2021-08-22;99041
2021-08-21;"Trnavský kraj";8;703;0;703;NA;281937;8;2021-08-21;99041
2021-08-20;"Trnavský kraj";4;1095;4;1099;NA;281937;8;2021-08-20;99033
2021-08-19;"Trnavský kraj";10;881;3;884;NA;281937;13;2021-08-19;99025
2021-08-18;"Trnavský kraj";6;789;2;791;NA;281937;8;2021-08-18;99012
2021-08-17;"Trnavský kraj";7;524;4;528;NA;281937;11;2021-08-17;99004
2021-08-16;"Trnavský kraj";9;966;3;969;NA;281937;12;2021-08-16;98993
2021-08-15;"Trnavský kraj";0;556;1;557;NA;281937;1;2021-08-15;98981
2021-08-14;"Trnavský kraj";10;801;3;804;NA;281937;13;2021-08-14;98980
2021-08-13;"Trnavský kraj";5;1077;6;1083;NA;281937;11;2021-08-13;98967
2021-08-12;"Trnavský kraj";3;666;3;669;NA;281937;6;2021-08-12;98956
2021-08-11;"Trnavský kraj";7;576;2;578;NA;281937;9;2021-08-11;98950
2021-08-10;"Trnavský kraj";3;757;3;760;NA;281937;6;2021-08-10;98941
2021-08-09;"Trnavský kraj";12;808;0;808;NA;281937;12;2021-08-09;98935
2021-08-08;"Trnavský kraj";1;545;0;545;NA;281937;1;2021-08-08;98923
2021-08-07;"Trnavský kraj";9;724;0;724;NA;281937;9;2021-08-07;98922
2021-08-06;"Trnavský kraj";3;988;0;988;NA;281937;3;2021-08-06;98913
2021-08-05;"Trnavský kraj";2;662;1;663;NA;281937;3;2021-08-05;98910
2021-08-04;"Trnavský kraj";1;891;1;892;NA;281937;2;2021-08-04;98907
2021-08-03;"Trnavský kraj";13;645;0;645;NA;281937;13;2021-08-03;98905
2021-08-02;"Trnavský kraj";2;725;1;726;NA;281937;3;2021-08-02;98892
2021-08-01;"Trnavský kraj";0;565;2;567;NA;281937;2;2021-08-01;98889
2021-07-31;"Trnavský kraj";3;886;0;886;NA;281937;3;2021-07-31;98887
2021-07-30;"Trnavský kraj";3;1084;3;1087;NA;281937;6;2021-07-30;98884
2021-07-29;"Trnavský kraj";1;775;0;775;NA;281937;1;2021-07-29;98878
2021-07-28;"Trnavský kraj";5;794;1;795;NA;281937;6;2021-07-28;98877
2021-07-27;"Trnavský kraj";7;623;2;625;NA;281937;9;2021-07-27;98871
2021-07-26;"Trnavský kraj";2;857;2;859;NA;281937;4;2021-07-26;98862
2021-07-25;"Trnavský kraj";0;707;0;707;NA;281937;0;2021-07-25;98858
2021-07-24;"Trnavský kraj";4;828;2;830;NA;281937;6;2021-07-24;98858
2021-07-23;"Trnavský kraj";3;1057;0;1057;NA;281937;3;2021-07-23;98852
2021-07-22;"Trnavský kraj";0;671;2;673;NA;281937;2;2021-07-22;98849
2021-07-21;"Trnavský kraj";2;660;2;662;NA;281937;4;2021-07-21;98847
2021-07-20;"Trnavský kraj";2;593;0;593;NA;281937;2;2021-07-20;98843
2021-07-19;"Trnavský kraj";9;886;0;886;NA;281937;9;2021-07-19;98841
2021-07-18;"Trnavský kraj";0;600;2;602;NA;281937;2;2021-07-18;98832
2021-07-17;"Trnavský kraj";8;796;0;796;NA;281937;8;2021-07-17;98830
2021-07-16;"Trnavský kraj";11;963;0;963;NA;281937;11;2021-07-16;98822
2021-07-15;"Trnavský kraj";4;832;1;833;NA;281937;5;2021-07-15;98811
2021-07-14;"Trnavský kraj";1;699;1;700;NA;281937;2;2021-07-14;98806
2021-07-13;"Trnavský kraj";1;693;1;694;NA;281937;2;2021-07-13;98804
2021-07-12;"Trnavský kraj";4;959;0;959;NA;281937;4;2021-07-12;98802
2021-07-11;"Trnavský kraj";0;692;0;692;NA;281937;0;2021-07-11;98798
2021-07-10;"Trnavský kraj";1;803;0;803;NA;281937;1;2021-07-10;98798
2021-07-09;"Trnavský kraj";3;1262;3;1265;NA;281937;6;2021-07-09;98797
2021-07-08;"Trnavský kraj";4;755;0;755;NA;281937;4;2021-07-08;98791
2021-07-07;"Trnavský kraj";9;924;2;926;NA;281937;11;2021-07-07;98787
2021-07-06;"Trnavský kraj";2;1401;1;1402;NA;281937;3;2021-07-06;98776
2021-07-05;"Trnavský kraj";1;503;2;505;NA;281937;3;2021-07-05;98773
2021-07-04;"Trnavský kraj";0;1129;3;1132;NA;281937;3;2021-07-04;98770
2021-07-03;"Trnavský kraj";4;815;0;815;NA;281937;4;2021-07-03;98767
2021-07-02;"Trnavský kraj";2;1137;2;1139;NA;281937;4;2021-07-02;98763
2021-07-01;"Trnavský kraj";4;487;0;487;NA;281937;4;2021-07-01;98759
2021-06-30;"Trnavský kraj";0;5135;1;5136;NA;281937;1;2021-06-30;98755
2021-06-29;"Trnavský kraj";4;2563;1;2564;NA;281937;5;2021-06-29;98754
2021-06-28;"Trnavský kraj";2;2600;1;2601;NA;281937;3;2021-06-28;98749
2021-06-27;"Trnavský kraj";0;3213;0;3213;NA;281937;0;2021-06-27;98746
2021-06-26;"Trnavský kraj";3;3871;1;3872;NA;281937;4;2021-06-26;98746
2021-06-25;"Trnavský kraj";2;4374;3;4377;NA;281937;5;2021-06-25;98742
2021-06-24;"Trnavský kraj";4;2520;3;2523;NA;281937;7;2021-06-24;98737
2021-06-23;"Trnavský kraj";4;2842;2;2844;NA;281937;6;2021-06-23;98730
2021-06-22;"Trnavský kraj";2;2996;1;2997;NA;281937;3;2021-06-22;98724
2021-06-21;"Trnavský kraj";6;3114;5;3119;NA;281937;11;2021-06-21;98721
2021-06-20;"Trnavský kraj";0;3952;1;3953;NA;281937;1;2021-06-20;98710
2021-06-19;"Trnavský kraj";3;4735;2;4737;NA;281937;5;2021-06-19;98709
2021-06-18;"Trnavský kraj";5;6125;4;6129;NA;281937;9;2021-06-18;98704
2021-06-17;"Trnavský kraj";3;3340;0;3340;NA;281937;3;2021-06-17;98695
2021-06-16;"Trnavský kraj";6;2926;3;2929;NA;281937;9;2021-06-16;98692
2021-06-15;"Trnavský kraj";8;3234;3;3237;NA;281937;11;2021-06-15;98683
2021-06-14;"Trnavský kraj";2;3829;1;3830;NA;281937;3;2021-06-14;98672
2021-06-13;"Trnavský kraj";0;5001;8;5009;NA;281937;8;2021-06-13;98669
2021-06-12;"Trnavský kraj";11;5807;2;5809;NA;281937;13;2021-06-12;98661
2021-06-11;"Trnavský kraj";17;5850;4;5854;NA;281937;21;2021-06-11;98648
2021-06-10;"Trnavský kraj";14;3476;1;3477;NA;281937;15;2021-06-10;98627
2021-06-09;"Trnavský kraj";10;3685;1;3686;NA;281937;11;2021-06-09;98612
2021-06-08;"Trnavský kraj";8;3344;4;3348;NA;281937;12;2021-06-08;98601
2021-06-07;"Trnavský kraj";12;4498;8;4506;NA;281937;20;2021-06-07;98589
2021-06-06;"Trnavský kraj";0;5517;2;5519;NA;281937;2;2021-06-06;98569
2021-06-05;"Trnavský kraj";20;6905;8;6913;NA;281937;28;2021-06-05;98567
2021-06-04;"Trnavský kraj";9;6735;10;6745;NA;281937;19;2021-06-04;98539
2021-06-03;"Trnavský kraj";14;4361;11;4372;NA;281937;25;2021-06-03;98520
2021-06-02;"Trnavský kraj";4;4148;11;4159;NA;281937;15;2021-06-02;98495
2021-06-01;"Trnavský kraj";18;3662;5;3667;NA;281937;23;2021-06-01;98480
2021-05-31;"Trnavský kraj";14;5515;16;5531;NA;281937;30;2021-05-31;98457
2021-05-30;"Trnavský kraj";0;6473;7;6480;NA;281937;7;2021-05-30;98427
2021-05-29;"Trnavský kraj";11;8964;4;8968;NA;281937;15;2021-05-29;98420
2021-05-28;"Trnavský kraj";14;7160;11;7171;NA;281937;25;2021-05-28;98405
2021-05-27;"Trnavský kraj";22;4753;8;4761;NA;281937;30;2021-05-27;98380
2021-05-26;"Trnavský kraj";6;4870;8;4878;NA;281937;14;2021-05-26;98350
2021-05-25;"Trnavský kraj";19;5026;27;5053;NA;281937;46;2021-05-25;98336
2021-05-24;"Trnavský kraj";15;6520;22;6542;NA;281937;37;2021-05-24;98290
2021-05-23;"Trnavský kraj";0;7920;8;7928;NA;281937;8;2021-05-23;98253
2021-05-22;"Trnavský kraj";13;13381;21;13402;NA;281937;34;2021-05-22;98245
2021-05-21;"Trnavský kraj";16;8525;19;8544;NA;281937;35;2021-05-21;98211
2021-05-20;"Trnavský kraj";15;5511;11;5522;NA;281937;26;2021-05-20;98176
2021-05-19;"Trnavský kraj";18;5431;13;5444;NA;281937;31;2021-05-19;98150
2021-05-18;"Trnavský kraj";26;5768;15;5783;NA;281937;41;2021-05-18;98119
2021-05-17;"Trnavský kraj";17;6262;24;6286;NA;281937;41;2021-05-17;98078
2021-05-16;"Trnavský kraj";10;9984;8;9992;NA;281937;18;2021-05-16;98037
2021-05-15;"Trnavský kraj";11;18525;14;18539;NA;281937;25;2021-05-15;98019
2021-05-14;"Trnavský kraj";34;10279;21;10300;NA;281937;55;2021-05-14;97994
2021-05-13;"Trnavský kraj";26;6913;12;6925;NA;281937;38;2021-05-13;97939
2021-05-12;"Trnavský kraj";34;6621;26;6647;NA;281937;60;2021-05-12;97901
2021-05-11;"Trnavský kraj";32;6393;13;6406;NA;281937;45;2021-05-11;97841
2021-05-10;"Trnavský kraj";58;9139;24;9163;NA;281937;82;2021-05-10;97796
2021-05-09;"Trnavský kraj";21;12570;12;12582;NA;281937;33;2021-05-09;97714
2021-05-08;"Trnavský kraj";4;23028;22;23050;NA;281937;26;2021-05-08;97681
2021-05-07;"Trnavský kraj";26;15465;30;15495;NA;281937;56;2021-05-07;97655
2021-05-06;"Trnavský kraj";22;8407;22;8429;NA;281937;44;2021-05-06;97599
2021-05-05;"Trnavský kraj";34;6273;22;6295;NA;281937;56;2021-05-05;97555
2021-05-04;"Trnavský kraj";51;8538;17;8555;NA;281937;68;2021-05-04;97499
2021-05-03;"Trnavský kraj";20;8957;22;8979;NA;281937;42;2021-05-03;97431
2021-05-02;"Trnavský kraj";0;25657;29;25686;NA;281937;29;2021-05-02;97389
2021-05-01;"Trnavský kraj";30;81353;64;81417;NA;281937;94;2021-05-01;97360
2021-04-30;"Trnavský kraj";45;26846;35;26881;NA;281937;80;2021-04-30;97266
2021-04-29;"Trnavský kraj";25;20323;28;20351;NA;281937;53;2021-04-29;97186
2021-04-28;"Trnavský kraj";46;8896;28;8924;NA;281937;74;2021-04-28;97133
2021-04-27;"Trnavský kraj";54;8756;37;8793;NA;281937;91;2021-04-27;97059
2021-04-26;"Trnavský kraj";53;16116;42;16158;NA;281937;95;2021-04-26;96968
2021-04-25;"Trnavský kraj";0;30183;24;30207;NA;281937;24;2021-04-25;96873
2021-04-24;"Trnavský kraj";46;126077;84;126161;NA;281937;130;2021-04-24;96849
2021-04-23;"Trnavský kraj";71;25741;53;25794;NA;281937;124;2021-04-23;96719
2021-04-22;"Trnavský kraj";40;10904;25;10929;NA;281937;65;2021-04-22;96595
2021-04-21;"Trnavský kraj";60;10748;45;10793;NA;281937;105;2021-04-21;96530
2021-04-20;"Trnavský kraj";57;13504;28;13532;NA;281937;85;2021-04-20;96425
2021-04-19;"Trnavský kraj";46;14603;18;14621;NA;281937;64;2021-04-19;96340
2021-04-18;"Trnavský kraj";7;40843;43;40886;NA;281937;50;2021-04-18;96276
2021-04-17;"Trnavský kraj";58;118102;89;118191;NA;281937;147;2021-04-17;96226
2021-04-16;"Trnavský kraj";67;25962;48;26010;NA;281937;115;2021-04-16;96079
2021-04-15;"Trnavský kraj";65;11373;36;11409;NA;281937;101;2021-04-15;95964
2021-04-14;"Trnavský kraj";78;18442;53;18495;NA;281937;131;2021-04-14;95863
2021-04-13;"Trnavský kraj";126;9871;44;9915;NA;281937;170;2021-04-13;95732
2021-04-12;"Trnavský kraj";40;15577;40;15617;NA;281937;80;2021-04-12;95562
2021-04-11;"Trnavský kraj";3;44420;44;44464;NA;281937;47;2021-04-11;95482
2021-04-10;"Trnavský kraj";60;123822;107;123929;NA;281937;167;2021-04-10;95435
2021-04-09;"Trnavský kraj";95;26191;34;26225;NA;281937;129;2021-04-09;95268
2021-04-08;"Trnavský kraj";85;10913;54;10967;NA;281937;139;2021-04-08;95139
2021-04-07;"Trnavský kraj";131;15979;81;16060;NA;281937;212;2021-04-07;95000
2021-04-06;"Trnavský kraj";92;20586;90;20676;NA;281937;182;2021-04-06;94788
2021-04-05;"Trnavský kraj";91;7542;17;7559;NA;281937;108;2021-04-05;94606
2021-04-04;"Trnavský kraj";9;28831;49;28880;NA;281937;58;2021-04-04;94498
2021-04-03;"Trnavský kraj";29;144452;186;144638;NA;281937;215;2021-04-03;94440
2021-04-02;"Trnavský kraj";91;17538;33;17571;NA;281937;124;2021-04-02;94225
2021-04-01;"Trnavský kraj";118;22279;71;22350;NA;281937;189;2021-04-01;94101
2021-03-31;"Trnavský kraj";140;15828;82;15910;NA;281937;222;2021-03-31;93912
2021-03-30;"Trnavský kraj";182;10482;79;10561;NA;281937;261;2021-03-30;93690
2021-03-29;"Trnavský kraj";126;19255;122;19377;NA;281937;248;2021-03-29;93429
2021-03-28;"Trnavský kraj";26;50664;134;50798;NA;281937;160;2021-03-28;93181
2021-03-27;"Trnavský kraj";64;130217;246;130463;NA;281937;310;2021-03-27;93021
2021-03-26;"Trnavský kraj";139;30217;130;30347;NA;281937;269;2021-03-26;92711
2021-03-25;"Trnavský kraj";135;14212;80;14292;NA;281937;215;2021-03-25;92442
2021-03-24;"Trnavský kraj";159;10521;89;10610;NA;281937;248;2021-03-24;92227
2021-03-23;"Trnavský kraj";221;12735;104;12839;NA;281937;325;2021-03-23;91979
2021-03-22;"Trnavský kraj";103;17118;110;17228;NA;281937;213;2021-03-22;91654
2021-03-21;"Trnavský kraj";31;49119;150;49269;NA;281937;181;2021-03-21;91441
2021-03-20;"Trnavský kraj";112;136963;317;137280;NA;281937;429;2021-03-20;91260
2021-03-19;"Trnavský kraj";174;29071;137;29208;NA;281937;311;2021-03-19;90831
2021-03-18;"Trnavský kraj";158;12217;136;12353;NA;281937;294;2021-03-18;90520
2021-03-17;"Trnavský kraj";245;10434;103;10537;NA;281937;348;2021-03-17;90226
2021-03-16;"Trnavský kraj";311;12811;135;12946;NA;281937;446;2021-03-16;89878
2021-03-15;"Trnavský kraj";127;18271;146;18417;NA;281937;273;2021-03-15;89432
2021-03-14;"Trnavský kraj";14;47608;164;47772;NA;281937;178;2021-03-14;89159
2021-03-13;"Trnavský kraj";155;139224;409;139633;NA;281937;564;2021-03-13;88981
2021-03-12;"Trnavský kraj";201;28566;181;28747;NA;281937;382;2021-03-12;88417
2021-03-11;"Trnavský kraj";204;13301;140;13441;NA;281937;344;2021-03-11;88035
2021-03-10;"Trnavský kraj";242;10583;135;10718;NA;281937;377;2021-03-10;87691
2021-03-09;"Trnavský kraj";442;12824;155;12979;NA;281937;597;2021-03-09;87314
2021-03-08;"Trnavský kraj";182;21812;166;21978;NA;281937;348;2021-03-08;86717
2021-03-07;"Trnavský kraj";30;45463;227;45690;NA;281937;257;2021-03-07;86369
2021-03-06;"Trnavský kraj";154;135784;531;136315;NA;281937;685;2021-03-06;86112
2021-03-05;"Trnavský kraj";299;27959;239;28198;NA;281937;538;2021-03-05;85427
2021-03-04;"Trnavský kraj";238;14505;176;14681;NA;281937;414;2021-03-04;84889
2021-03-03;"Trnavský kraj";413;11583;246;11829;NA;281937;659;2021-03-03;84475
2021-03-02;"Trnavský kraj";477;12367;191;12558;NA;281937;668;2021-03-02;83816
2021-03-01;"Trnavský kraj";189;18586;234;18820;NA;281937;423;2021-03-01;83148
2021-02-28;"Trnavský kraj";87;47709;321;48030;NA;281937;408;2021-02-28;82725
2021-02-27;"Trnavský kraj";264;140224;800;141024;NA;281937;1064;2021-02-27;82317
2021-02-26;"Trnavský kraj";362;26637;284;26921;NA;281937;646;2021-02-26;81253
2021-02-25;"Trnavský kraj";433;10490;227;10717;NA;281937;660;2021-02-25;80607
2021-02-24;"Trnavský kraj";407;9113;290;9403;NA;281937;697;2021-02-24;79947
2021-02-23;"Trnavský kraj";469;11322;284;11606;NA;281937;753;2021-02-23;79250
2021-02-22;"Trnavský kraj";206;19901;330;20231;NA;281937;536;2021-02-22;78497
2021-02-21;"Trnavský kraj";38;48221;329;48550;NA;281937;367;2021-02-21;77961
2021-02-20;"Trnavský kraj";273;135835;859;136694;NA;281937;1132;2021-02-20;77594
2021-02-19;"Trnavský kraj";335;26382;366;26748;NA;281937;701;2021-02-19;76462
2021-02-18;"Trnavský kraj";344;11264;348;11612;NA;281937;692;2021-02-18;75761
2021-02-17;"Trnavský kraj";431;8783;416;9199;NA;281937;847;2021-02-17;75069
2021-02-16;"Trnavský kraj";426;11236;294;11530;NA;281937;720;2021-02-16;74222
2021-02-15;"Trnavský kraj";146;18276;326;18602;NA;281937;472;2021-02-15;73502
2021-02-14;"Trnavský kraj";51;57642;495;58137;NA;281937;546;2021-02-14;73030
2021-02-13;"Trnavský kraj";218;137051;994;138045;NA;281937;1212;2021-02-13;72484
2021-02-12;"Trnavský kraj";300;24090;352;24442;NA;281937;652;2021-02-12;71272
2021-02-11;"Trnavský kraj";422;9831;349;10180;NA;281937;771;2021-02-11;70620
2021-02-10;"Trnavský kraj";511;9194;342;9536;NA;281937;853;2021-02-10;69849
2021-02-09;"Trnavský kraj";544;12755;369;13124;NA;281937;913;2021-02-09;68996
2021-02-08;"Trnavský kraj";220;33414;497;33911;NA;281937;717;2021-02-08;68083
2021-02-07;"Trnavský kraj";140;69694;628;70322;NA;281937;768;2021-02-07;67366
2021-02-06;"Trnavský kraj";348;112687;1482;114169;NA;281937;1830;2021-02-06;66598
2021-02-05;"Trnavský kraj";377;16063;373;16436;NA;281937;750;2021-02-05;64768
2021-02-04;"Trnavský kraj";456;7317;456;7773;NA;281937;912;2021-02-04;64018
2021-02-03;"Trnavský kraj";472;6583;434;7017;NA;281937;906;2021-02-03;63106
2021-02-02;"Trnavský kraj";446;14243;424;14667;NA;281937;870;2021-02-02;62200
2021-02-01;"Trnavský kraj";198;38882;679;39561;NA;281937;877;2021-02-01;61330
2021-01-31;"Trnavský kraj";19;64707;822;65529;NA;281937;841;2021-01-31;60453
2021-01-30;"Trnavský kraj";323;111483;1288;112771;NA;281937;1611;2021-01-30;59612
2021-01-29;"Trnavský kraj";421;9689;290;9979;NA;281937;711;2021-01-29;58001
2021-01-28;"Trnavský kraj";389;5817;289;6106;NA;281937;678;2021-01-28;57290
2021-01-27;"Trnavský kraj";433;5554;225;5779;NA;281937;658;2021-01-27;56612
2021-01-26;"Trnavský kraj";565;25411;636;26047;NA;281937;1201;2021-01-26;55954
2021-01-25;"Trnavský kraj";210;41805;620;42425;NA;281937;830;2021-01-25;54753
2021-01-24;"Trnavský kraj";91;66399;779;67178;NA;281937;870;2021-01-24;53923
2021-01-23;"Trnavský kraj";372;113375;1319;114694;NA;281937;1691;2021-01-23;53053
2021-01-22;"Trnavský kraj";217;32755;505;33260;NA;281937;722;2021-01-22;51362
2021-01-21;"Trnavský kraj";311;13913;377;14290;NA;281937;688;2021-01-21;50640
2021-01-20;"Trnavský kraj";503;8685;283;8968;NA;281937;786;2021-01-20;49952
2021-01-19;"Trnavský kraj";415;7013;347;7360;NA;281937;762;2021-01-19;49166
2021-01-18;"Trnavský kraj";247;6690;513;7203;NA;281937;760;2021-01-18;48404
2021-01-17;"Trnavský kraj";128;854;215;1069;NA;281937;343;2021-01-17;47644
2021-01-16;"Trnavský kraj";103;898;24;922;NA;281937;127;2021-01-16;47301
2021-01-15;"Trnavský kraj";278;5467;336;5803;NA;281937;614;2021-01-15;47174
2021-01-14;"Trnavský kraj";452;4001;338;4339;NA;281937;790;2021-01-14;46560
2021-01-13;"Trnavský kraj";457;4751;378;5129;NA;281937;835;2021-01-13;45770
2021-01-12;"Trnavský kraj";469;6860;470;7330;NA;281937;939;2021-01-12;44935
2021-01-11;"Trnavský kraj";370;4587;360;4947;NA;281937;730;2021-01-11;43996
2021-01-10;"Trnavský kraj";71;13;0;13;NA;281937;71;2021-01-10;43266
2021-01-09;"Trnavský kraj";417;1775;100;1875;NA;281937;517;2021-01-09;43195
2021-01-08;"Trnavský kraj";381;6016;506;6522;NA;281937;887;2021-01-08;42678
2021-01-07;"Trnavský kraj";501;3545;329;3874;NA;281937;830;2021-01-07;41791
2021-01-06;"Trnavský kraj";179;758;132;890;NA;281937;311;2021-01-06;40961
2021-01-05;"Trnavský kraj";611;5165;561;5726;NA;281937;1172;2021-01-05;40650
2021-01-04;"Trnavský kraj";302;5556;709;6265;NA;281937;1011;2021-01-04;39478
2021-01-03;"Trnavský kraj";60;53;7;60;NA;281937;67;2021-01-03;38467
2021-01-02;"Trnavský kraj";282;417;32;449;NA;281937;314;2021-01-02;38400
2021-01-01;"Trnavský kraj";143;455;76;531;NA;281937;219;2021-01-01;38086
2020-12-31;"Trnavský kraj";498;8325;820;9145;NA;281937;1318;2020-12-31;37867
2020-12-30;"Trnavský kraj";785;5318;612;5930;NA;281937;1397;2020-12-30;36549
2020-12-29;"Trnavský kraj";322;4913;565;5478;NA;281937;887;2020-12-29;35152
2020-12-28;"Trnavský kraj";213;4900;552;5452;NA;281937;765;2020-12-28;34265
2020-12-27;"Trnavský kraj";27;20;4;24;NA;281937;31;2020-12-27;33500
2020-12-26;"Trnavský kraj";148;44;1;45;NA;281937;149;2020-12-26;33469
2020-12-25;"Trnavský kraj";65;49;5;54;NA;281937;70;2020-12-25;33320
2020-12-24;"Trnavský kraj";333;1359;117;1476;NA;281937;450;2020-12-24;33250
2020-12-23;"Trnavský kraj";210;6672;414;7086;NA;281937;624;2020-12-23;32800
2020-12-22;"Trnavský kraj";311;5427;455;5882;NA;281937;766;2020-12-22;32176
2020-12-21;"Trnavský kraj";328;4092;350;4442;NA;281937;678;2020-12-21;31410
2020-12-20;"Trnavský kraj";134;133;12;145;NA;281937;146;2020-12-20;30732
2020-12-19;"Trnavský kraj";201;1407;103;1510;NA;281937;304;2020-12-19;30586
2020-12-18;"Trnavský kraj";341;4432;334;4766;NA;281937;675;2020-12-18;30282
2020-12-17;"Trnavský kraj";375;4880;414;5294;NA;281937;789;2020-12-17;29607
2020-12-16;"Trnavský kraj";312;4945;383;5328;NA;281937;695;2020-12-16;28818
2020-12-15;"Trnavský kraj";492;6240;598;6838;NA;281937;1090;2020-12-15;28123
2020-12-14;"Trnavský kraj";161;3505;292;3797;NA;281937;453;2020-12-14;27033
2020-12-13;"Trnavský kraj";7;7;0;7;NA;281937;7;2020-12-13;26580
2020-12-12;"Trnavský kraj";254;1456;114;1570;NA;281937;368;2020-12-12;26573
2020-12-11;"Trnavský kraj";384;4289;241;4530;NA;281937;625;2020-12-11;26205
2020-12-10;"Trnavský kraj";183;5197;320;5517;NA;281937;503;2020-12-10;25580
2020-12-09;"Trnavský kraj";521;4199;317;4516;NA;281937;838;2020-12-09;25077
2020-12-08;"Trnavský kraj";281;4090;304;4394;NA;281937;585;2020-12-08;24239
2020-12-07;"Trnavský kraj";178;2895;199;3094;NA;281937;377;2020-12-07;23654
2020-12-06;"Trnavský kraj";46;0;0;0;NA;281937;46;2020-12-06;23277
2020-12-05;"Trnavský kraj";129;2218;41;2259;NA;281937;170;2020-12-05;23231
2020-12-04;"Trnavský kraj";242;3948;158;4106;NA;281937;400;2020-12-04;23061
2020-12-03;"Trnavský kraj";248;2770;190;2960;NA;281937;438;2020-12-03;22661
2020-12-02;"Trnavský kraj";284;4516;176;4692;NA;281937;460;2020-12-02;22223
2020-12-01;"Trnavský kraj";253;3190;205;3395;NA;281937;458;2020-12-01;21763
2020-11-30;"Trnavský kraj";200;7360;186;7546;NA;281937;386;2020-11-30;21305
2020-11-29;"Trnavský kraj";17;738;36;774;NA;281937;53;2020-11-29;20919
2020-11-28;"Trnavský kraj";83;1453;77;1530;NA;281937;160;2020-11-28;20866
2020-11-27;"Trnavský kraj";148;1779;85;1864;NA;281937;233;2020-11-27;20706
2020-11-26;"Trnavský kraj";234;1123;68;1191;NA;281937;302;2020-11-26;20473
2020-11-25;"Trnavský kraj";232;1168;74;1242;NA;281937;306;2020-11-25;20171
2020-11-24;"Trnavský kraj";295;1909;96;2005;NA;281937;391;2020-11-24;19865
2020-11-23;"Trnavský kraj";242;7393;129;7522;NA;281937;371;2020-11-23;19474
2020-11-22;"Trnavský kraj";10;82;9;91;NA;281937;19;2020-11-22;19103
2020-11-21;"Trnavský kraj";129;1354;36;1390;NA;281937;165;2020-11-21;19084
2020-11-20;"Trnavský kraj";246;1154;64;1218;NA;281937;310;2020-11-20;18919
2020-11-19;"Trnavský kraj";157;823;64;887;NA;281937;221;2020-11-19;18609
2020-11-18;"Trnavský kraj";235;822;82;904;NA;281937;317;2020-11-18;18388
2020-11-17;"Trnavský kraj";129;705;74;779;NA;281937;203;2020-11-17;18071
2020-11-16;"Trnavský kraj";187;732;32;764;NA;281937;219;2020-11-16;17868
2020-11-15;"Trnavský kraj";23;73;4;77;NA;281937;27;2020-11-15;17649
2020-11-14;"Trnavský kraj";86;397;12;409;NA;281937;98;2020-11-14;17622
2020-11-13;"Trnavský kraj";219;1312;21;1333;NA;281937;240;2020-11-13;17524
2020-11-12;"Trnavský kraj";162;420;18;438;NA;281937;180;2020-11-12;17284
2020-11-11;"Trnavský kraj";257;392;15;407;NA;281937;272;2020-11-11;17104
2020-11-10;"Trnavský kraj";189;889;30;919;NA;281937;219;2020-11-10;16832
2020-11-09;"Trnavský kraj";196;369;23;392;NA;281937;219;2020-11-09;16613
2020-11-08;"Trnavský kraj";55;400;4;404;NA;281937;59;2020-11-08;16394
2020-11-07;"Trnavský kraj";207;6070;74;6144;NA;281937;281;2020-11-07;16335
2020-11-06;"Trnavský kraj";260;1531;19;1550;NA;281937;279;2020-11-06;16054
2020-11-05;"Trnavský kraj";150;220;27;247;NA;281937;177;2020-11-05;15775
2020-11-04;"Trnavský kraj";188;212;10;222;NA;281937;198;2020-11-04;15598
2020-11-03;"Trnavský kraj";317;127;8;135;NA;281937;325;2020-11-03;15400
2020-11-02;"Trnavský kraj";281;1728;31;1759;NA;281937;312;2020-11-02;15075
2020-11-01;"Trnavský kraj";87;494;27;521;NA;281937;114;2020-11-01;14763
2020-10-31;"Trnavský kraj";259;5024;41;5065;NA;281937;300;2020-10-31;14649
2020-10-30;"Trnavský kraj";198;3784;27;3811;NA;281937;225;2020-10-30;14349
2020-10-29;"Trnavský kraj";273;1461;16;1477;NA;281937;289;2020-10-29;14124
2020-10-28;"Trnavský kraj";319;117;16;133;NA;281937;335;2020-10-28;13835
2020-10-27;"Trnavský kraj";199;461;36;497;NA;281937;235;2020-10-27;13500
2020-10-26;"Trnavský kraj";153;29;2;31;NA;281937;155;2020-10-26;13265
2020-10-25;"Trnavský kraj";95;19;1;20;NA;281937;96;2020-10-25;13110
2020-10-24;"Trnavský kraj";158;109;2;111;NA;281937;160;2020-10-24;13014
2020-10-23;"Trnavský kraj";201;89;4;93;NA;281937;205;2020-10-23;12854
2020-10-22;"Trnavský kraj";195;55;2;57;NA;281937;197;2020-10-22;12649
2020-10-21;"Trnavský kraj";134;73;3;76;NA;281937;137;2020-10-21;12452
2020-10-20;"Trnavský kraj";202;82;3;85;NA;281937;205;2020-10-20;12315
2020-10-19;"Trnavský kraj";67;55;0;55;NA;281937;67;2020-10-19;12110
2020-10-18;"Trnavský kraj";84;0;0;0;NA;281937;84;2020-10-18;12043
2020-10-17;"Trnavský kraj";123;0;0;0;NA;281937;123;2020-10-17;11959
2020-10-16;"Trnavský kraj";86;45;2;47;NA;281937;88;2020-10-16;11836
2020-10-15;"Trnavský kraj";155;66;2;68;NA;281937;157;2020-10-15;11748
2020-10-14;"Trnavský kraj";236;468;3;471;NA;281937;239;2020-10-14;11591
2020-10-13;"Trnavský kraj";138;16;2;18;NA;281937;140;2020-10-13;11352
2020-10-12;"Trnavský kraj";33;41;1;42;NA;281937;34;2020-10-12;11212
2020-10-11;"Trnavský kraj";31;0;0;0;NA;281937;31;2020-10-11;11178
2020-10-10;"Trnavský kraj";128;0;0;0;NA;281937;128;2020-10-10;11147
2020-10-09;"Trnavský kraj";156;0;0;0;NA;281937;156;2020-10-09;11019
2020-10-08;"Trnavský kraj";153;0;0;0;NA;281937;153;2020-10-08;10863
2020-10-07;"Trnavský kraj";80;0;0;0;NA;281937;80;2020-10-07;10710
2020-10-06;"Trnavský kraj";112;0;0;0;NA;281937;112;2020-10-06;10630
2020-10-05;"Trnavský kraj";33;0;0;0;NA;281937;33;2020-10-05;10518
2020-10-04;"Trnavský kraj";44;0;0;0;NA;281937;44;2020-10-04;10485
2020-10-03;"Trnavský kraj";60;0;0;0;NA;281937;60;2020-10-03;10441
2020-10-02;"Trnavský kraj";41;0;0;0;NA;281937;41;2020-10-02;10381
2020-10-01;"Trnavský kraj";53;0;0;0;NA;281937;53;2020-10-01;10340
2020-09-30;"Trnavský kraj";91;0;0;0;NA;281937;91;2020-09-30;10287
2020-09-29;"Trnavský kraj";40;0;0;0;NA;281937;40;2020-09-29;10196
2020-09-28;"Trnavský kraj";69;0;0;0;NA;281937;69;2020-09-28;10156
2020-09-27;"Trnavský kraj";30;0;0;0;NA;281937;30;2020-09-27;10087
2020-09-26;"Trnavský kraj";46;0;0;0;NA;281937;46;2020-09-26;10057
2020-09-25;"Trnavský kraj";32;0;0;0;NA;281937;32;2020-09-25;10011
2020-09-24;"Trnavský kraj";42;0;0;0;NA;281937;42;2020-09-24;9979
2020-09-23;"Trnavský kraj";43;0;0;0;NA;281937;43;2020-09-23;9937
2020-09-22;"Trnavský kraj";55;0;0;0;NA;281937;55;2020-09-22;9894
2020-09-21;"Trnavský kraj";41;0;0;0;NA;281937;41;2020-09-21;9839
2020-09-20;"Trnavský kraj";17;0;0;0;NA;281937;17;2020-09-20;9798
2020-09-19;"Trnavský kraj";4;0;0;0;NA;281937;4;2020-09-19;9781
2020-09-18;"Trnavský kraj";33;0;0;0;NA;281937;33;2020-09-18;9777
2020-09-17;"Trnavský kraj";42;0;0;0;NA;281937;42;2020-09-17;9744
2020-09-16;"Trnavský kraj";49;0;0;0;NA;281937;49;2020-09-16;9702
2020-09-15;"Trnavský kraj";5;0;0;0;NA;281937;5;2020-09-15;9653
2020-09-14;"Trnavský kraj";26;0;0;0;NA;281937;26;2020-09-14;9648
2020-09-13;"Trnavský kraj";9;0;0;0;NA;281937;9;2020-09-13;9622
2020-09-12;"Trnavský kraj";12;0;0;0;NA;281937;12;2020-09-12;9613
2020-09-11;"Trnavský kraj";16;0;0;0;NA;281937;16;2020-09-11;9601
2020-09-10;"Trnavský kraj";32;0;0;0;NA;281937;32;2020-09-10;9585
2020-09-09;"Trnavský kraj";14;0;0;0;NA;281937;14;2020-09-09;9553
2020-09-08;"Trnavský kraj";11;0;0;0;NA;281937;11;2020-09-08;9539
2020-09-07;"Trnavský kraj";7;0;0;0;NA;281937;7;2020-09-07;9528
2020-09-06;"Trnavský kraj";5;0;0;0;NA;281937;5;2020-09-06;9521
2020-09-05;"Trnavský kraj";7;0;0;0;NA;281937;7;2020-09-05;9516
2020-09-04;"Trnavský kraj";16;0;0;0;NA;281937;16;2020-09-04;9509
2020-09-03;"Trnavský kraj";8;0;0;0;NA;281937;8;2020-09-03;9493
2020-09-02;"Trnavský kraj";7;0;0;0;NA;281937;7;2020-09-02;9485
2020-09-01;"Trnavský kraj";1;0;0;0;NA;281937;1;2020-09-01;9478
2020-08-31;"Trnavský kraj";6;0;0;0;NA;281937;6;2020-08-31;9477
2020-08-30;"Trnavský kraj";1;0;0;0;NA;281937;1;2020-08-30;9471
2020-08-29;"Trnavský kraj";3;0;0;0;NA;281937;3;2020-08-29;9470
2020-08-28;"Trnavský kraj";14;0;0;0;NA;281937;14;2020-08-28;9467
2020-08-27;"Trnavský kraj";6;0;0;0;NA;281937;6;2020-08-27;9453
2020-08-26;"Trnavský kraj";4;0;0;0;NA;281937;4;2020-08-26;9447
2020-08-25;"Trnavský kraj";7;0;0;0;NA;281937;7;2020-08-25;9443
2020-08-24;"Trnavský kraj";1;0;0;0;NA;281937;1;2020-08-24;9436
2020-08-23;"Trnavský kraj";6;0;0;0;NA;281937;6;2020-08-23;9435
2020-08-22;"Trnavský kraj";3;0;0;0;NA;281937;3;2020-08-22;9429
2020-08-21;"Trnavský kraj";4;0;0;0;NA;281937;4;2020-08-21;9426
2020-08-20;"Trnavský kraj";23;0;0;0;NA;281937;23;2020-08-20;9422
2020-08-19;"Trnavský kraj";13;0;0;0;NA;281937;13;2020-08-19;9399
2020-08-18;"Trnavský kraj";20;0;0;0;NA;281937;20;2020-08-18;9386
2020-08-17;"Trnavský kraj";3;0;0;0;NA;281937;3;2020-08-17;9366
2020-08-16;"Trnavský kraj";0;0;0;0;NA;281937;0;2020-08-16;9363
2020-08-15;"Trnavský kraj";7;0;0;0;NA;281937;7;2020-08-15;9363
2020-08-14;"Trnavský kraj";6;0;0;0;NA;281937;6;2020-08-14;9356
2020-08-13;"Trnavský kraj";10;0;0;0;NA;281937;10;2020-08-13;9350
2020-08-12;"Trnavský kraj";2;0;0;0;NA;281937;2;2020-08-12;9340
2020-08-11;"Trnavský kraj";30;0;0;0;NA;281937;30;2020-08-11;9338
2020-08-10;"Trnavský kraj";0;0;0;0;NA;281937;0;2020-08-10;9308
2020-08-09;"Trnavský kraj";0;0;0;0;NA;281937;0;2020-08-09;9308
2020-08-08;"Trnavský kraj";13;0;0;0;NA;281937;13;2020-08-08;9308
2020-08-07;"Trnavský kraj";4;0;0;0;NA;281937;4;2020-08-07;9295
2020-08-06;"Trnavský kraj";4;0;0;0;NA;281937;4;2020-08-06;9291
2020-08-05;"Trnavský kraj";0;0;0;0;NA;281937;0;2020-08-05;9287
2020-08-04;"Trnavský kraj";1;0;0;0;NA;281937;1;2020-08-04;9287
2020-08-03;"Trnavský kraj";2;0;0;0;NA;281937;2;2020-08-03;9286
2020-08-02;"Trnavský kraj";1;0;0;0;NA;281937;1;2020-08-02;9284
2020-08-01;"Trnavský kraj";0;0;0;0;NA;281937;0;2020-08-01;9283
2020-07-31;"Trnavský kraj";7;0;0;0;NA;281937;7;2020-07-31;9283
2020-07-30;"Trnavský kraj";6;0;0;0;NA;281937;6;2020-07-30;9276
2020-07-29;"Trnavský kraj";0;0;0;0;NA;281937;0;2020-07-29;9270
2020-07-28;"Trnavský kraj";1;0;0;0;NA;281937;1;2020-07-28;9270
2020-07-27;"Trnavský kraj";2;0;0;0;NA;281937;2;2020-07-27;9269
2020-07-26;"Trnavský kraj";0;0;0;0;NA;281937;0;2020-07-26;9267
2020-07-25;"Trnavský kraj";0;0;0;0;NA;281937;0;2020-07-25;9267
2020-07-24;"Trnavský kraj";1;0;0;0;NA;281937;1;2020-07-24;9267
2020-07-23;"Trnavský kraj";2;0;0;0;NA;281937;2;2020-07-23;9266
2020-07-22;"Trnavský kraj";1;0;0;0;NA;281937;1;2020-07-22;9264
2020-07-21;"Trnavský kraj";2;0;0;0;NA;281937;2;2020-07-21;9263
2020-07-20;"Trnavský kraj";0;0;0;0;NA;281937;0;2020-07-20;9261
2020-07-19;"Trnavský kraj";0;0;0;0;NA;281937;0;2020-07-19;9261
2020-07-18;"Trnavský kraj";0;0;0;0;NA;281937;0;2020-07-18;9261
2020-07-17;"Trnavský kraj";0;0;0;0;NA;281937;0;2020-07-17;9261
2020-07-16;"Trnavský kraj";0;0;0;0;NA;281937;0;2020-07-16;9261
2020-07-15;"Trnavský kraj";1;0;0;0;NA;281937;1;2020-07-15;9261
2020-07-14;"Trnavský kraj";0;0;0;0;NA;281937;0;2020-07-14;9260
2020-07-13;"Trnavský kraj";0;0;0;0;NA;281937;0;2020-07-13;9260
2020-07-12;"Trnavský kraj";0;0;0;0;NA;281937;0;2020-07-12;9260
2020-07-11;"Trnavský kraj";0;0;0;0;NA;281937;0;2020-07-11;9260
2020-07-10;"Trnavský kraj";0;0;0;0;NA;281937;0;2020-07-10;9260
2020-07-09;"Trnavský kraj";0;0;0;0;NA;281937;0;2020-07-09;9260
2020-07-08;"Trnavský kraj";3;0;0;0;NA;281937;3;2020-07-08;9260
2020-07-07;"Trnavský kraj";4;0;0;0;NA;281937;4;2020-07-07;9257
2020-07-06;"Trnavský kraj";0;0;0;0;NA;281937;0;2020-07-06;9253
2020-07-05;"Trnavský kraj";0;0;0;0;NA;281937;0;2020-07-05;9253
2020-07-04;"Trnavský kraj";0;0;0;0;NA;281937;0;2020-07-04;9253
2020-07-03;"Trnavský kraj";0;0;0;0;NA;281937;0;2020-07-03;9253
2020-07-02;"Trnavský kraj";3;0;0;0;NA;281937;3;2020-07-02;9253
2020-07-01;"Trnavský kraj";0;0;0;0;NA;281937;0;2020-07-01;9250
2020-06-30;"Trnavský kraj";0;0;0;0;NA;281937;0;2020-06-30;9250
2020-06-29;"Trnavský kraj";0;0;0;0;NA;281937;0;2020-06-29;9250
2020-06-28;"Trnavský kraj";0;0;0;0;NA;281937;0;2020-06-28;9250
2020-06-27;"Trnavský kraj";0;0;0;0;NA;281937;0;2020-06-27;9250
2020-06-26;"Trnavský kraj";0;0;0;0;NA;281937;0;2020-06-26;9250
2020-06-25;"Trnavský kraj";0;0;0;0;NA;281937;0;2020-06-25;9250
2020-06-24;"Trnavský kraj";0;0;0;0;NA;281937;0;2020-06-24;9250
2020-06-23;"Trnavský kraj";0;0;0;0;NA;281937;0;2020-06-23;9250
2020-06-22;"Trnavský kraj";0;0;0;0;NA;281937;0;2020-06-22;9250
2020-06-21;"Trnavský kraj";0;0;0;0;NA;281937;0;2020-06-21;9250
2020-06-20;"Trnavský kraj";0;0;0;0;NA;281937;0;2020-06-20;9250
2020-06-19;"Trnavský kraj";0;0;0;0;NA;281937;0;2020-06-19;9250
2020-06-18;"Trnavský kraj";2;0;0;0;NA;281937;2;2020-06-18;9250
2020-06-17;"Trnavský kraj";0;0;0;0;NA;281937;0;2020-06-17;9248
2020-06-16;"Trnavský kraj";0;0;0;0;NA;281937;0;2020-06-16;9248
2020-06-14;"Trnavský kraj";0;0;0;0;NA;281937;0;2020-06-14;9248
2020-06-13;"Trnavský kraj";0;0;0;0;NA;281937;0;2020-06-13;9248
2020-06-12;"Trnavský kraj";0;0;0;0;NA;281937;0;2020-06-12;9248
2020-06-11;"Trnavský kraj";0;0;0;0;NA;281937;0;2020-06-11;9248
2020-06-10;"Trnavský kraj";0;0;0;0;NA;281937;0;2020-06-10;9248
2020-06-09;"Trnavský kraj";0;0;0;0;NA;281937;0;2020-06-09;9248
2020-06-08;"Trnavský kraj";0;0;0;0;NA;281937;0;2020-06-08;9248
2020-06-07;"Trnavský kraj";0;0;0;0;NA;281937;0;2020-06-07;9248
2020-06-05;"Trnavský kraj";0;0;0;0;NA;281937;0;2020-06-05;9248
2020-06-03;"Trnavský kraj";0;0;0;0;NA;281937;0;2020-06-03;9248
2020-06-02;"Trnavský kraj";0;0;0;0;NA;281937;0;2020-06-02;9248
2020-05-31;"Trnavský kraj";0;0;0;0;NA;281937;0;2020-05-31;9248
2020-05-29;"Trnavský kraj";0;0;0;0;NA;281937;0;2020-05-29;9248
2020-05-27;"Trnavský kraj";0;0;0;0;NA;281937;0;2020-05-27;9248
2020-05-26;"Trnavský kraj";0;0;0;0;NA;281937;0;2020-05-26;9248
2020-05-25;"Trnavský kraj";1;0;0;0;NA;281937;1;2020-05-25;9248
2020-05-24;"Trnavský kraj";0;0;0;0;NA;281937;0;2020-05-24;9247
2020-05-23;"Trnavský kraj";2;0;0;0;NA;281937;2;2020-05-23;9247
2020-05-22;"Trnavský kraj";0;0;0;0;NA;281937;0;2020-05-22;9245
2020-05-21;"Trnavský kraj";0;0;0;0;NA;281937;0;2020-05-21;9245
2020-05-20;"Trnavský kraj";2;0;0;0;NA;281937;2;2020-05-20;9245
2020-05-19;"Trnavský kraj";0;0;0;0;NA;281937;0;2020-05-19;9243
2020-05-17;"Trnavský kraj";0;0;0;0;NA;281937;0;2020-05-17;9243
2020-05-16;"Trnavský kraj";0;0;0;0;NA;281937;0;2020-05-16;9243
2020-05-15;"Trnavský kraj";1;0;0;0;NA;281937;1;2020-05-15;9243
2020-05-14;"Trnavský kraj";0;0;0;0;NA;281937;0;2020-05-14;9242
2020-05-13;"Trnavský kraj";0;0;0;0;NA;281937;0;2020-05-13;9242
2020-05-12;"Trnavský kraj";0;0;0;0;NA;281937;0;2020-05-12;9242
2020-05-11;"Trnavský kraj";2;0;0;0;NA;281937;2;2020-05-11;9242
2020-05-09;"Trnavský kraj";0;0;0;0;NA;281937;0;2020-05-09;9240
2020-05-07;"Trnavský kraj";0;0;0;0;NA;281937;0;2020-05-07;9240
2020-05-06;"Trnavský kraj";0;0;0;0;NA;281937;0;2020-05-06;9240
2020-05-05;"Trnavský kraj";0;0;0;0;NA;281937;0;2020-05-05;9240
2020-05-04;"Trnavský kraj";0;0;0;0;NA;281937;0;2020-05-04;9240
2020-05-03;"Trnavský kraj";0;0;0;0;NA;281937;0;2020-05-03;9240
2020-05-02;"Trnavský kraj";0;0;0;0;NA;281937;0;2020-05-02;9240
2020-05-01;"Trnavský kraj";0;0;0;0;NA;281937;0;2020-05-01;9240
2020-04-30;"Trnavský kraj";0;0;0;0;NA;281937;0;2020-04-30;9240
2020-04-29;"Trnavský kraj";0;0;0;0;NA;281937;0;2020-04-29;9240
2020-04-28;"Trnavský kraj";1;0;0;0;NA;281937;1;2020-04-28;9240
2020-04-27;"Trnavský kraj";0;0;0;0;NA;281937;0;2020-04-27;9239
2020-04-26;"Trnavský kraj";0;0;0;0;NA;281937;0;2020-04-26;9239
2020-04-25;"Trnavský kraj";2;0;0;0;NA;281937;2;2020-04-25;9239
2020-04-24;"Trnavský kraj";4;0;0;0;NA;281937;4;2020-04-24;9237
2020-04-23;"Trnavský kraj";5;0;0;0;NA;281937;5;2020-04-23;9233
2020-04-22;"Trnavský kraj";10;0;0;0;NA;281937;10;2020-04-22;9228
2020-04-21;"Trnavský kraj";5;0;0;0;NA;281937;5;2020-04-21;9218
2020-04-20;"Trnavský kraj";0;0;0;0;NA;281937;0;2020-04-20;9213
2020-04-19;"Trnavský kraj";1;0;0;0;NA;281937;1;2020-04-19;9213
2020-04-18;"Trnavský kraj";4;0;0;0;NA;281937;4;2020-04-18;9212
2020-04-17;"Trnavský kraj";7;0;0;0;NA;281937;7;2020-04-17;9208
2020-04-16;"Trnavský kraj";5;0;0;0;NA;281937;5;2020-04-16;9201
2020-04-15;"Trnavský kraj";5;0;0;0;NA;281937;5;2020-04-15;9196
2020-04-14;"Trnavský kraj";1;0;0;0;NA;281937;1;2020-04-14;9191
2020-04-13;"Trnavský kraj";0;0;0;0;NA;281937;0;2020-04-13;9190
2020-04-12;"Trnavský kraj";0;0;0;0;NA;281937;0;2020-04-12;9190
2020-04-11;"Trnavský kraj";0;0;0;0;NA;281937;0;2020-04-11;9190
2020-04-10;"Trnavský kraj";2;0;0;0;NA;281937;2;2020-04-10;9190
2020-04-09;"Trnavský kraj";3;0;0;0;NA;281937;3;2020-04-09;9188
2020-04-08;"Trnavský kraj";4;0;0;0;NA;281937;4;2020-04-08;9185
2020-04-07;"Trnavský kraj";6;0;0;0;NA;281937;6;2020-04-07;9181
2020-04-06;"Trnavský kraj";6;0;0;0;NA;281937;6;2020-04-06;9175
2020-04-05;"Trnavský kraj";1;0;0;0;NA;281937;1;2020-04-05;9169
2020-04-04;"Trnavský kraj";1;0;0;0;NA;281937;1;2020-04-04;9168
2020-04-03;"Trnavský kraj";3;0;0;0;NA;281937;3;2020-04-03;9167
2020-04-02;"Trnavský kraj";4;0;0;0;NA;281937;4;2020-04-02;9164
2020-04-01;"Trnavský kraj";0;0;0;0;NA;281937;0;2020-04-01;9160
2020-03-31;"Trnavský kraj";3;0;0;0;NA;281937;3;2020-03-31;9160
2020-03-30;"Trnavský kraj";4;0;0;0;NA;281937;4;2020-03-30;9157
2020-03-29;"Trnavský kraj";1;0;0;0;NA;281937;1;2020-03-29;9153
2020-03-28;"Trnavský kraj";3;0;0;0;NA;281937;3;2020-03-28;9152
2020-03-27;"Trnavský kraj";5;0;0;0;NA;281937;5;2020-03-27;9149
2020-03-26;"Trnavský kraj";5;0;0;0;NA;281937;5;2020-03-26;9144
2020-03-25;"Trnavský kraj";1;0;0;0;NA;281937;1;2020-03-25;9139
2020-03-24;"Trnavský kraj";0;0;0;0;NA;281937;0;2020-03-24;9138
2020-03-23;"Trnavský kraj";2;0;0;0;NA;281937;2;2020-03-23;9138
2020-03-22;"Trnavský kraj";1;0;0;0;NA;281937;1;2020-03-22;9136
2020-03-21;"Trnavský kraj";5;0;0;0;NA;281937;5;2020-03-21;9135
2020-03-20;"Trnavský kraj";0;0;0;0;NA;281937;0;2020-03-20;9130
2020-03-19;"Trnavský kraj";0;0;0;0;NA;281937;0;2020-03-19;9130
2020-03-18;"Trnavský kraj";0;0;0;0;NA;281937;0;2020-03-18;9130
2020-03-17;"Trnavský kraj";3;0;0;0;NA;281937;3;2020-03-17;9130
2020-03-16;"Trnavský kraj";1;0;0;0;NA;281937;1;2020-03-16;9127
2020-03-15;"Trnavský kraj";0;0;0;0;NA;281937;0;2020-03-15;9126
2020-03-14;"Trnavský kraj";0;0;0;0;NA;281937;0;2020-03-14;9126
2020-03-13;"Trnavský kraj";1;0;0;0;NA;281937;1;2020-03-13;9126
2020-03-12;"Trnavský kraj";1;0;0;0;NA;281937;1;2020-03-12;9125
2020-03-11;"Trnavský kraj";0;0;0;0;NA;281937;0;2020-03-11;9124
2020-03-09;"Trnavský kraj";0;0;0;0;NA;281937;0;2020-03-09;9124
2020-03-08;"Trnavský kraj";0;0;0;0;NA;281937;0;2020-03-08;9124
2020-03-07;"Trnavský kraj";0;0;0;0;NA;281937;0;2020-03-07;9124
2020-03-06;"Trnavský kraj";0;0;0;0;NA;281937;0;2020-03-06;9124
2022-05-24;"Žilinský kraj";20;0;0;0;254022;350342;20;2022-05-24;350342
2022-05-23;"Žilinský kraj";29;4;0;4;NA;350342;29;2022-05-23;350322
2022-05-22;"Žilinský kraj";4;18;1;19;NA;350342;5;2022-05-22;350293
2022-05-21;"Žilinský kraj";13;81;0;81;NA;350342;13;2022-05-21;350288
2022-05-20;"Žilinský kraj";27;189;15;204;NA;350342;42;2022-05-20;350275
2022-05-19;"Žilinský kraj";22;324;7;331;NA;350342;29;2022-05-19;350233
2022-05-18;"Žilinský kraj";28;253;26;279;NA;350342;54;2022-05-18;350204
2022-05-17;"Žilinský kraj";46;288;11;299;NA;350342;57;2022-05-17;350150
2022-05-16;"Žilinský kraj";42;383;21;404;NA;350342;63;2022-05-16;350093
2022-05-15;"Žilinský kraj";1;128;7;135;NA;350342;8;2022-05-15;350030
2022-05-14;"Žilinský kraj";15;284;18;302;NA;350342;33;2022-05-14;350022
2022-05-13;"Žilinský kraj";40;385;26;411;NA;350342;66;2022-05-13;349989
2022-05-12;"Žilinský kraj";28;302;24;326;NA;350342;52;2022-05-12;349923
2022-05-11;"Žilinský kraj";41;501;24;525;NA;350342;65;2022-05-11;349871
2022-05-10;"Žilinský kraj";74;355;26;381;NA;350342;100;2022-05-10;349806
2022-05-09;"Žilinský kraj";52;515;49;564;NA;350342;101;2022-05-09;349706
2022-05-08;"Žilinský kraj";2;131;10;141;NA;350342;12;2022-05-08;349605
2022-05-07;"Žilinský kraj";27;257;27;284;NA;350342;54;2022-05-07;349593
2022-05-06;"Žilinský kraj";83;268;29;297;NA;350342;112;2022-05-06;349539
2022-05-05;"Žilinský kraj";55;527;30;557;NA;350342;85;2022-05-05;349427
2022-05-04;"Žilinský kraj";60;518;69;587;NA;350342;129;2022-05-04;349342
2022-05-03;"Žilinský kraj";108;537;34;571;NA;350342;142;2022-05-03;349213
2022-05-02;"Žilinský kraj";104;711;41;752;NA;350342;145;2022-05-02;349071
2022-05-01;"Žilinský kraj";15;124;9;133;NA;350342;24;2022-05-01;348926
2022-04-30;"Žilinský kraj";113;372;24;396;NA;350342;137;2022-04-30;348902
2022-04-29;"Žilinský kraj";127;842;29;871;NA;350342;156;2022-04-29;348765
2022-04-28;"Žilinský kraj";117;613;47;660;NA;350342;164;2022-04-28;348609
2022-04-27;"Žilinský kraj";125;874;16;890;NA;350342;141;2022-04-27;348445
2022-04-26;"Žilinský kraj";207;725;30;755;NA;350342;237;2022-04-26;348304
2022-04-25;"Žilinský kraj";218;1155;79;1234;NA;350342;297;2022-04-25;348067
2022-04-24;"Žilinský kraj";8;251;20;271;NA;350342;28;2022-04-24;347770
2022-04-23;"Žilinský kraj";212;391;22;413;NA;350342;234;2022-04-23;347742
2022-04-22;"Žilinský kraj";126;548;35;583;NA;350342;161;2022-04-22;347508
2022-04-21;"Žilinský kraj";218;781;63;844;NA;350342;281;2022-04-21;347347
2022-04-20;"Žilinský kraj";366;915;52;967;NA;350342;418;2022-04-20;347066
2022-04-19;"Žilinský kraj";346;1852;79;1931;NA;350342;425;2022-04-19;346648
2022-04-18;"Žilinský kraj";84;368;27;395;NA;350342;111;2022-04-18;346223
2022-04-17;"Žilinský kraj";157;175;13;188;NA;350342;170;2022-04-17;346112
2022-04-16;"Žilinský kraj";111;282;54;336;NA;350342;165;2022-04-16;345942
2022-04-15;"Žilinský kraj";43;223;11;234;NA;350342;54;2022-04-15;345777
2022-04-14;"Žilinský kraj";315;1195;53;1248;NA;350342;368;2022-04-14;345723
2022-04-13;"Žilinský kraj";331;1101;39;1140;NA;350342;370;2022-04-13;345355
2022-04-12;"Žilinský kraj";280;1079;42;1121;NA;350342;322;2022-04-12;344985
2022-04-11;"Žilinský kraj";453;1335;87;1422;NA;350342;540;2022-04-11;344663
2022-04-10;"Žilinský kraj";20;313;26;339;NA;350342;46;2022-04-10;344123
2022-04-09;"Žilinský kraj";233;261;38;299;NA;350342;271;2022-04-09;344077
2022-04-08;"Žilinský kraj";368;762;50;812;NA;350342;418;2022-04-08;343806
2022-04-07;"Žilinský kraj";359;797;54;851;NA;350342;413;2022-04-07;343388
2022-04-06;"Žilinský kraj";541;1030;69;1099;NA;350342;610;2022-04-06;342975
2022-04-05;"Žilinský kraj";699;1038;78;1116;NA;350342;777;2022-04-05;342365
2022-04-04;"Žilinský kraj";605;1340;110;1450;NA;350342;715;2022-04-04;341588
2022-04-03;"Žilinský kraj";82;268;34;302;NA;350342;116;2022-04-03;340873
2022-04-02;"Žilinský kraj";289;224;33;257;NA;350342;322;2022-04-02;340757
2022-04-01;"Žilinský kraj";592;943;60;1003;NA;350342;652;2022-04-01;340435
2022-03-31;"Žilinský kraj";557;863;92;955;NA;350342;649;2022-03-31;339783
2022-03-30;"Žilinský kraj";688;1644;102;1746;NA;350342;790;2022-03-30;339134
2022-03-29;"Žilinský kraj";755;917;103;1020;NA;350342;858;2022-03-29;338344
2022-03-28;"Žilinský kraj";825;1744;141;1885;NA;350342;966;2022-03-28;337486
2022-03-27;"Žilinský kraj";88;414;91;505;NA;350342;179;2022-03-27;336520
2022-03-26;"Žilinský kraj";586;224;53;277;NA;350342;639;2022-03-26;336341
2022-03-25;"Žilinský kraj";601;866;100;966;NA;350342;701;2022-03-25;335702
2022-03-24;"Žilinský kraj";697;1433;100;1533;NA;350342;797;2022-03-24;335001
2022-03-23;"Žilinský kraj";883;940;103;1043;NA;350342;986;2022-03-23;334204
2022-03-22;"Žilinský kraj";1102;2516;136;2652;NA;350342;1238;2022-03-22;333218
2022-03-21;"Žilinský kraj";969;1921;163;2084;NA;350342;1132;2022-03-21;331980
2022-03-20;"Žilinský kraj";157;438;88;526;NA;350342;245;2022-03-20;330848
2022-03-19;"Žilinský kraj";479;340;69;409;NA;350342;548;2022-03-19;330603
2022-03-18;"Žilinský kraj";864;773;119;892;NA;350342;983;2022-03-18;330055
2022-03-17;"Žilinský kraj";733;1120;154;1274;NA;350342;887;2022-03-17;329072
2022-03-16;"Žilinský kraj";995;1371;165;1536;NA;350342;1160;2022-03-16;328185
2022-03-15;"Žilinský kraj";1252;2522;215;2737;NA;350342;1467;2022-03-15;327025
2022-03-14;"Žilinský kraj";1138;1546;209;1755;NA;350342;1347;2022-03-14;325558
2022-03-13;"Žilinský kraj";226;522;112;634;NA;350342;338;2022-03-13;324211
2022-03-12;"Žilinský kraj";650;346;94;440;NA;350342;744;2022-03-12;323873
2022-03-11;"Žilinský kraj";824;1755;197;1952;NA;350342;1021;2022-03-11;323129
2022-03-10;"Žilinský kraj";1249;1519;169;1688;NA;350342;1418;2022-03-10;322108
2022-03-09;"Žilinský kraj";1713;1457;206;1663;NA;350342;1919;2022-03-09;320690
2022-03-08;"Žilinský kraj";699;2333;311;2644;NA;350342;1010;2022-03-08;318771
2022-03-07;"Žilinský kraj";1448;2225;300;2525;NA;350342;1748;2022-03-07;317761
2022-03-06;"Žilinský kraj";323;797;211;1008;NA;350342;534;2022-03-06;316013
2022-03-05;"Žilinský kraj";576;572;129;701;NA;350342;705;2022-03-05;315479
2022-03-04;"Žilinský kraj";1194;1884;264;2148;NA;350342;1458;2022-03-04;314774
2022-03-03;"Žilinský kraj";1240;1852;247;2099;NA;350342;1487;2022-03-03;313316
2022-03-02;"Žilinský kraj";1194;1798;250;2048;NA;350342;1444;2022-03-02;311829
2022-03-01;"Žilinský kraj";1710;2974;347;3321;NA;350342;2057;2022-03-01;310385
2022-02-28;"Žilinský kraj";1700;2980;355;3335;NA;350342;2055;2022-02-28;308328
2022-02-27;"Žilinský kraj";224;940;221;1161;NA;350342;445;2022-02-27;306273
2022-02-26;"Žilinský kraj";1184;816;171;987;NA;350342;1355;2022-02-26;305828
2022-02-25;"Žilinský kraj";1371;2421;320;2741;NA;350342;1691;2022-02-25;304473
2022-02-24;"Žilinský kraj";1504;2589;314;2903;NA;350342;1818;2022-02-24;302782
2022-02-23;"Žilinský kraj";1766;3298;333;3631;NA;350342;2099;2022-02-23;300964
2022-02-22;"Žilinský kraj";2419;3369;406;3775;NA;350342;2825;2022-02-22;298865
2022-02-21;"Žilinský kraj";2227;4183;573;4756;NA;350342;2800;2022-02-21;296040
2022-02-20;"Žilinský kraj";541;1473;304;1777;NA;350342;845;2022-02-20;293240
2022-02-19;"Žilinský kraj";1656;944;273;1217;NA;350342;1929;2022-02-19;292395
2022-02-18;"Žilinský kraj";1994;3339;439;3778;NA;350342;2433;2022-02-18;290466
2022-02-17;"Žilinský kraj";2274;3019;424;3443;NA;350342;2698;2022-02-17;288033
2022-02-16;"Žilinský kraj";2676;3579;496;4075;NA;350342;3172;2022-02-16;285335
2022-02-15;"Žilinský kraj";2939;4226;604;4830;NA;350342;3543;2022-02-15;282163
2022-02-14;"Žilinský kraj";2955;4182;777;4959;NA;350342;3732;2022-02-14;278620
2022-02-13;"Žilinský kraj";751;1842;464;2306;NA;350342;1215;2022-02-13;274888
2022-02-12;"Žilinský kraj";1771;1431;319;1750;NA;350342;2090;2022-02-12;273673
2022-02-11;"Žilinský kraj";2856;3332;570;3902;NA;350342;3426;2022-02-11;271583
2022-02-10;"Žilinský kraj";2861;3472;583;4055;NA;350342;3444;2022-02-10;268157
2022-02-09;"Žilinský kraj";3365;3863;618;4481;NA;350342;3983;2022-02-09;264713
2022-02-08;"Žilinský kraj";3367;4866;780;5646;NA;350342;4147;2022-02-08;260730
2022-02-07;"Žilinský kraj";3242;5569;913;6482;NA;350342;4155;2022-02-07;256583
2022-02-06;"Žilinský kraj";1389;2587;529;3116;NA;350342;1918;2022-02-06;252428
2022-02-05;"Žilinský kraj";2107;1846;425;2271;NA;350342;2532;2022-02-05;250510
2022-02-04;"Žilinský kraj";3099;4389;631;5020;NA;350342;3730;2022-02-04;247978
2022-02-03;"Žilinský kraj";3201;4122;613;4735;NA;350342;3814;2022-02-03;244248
2022-02-02;"Žilinský kraj";3168;4616;666;5282;NA;350342;3834;2022-02-02;240434
2022-02-01;"Žilinský kraj";3593;5240;694;5934;NA;350342;4287;2022-02-01;236600
2022-01-31;"Žilinský kraj";2145;7492;931;8423;NA;350342;3076;2022-01-31;232313
2022-01-30;"Žilinský kraj";1487;2898;431;3329;NA;350342;1918;2022-01-30;229237
2022-01-29;"Žilinský kraj";2055;2033;365;2398;NA;350342;2420;2022-01-29;227319
2022-01-28;"Žilinský kraj";2572;4800;546;5346;NA;350342;3118;2022-01-28;224899
2022-01-27;"Žilinský kraj";2406;4038;537;4575;NA;350342;2943;2022-01-27;221781
2022-01-26;"Žilinský kraj";2693;5009;516;5525;NA;350342;3209;2022-01-26;218838
2022-01-25;"Žilinský kraj";2595;5626;416;6042;NA;350342;3011;2022-01-25;215629
2022-01-24;"Žilinský kraj";1401;7098;522;7620;NA;350342;1923;2022-01-24;212618
2022-01-23;"Žilinský kraj";654;2923;276;3199;NA;350342;930;2022-01-23;210695
2022-01-22;"Žilinský kraj";1256;1706;206;1912;NA;350342;1462;2022-01-22;209765
2022-01-21;"Žilinský kraj";1188;4187;265;4452;NA;350342;1453;2022-01-21;208303
2022-01-20;"Žilinský kraj";1288;3654;205;3859;NA;350342;1493;2022-01-20;206850
2022-01-19;"Žilinský kraj";1215;4086;206;4292;NA;350342;1421;2022-01-19;205357
2022-01-18;"Žilinský kraj";1191;4213;168;4381;NA;350342;1359;2022-01-18;203936
2022-01-17;"Žilinský kraj";675;6886;256;7142;NA;350342;931;2022-01-17;202577
2022-01-16;"Žilinský kraj";175;2418;106;2524;NA;350342;281;2022-01-16;201646
2022-01-15;"Žilinský kraj";398;1410;70;1480;NA;350342;468;2022-01-15;201365
2022-01-14;"Žilinský kraj";446;3716;106;3822;NA;350342;552;2022-01-14;200897
2022-01-13;"Žilinský kraj";295;2912;78;2990;NA;350342;373;2022-01-13;200345
2022-01-12;"Žilinský kraj";422;3168;72;3240;NA;350342;494;2022-01-12;199972
2022-01-11;"Žilinský kraj";622;4216;57;4273;NA;350342;679;2022-01-11;199478
2022-01-10;"Žilinský kraj";436;6344;102;6446;NA;350342;538;2022-01-10;198799
2022-01-09;"Žilinský kraj";95;2934;54;2988;NA;350342;149;2022-01-09;198261
2022-01-08;"Žilinský kraj";345;1650;45;1695;NA;350342;390;2022-01-08;198112
2022-01-07;"Žilinský kraj";525;4566;75;4641;NA;350342;600;2022-01-07;197722
2022-01-06;"Žilinský kraj";167;1214;40;1254;NA;350342;207;2022-01-06;197122
2022-01-05;"Žilinský kraj";471;3492;75;3567;NA;350342;546;2022-01-05;196915
2022-01-04;"Žilinský kraj";606;3762;87;3849;NA;350342;693;2022-01-04;196369
2022-01-03;"Žilinský kraj";601;6083;116;6199;NA;350342;717;2022-01-03;195676
2022-01-02;"Žilinský kraj";288;2596;85;2681;NA;350342;373;2022-01-02;194959
2022-01-01;"Žilinský kraj";14;439;15;454;NA;350342;29;2022-01-01;194586
2021-12-31;"Žilinský kraj";323;1608;70;1678;NA;350342;393;2021-12-31;194557
2021-12-30;"Žilinský kraj";492;2213;95;2308;NA;350342;587;2021-12-30;194164
2021-12-29;"Žilinský kraj";543;6864;83;6947;NA;350342;626;2021-12-29;193577
2021-12-28;"Žilinský kraj";641;3408;106;3514;NA;350342;747;2021-12-28;192951
2021-12-27;"Žilinský kraj";691;3961;145;4106;NA;350342;836;2021-12-27;192204
2021-12-26;"Žilinský kraj";242;1167;58;1225;NA;350342;300;2021-12-26;191368
2021-12-25;"Žilinský kraj";22;442;45;487;NA;350342;67;2021-12-25;191068
2021-12-24;"Žilinský kraj";98;518;21;539;NA;350342;119;2021-12-24;191001
2021-12-23;"Žilinský kraj";731;2678;105;2783;NA;350342;836;2021-12-23;190882
2021-12-22;"Žilinský kraj";510;2428;77;2505;NA;350342;587;2021-12-22;190046
2021-12-21;"Žilinský kraj";755;3641;102;3743;NA;350342;857;2021-12-21;189459
2021-12-20;"Žilinský kraj";563;4545;125;4670;NA;350342;688;2021-12-20;188602
2021-12-19;"Žilinský kraj";133;2215;90;2305;NA;350342;223;2021-12-19;187914
2021-12-18;"Žilinský kraj";417;1321;70;1391;NA;350342;487;2021-12-18;187691
2021-12-17;"Žilinský kraj";604;3895;127;4022;NA;350342;731;2021-12-17;187204
2021-12-16;"Žilinský kraj";660;3931;109;4040;NA;350342;769;2021-12-16;186473
2021-12-15;"Žilinský kraj";802;3491;122;3613;NA;350342;924;2021-12-15;185704
2021-12-14;"Žilinský kraj";798;4587;129;4716;NA;350342;927;2021-12-14;184780
2021-12-13;"Žilinský kraj";759;7755;212;7967;NA;350342;971;2021-12-13;183853
2021-12-12;"Žilinský kraj";340;2836;114;2950;NA;350342;454;2021-12-12;182882
2021-12-11;"Žilinský kraj";761;1849;112;1961;NA;350342;873;2021-12-11;182428
2021-12-10;"Žilinský kraj";638;4041;136;4177;NA;350342;774;2021-12-10;181555
2021-12-09;"Žilinský kraj";870;5842;161;6003;NA;350342;1031;2021-12-09;180781
2021-12-08;"Žilinský kraj";1018;3215;158;3373;NA;350342;1176;2021-12-08;179750
2021-12-07;"Žilinský kraj";1356;5148;160;5308;NA;350342;1516;2021-12-07;178574
2021-12-06;"Žilinský kraj";919;7441;226;7667;NA;350342;1145;2021-12-06;177058
2021-12-05;"Žilinský kraj";505;3306;134;3440;NA;350342;639;2021-12-05;175913
2021-12-04;"Žilinský kraj";704;1892;153;2045;NA;350342;857;2021-12-04;175274
2021-12-03;"Žilinský kraj";1204;4864;215;5079;NA;350342;1419;2021-12-03;174417
2021-12-02;"Žilinský kraj";1847;4131;199;4330;NA;350342;2046;2021-12-02;172998
2021-12-01;"Žilinský kraj";1183;4073;195;4268;NA;350342;1378;2021-12-01;170952
2021-11-30;"Žilinský kraj";1575;5467;252;5719;NA;350342;1827;2021-11-30;169574
2021-11-29;"Žilinský kraj";1395;9069;358;9427;NA;350342;1753;2021-11-29;167747
2021-11-28;"Žilinský kraj";625;4581;235;4816;NA;350342;860;2021-11-28;165994
2021-11-27;"Žilinský kraj";909;2557;192;2749;NA;350342;1101;2021-11-27;165134
2021-11-26;"Žilinský kraj";1195;6599;344;6943;NA;350342;1539;2021-11-26;164033
2021-11-25;"Žilinský kraj";1281;4701;331;5032;NA;350342;1612;2021-11-25;162494
2021-11-24;"Žilinský kraj";1792;4660;324;4984;NA;350342;2116;2021-11-24;160882
2021-11-23;"Žilinský kraj";1630;4654;353;5007;NA;350342;1983;2021-11-23;158766
2021-11-22;"Žilinský kraj";1126;6699;452;7151;NA;350342;1578;2021-11-22;156783
2021-11-21;"Žilinský kraj";443;2865;260;3125;NA;350342;703;2021-11-21;155205
2021-11-20;"Žilinský kraj";963;2104;241;2345;NA;350342;1204;2021-11-20;154502
2021-11-19;"Žilinský kraj";1281;4622;434;5056;NA;350342;1715;2021-11-19;153298
2021-11-18;"Žilinský kraj";1220;4432;376;4808;NA;350342;1596;2021-11-18;151583
2021-11-17;"Žilinský kraj";1001;1434;149;1583;NA;350342;1150;2021-11-17;149987
2021-11-16;"Žilinský kraj";1197;4058;323;4381;NA;350342;1520;2021-11-16;148837
2021-11-15;"Žilinský kraj";977;5050;476;5526;NA;350342;1453;2021-11-15;147317
2021-11-14;"Žilinský kraj";356;2287;262;2549;NA;350342;618;2021-11-14;145864
2021-11-13;"Žilinský kraj";652;1882;220;2102;NA;350342;872;2021-11-13;145246
2021-11-12;"Žilinský kraj";1027;4291;340;4631;NA;350342;1367;2021-11-12;144374
2021-11-11;"Žilinský kraj";924;4192;272;4464;NA;350342;1196;2021-11-11;143007
2021-11-10;"Žilinský kraj";897;4509;305;4814;NA;350342;1202;2021-11-10;141811
2021-11-09;"Žilinský kraj";1440;4619;256;4875;NA;350342;1696;2021-11-09;140609
2021-11-08;"Žilinský kraj";781;4438;425;4863;NA;350342;1206;2021-11-08;138913
2021-11-07;"Žilinský kraj";304;2130;231;2361;NA;350342;535;2021-11-07;137707
2021-11-06;"Žilinský kraj";741;2150;201;2351;NA;350342;942;2021-11-06;137172
2021-11-05;"Žilinský kraj";1064;4067;235;4302;NA;350342;1299;2021-11-05;136230
2021-11-04;"Žilinský kraj";776;3709;232;3941;NA;350342;1008;2021-11-04;134931
2021-11-03;"Žilinský kraj";1106;5550;338;5888;NA;350342;1444;2021-11-03;133923
2021-11-02;"Žilinský kraj";1136;4451;333;4784;NA;350342;1469;2021-11-02;132479
2021-11-01;"Žilinský kraj";399;1456;137;1593;NA;350342;536;2021-11-01;131010
2021-10-31;"Žilinský kraj";344;1387;145;1532;NA;350342;489;2021-10-31;130474
2021-10-30;"Žilinský kraj";571;1944;161;2105;NA;350342;732;2021-10-30;129985
2021-10-29;"Žilinský kraj";733;3339;194;3533;NA;350342;927;2021-10-29;129253
2021-10-28;"Žilinský kraj";639;4953;247;5200;NA;350342;886;2021-10-28;128326
2021-10-27;"Žilinský kraj";739;3446;173;3619;NA;350342;912;2021-10-27;127440
2021-10-26;"Žilinský kraj";945;4748;216;4964;NA;350342;1161;2021-10-26;126528
2021-10-25;"Žilinský kraj";649;5736;271;6007;NA;350342;920;2021-10-25;125367
2021-10-24;"Žilinský kraj";248;1679;107;1786;NA;350342;355;2021-10-24;124447
2021-10-23;"Žilinský kraj";399;2415;149;2564;NA;350342;548;2021-10-23;124092
2021-10-22;"Žilinský kraj";587;3898;151;4049;NA;350342;738;2021-10-22;123544
2021-10-21;"Žilinský kraj";591;3367;162;3529;NA;350342;753;2021-10-21;122806
2021-10-20;"Žilinský kraj";479;3864;154;4018;NA;350342;633;2021-10-20;122053
2021-10-19;"Žilinský kraj";675;3763;161;3924;NA;350342;836;2021-10-19;121420
2021-10-18;"Žilinský kraj";432;5160;271;5431;NA;350342;703;2021-10-18;120584
2021-10-17;"Žilinský kraj";135;1769;101;1870;NA;350342;236;2021-10-17;119881
2021-10-16;"Žilinský kraj";273;2341;100;2441;NA;350342;373;2021-10-16;119645
2021-10-15;"Žilinský kraj";347;3859;146;4005;NA;350342;493;2021-10-15;119272
2021-10-14;"Žilinský kraj";419;3035;110;3145;NA;350342;529;2021-10-14;118779
2021-10-13;"Žilinský kraj";404;3427;112;3539;NA;350342;516;2021-10-13;118250
2021-10-12;"Žilinský kraj";589;4000;141;4141;NA;350342;730;2021-10-12;117734
2021-10-11;"Žilinský kraj";323;4501;154;4655;NA;350342;477;2021-10-11;117004
2021-10-10;"Žilinský kraj";113;1577;77;1654;NA;350342;190;2021-10-10;116527
2021-10-09;"Žilinský kraj";201;1565;57;1622;NA;350342;258;2021-10-09;116337
2021-10-08;"Žilinský kraj";265;4227;99;4326;NA;350342;364;2021-10-08;116079
2021-10-07;"Žilinský kraj";338;3384;113;3497;NA;350342;451;2021-10-07;115715
2021-10-06;"Žilinský kraj";313;3901;89;3990;NA;350342;402;2021-10-06;115264
2021-10-05;"Žilinský kraj";387;4031;122;4153;NA;350342;509;2021-10-05;114862
2021-10-04;"Žilinský kraj";297;4449;121;4570;NA;350342;418;2021-10-04;114353
2021-10-03;"Žilinský kraj";22;1596;63;1659;NA;350342;85;2021-10-03;113935
2021-10-02;"Žilinský kraj";209;1990;45;2035;NA;350342;254;2021-10-02;113850
2021-10-01;"Žilinský kraj";263;4047;104;4151;NA;350342;367;2021-10-01;113596
2021-09-30;"Žilinský kraj";248;3531;71;3602;NA;350342;319;2021-09-30;113229
2021-09-29;"Žilinský kraj";285;3577;82;3659;NA;350342;367;2021-09-29;112910
2021-09-28;"Žilinský kraj";272;3656;73;3729;NA;350342;345;2021-09-28;112543
2021-09-27;"Žilinský kraj";239;4418;152;4570;NA;350342;391;2021-09-27;112198
2021-09-26;"Žilinský kraj";17;1665;42;1707;NA;350342;59;2021-09-26;111807
2021-09-25;"Žilinský kraj";111;1711;50;1761;NA;350342;161;2021-09-25;111748
2021-09-24;"Žilinský kraj";199;6127;98;6225;NA;350342;297;2021-09-24;111587
2021-09-23;"Žilinský kraj";176;2629;74;2703;NA;350342;250;2021-09-23;111290
2021-09-22;"Žilinský kraj";185;2728;77;2805;NA;350342;262;2021-09-22;111040
2021-09-21;"Žilinský kraj";250;3123;78;3201;NA;350342;328;2021-09-21;110778
2021-09-20;"Žilinský kraj";244;3231;95;3326;NA;350342;339;2021-09-20;110450
2021-09-19;"Žilinský kraj";26;1579;37;1616;NA;350342;63;2021-09-19;110111
2021-09-18;"Žilinský kraj";87;1441;45;1486;NA;350342;132;2021-09-18;110048
2021-09-17;"Žilinský kraj";192;3351;56;3407;NA;350342;248;2021-09-17;109916
2021-09-16;"Žilinský kraj";164;2744;87;2831;NA;350342;251;2021-09-16;109668
2021-09-15;"Žilinský kraj";31;555;11;566;NA;350342;42;2021-09-15;109417
2021-09-14;"Žilinský kraj";155;3268;61;3329;NA;350342;216;2021-09-14;109375
2021-09-13;"Žilinský kraj";81;3250;75;3325;NA;350342;156;2021-09-13;109159
2021-09-12;"Žilinský kraj";9;1138;24;1162;NA;350342;33;2021-09-12;109003
2021-09-11;"Žilinský kraj";47;1322;21;1343;NA;350342;68;2021-09-11;108970
2021-09-10;"Žilinský kraj";66;2439;34;2473;NA;350342;100;2021-09-10;108902
2021-09-09;"Žilinský kraj";56;2352;18;2370;NA;350342;74;2021-09-09;108802
2021-09-08;"Žilinský kraj";68;1560;24;1584;NA;350342;92;2021-09-08;108728
2021-09-07;"Žilinský kraj";72;1806;27;1833;NA;350342;99;2021-09-07;108636
2021-09-06;"Žilinský kraj";31;2381;45;2426;NA;350342;76;2021-09-06;108537
2021-09-05;"Žilinský kraj";11;785;8;793;NA;350342;19;2021-09-05;108461
2021-09-04;"Žilinský kraj";24;1080;5;1085;NA;350342;29;2021-09-04;108442
2021-09-03;"Žilinský kraj";52;2047;28;2075;NA;350342;80;2021-09-03;108413
2021-09-02;"Žilinský kraj";30;1432;22;1454;NA;350342;52;2021-09-02;108333
2021-09-01;"Žilinský kraj";5;461;6;467;NA;350342;11;2021-09-01;108281
2021-08-31;"Žilinský kraj";32;1710;15;1725;NA;350342;47;2021-08-31;108270
2021-08-30;"Žilinský kraj";7;1801;4;1805;NA;350342;11;2021-08-30;108223
2021-08-29;"Žilinský kraj";8;631;5;636;NA;350342;13;2021-08-29;108212
2021-08-28;"Žilinský kraj";2;1005;1;1006;NA;350342;3;2021-08-28;108199
2021-08-27;"Žilinský kraj";13;1765;12;1777;NA;350342;25;2021-08-27;108196
2021-08-26;"Žilinský kraj";17;1636;7;1643;NA;350342;24;2021-08-26;108171
2021-08-25;"Žilinský kraj";9;1203;11;1214;NA;350342;20;2021-08-25;108147
2021-08-24;"Žilinský kraj";6;1395;9;1404;NA;350342;15;2021-08-24;108127
2021-08-23;"Žilinský kraj";11;1877;7;1884;NA;350342;18;2021-08-23;108112
2021-08-22;"Žilinský kraj";2;733;3;736;NA;350342;5;2021-08-22;108094
2021-08-21;"Žilinský kraj";6;1183;2;1185;NA;350342;8;2021-08-21;108089
2021-08-20;"Žilinský kraj";7;2284;5;2289;NA;350342;12;2021-08-20;108081
2021-08-19;"Žilinský kraj";6;1281;3;1284;NA;350342;9;2021-08-19;108069
2021-08-18;"Žilinský kraj";4;1331;7;1338;NA;350342;11;2021-08-18;108060
2021-08-17;"Žilinský kraj";9;1219;3;1222;NA;350342;12;2021-08-17;108049
2021-08-16;"Žilinský kraj";14;1696;5;1701;NA;350342;19;2021-08-16;108037
2021-08-15;"Žilinský kraj";1;880;2;882;NA;350342;3;2021-08-15;108018
2021-08-14;"Žilinský kraj";5;1197;0;1197;NA;350342;5;2021-08-14;108015
2021-08-13;"Žilinský kraj";6;1685;0;1685;NA;350342;6;2021-08-13;108010
2021-08-12;"Žilinský kraj";4;1105;1;1106;NA;350342;5;2021-08-12;108004
2021-08-11;"Žilinský kraj";13;1250;3;1253;NA;350342;16;2021-08-11;107999
2021-08-10;"Žilinský kraj";12;1292;3;1295;NA;350342;15;2021-08-10;107983
2021-08-09;"Žilinský kraj";9;1142;1;1143;NA;350342;10;2021-08-09;107968
2021-08-08;"Žilinský kraj";1;748;5;753;NA;350342;6;2021-08-08;107958
2021-08-07;"Žilinský kraj";7;1192;1;1193;NA;350342;8;2021-08-07;107952
2021-08-06;"Žilinský kraj";1;1347;0;1347;NA;350342;1;2021-08-06;107944
2021-08-05;"Žilinský kraj";7;1148;3;1151;NA;350342;10;2021-08-05;107943
2021-08-04;"Žilinský kraj";12;895;0;895;NA;350342;12;2021-08-04;107933
2021-08-03;"Žilinský kraj";11;918;0;918;NA;350342;11;2021-08-03;107921
2021-08-02;"Žilinský kraj";5;1513;1;1514;NA;350342;6;2021-08-02;107910
2021-08-01;"Žilinský kraj";0;679;2;681;NA;350342;2;2021-08-01;107904
2021-07-31;"Žilinský kraj";4;1114;0;1114;NA;350342;4;2021-07-31;107902
2021-07-30;"Žilinský kraj";3;1671;0;1671;NA;350342;3;2021-07-30;107898
2021-07-29;"Žilinský kraj";1;1299;0;1299;NA;350342;1;2021-07-29;107895
2021-07-28;"Žilinský kraj";4;901;0;901;NA;350342;4;2021-07-28;107894
2021-07-27;"Žilinský kraj";11;1378;0;1378;NA;350342;11;2021-07-27;107890
2021-07-26;"Žilinský kraj";1;1301;1;1302;NA;350342;2;2021-07-26;107879
2021-07-25;"Žilinský kraj";2;828;2;830;NA;350342;4;2021-07-25;107877
2021-07-24;"Žilinský kraj";2;1338;2;1340;NA;350342;4;2021-07-24;107873
2021-07-23;"Žilinský kraj";4;1750;0;1750;NA;350342;4;2021-07-23;107869
2021-07-22;"Žilinský kraj";2;1207;0;1207;NA;350342;2;2021-07-22;107865
2021-07-21;"Žilinský kraj";2;1021;0;1021;NA;350342;2;2021-07-21;107863
2021-07-20;"Žilinský kraj";4;1439;0;1439;NA;350342;4;2021-07-20;107861
2021-07-19;"Žilinský kraj";4;1763;1;1764;NA;350342;5;2021-07-19;107857
2021-07-18;"Žilinský kraj";0;854;1;855;NA;350342;1;2021-07-18;107852
2021-07-17;"Žilinský kraj";0;1350;0;1350;NA;350342;0;2021-07-17;107851
2021-07-16;"Žilinský kraj";2;1767;0;1767;NA;350342;2;2021-07-16;107851
2021-07-15;"Žilinský kraj";2;1577;0;1577;NA;350342;2;2021-07-15;107849
2021-07-14;"Žilinský kraj";5;1042;1;1043;NA;350342;6;2021-07-14;107847
2021-07-13;"Žilinský kraj";3;1709;1;1710;NA;350342;4;2021-07-13;107841
2021-07-12;"Žilinský kraj";3;1325;1;1326;NA;350342;4;2021-07-12;107837
2021-07-11;"Žilinský kraj";2;989;0;989;NA;350342;2;2021-07-11;107833
2021-07-10;"Žilinský kraj";1;1511;4;1515;NA;350342;5;2021-07-10;107831
2021-07-09;"Žilinský kraj";1;2208;1;2209;NA;350342;2;2021-07-09;107826
2021-07-08;"Žilinský kraj";6;1776;3;1779;NA;350342;9;2021-07-08;107824
2021-07-07;"Žilinský kraj";1;1585;3;1588;NA;350342;4;2021-07-07;107815
2021-07-06;"Žilinský kraj";4;1956;0;1956;NA;350342;4;2021-07-06;107811
2021-07-05;"Žilinský kraj";2;1031;1;1032;NA;350342;3;2021-07-05;107807
2021-07-04;"Žilinský kraj";0;1003;0;1003;NA;350342;0;2021-07-04;107804
2021-07-03;"Žilinský kraj";1;1696;2;1698;NA;350342;3;2021-07-03;107804
2021-07-02;"Žilinský kraj";0;3356;2;3358;NA;350342;2;2021-07-02;107801
2021-07-01;"Žilinský kraj";1;1118;0;1118;NA;350342;1;2021-07-01;107799
2021-06-30;"Žilinský kraj";1;10464;6;10470;NA;350342;7;2021-06-30;107798
2021-06-29;"Žilinský kraj";10;5946;0;5946;NA;350342;10;2021-06-29;107791
2021-06-28;"Žilinský kraj";4;6245;2;6247;NA;350342;6;2021-06-28;107781
2021-06-27;"Žilinský kraj";3;4702;1;4703;NA;350342;4;2021-06-27;107775
2021-06-26;"Žilinský kraj";4;5919;0;5919;NA;350342;4;2021-06-26;107771
2021-06-25;"Žilinský kraj";8;9756;5;9761;NA;350342;13;2021-06-25;107767
2021-06-24;"Žilinský kraj";6;5657;3;5660;NA;350342;9;2021-06-24;107754
2021-06-23;"Žilinský kraj";7;5955;10;5965;NA;350342;17;2021-06-23;107745
2021-06-22;"Žilinský kraj";6;5214;8;5222;NA;350342;14;2021-06-22;107728
2021-06-21;"Žilinský kraj";6;6287;8;6295;NA;350342;14;2021-06-21;107714
2021-06-20;"Žilinský kraj";1;5531;8;5539;NA;350342;9;2021-06-20;107700
2021-06-19;"Žilinský kraj";9;8353;2;8355;NA;350342;11;2021-06-19;107691
2021-06-18;"Žilinský kraj";11;10624;12;10636;NA;350342;23;2021-06-18;107680
2021-06-17;"Žilinský kraj";10;6092;12;6104;NA;350342;22;2021-06-17;107657
2021-06-16;"Žilinský kraj";17;5786;11;5797;NA;350342;28;2021-06-16;107635
2021-06-15;"Žilinský kraj";13;5996;13;6009;NA;350342;26;2021-06-15;107607
2021-06-14;"Žilinský kraj";10;7596;21;7617;NA;350342;31;2021-06-14;107581
2021-06-13;"Žilinský kraj";2;6682;9;6691;NA;350342;11;2021-06-13;107550
2021-06-12;"Žilinský kraj";9;8634;11;8645;NA;350342;20;2021-06-12;107539
2021-06-11;"Žilinský kraj";11;11566;14;11580;NA;350342;25;2021-06-11;107519
2021-06-10;"Žilinský kraj";14;6788;14;6802;NA;350342;28;2021-06-10;107494
2021-06-09;"Žilinský kraj";23;5925;14;5939;NA;350342;37;2021-06-09;107466
2021-06-08;"Žilinský kraj";18;6615;16;6631;NA;350342;34;2021-06-08;107429
2021-06-07;"Žilinský kraj";25;8534;21;8555;NA;350342;46;2021-06-07;107395
2021-06-06;"Žilinský kraj";10;8056;27;8083;NA;350342;37;2021-06-06;107349
2021-06-05;"Žilinský kraj";8;9175;10;9185;NA;350342;18;2021-06-05;107312
2021-06-04;"Žilinský kraj";19;12260;34;12294;NA;350342;53;2021-06-04;107294
2021-06-03;"Žilinský kraj";12;7033;33;7066;NA;350342;45;2021-06-03;107241
2021-06-02;"Žilinský kraj";17;7103;28;7131;NA;350342;45;2021-06-02;107196
2021-06-01;"Žilinský kraj";38;8285;46;8331;NA;350342;84;2021-06-01;107151
2021-05-31;"Žilinský kraj";31;9616;59;9675;NA;350342;90;2021-05-31;107067
2021-05-30;"Žilinský kraj";21;9025;35;9060;NA;350342;56;2021-05-30;106977
2021-05-29;"Žilinský kraj";13;11195;23;11218;NA;350342;36;2021-05-29;106921
2021-05-28;"Žilinský kraj";28;13277;30;13307;NA;350342;58;2021-05-28;106885
2021-05-27;"Žilinský kraj";17;8267;39;8306;NA;350342;56;2021-05-27;106827
2021-05-26;"Žilinský kraj";20;8329;25;8354;NA;350342;45;2021-05-26;106771
2021-05-25;"Žilinský kraj";21;9624;38;9662;NA;350342;59;2021-05-25;106726
2021-05-24;"Žilinský kraj";36;11487;57;11544;NA;350342;93;2021-05-24;106667
2021-05-23;"Žilinský kraj";4;10923;56;10979;NA;350342;60;2021-05-23;106574
2021-05-22;"Žilinský kraj";21;11893;28;11921;NA;350342;49;2021-05-22;106514
2021-05-21;"Žilinský kraj";28;15654;50;15704;NA;350342;78;2021-05-21;106465
2021-05-20;"Žilinský kraj";30;9616;30;9646;NA;350342;60;2021-05-20;106387
2021-05-19;"Žilinský kraj";46;8693;41;8734;NA;350342;87;2021-05-19;106327
2021-05-18;"Žilinský kraj";52;10609;44;10653;NA;350342;96;2021-05-18;106240
2021-05-17;"Žilinský kraj";51;12676;84;12760;NA;350342;135;2021-05-17;106144
2021-05-16;"Žilinský kraj";13;14114;42;14156;NA;350342;55;2021-05-16;106009
2021-05-15;"Žilinský kraj";30;18404;35;18439;NA;350342;65;2021-05-15;105954
2021-05-14;"Žilinský kraj";34;21205;82;21287;NA;350342;116;2021-05-14;105889
2021-05-13;"Žilinský kraj";64;11865;51;11916;NA;350342;115;2021-05-13;105773
2021-05-12;"Žilinský kraj";57;10337;51;10388;NA;350342;108;2021-05-12;105658
2021-05-11;"Žilinský kraj";70;12174;51;12225;NA;350342;121;2021-05-11;105550
2021-05-10;"Žilinský kraj";69;16182;72;16254;NA;350342;141;2021-05-10;105429
2021-05-09;"Žilinský kraj";58;20385;77;20462;NA;350342;135;2021-05-09;105288
2021-05-08;"Žilinský kraj";0;24133;63;24196;NA;350342;63;2021-05-08;105153
2021-05-07;"Žilinský kraj";65;26522;87;26609;NA;350342;152;2021-05-07;105090
2021-05-06;"Žilinský kraj";67;16615;72;16687;NA;350342;139;2021-05-06;104938
2021-05-05;"Žilinský kraj";71;13096;73;13169;NA;350342;144;2021-05-05;104799
2021-05-04;"Žilinský kraj";81;16749;80;16829;NA;350342;161;2021-05-04;104655
2021-05-03;"Žilinský kraj";97;20391;111;20502;NA;350342;208;2021-05-03;104494
2021-05-02;"Žilinský kraj";8;28886;64;28950;NA;350342;72;2021-05-02;104286
2021-05-01;"Žilinský kraj";65;55053;105;55158;NA;350342;170;2021-05-01;104214
2021-04-30;"Žilinský kraj";84;44000;117;44117;NA;350342;201;2021-04-30;104044
2021-04-29;"Žilinský kraj";77;24566;101;24667;NA;350342;178;2021-04-29;103843
2021-04-28;"Žilinský kraj";76;19214;91;19305;NA;350342;167;2021-04-28;103665
2021-04-27;"Žilinský kraj";97;21805;110;21915;NA;350342;207;2021-04-27;103498
2021-04-26;"Žilinský kraj";114;27412;136;27548;NA;350342;250;2021-04-26;103291
2021-04-25;"Žilinský kraj";38;35750;82;35832;NA;350342;120;2021-04-25;103041
2021-04-24;"Žilinský kraj";93;78854;157;79011;NA;350342;250;2021-04-24;102921
2021-04-23;"Žilinský kraj";144;49440;153;49593;NA;350342;297;2021-04-23;102671
2021-04-22;"Žilinský kraj";110;25247;132;25379;NA;350342;242;2021-04-22;102374
2021-04-21;"Žilinský kraj";118;20616;145;20761;NA;350342;263;2021-04-21;102132
2021-04-20;"Žilinský kraj";128;23873;136;24009;NA;350342;264;2021-04-20;101869
2021-04-19;"Žilinský kraj";164;32773;210;32983;NA;350342;374;2021-04-19;101605
2021-04-18;"Žilinský kraj";18;36767;91;36858;NA;350342;109;2021-04-18;101231
2021-04-17;"Žilinský kraj";108;89377;156;89533;NA;350342;264;2021-04-17;101122
2021-04-16;"Žilinský kraj";185;47847;208;48055;NA;350342;393;2021-04-16;100858
2021-04-15;"Žilinský kraj";108;24830;130;24960;NA;350342;238;2021-04-15;100465
2021-04-14;"Žilinský kraj";135;23145;145;23290;NA;350342;280;2021-04-14;100227
2021-04-13;"Žilinský kraj";171;25050;135;25185;NA;350342;306;2021-04-13;99947
2021-04-12;"Žilinský kraj";266;30794;189;30983;NA;350342;455;2021-04-12;99641
2021-04-11;"Žilinský kraj";19;37126;107;37233;NA;350342;126;2021-04-11;99186
2021-04-10;"Žilinský kraj";111;86284;237;86521;NA;350342;348;2021-04-10;99060
2021-04-09;"Žilinský kraj";195;41973;206;42179;NA;350342;401;2021-04-09;98712
2021-04-08;"Žilinský kraj";179;24434;141;24575;NA;350342;320;2021-04-08;98311
2021-04-07;"Žilinský kraj";309;28651;174;28825;NA;350342;483;2021-04-07;97991
2021-04-06;"Žilinský kraj";308;40107;301;40408;NA;350342;609;2021-04-06;97508
2021-04-05;"Žilinský kraj";17;14747;140;14887;NA;350342;157;2021-04-05;96899
2021-04-04;"Žilinský kraj";17;16284;69;16353;NA;350342;86;2021-04-04;96742
2021-04-03;"Žilinský kraj";180;100699;403;101102;NA;350342;583;2021-04-03;96656
2021-04-02;"Žilinský kraj";73;22411;83;22494;NA;350342;156;2021-04-02;96073
2021-04-01;"Žilinský kraj";334;43264;240;43504;NA;350342;574;2021-04-01;95917
2021-03-31;"Žilinský kraj";170;31635;247;31882;NA;350342;417;2021-03-31;95343
2021-03-30;"Žilinský kraj";406;26323;243;26566;NA;350342;649;2021-03-30;94926
2021-03-29;"Žilinský kraj";297;28029;268;28297;NA;350342;565;2021-03-29;94277
2021-03-28;"Žilinský kraj";21;36206;239;36445;NA;350342;260;2021-03-28;93712
2021-03-27;"Žilinský kraj";151;89107;353;89460;NA;350342;504;2021-03-27;93452
2021-03-26;"Žilinský kraj";312;51757;330;52087;NA;350342;642;2021-03-26;92948
2021-03-25;"Žilinský kraj";281;27619;214;27833;NA;350342;495;2021-03-25;92306
2021-03-24;"Žilinský kraj";280;21268;260;21528;NA;350342;540;2021-03-24;91811
2021-03-23;"Žilinský kraj";418;23193;278;23471;NA;350342;696;2021-03-23;91271
2021-03-22;"Žilinský kraj";293;29289;314;29603;NA;350342;607;2021-03-22;90575
2021-03-21;"Žilinský kraj";32;33705;227;33932;NA;350342;259;2021-03-21;89968
2021-03-20;"Žilinský kraj";165;93015;497;93512;NA;350342;662;2021-03-20;89709
2021-03-19;"Žilinský kraj";357;51988;414;52402;NA;350342;771;2021-03-19;89047
2021-03-18;"Žilinský kraj";329;28459;294;28753;NA;350342;623;2021-03-18;88276
2021-03-17;"Žilinský kraj";395;21919;269;22188;NA;350342;664;2021-03-17;87653
2021-03-16;"Žilinský kraj";514;24341;317;24658;NA;350342;831;2021-03-16;86989
2021-03-15;"Žilinský kraj";341;29613;419;30032;NA;350342;760;2021-03-15;86158
2021-03-14;"Žilinský kraj";87;34121;267;34388;NA;350342;354;2021-03-14;85398
2021-03-13;"Žilinský kraj";113;93386;581;93967;NA;350342;694;2021-03-13;85044
2021-03-12;"Žilinský kraj";520;52329;411;52740;NA;350342;931;2021-03-12;84350
2021-03-11;"Žilinský kraj";399;28189;302;28491;NA;350342;701;2021-03-11;83419
2021-03-10;"Žilinský kraj";368;22414;378;22792;NA;350342;746;2021-03-10;82718
2021-03-09;"Žilinský kraj";537;24857;316;25173;NA;350342;853;2021-03-09;81972
2021-03-08;"Žilinský kraj";387;30873;458;31331;NA;350342;845;2021-03-08;81119
2021-03-07;"Žilinský kraj";48;33469;290;33759;NA;350342;338;2021-03-07;80274
2021-03-06;"Žilinský kraj";173;92410;589;92999;NA;350342;762;2021-03-06;79936
2021-03-05;"Žilinský kraj";369;51987;484;52471;NA;350342;853;2021-03-05;79174
2021-03-04;"Žilinský kraj";467;30037;377;30414;NA;350342;844;2021-03-04;78321
2021-03-03;"Žilinský kraj";448;26261;394;26655;NA;350342;842;2021-03-03;77477
2021-03-02;"Žilinský kraj";551;25913;378;26291;NA;350342;929;2021-03-02;76635
2021-03-01;"Žilinský kraj";375;30498;441;30939;NA;350342;816;2021-03-01;75706
2021-02-28;"Žilinský kraj";61;34802;327;35129;NA;350342;388;2021-02-28;74890
2021-02-27;"Žilinský kraj";159;83781;639;84420;NA;350342;798;2021-02-27;74502
2021-02-26;"Žilinský kraj";459;47500;508;48008;NA;350342;967;2021-02-26;73704
2021-02-25;"Žilinský kraj";347;30879;393;31272;NA;350342;740;2021-02-25;72737
2021-02-24;"Žilinský kraj";339;18760;395;19155;NA;350342;734;2021-02-24;71997
2021-02-23;"Žilinský kraj";437;22172;418;22590;NA;350342;855;2021-02-23;71263
2021-02-22;"Žilinský kraj";345;29270;438;29708;NA;350342;783;2021-02-22;70408
2021-02-21;"Žilinský kraj";36;28686;322;29008;NA;350342;358;2021-02-21;69625
2021-02-20;"Žilinský kraj";152;89944;671;90615;NA;350342;823;2021-02-20;69267
2021-02-19;"Žilinský kraj";337;45541;417;45958;NA;350342;754;2021-02-19;68444
2021-02-18;"Žilinský kraj";263;24662;337;24999;NA;350342;600;2021-02-18;67690
2021-02-17;"Žilinský kraj";269;17932;355;18287;NA;350342;624;2021-02-17;67090
2021-02-16;"Žilinský kraj";321;24298;325;24623;NA;350342;646;2021-02-16;66466
2021-02-15;"Žilinský kraj";230;30420;311;30731;NA;350342;541;2021-02-15;65820
2021-02-14;"Žilinský kraj";30;28723;231;28954;NA;350342;261;2021-02-14;65279
2021-02-13;"Žilinský kraj";91;69638;453;70091;NA;350342;544;2021-02-13;65018
2021-02-12;"Žilinský kraj";242;43338;336;43674;NA;350342;578;2021-02-12;64474
2021-02-11;"Žilinský kraj";228;23521;300;23821;NA;350342;528;2021-02-11;63896
2021-02-10;"Žilinský kraj";259;17894;267;18161;NA;350342;526;2021-02-10;63368
2021-02-09;"Žilinský kraj";377;24784;274;25058;NA;350342;651;2021-02-09;62842
2021-02-08;"Žilinský kraj";160;41375;390;41765;NA;350342;550;2021-02-08;62191
2021-02-07;"Žilinský kraj";24;46446;252;46698;NA;350342;276;2021-02-07;61641
2021-02-06;"Žilinský kraj";71;72880;367;73247;NA;350342;438;2021-02-06;61365
2021-02-05;"Žilinský kraj";248;31869;323;32192;NA;350342;571;2021-02-05;60927
2021-02-04;"Žilinský kraj";238;13240;258;13498;NA;350342;496;2021-02-04;60356
2021-02-03;"Žilinský kraj";194;9186;255;9441;NA;350342;449;2021-02-03;59860
2021-02-02;"Žilinský kraj";216;9280;272;9552;NA;350342;488;2021-02-02;59411
2021-02-01;"Žilinský kraj";220;19690;370;20060;NA;350342;590;2021-02-01;58923
2021-01-31;"Žilinský kraj";11;2652;27;2679;NA;350342;38;2021-01-31;58333
2021-01-30;"Žilinský kraj";85;18447;187;18634;NA;350342;272;2021-01-30;58295
2021-01-29;"Žilinský kraj";209;22891;304;23195;NA;350342;513;2021-01-29;58023
2021-01-28;"Žilinský kraj";240;5533;172;5705;NA;350342;412;2021-01-28;57510
2021-01-27;"Žilinský kraj";256;6725;119;6844;NA;350342;375;2021-01-27;57098
2021-01-26;"Žilinský kraj";245;49781;348;50129;NA;350342;593;2021-01-26;56723
2021-01-25;"Žilinský kraj";159;21245;150;21395;NA;350342;309;2021-01-25;56130
2021-01-24;"Žilinský kraj";22;55835;268;56103;NA;350342;290;2021-01-24;55821
2021-01-23;"Žilinský kraj";91;101730;444;102174;NA;350342;535;2021-01-23;55531
2021-01-22;"Žilinský kraj";163;32160;237;32397;NA;350342;400;2021-01-22;54996
2021-01-21;"Žilinský kraj";116;19828;181;20009;NA;350342;297;2021-01-21;54596
2021-01-20;"Žilinský kraj";236;17126;159;17285;NA;350342;395;2021-01-20;54299
2021-01-19;"Žilinský kraj";245;15730;285;16015;NA;350342;530;2021-01-19;53904
2021-01-18;"Žilinský kraj";236;12685;326;13011;NA;350342;562;2021-01-18;53374
2021-01-17;"Žilinský kraj";95;147;8;155;NA;350342;103;2021-01-17;52812
2021-01-16;"Žilinský kraj";14;516;31;547;NA;350342;45;2021-01-16;52709
2021-01-15;"Žilinský kraj";248;7486;209;7695;NA;350342;457;2021-01-15;52664
2021-01-14;"Žilinský kraj";166;5319;239;5558;NA;350342;405;2021-01-14;52207
2021-01-13;"Žilinský kraj";247;11263;557;11820;NA;350342;804;2021-01-13;51802
2021-01-12;"Žilinský kraj";376;8410;385;8795;NA;350342;761;2021-01-12;50998
2021-01-11;"Žilinský kraj";351;10058;465;10523;NA;350342;816;2021-01-11;50237
2021-01-10;"Žilinský kraj";38;229;6;235;NA;350342;44;2021-01-10;49421
2021-01-09;"Žilinský kraj";192;1282;60;1342;NA;350342;252;2021-01-09;49377
2021-01-08;"Žilinský kraj";413;8721;462;9183;NA;350342;875;2021-01-08;49125
2021-01-07;"Žilinský kraj";438;23407;1872;25279;NA;350342;2310;2021-01-07;48250
2021-01-06;"Žilinský kraj";145;1076;67;1143;NA;350342;212;2021-01-06;45940
2021-01-05;"Žilinský kraj";717;10227;796;11023;NA;350342;1513;2021-01-05;45728
2021-01-04;"Žilinský kraj";479;9313;893;10206;NA;350342;1372;2021-01-04;44215
2021-01-03;"Žilinský kraj";13;1006;107;1113;NA;350342;120;2021-01-03;42843
2021-01-02;"Žilinský kraj";98;789;91;880;NA;350342;189;2021-01-02;42723
2021-01-01;"Žilinský kraj";118;241;13;254;NA;350342;131;2021-01-01;42534
2020-12-31;"Žilinský kraj";395;9626;784;10410;NA;350342;1179;2020-12-31;42403
2020-12-30;"Žilinský kraj";1038;11781;823;12604;NA;350342;1861;2020-12-30;41224
2020-12-29;"Žilinský kraj";256;10159;979;11138;NA;350342;1235;2020-12-29;39363
2020-12-28;"Žilinský kraj";406;10704;976;11680;NA;350342;1382;2020-12-28;38128
2020-12-27;"Žilinský kraj";40;684;94;778;NA;350342;134;2020-12-27;36746
2020-12-26;"Žilinský kraj";135;593;48;641;NA;350342;183;2020-12-26;36612
2020-12-25;"Žilinský kraj";66;83;9;92;NA;350342;75;2020-12-25;36429
2020-12-24;"Žilinský kraj";643;667;55;722;NA;350342;698;2020-12-24;36354
2020-12-23;"Žilinský kraj";228;16229;975;17204;NA;350342;1203;2020-12-23;35656
2020-12-22;"Žilinský kraj";519;13483;988;14471;NA;350342;1507;2020-12-22;34453
2020-12-21;"Žilinský kraj";444;12429;1078;13507;NA;350342;1522;2020-12-21;32946
2020-12-20;"Žilinský kraj";36;598;80;678;NA;350342;116;2020-12-20;31424
2020-12-19;"Žilinský kraj";208;1678;127;1805;NA;350342;335;2020-12-19;31308
2020-12-18;"Žilinský kraj";333;6553;370;6923;NA;350342;703;2020-12-18;30973
2020-12-17;"Žilinský kraj";500;3922;262;4184;NA;350342;762;2020-12-17;30270
2020-12-16;"Žilinský kraj";333;3815;267;4082;NA;350342;600;2020-12-16;29508
2020-12-15;"Žilinský kraj";528;3729;340;4069;NA;350342;868;2020-12-15;28908
2020-12-14;"Žilinský kraj";321;3884;309;4193;NA;350342;630;2020-12-14;28040
2020-12-13;"Žilinský kraj";26;494;66;560;NA;350342;92;2020-12-13;27410
2020-12-12;"Žilinský kraj";95;767;46;813;NA;350342;141;2020-12-12;27318
2020-12-11;"Žilinský kraj";455;3938;227;4165;NA;350342;682;2020-12-11;27177
2020-12-10;"Žilinský kraj";166;9129;838;9967;NA;350342;1004;2020-12-10;26495
2020-12-09;"Žilinský kraj";392;2169;132;2301;NA;350342;524;2020-12-09;25491
2020-12-08;"Žilinský kraj";331;3127;101;3228;NA;350342;432;2020-12-08;24967
2020-12-07;"Žilinský kraj";348;2746;162;2908;NA;350342;510;2020-12-07;24535
2020-12-06;"Žilinský kraj";15;128;6;134;NA;350342;21;2020-12-06;24025
2020-12-05;"Žilinský kraj";98;781;41;822;NA;350342;139;2020-12-05;24004
2020-12-04;"Žilinský kraj";228;3091;107;3198;NA;350342;335;2020-12-04;23865
2020-12-03;"Žilinský kraj";237;1609;115;1724;NA;350342;352;2020-12-03;23530
2020-12-02;"Žilinský kraj";181;1710;94;1804;NA;350342;275;2020-12-02;23178
2020-12-01;"Žilinský kraj";209;6239;284;6523;NA;350342;493;2020-12-01;22903
2020-11-30;"Žilinský kraj";203;5326;305;5631;NA;350342;508;2020-11-30;22410
2020-11-29;"Žilinský kraj";18;81;7;88;NA;350342;25;2020-11-29;21902
2020-11-28;"Žilinský kraj";99;349;15;364;NA;350342;114;2020-11-28;21877
2020-11-27;"Žilinský kraj";218;904;46;950;NA;350342;264;2020-11-27;21763
2020-11-26;"Žilinský kraj";190;1041;54;1095;NA;350342;244;2020-11-26;21499
2020-11-25;"Žilinský kraj";225;1217;49;1266;NA;350342;274;2020-11-25;21255
2020-11-24;"Žilinský kraj";213;2139;67;2206;NA;350342;280;2020-11-24;20981
2020-11-23;"Žilinský kraj";170;759;44;803;NA;350342;214;2020-11-23;20701
2020-11-22;"Žilinský kraj";11;67;2;69;NA;350342;13;2020-11-22;20487
2020-11-21;"Žilinský kraj";61;505;20;525;NA;350342;81;2020-11-21;20474
2020-11-20;"Žilinský kraj";251;1074;45;1119;NA;350342;296;2020-11-20;20393
2020-11-19;"Žilinský kraj";252;752;61;813;NA;350342;313;2020-11-19;20097
2020-11-18;"Žilinský kraj";346;348;15;363;NA;350342;361;2020-11-18;19784
2020-11-17;"Žilinský kraj";123;490;15;505;NA;350342;138;2020-11-17;19423
2020-11-16;"Žilinský kraj";227;247;15;262;NA;350342;242;2020-11-16;19285
2020-11-15;"Žilinský kraj";63;13;0;13;NA;350342;63;2020-11-15;19043
2020-11-14;"Žilinský kraj";189;1038;11;1049;NA;350342;200;2020-11-14;18980
2020-11-13;"Žilinský kraj";181;125;9;134;NA;350342;190;2020-11-13;18780
2020-11-12;"Žilinský kraj";334;79;2;81;NA;350342;336;2020-11-12;18590
2020-11-11;"Žilinský kraj";489;147;10;157;NA;350342;499;2020-11-11;18254
2020-11-10;"Žilinský kraj";374;519;9;528;NA;350342;383;2020-11-10;17755
2020-11-09;"Žilinský kraj";143;2335;30;2365;NA;350342;173;2020-11-09;17372
2020-11-08;"Žilinský kraj";59;2538;37;2575;NA;350342;96;2020-11-08;17199
2020-11-07;"Žilinský kraj";312;8175;88;8263;NA;350342;400;2020-11-07;17103
2020-11-06;"Žilinský kraj";503;4090;38;4128;NA;350342;541;2020-11-06;16703
2020-11-05;"Žilinský kraj";473;64;4;68;NA;350342;477;2020-11-05;16162
2020-11-04;"Žilinský kraj";423;178;10;188;NA;350342;433;2020-11-04;15685
2020-11-03;"Žilinský kraj";688;889;16;905;NA;350342;704;2020-11-03;15252
2020-11-02;"Žilinský kraj";472;1043;39;1082;NA;350342;511;2020-11-02;14548
2020-11-01;"Žilinský kraj";349;5096;130;5226;NA;350342;479;2020-11-01;14037
2020-10-31;"Žilinský kraj";661;7963;203;8166;NA;350342;864;2020-10-31;13558
2020-10-30;"Žilinský kraj";529;2575;61;2636;NA;350342;590;2020-10-30;12694
2020-10-29;"Žilinský kraj";740;503;17;520;NA;350342;757;2020-10-29;12104
2020-10-28;"Žilinský kraj";635;105;11;116;NA;350342;646;2020-10-28;11347
2020-10-27;"Žilinský kraj";355;154;24;178;NA;350342;379;2020-10-27;10701
2020-10-26;"Žilinský kraj";148;117;28;145;NA;350342;176;2020-10-26;10322
2020-10-25;"Žilinský kraj";436;0;0;0;NA;350342;436;2020-10-25;10146
2020-10-24;"Žilinský kraj";803;0;0;0;NA;350342;803;2020-10-24;9710
2020-10-23;"Žilinský kraj";659;102;13;115;NA;350342;672;2020-10-23;8907
2020-10-22;"Žilinský kraj";525;33;3;36;NA;350342;528;2020-10-22;8235
2020-10-21;"Žilinský kraj";478;74;14;88;NA;350342;492;2020-10-21;7707
2020-10-20;"Žilinský kraj";524;127;8;135;NA;350342;532;2020-10-20;7215
2020-10-19;"Žilinský kraj";70;80;12;92;NA;350342;82;2020-10-19;6683
2020-10-18;"Žilinský kraj";159;0;0;0;NA;350342;159;2020-10-18;6601
2020-10-17;"Žilinský kraj";509;0;0;0;NA;350342;509;2020-10-17;6442
2020-10-16;"Žilinský kraj";603;51;9;60;NA;350342;612;2020-10-16;5933
2020-10-15;"Žilinský kraj";679;61;3;64;NA;350342;682;2020-10-15;5321
2020-10-14;"Žilinský kraj";523;269;6;275;NA;350342;529;2020-10-14;4639
2020-10-13;"Žilinský kraj";367;458;40;498;NA;350342;407;2020-10-13;4110
2020-10-12;"Žilinský kraj";62;0;0;0;NA;350342;62;2020-10-12;3703
2020-10-11;"Žilinský kraj";50;0;0;0;NA;350342;50;2020-10-11;3641
2020-10-10;"Žilinský kraj";213;0;0;0;NA;350342;213;2020-10-10;3591
2020-10-09;"Žilinský kraj";543;0;0;0;NA;350342;543;2020-10-09;3378
2020-10-08;"Žilinský kraj";238;0;0;0;NA;350342;238;2020-10-08;2835
2020-10-07;"Žilinský kraj";168;0;0;0;NA;350342;168;2020-10-07;2597
2020-10-06;"Žilinský kraj";233;0;0;0;NA;350342;233;2020-10-06;2429
2020-10-05;"Žilinský kraj";33;0;0;0;NA;350342;33;2020-10-05;2196
2020-10-04;"Žilinský kraj";35;0;0;0;NA;350342;35;2020-10-04;2163
2020-10-03;"Žilinský kraj";155;0;0;0;NA;350342;155;2020-10-03;2128
2020-10-02;"Žilinský kraj";105;0;0;0;NA;350342;105;2020-10-02;1973
2020-10-01;"Žilinský kraj";147;0;0;0;NA;350342;147;2020-10-01;1868
2020-09-30;"Žilinský kraj";163;0;0;0;NA;350342;163;2020-09-30;1721
2020-09-29;"Žilinský kraj";105;0;0;0;NA;350342;105;2020-09-29;1558
2020-09-28;"Žilinský kraj";34;0;0;0;NA;350342;34;2020-09-28;1453
2020-09-27;"Žilinský kraj";108;0;0;0;NA;350342;108;2020-09-27;1419
2020-09-26;"Žilinský kraj";96;0;0;0;NA;350342;96;2020-09-26;1311
2020-09-25;"Žilinský kraj";69;0;0;0;NA;350342;69;2020-09-25;1215
2020-09-24;"Žilinský kraj";100;0;0;0;NA;350342;100;2020-09-24;1146
2020-09-23;"Žilinský kraj";65;0;0;0;NA;350342;65;2020-09-23;1046
2020-09-22;"Žilinský kraj";65;0;0;0;NA;350342;65;2020-09-22;981
2020-09-21;"Žilinský kraj";47;0;0;0;NA;350342;47;2020-09-21;916
2020-09-20;"Žilinský kraj";4;0;0;0;NA;350342;4;2020-09-20;869
2020-09-19;"Žilinský kraj";6;0;0;0;NA;350342;6;2020-09-19;865
2020-09-18;"Žilinský kraj";82;0;0;0;NA;350342;82;2020-09-18;859
2020-09-17;"Žilinský kraj";30;0;0;0;NA;350342;30;2020-09-17;777
2020-09-16;"Žilinský kraj";34;0;0;0;NA;350342;34;2020-09-16;747
2020-09-15;"Žilinský kraj";12;0;0;0;NA;350342;12;2020-09-15;713
2020-09-14;"Žilinský kraj";39;0;0;0;NA;350342;39;2020-09-14;701
2020-09-13;"Žilinský kraj";6;0;0;0;NA;350342;6;2020-09-13;662
2020-09-12;"Žilinský kraj";4;0;0;0;NA;350342;4;2020-09-12;656
2020-09-11;"Žilinský kraj";31;0;0;0;NA;350342;31;2020-09-11;652
2020-09-10;"Žilinský kraj";31;12;0;12;NA;350342;31;2020-09-10;621
2020-09-09;"Žilinský kraj";23;0;0;0;NA;350342;23;2020-09-09;590
2020-09-08;"Žilinský kraj";25;0;0;0;NA;350342;25;2020-09-08;567
2020-09-07;"Žilinský kraj";11;0;0;0;NA;350342;11;2020-09-07;542
2020-09-06;"Žilinský kraj";0;0;0;0;NA;350342;0;2020-09-06;531
2020-09-05;"Žilinský kraj";2;0;0;0;NA;350342;2;2020-09-05;531
2020-09-04;"Žilinský kraj";33;0;0;0;NA;350342;33;2020-09-04;529
2020-09-03;"Žilinský kraj";18;0;0;0;NA;350342;18;2020-09-03;496
2020-09-02;"Žilinský kraj";16;0;0;0;NA;350342;16;2020-09-02;478
2020-09-01;"Žilinský kraj";4;0;0;0;NA;350342;4;2020-09-01;462
2020-08-31;"Žilinský kraj";5;0;0;0;NA;350342;5;2020-08-31;458
2020-08-30;"Žilinský kraj";3;0;0;0;NA;350342;3;2020-08-30;453
2020-08-29;"Žilinský kraj";5;0;0;0;NA;350342;5;2020-08-29;450
2020-08-28;"Žilinský kraj";13;0;0;0;NA;350342;13;2020-08-28;445
2020-08-27;"Žilinský kraj";18;0;0;0;NA;350342;18;2020-08-27;432
2020-08-26;"Žilinský kraj";8;0;0;0;NA;350342;8;2020-08-26;414
2020-08-25;"Žilinský kraj";2;0;0;0;NA;350342;2;2020-08-25;406
2020-08-24;"Žilinský kraj";5;0;0;0;NA;350342;5;2020-08-24;404
2020-08-23;"Žilinský kraj";0;0;0;0;NA;350342;0;2020-08-23;399
2020-08-22;"Žilinský kraj";0;0;0;0;NA;350342;0;2020-08-22;399
2020-08-21;"Žilinský kraj";10;0;0;0;NA;350342;10;2020-08-21;399
2020-08-20;"Žilinský kraj";13;0;0;0;NA;350342;13;2020-08-20;389
2020-08-19;"Žilinský kraj";7;0;0;0;NA;350342;7;2020-08-19;376
2020-08-18;"Žilinský kraj";9;0;0;0;NA;350342;9;2020-08-18;369
2020-08-17;"Žilinský kraj";1;0;0;0;NA;350342;1;2020-08-17;360
2020-08-16;"Žilinský kraj";0;0;0;0;NA;350342;0;2020-08-16;359
2020-08-15;"Žilinský kraj";0;0;0;0;NA;350342;0;2020-08-15;359
2020-08-14;"Žilinský kraj";4;0;0;0;NA;350342;4;2020-08-14;359
2020-08-13;"Žilinský kraj";2;0;0;0;NA;350342;2;2020-08-13;355
2020-08-12;"Žilinský kraj";0;0;0;0;NA;350342;0;2020-08-12;353
2020-08-11;"Žilinský kraj";4;0;0;0;NA;350342;4;2020-08-11;353
2020-08-10;"Žilinský kraj";1;0;0;0;NA;350342;1;2020-08-10;349
2020-08-09;"Žilinský kraj";0;0;0;0;NA;350342;0;2020-08-09;348
2020-08-08;"Žilinský kraj";3;0;0;0;NA;350342;3;2020-08-08;348
2020-08-07;"Žilinský kraj";8;0;0;0;NA;350342;8;2020-08-07;345
2020-08-06;"Žilinský kraj";1;0;0;0;NA;350342;1;2020-08-06;337
2020-08-05;"Žilinský kraj";1;0;0;0;NA;350342;1;2020-08-05;336
2020-08-04;"Žilinský kraj";2;0;0;0;NA;350342;2;2020-08-04;335
2020-08-03;"Žilinský kraj";0;0;0;0;NA;350342;0;2020-08-03;333
2020-08-02;"Žilinský kraj";1;0;0;0;NA;350342;1;2020-08-02;333
2020-08-01;"Žilinský kraj";0;0;0;0;NA;350342;0;2020-08-01;332
2020-07-31;"Žilinský kraj";4;0;0;0;NA;350342;4;2020-07-31;332
2020-07-30;"Žilinský kraj";2;0;0;0;NA;350342;2;2020-07-30;328
2020-07-29;"Žilinský kraj";2;0;0;0;NA;350342;2;2020-07-29;326
2020-07-28;"Žilinský kraj";4;0;0;0;NA;350342;4;2020-07-28;324
2020-07-27;"Žilinský kraj";6;0;0;0;NA;350342;6;2020-07-27;320
2020-07-26;"Žilinský kraj";0;0;0;0;NA;350342;0;2020-07-26;314
2020-07-25;"Žilinský kraj";0;0;0;0;NA;350342;0;2020-07-25;314
2020-07-24;"Žilinský kraj";2;0;0;0;NA;350342;2;2020-07-24;314
2020-07-23;"Žilinský kraj";0;0;0;0;NA;350342;0;2020-07-23;312
2020-07-22;"Žilinský kraj";1;0;0;0;NA;350342;1;2020-07-22;312
2020-07-21;"Žilinský kraj";2;0;0;0;NA;350342;2;2020-07-21;311
2020-07-20;"Žilinský kraj";3;0;0;0;NA;350342;3;2020-07-20;309
2020-07-19;"Žilinský kraj";0;0;0;0;NA;350342;0;2020-07-19;306
2020-07-18;"Žilinský kraj";0;0;0;0;NA;350342;0;2020-07-18;306
2020-07-17;"Žilinský kraj";2;0;0;0;NA;350342;2;2020-07-17;306
2020-07-16;"Žilinský kraj";2;0;0;0;NA;350342;2;2020-07-16;304
2020-07-15;"Žilinský kraj";2;0;0;0;NA;350342;2;2020-07-15;302
2020-07-14;"Žilinský kraj";1;0;0;0;NA;350342;1;2020-07-14;300
2020-07-13;"Žilinský kraj";0;0;0;0;NA;350342;0;2020-07-13;299
2020-07-12;"Žilinský kraj";0;0;0;0;NA;350342;0;2020-07-12;299
2020-07-11;"Žilinský kraj";2;0;0;0;NA;350342;2;2020-07-11;299
2020-07-10;"Žilinský kraj";3;0;0;0;NA;350342;3;2020-07-10;297
2020-07-09;"Žilinský kraj";2;0;0;0;NA;350342;2;2020-07-09;294
2020-07-08;"Žilinský kraj";10;0;0;0;NA;350342;10;2020-07-08;292
2020-07-07;"Žilinský kraj";7;0;0;0;NA;350342;7;2020-07-07;282
2020-07-06;"Žilinský kraj";0;0;0;0;NA;350342;0;2020-07-06;275
2020-07-05;"Žilinský kraj";0;0;0;0;NA;350342;0;2020-07-05;275
2020-07-04;"Žilinský kraj";10;0;0;0;NA;350342;10;2020-07-04;275
2020-07-03;"Žilinský kraj";18;0;0;0;NA;350342;18;2020-07-03;265
2020-07-02;"Žilinský kraj";7;0;0;0;NA;350342;7;2020-07-02;247
2020-07-01;"Žilinský kraj";0;0;0;0;NA;350342;0;2020-07-01;240
2020-06-30;"Žilinský kraj";4;0;0;0;NA;350342;4;2020-06-30;240
2020-06-29;"Žilinský kraj";0;0;0;0;NA;350342;0;2020-06-29;236
2020-06-28;"Žilinský kraj";1;0;0;0;NA;350342;1;2020-06-28;236
2020-06-27;"Žilinský kraj";3;0;0;0;NA;350342;3;2020-06-27;235
2020-06-26;"Žilinský kraj";5;0;0;0;NA;350342;5;2020-06-26;232
2020-06-25;"Žilinský kraj";7;0;0;0;NA;350342;7;2020-06-25;227
2020-06-24;"Žilinský kraj";11;0;0;0;NA;350342;11;2020-06-24;220
2020-06-23;"Žilinský kraj";9;0;0;0;NA;350342;9;2020-06-23;209
2020-06-22;"Žilinský kraj";0;0;0;0;NA;350342;0;2020-06-22;200
2020-06-21;"Žilinský kraj";1;0;0;0;NA;350342;1;2020-06-21;200
2020-06-20;"Žilinský kraj";1;0;0;0;NA;350342;1;2020-06-20;199
2020-06-19;"Žilinský kraj";4;0;0;0;NA;350342;4;2020-06-19;198
2020-06-18;"Žilinský kraj";1;0;0;0;NA;350342;1;2020-06-18;194
2020-06-17;"Žilinský kraj";0;0;0;0;NA;350342;0;2020-06-17;193
2020-06-16;"Žilinský kraj";1;0;0;0;NA;350342;1;2020-06-16;193
2020-06-14;"Žilinský kraj";0;0;0;0;NA;350342;0;2020-06-14;192
2020-06-13;"Žilinský kraj";0;0;0;0;NA;350342;0;2020-06-13;192
2020-06-12;"Žilinský kraj";0;0;0;0;NA;350342;0;2020-06-12;192
2020-06-11;"Žilinský kraj";0;0;0;0;NA;350342;0;2020-06-11;192
2020-06-10;"Žilinský kraj";0;0;0;0;NA;350342;0;2020-06-10;192
2020-06-09;"Žilinský kraj";1;0;0;0;NA;350342;1;2020-06-09;192
2020-06-08;"Žilinský kraj";0;0;0;0;NA;350342;0;2020-06-08;191
2020-06-07;"Žilinský kraj";0;0;0;0;NA;350342;0;2020-06-07;191
2020-06-05;"Žilinský kraj";0;0;0;0;NA;350342;0;2020-06-05;191
2020-06-03;"Žilinský kraj";0;0;0;0;NA;350342;0;2020-06-03;191
2020-06-02;"Žilinský kraj";0;0;0;0;NA;350342;0;2020-06-02;191
2020-05-31;"Žilinský kraj";0;0;0;0;NA;350342;0;2020-05-31;191
2020-05-29;"Žilinský kraj";0;0;0;0;NA;350342;0;2020-05-29;191
2020-05-27;"Žilinský kraj";1;0;0;0;NA;350342;1;2020-05-27;191
2020-05-26;"Žilinský kraj";1;0;0;0;NA;350342;1;2020-05-26;190
2020-05-25;"Žilinský kraj";0;0;0;0;NA;350342;0;2020-05-25;189
2020-05-24;"Žilinský kraj";0;0;0;0;NA;350342;0;2020-05-24;189
2020-05-23;"Žilinský kraj";0;0;0;0;NA;350342;0;2020-05-23;189
2020-05-22;"Žilinský kraj";0;0;0;0;NA;350342;0;2020-05-22;189
2020-05-21;"Žilinský kraj";0;0;0;0;NA;350342;0;2020-05-21;189
2020-05-20;"Žilinský kraj";0;0;0;0;NA;350342;0;2020-05-20;189
2020-05-19;"Žilinský kraj";1;0;0;0;NA;350342;1;2020-05-19;189
2020-05-17;"Žilinský kraj";0;0;0;0;NA;350342;0;2020-05-17;188
2020-05-16;"Žilinský kraj";0;0;0;0;NA;350342;0;2020-05-16;188
2020-05-15;"Žilinský kraj";0;0;0;0;NA;350342;0;2020-05-15;188
2020-05-14;"Žilinský kraj";0;0;0;0;NA;350342;0;2020-05-14;188
2020-05-13;"Žilinský kraj";0;0;0;0;NA;350342;0;2020-05-13;188
2020-05-12;"Žilinský kraj";0;0;0;0;NA;350342;0;2020-05-12;188
2020-05-11;"Žilinský kraj";0;0;0;0;NA;350342;0;2020-05-11;188
2020-05-09;"Žilinský kraj";0;0;0;0;NA;350342;0;2020-05-09;188
2020-05-07;"Žilinský kraj";0;0;0;0;NA;350342;0;2020-05-07;188
2020-05-06;"Žilinský kraj";2;0;0;0;NA;350342;2;2020-05-06;188
2020-05-05;"Žilinský kraj";3;0;0;0;NA;350342;3;2020-05-05;186
2020-05-04;"Žilinský kraj";3;0;0;0;NA;350342;3;2020-05-04;183
2020-05-03;"Žilinský kraj";1;0;0;0;NA;350342;1;2020-05-03;180
2020-05-02;"Žilinský kraj";0;0;0;0;NA;350342;0;2020-05-02;179
2020-05-01;"Žilinský kraj";1;0;0;0;NA;350342;1;2020-05-01;179
2020-04-30;"Žilinský kraj";0;0;0;0;NA;350342;0;2020-04-30;178
2020-04-29;"Žilinský kraj";0;0;0;0;NA;350342;0;2020-04-29;178
2020-04-28;"Žilinský kraj";0;0;0;0;NA;350342;0;2020-04-28;178
2020-04-27;"Žilinský kraj";0;0;0;0;NA;350342;0;2020-04-27;178
2020-04-26;"Žilinský kraj";0;0;0;0;NA;350342;0;2020-04-26;178
2020-04-25;"Žilinský kraj";2;0;0;0;NA;350342;2;2020-04-25;178
2020-04-24;"Žilinský kraj";1;0;0;0;NA;350342;1;2020-04-24;176
2020-04-23;"Žilinský kraj";2;0;0;0;NA;350342;2;2020-04-23;175
2020-04-22;"Žilinský kraj";9;0;0;0;NA;350342;9;2020-04-22;173
2020-04-21;"Žilinský kraj";1;0;0;0;NA;350342;1;2020-04-21;164
2020-04-20;"Žilinský kraj";4;0;0;0;NA;350342;4;2020-04-20;163
2020-04-19;"Žilinský kraj";0;0;0;0;NA;350342;0;2020-04-19;159
2020-04-18;"Žilinský kraj";49;0;0;0;NA;350342;49;2020-04-18;159
2020-04-17;"Žilinský kraj";3;0;0;0;NA;350342;3;2020-04-17;110
2020-04-16;"Žilinský kraj";4;0;0;0;NA;350342;4;2020-04-16;107
2020-04-15;"Žilinský kraj";7;0;0;0;NA;350342;7;2020-04-15;103
2020-04-14;"Žilinský kraj";1;0;0;0;NA;350342;1;2020-04-14;96
2020-04-13;"Žilinský kraj";2;0;0;0;NA;350342;2;2020-04-13;95
2020-04-12;"Žilinský kraj";5;0;0;0;NA;350342;5;2020-04-12;93
2020-04-11;"Žilinský kraj";2;0;0;0;NA;350342;2;2020-04-11;88
2020-04-10;"Žilinský kraj";1;0;0;0;NA;350342;1;2020-04-10;86
2020-04-09;"Žilinský kraj";1;0;0;0;NA;350342;1;2020-04-09;85
2020-04-08;"Žilinský kraj";3;0;0;0;NA;350342;3;2020-04-08;84
2020-04-07;"Žilinský kraj";5;0;0;0;NA;350342;5;2020-04-07;81
2020-04-06;"Žilinský kraj";6;0;0;0;NA;350342;6;2020-04-06;76
2020-04-05;"Žilinský kraj";8;0;0;0;NA;350342;8;2020-04-05;70
2020-04-04;"Žilinský kraj";0;0;0;0;NA;350342;0;2020-04-04;62
2020-04-03;"Žilinský kraj";3;0;0;0;NA;350342;3;2020-04-03;62
2020-04-02;"Žilinský kraj";5;0;0;0;NA;350342;5;2020-04-02;59
2020-04-01;"Žilinský kraj";4;0;0;0;NA;350342;4;2020-04-01;54
2020-03-31;"Žilinský kraj";1;0;0;0;NA;350342;1;2020-03-31;50
2020-03-30;"Žilinský kraj";3;0;0;0;NA;350342;3;2020-03-30;49
2020-03-29;"Žilinský kraj";0;0;0;0;NA;350342;0;2020-03-29;46
2020-03-28;"Žilinský kraj";1;0;0;0;NA;350342;1;2020-03-28;46
2020-03-27;"Žilinský kraj";9;0;0;0;NA;350342;9;2020-03-27;45
2020-03-26;"Žilinský kraj";4;0;0;0;NA;350342;4;2020-03-26;36
2020-03-25;"Žilinský kraj";1;0;0;0;NA;350342;1;2020-03-25;32
2020-03-24;"Žilinský kraj";2;0;0;0;NA;350342;2;2020-03-24;31
2020-03-23;"Žilinský kraj";3;0;0;0;NA;350342;3;2020-03-23;29
2020-03-22;"Žilinský kraj";1;0;0;0;NA;350342;1;2020-03-22;26
2020-03-21;"Žilinský kraj";2;0;0;0;NA;350342;2;2020-03-21;25
2020-03-20;"Žilinský kraj";4;0;0;0;NA;350342;4;2020-03-20;23
2020-03-19;"Žilinský kraj";2;0;0;0;NA;350342;2;2020-03-19;19
2020-03-18;"Žilinský kraj";1;0;0;0;NA;350342;1;2020-03-18;17
2020-03-17;"Žilinský kraj";5;0;0;0;NA;350342;5;2020-03-17;16
2020-03-16;"Žilinský kraj";1;0;0;0;NA;350342;1;2020-03-16;11
2020-03-15;"Žilinský kraj";2;0;0;0;NA;350342;2;2020-03-15;10
2020-03-14;"Žilinský kraj";1;0;0;0;NA;350342;1;2020-03-14;8
2020-03-13;"Žilinský kraj";5;0;0;0;NA;350342;5;2020-03-13;7
2020-03-12;"Žilinský kraj";1;0;0;0;NA;350342;1;2020-03-12;2
2020-03-11;"Žilinský kraj";0;0;0;0;NA;350342;0;2020-03-11;1
2020-03-09;"Žilinský kraj";1;0;0;0;NA;350342;1;2020-03-09;1
2020-03-08;"Žilinský kraj";0;0;0;0;NA;350342;0;2020-03-08;0
2020-03-07;"Žilinský kraj";0;0;0;0;NA;350342;0;2020-03-07;0
2020-03-06;"Žilinský kraj";0;0;0;0;NA;350342;0;2020-03-06;0
