"Datum";"Region";"PCR_Pos";"Ag_Neg";"Ag_Pos";"Total";"Pocet.potvrdenych";"Potvrdenych";"newcases";"date";"positive"
2022-03-27;"Banskobystrický kraj";147;332;104;436;174330;263264;251;2022-03-27;263264
2022-03-26;"Banskobystrický kraj";343;120;52;172;NA;263264;395;2022-03-26;263013
2022-03-25;"Banskobystrický kraj";721;1355;189;1544;NA;263264;910;2022-03-25;262618
2022-03-24;"Banskobystrický kraj";769;1773;161;1934;NA;263264;930;2022-03-24;261708
2022-03-23;"Banskobystrický kraj";823;1635;209;1844;NA;263264;1032;2022-03-23;260778
2022-03-22;"Banskobystrický kraj";1148;1703;220;1923;NA;263264;1368;2022-03-22;259746
2022-03-21;"Banskobystrický kraj";879;2709;356;3065;NA;263264;1235;2022-03-21;258378
2022-03-20;"Banskobystrický kraj";172;604;174;778;NA;263264;346;2022-03-20;257143
2022-03-19;"Banskobystrický kraj";529;218;89;307;NA;263264;618;2022-03-19;256797
2022-03-18;"Banskobystrický kraj";819;2081;200;2281;NA;263264;1019;2022-03-18;256179
2022-03-17;"Banskobystrický kraj";981;3476;224;3700;NA;263264;1205;2022-03-17;255160
2022-03-16;"Banskobystrický kraj";1189;1396;235;1631;NA;263264;1424;2022-03-16;253955
2022-03-15;"Banskobystrický kraj";1420;1730;231;1961;NA;263264;1651;2022-03-15;252531
2022-03-14;"Banskobystrický kraj";948;3220;426;3646;NA;263264;1374;2022-03-14;250880
2022-03-13;"Banskobystrický kraj";224;576;216;792;NA;263264;440;2022-03-13;249506
2022-03-12;"Banskobystrický kraj";625;262;94;356;NA;263264;719;2022-03-12;249066
2022-03-11;"Banskobystrický kraj";1144;1816;287;2103;NA;263264;1431;2022-03-11;248347
2022-03-10;"Banskobystrický kraj";1325;2126;311;2437;NA;263264;1636;2022-03-10;246916
2022-03-09;"Banskobystrický kraj";1370;2033;333;2366;NA;263264;1703;2022-03-09;245280
2022-03-08;"Banskobystrický kraj";1738;2327;376;2703;NA;263264;2114;2022-03-08;243577
2022-03-07;"Banskobystrický kraj";1048;4974;603;5577;NA;263264;1651;2022-03-07;241463
2022-03-06;"Banskobystrický kraj";356;1264;278;1542;NA;263264;634;2022-03-06;239812
2022-03-05;"Banskobystrický kraj";745;494;180;674;NA;263264;925;2022-03-05;239178
2022-03-04;"Banskobystrický kraj";1302;2574;390;2964;NA;263264;1692;2022-03-04;238253
2022-03-03;"Banskobystrický kraj";1766;3463;386;3849;NA;263264;2152;2022-03-03;236561
2022-03-02;"Banskobystrický kraj";1515;5604;415;6019;NA;263264;1930;2022-03-02;234409
2022-03-01;"Banskobystrický kraj";1842;3325;396;3721;NA;263264;2238;2022-03-01;232479
2022-02-28;"Banskobystrický kraj";1050;4913;708;5621;NA;263264;1758;2022-02-28;230241
2022-02-27;"Banskobystrický kraj";604;1162;303;1465;NA;263264;907;2022-02-27;228483
2022-02-26;"Banskobystrický kraj";909;528;154;682;NA;263264;1063;2022-02-26;227576
2022-02-25;"Banskobystrický kraj";1591;2517;430;2947;NA;263264;2021;2022-02-25;226513
2022-02-24;"Banskobystrický kraj";1781;3857;404;4261;NA;263264;2185;2022-02-24;224492
2022-02-23;"Banskobystrický kraj";2094;2869;454;3323;NA;263264;2548;2022-02-23;222307
2022-02-22;"Banskobystrický kraj";2195;3736;469;4205;NA;263264;2664;2022-02-22;219759
2022-02-21;"Banskobystrický kraj";1409;5732;806;6538;NA;263264;2215;2022-02-21;217095
2022-02-20;"Banskobystrický kraj";484;1717;423;2140;NA;263264;907;2022-02-20;214880
2022-02-19;"Banskobystrický kraj";1180;774;242;1016;NA;263264;1422;2022-02-19;213973
2022-02-18;"Banskobystrický kraj";2473;3620;541;4161;NA;263264;3014;2022-02-18;212551
2022-02-17;"Banskobystrický kraj";1924;4239;460;4699;NA;263264;2384;2022-02-17;209537
2022-02-16;"Banskobystrický kraj";1856;3633;543;4176;NA;263264;2399;2022-02-16;207153
2022-02-15;"Banskobystrický kraj";2287;4459;584;5043;NA;263264;2871;2022-02-15;204754
2022-02-14;"Banskobystrický kraj";2071;6844;891;7735;NA;263264;2962;2022-02-14;201883
2022-02-13;"Banskobystrický kraj";577;2247;471;2718;NA;263264;1048;2022-02-13;198921
2022-02-12;"Banskobystrický kraj";1308;906;308;1214;NA;263264;1616;2022-02-12;197873
2022-02-11;"Banskobystrický kraj";2684;3817;555;4372;NA;263264;3239;2022-02-11;196257
2022-02-10;"Banskobystrický kraj";1765;5732;567;6299;NA;263264;2332;2022-02-10;193018
2022-02-09;"Banskobystrický kraj";2544;3794;569;4363;NA;263264;3113;2022-02-09;190686
2022-02-08;"Banskobystrický kraj";1806;4417;538;4955;NA;263264;2344;2022-02-08;187573
2022-02-07;"Banskobystrický kraj";1683;7386;728;8114;NA;263264;2411;2022-02-07;185229
2022-02-06;"Banskobystrický kraj";604;2244;392;2636;NA;263264;996;2022-02-06;182818
2022-02-05;"Banskobystrický kraj";1032;1434;233;1667;NA;263264;1265;2022-02-05;181822
2022-02-04;"Banskobystrický kraj";1866;3745;438;4183;NA;263264;2304;2022-02-04;180557
2022-02-03;"Banskobystrický kraj";1561;5433;359;5792;NA;263264;1920;2022-02-03;178253
2022-02-02;"Banskobystrický kraj";1716;4780;395;5175;NA;263264;2111;2022-02-02;176333
2022-02-01;"Banskobystrický kraj";1918;4558;410;4968;NA;263264;2328;2022-02-01;174222
2022-01-31;"Banskobystrický kraj";779;9006;553;9559;NA;263264;1332;2022-01-31;171894
2022-01-30;"Banskobystrický kraj";412;3055;267;3322;NA;263264;679;2022-01-30;170562
2022-01-29;"Banskobystrický kraj";981;1155;174;1329;NA;263264;1155;2022-01-29;169883
2022-01-28;"Banskobystrický kraj";1040;3814;313;4127;NA;263264;1353;2022-01-28;168728
2022-01-27;"Banskobystrický kraj";1035;4955;225;5180;NA;263264;1260;2022-01-27;167375
2022-01-26;"Banskobystrický kraj";1060;4035;213;4248;NA;263264;1273;2022-01-26;166115
2022-01-25;"Banskobystrický kraj";1001;6118;257;6375;NA;263264;1258;2022-01-25;164842
2022-01-24;"Banskobystrický kraj";557;10186;257;10443;NA;263264;814;2022-01-24;163584
2022-01-23;"Banskobystrický kraj";246;3710;129;3839;NA;263264;375;2022-01-23;162770
2022-01-22;"Banskobystrický kraj";411;1077;64;1141;NA;263264;475;2022-01-22;162395
2022-01-21;"Banskobystrický kraj";578;3491;113;3604;NA;263264;691;2022-01-21;161920
2022-01-20;"Banskobystrický kraj";490;3809;91;3900;NA;263264;581;2022-01-20;161229
2022-01-19;"Banskobystrický kraj";421;4173;98;4271;NA;263264;519;2022-01-19;160648
2022-01-18;"Banskobystrický kraj";517;4737;95;4832;NA;263264;612;2022-01-18;160129
2022-01-17;"Banskobystrický kraj";269;8102;114;8216;NA;263264;383;2022-01-17;159517
2022-01-16;"Banskobystrický kraj";63;2746;84;2830;NA;263264;147;2022-01-16;159134
2022-01-15;"Banskobystrický kraj";287;858;16;874;NA;263264;303;2022-01-15;158987
2022-01-14;"Banskobystrický kraj";165;2758;67;2825;NA;263264;232;2022-01-14;158684
2022-01-13;"Banskobystrický kraj";182;3411;57;3468;NA;263264;239;2022-01-13;158452
2022-01-12;"Banskobystrický kraj";241;3787;67;3854;NA;263264;308;2022-01-12;158213
2022-01-11;"Banskobystrický kraj";327;4970;74;5044;NA;263264;401;2022-01-11;157905
2022-01-10;"Banskobystrický kraj";219;7978;108;8086;NA;263264;327;2022-01-10;157504
2022-01-09;"Banskobystrický kraj";54;3514;38;3552;NA;263264;92;2022-01-09;157177
2022-01-08;"Banskobystrický kraj";177;1054;40;1094;NA;263264;217;2022-01-08;157085
2022-01-07;"Banskobystrický kraj";320;3087;86;3173;NA;263264;406;2022-01-07;156868
2022-01-06;"Banskobystrický kraj";101;985;21;1006;NA;263264;122;2022-01-06;156462
2022-01-05;"Banskobystrický kraj";376;2852;67;2919;NA;263264;443;2022-01-05;156340
2022-01-04;"Banskobystrický kraj";458;4197;72;4269;NA;263264;530;2022-01-04;155897
2022-01-03;"Banskobystrický kraj";420;8216;115;8331;NA;263264;535;2022-01-03;155367
2022-01-02;"Banskobystrický kraj";117;2239;95;2334;NA;263264;212;2022-01-02;154832
2022-01-01;"Banskobystrický kraj";33;80;4;84;NA;263264;37;2022-01-01;154620
2021-12-31;"Banskobystrický kraj";314;1803;68;1871;NA;263264;382;2021-12-31;154583
2021-12-30;"Banskobystrický kraj";308;2833;88;2921;NA;263264;396;2021-12-30;154201
2021-12-29;"Banskobystrický kraj";390;2448;83;2531;NA;263264;473;2021-12-29;153805
2021-12-28;"Banskobystrický kraj";492;2902;95;2997;NA;263264;587;2021-12-28;153332
2021-12-27;"Banskobystrický kraj";397;5029;203;5232;NA;263264;600;2021-12-27;152745
2021-12-26;"Banskobystrický kraj";76;1245;62;1307;NA;263264;138;2021-12-26;152145
2021-12-25;"Banskobystrický kraj";107;373;45;418;NA;263264;152;2021-12-25;152007
2021-12-24;"Banskobystrický kraj";116;213;10;223;NA;263264;126;2021-12-24;151855
2021-12-23;"Banskobystrický kraj";429;3501;107;3608;NA;263264;536;2021-12-23;151729
2021-12-22;"Banskobystrický kraj";393;3394;106;3500;NA;263264;499;2021-12-22;151193
2021-12-21;"Banskobystrický kraj";508;4173;88;4261;NA;263264;596;2021-12-21;150694
2021-12-20;"Banskobystrický kraj";424;7610;186;7796;NA;263264;610;2021-12-20;150098
2021-12-19;"Banskobystrický kraj";39;2681;87;2768;NA;263264;126;2021-12-19;149488
2021-12-18;"Banskobystrický kraj";333;1036;67;1103;NA;263264;400;2021-12-18;149362
2021-12-17;"Banskobystrický kraj";465;3805;102;3907;NA;263264;567;2021-12-17;148962
2021-12-16;"Banskobystrický kraj";499;4278;116;4394;NA;263264;615;2021-12-16;148395
2021-12-15;"Banskobystrický kraj";554;4772;102;4874;NA;263264;656;2021-12-15;147780
2021-12-14;"Banskobystrický kraj";729;4614;108;4722;NA;263264;837;2021-12-14;147124
2021-12-13;"Banskobystrický kraj";470;8201;222;8423;NA;263264;692;2021-12-13;146287
2021-12-12;"Banskobystrický kraj";161;3332;101;3433;NA;263264;262;2021-12-12;145595
2021-12-11;"Banskobystrický kraj";568;1166;82;1248;NA;263264;650;2021-12-11;145333
2021-12-10;"Banskobystrický kraj";731;4033;185;4218;NA;263264;916;2021-12-10;144683
2021-12-09;"Banskobystrický kraj";652;4381;139;4520;NA;263264;791;2021-12-09;143767
2021-12-08;"Banskobystrický kraj";1087;4100;169;4269;NA;263264;1256;2021-12-08;142976
2021-12-07;"Banskobystrický kraj";1104;5410;201;5611;NA;263264;1305;2021-12-07;141720
2021-12-06;"Banskobystrický kraj";647;9113;324;9437;NA;263264;971;2021-12-06;140415
2021-12-05;"Banskobystrický kraj";217;3425;155;3580;NA;263264;372;2021-12-05;139444
2021-12-04;"Banskobystrický kraj";654;1334;131;1465;NA;263264;785;2021-12-04;139072
2021-12-03;"Banskobystrický kraj";1117;5057;246;5303;NA;263264;1363;2021-12-03;138287
2021-12-02;"Banskobystrický kraj";1710;5259;258;5517;NA;263264;1968;2021-12-02;136924
2021-12-01;"Banskobystrický kraj";947;4753;264;5017;NA;263264;1211;2021-12-01;134956
2021-11-30;"Banskobystrický kraj";1266;6543;245;6788;NA;263264;1511;2021-11-30;133745
2021-11-29;"Banskobystrický kraj";591;10653;468;11121;NA;263264;1059;2021-11-29;132234
2021-11-28;"Banskobystrický kraj";418;4289;216;4505;NA;263264;634;2021-11-28;131175
2021-11-27;"Banskobystrický kraj";827;1781;208;1989;NA;263264;1035;2021-11-27;130541
2021-11-26;"Banskobystrický kraj";963;4771;354;5125;NA;263264;1317;2021-11-26;129506
2021-11-25;"Banskobystrický kraj";1110;5911;350;6261;NA;263264;1460;2021-11-25;128189
2021-11-24;"Banskobystrický kraj";1387;5956;330;6286;NA;263264;1717;2021-11-24;126729
2021-11-23;"Banskobystrický kraj";1436;6082;377;6459;NA;263264;1813;2021-11-23;125012
2021-11-22;"Banskobystrický kraj";489;8727;579;9306;NA;263264;1068;2021-11-22;123199
2021-11-21;"Banskobystrický kraj";408;4109;307;4416;NA;263264;715;2021-11-21;122131
2021-11-20;"Banskobystrický kraj";985;1758;199;1957;NA;263264;1184;2021-11-20;121416
2021-11-19;"Banskobystrický kraj";1006;4886;470;5356;NA;263264;1476;2021-11-19;120232
2021-11-18;"Banskobystrický kraj";979;8037;620;8657;NA;263264;1599;2021-11-18;118756
2021-11-17;"Banskobystrický kraj";772;1051;147;1198;NA;263264;919;2021-11-17;117157
2021-11-16;"Banskobystrický kraj";1130;5473;453;5926;NA;263264;1583;2021-11-16;116238
2021-11-15;"Banskobystrický kraj";749;7884;588;8472;NA;263264;1337;2021-11-15;114655
2021-11-14;"Banskobystrický kraj";311;2629;302;2931;NA;263264;613;2021-11-14;113318
2021-11-13;"Banskobystrický kraj";761;1471;214;1685;NA;263264;975;2021-11-13;112705
2021-11-12;"Banskobystrický kraj";972;5019;434;5453;NA;263264;1406;2021-11-12;111730
2021-11-11;"Banskobystrický kraj";1023;5584;345;5929;NA;263264;1368;2021-11-11;110324
2021-11-10;"Banskobystrický kraj";950;4713;333;5046;NA;263264;1283;2021-11-10;108956
2021-11-09;"Banskobystrický kraj";921;4616;283;4899;NA;263264;1204;2021-11-09;107673
2021-11-08;"Banskobystrický kraj";519;7249;488;7737;NA;263264;1007;2021-11-08;106469
2021-11-07;"Banskobystrický kraj";460;2479;258;2737;NA;263264;718;2021-11-07;105462
2021-11-06;"Banskobystrický kraj";505;1344;170;1514;NA;263264;675;2021-11-06;104744
2021-11-05;"Banskobystrický kraj";997;4773;342;5115;NA;263264;1339;2021-11-05;104069
2021-11-04;"Banskobystrický kraj";1086;4811;248;5059;NA;263264;1334;2021-11-04;102730
2021-11-03;"Banskobystrický kraj";976;4825;330;5155;NA;263264;1306;2021-11-03;101396
2021-11-02;"Banskobystrický kraj";538;5709;492;6201;NA;263264;1030;2021-11-02;100090
2021-11-01;"Banskobystrický kraj";390;1178;132;1310;NA;263264;522;2021-11-01;99060
2021-10-31;"Banskobystrický kraj";150;1700;210;1910;NA;263264;360;2021-10-31;98538
2021-10-30;"Banskobystrický kraj";449;1508;140;1648;NA;263264;589;2021-10-30;98178
2021-10-29;"Banskobystrický kraj";780;4178;286;4464;NA;263264;1066;2021-10-29;97589
2021-10-28;"Banskobystrický kraj";744;4182;247;4429;NA;263264;991;2021-10-28;96523
2021-10-27;"Banskobystrický kraj";664;4577;233;4810;NA;263264;897;2021-10-27;95532
2021-10-26;"Banskobystrický kraj";700;3673;187;3860;NA;263264;887;2021-10-26;94635
2021-10-25;"Banskobystrický kraj";376;5478;257;5735;NA;263264;633;2021-10-25;93748
2021-10-24;"Banskobystrický kraj";161;1707;143;1850;NA;263264;304;2021-10-24;93115
2021-10-23;"Banskobystrický kraj";238;1286;79;1365;NA;263264;317;2021-10-23;92811
2021-10-22;"Banskobystrický kraj";530;3816;185;4001;NA;263264;715;2021-10-22;92494
2021-10-21;"Banskobystrický kraj";416;4128;140;4268;NA;263264;556;2021-10-21;91779
2021-10-20;"Banskobystrický kraj";387;3615;123;3738;NA;263264;510;2021-10-20;91223
2021-10-19;"Banskobystrický kraj";419;4094;103;4197;NA;263264;522;2021-10-19;90713
2021-10-18;"Banskobystrický kraj";162;5286;175;5461;NA;263264;337;2021-10-18;90191
2021-10-17;"Banskobystrický kraj";26;1555;71;1626;NA;263264;97;2021-10-17;89854
2021-10-16;"Banskobystrický kraj";162;1387;50;1437;NA;263264;212;2021-10-16;89757
2021-10-15;"Banskobystrický kraj";187;3693;81;3774;NA;263264;268;2021-10-15;89545
2021-10-14;"Banskobystrický kraj";198;3705;47;3752;NA;263264;245;2021-10-14;89277
2021-10-13;"Banskobystrický kraj";217;3068;55;3123;NA;263264;272;2021-10-13;89032
2021-10-12;"Banskobystrický kraj";301;3743;59;3802;NA;263264;360;2021-10-12;88760
2021-10-11;"Banskobystrický kraj";128;4734;96;4830;NA;263264;224;2021-10-11;88400
2021-10-10;"Banskobystrický kraj";26;1815;53;1868;NA;263264;79;2021-10-10;88176
2021-10-09;"Banskobystrický kraj";73;1122;27;1149;NA;263264;100;2021-10-09;88097
2021-10-08;"Banskobystrický kraj";239;3027;61;3088;NA;263264;300;2021-10-08;87997
2021-10-07;"Banskobystrický kraj";179;3437;42;3479;NA;263264;221;2021-10-07;87697
2021-10-06;"Banskobystrický kraj";136;3862;48;3910;NA;263264;184;2021-10-06;87476
2021-10-05;"Banskobystrický kraj";209;2979;54;3033;NA;263264;263;2021-10-05;87292
2021-10-04;"Banskobystrický kraj";126;3725;64;3789;NA;263264;190;2021-10-04;87029
2021-10-03;"Banskobystrický kraj";11;1407;34;1441;NA;263264;45;2021-10-03;86839
2021-10-02;"Banskobystrický kraj";66;1042;26;1068;NA;263264;92;2021-10-02;86794
2021-10-01;"Banskobystrický kraj";158;3228;51;3279;NA;263264;209;2021-10-01;86702
2021-09-30;"Banskobystrický kraj";120;3362;30;3392;NA;263264;150;2021-09-30;86493
2021-09-29;"Banskobystrický kraj";118;2626;40;2666;NA;263264;158;2021-09-29;86343
2021-09-28;"Banskobystrický kraj";112;3061;45;3106;NA;263264;157;2021-09-28;86185
2021-09-27;"Banskobystrický kraj";90;4456;72;4528;NA;263264;162;2021-09-27;86028
2021-09-26;"Banskobystrický kraj";17;1498;31;1529;NA;263264;48;2021-09-26;85866
2021-09-25;"Banskobystrický kraj";17;1481;7;1488;NA;263264;24;2021-09-25;85818
2021-09-24;"Banskobystrický kraj";98;4254;32;4286;NA;263264;130;2021-09-24;85794
2021-09-23;"Banskobystrický kraj";63;3019;13;3032;NA;263264;76;2021-09-23;85664
2021-09-22;"Banskobystrický kraj";75;2442;19;2461;NA;263264;94;2021-09-22;85588
2021-09-21;"Banskobystrický kraj";125;2976;20;2996;NA;263264;145;2021-09-21;85494
2021-09-20;"Banskobystrický kraj";45;3951;30;3981;NA;263264;75;2021-09-20;85349
2021-09-19;"Banskobystrický kraj";6;1456;24;1480;NA;263264;30;2021-09-19;85274
2021-09-18;"Banskobystrický kraj";44;1318;15;1333;NA;263264;59;2021-09-18;85244
2021-09-17;"Banskobystrický kraj";73;3485;32;3517;NA;263264;105;2021-09-17;85185
2021-09-16;"Banskobystrický kraj";95;3019;29;3048;NA;263264;124;2021-09-16;85080
2021-09-15;"Banskobystrický kraj";22;394;1;395;NA;263264;23;2021-09-15;84956
2021-09-14;"Banskobystrický kraj";95;2508;28;2536;NA;263264;123;2021-09-14;84933
2021-09-13;"Banskobystrický kraj";29;3206;28;3234;NA;263264;57;2021-09-13;84810
2021-09-12;"Banskobystrický kraj";7;958;15;973;NA;263264;22;2021-09-12;84753
2021-09-11;"Banskobystrický kraj";31;865;11;876;NA;263264;42;2021-09-11;84731
2021-09-10;"Banskobystrický kraj";59;2250;24;2274;NA;263264;83;2021-09-10;84689
2021-09-09;"Banskobystrický kraj";46;2011;17;2028;NA;263264;63;2021-09-09;84606
2021-09-08;"Banskobystrický kraj";46;1713;27;1740;NA;263264;73;2021-09-08;84543
2021-09-07;"Banskobystrický kraj";27;1422;21;1443;NA;263264;48;2021-09-07;84470
2021-09-06;"Banskobystrický kraj";26;2570;13;2583;NA;263264;39;2021-09-06;84422
2021-09-05;"Banskobystrický kraj";9;742;2;744;NA;263264;11;2021-09-05;84383
2021-09-04;"Banskobystrický kraj";14;745;10;755;NA;263264;24;2021-09-04;84372
2021-09-03;"Banskobystrický kraj";49;2116;22;2138;NA;263264;71;2021-09-03;84348
2021-09-02;"Banskobystrický kraj";19;1730;25;1755;NA;263264;44;2021-09-02;84277
2021-09-01;"Banskobystrický kraj";6;230;6;236;NA;263264;12;2021-09-01;84233
2021-08-31;"Banskobystrický kraj";18;1406;13;1419;NA;263264;31;2021-08-31;84221
2021-08-30;"Banskobystrický kraj";23;1867;10;1877;NA;263264;33;2021-08-30;84190
2021-08-29;"Banskobystrický kraj";0;351;5;356;NA;263264;5;2021-08-29;84157
2021-08-28;"Banskobystrický kraj";9;827;5;832;NA;263264;14;2021-08-28;84152
2021-08-27;"Banskobystrický kraj";7;1608;12;1620;NA;263264;19;2021-08-27;84138
2021-08-26;"Banskobystrický kraj";7;1161;2;1163;NA;263264;9;2021-08-26;84119
2021-08-25;"Banskobystrický kraj";6;1052;1;1053;NA;263264;7;2021-08-25;84110
2021-08-24;"Banskobystrický kraj";12;1117;1;1118;NA;263264;13;2021-08-24;84103
2021-08-23;"Banskobystrický kraj";7;1368;5;1373;NA;263264;12;2021-08-23;84090
2021-08-22;"Banskobystrický kraj";0;773;2;775;NA;263264;2;2021-08-22;84078
2021-08-21;"Banskobystrický kraj";3;793;1;794;NA;263264;4;2021-08-21;84076
2021-08-20;"Banskobystrický kraj";5;1616;4;1620;NA;263264;9;2021-08-20;84072
2021-08-19;"Banskobystrický kraj";4;1092;3;1095;NA;263264;7;2021-08-19;84063
2021-08-18;"Banskobystrický kraj";1;1044;1;1045;NA;263264;2;2021-08-18;84056
2021-08-17;"Banskobystrický kraj";12;890;0;890;NA;263264;12;2021-08-17;84054
2021-08-16;"Banskobystrický kraj";7;1321;3;1324;NA;263264;10;2021-08-16;84042
2021-08-15;"Banskobystrický kraj";0;366;3;369;NA;263264;3;2021-08-15;84032
2021-08-14;"Banskobystrický kraj";6;435;1;436;NA;263264;7;2021-08-14;84029
2021-08-13;"Banskobystrický kraj";11;898;0;898;NA;263264;11;2021-08-13;84022
2021-08-12;"Banskobystrický kraj";10;951;1;952;NA;263264;11;2021-08-12;84011
2021-08-11;"Banskobystrický kraj";7;575;3;578;NA;263264;10;2021-08-11;84000
2021-08-10;"Banskobystrický kraj";7;678;2;680;NA;263264;9;2021-08-10;83990
2021-08-09;"Banskobystrický kraj";9;1064;0;1064;NA;263264;9;2021-08-09;83981
2021-08-08;"Banskobystrický kraj";4;335;1;336;NA;263264;5;2021-08-08;83972
2021-08-07;"Banskobystrický kraj";0;308;4;312;NA;263264;4;2021-08-07;83967
2021-08-06;"Banskobystrický kraj";5;929;2;931;NA;263264;7;2021-08-06;83963
2021-08-05;"Banskobystrický kraj";2;838;1;839;NA;263264;3;2021-08-05;83956
2021-08-04;"Banskobystrický kraj";2;579;1;580;NA;263264;3;2021-08-04;83953
2021-08-03;"Banskobystrický kraj";4;743;0;743;NA;263264;4;2021-08-03;83950
2021-08-02;"Banskobystrický kraj";6;934;0;934;NA;263264;6;2021-08-02;83946
2021-08-01;"Banskobystrický kraj";0;271;0;271;NA;263264;0;2021-08-01;83940
2021-07-31;"Banskobystrický kraj";1;370;4;374;NA;263264;5;2021-07-31;83940
2021-07-30;"Banskobystrický kraj";27;928;2;930;NA;263264;29;2021-07-30;83935
2021-07-29;"Banskobystrický kraj";2;890;1;891;NA;263264;3;2021-07-29;83906
2021-07-28;"Banskobystrický kraj";4;520;1;521;NA;263264;5;2021-07-28;83903
2021-07-27;"Banskobystrický kraj";15;1092;0;1092;NA;263264;15;2021-07-27;83898
2021-07-26;"Banskobystrický kraj";2;911;1;912;NA;263264;3;2021-07-26;83883
2021-07-25;"Banskobystrický kraj";0;367;1;368;NA;263264;1;2021-07-25;83880
2021-07-24;"Banskobystrický kraj";2;298;0;298;NA;263264;2;2021-07-24;83879
2021-07-23;"Banskobystrický kraj";7;840;0;840;NA;263264;7;2021-07-23;83877
2021-07-22;"Banskobystrický kraj";5;727;3;730;NA;263264;8;2021-07-22;83870
2021-07-21;"Banskobystrický kraj";2;560;0;560;NA;263264;2;2021-07-21;83862
2021-07-20;"Banskobystrický kraj";6;885;2;887;NA;263264;8;2021-07-20;83860
2021-07-19;"Banskobystrický kraj";1;854;3;857;NA;263264;4;2021-07-19;83852
2021-07-18;"Banskobystrický kraj";0;377;1;378;NA;263264;1;2021-07-18;83848
2021-07-17;"Banskobystrický kraj";1;324;0;324;NA;263264;1;2021-07-17;83847
2021-07-16;"Banskobystrický kraj";3;974;1;975;NA;263264;4;2021-07-16;83846
2021-07-15;"Banskobystrický kraj";1;1038;0;1038;NA;263264;1;2021-07-15;83842
2021-07-14;"Banskobystrický kraj";3;765;0;765;NA;263264;3;2021-07-14;83841
2021-07-13;"Banskobystrický kraj";2;695;0;695;NA;263264;2;2021-07-13;83838
2021-07-12;"Banskobystrický kraj";1;1057;0;1057;NA;263264;1;2021-07-12;83836
2021-07-11;"Banskobystrický kraj";0;446;0;446;NA;263264;0;2021-07-11;83835
2021-07-10;"Banskobystrický kraj";2;368;0;368;NA;263264;2;2021-07-10;83835
2021-07-09;"Banskobystrický kraj";3;1209;0;1209;NA;263264;3;2021-07-09;83833
2021-07-08;"Banskobystrický kraj";0;1083;1;1084;NA;263264;1;2021-07-08;83830
2021-07-07;"Banskobystrický kraj";1;798;0;798;NA;263264;1;2021-07-07;83829
2021-07-06;"Banskobystrický kraj";6;1365;0;1365;NA;263264;6;2021-07-06;83828
2021-07-05;"Banskobystrický kraj";2;392;1;393;NA;263264;3;2021-07-05;83822
2021-07-04;"Banskobystrický kraj";0;318;0;318;NA;263264;0;2021-07-04;83819
2021-07-03;"Banskobystrický kraj";1;413;1;414;NA;263264;2;2021-07-03;83819
2021-07-02;"Banskobystrický kraj";3;1045;0;1045;NA;263264;3;2021-07-02;83817
2021-07-01;"Banskobystrický kraj";0;705;1;706;NA;263264;1;2021-07-01;83814
2021-06-30;"Banskobystrický kraj";3;7607;1;7608;NA;263264;4;2021-06-30;83813
2021-06-29;"Banskobystrický kraj";2;4642;1;4643;NA;263264;3;2021-06-29;83809
2021-06-28;"Banskobystrický kraj";3;5695;1;5696;NA;263264;4;2021-06-28;83806
2021-06-27;"Banskobystrický kraj";0;4369;5;4374;NA;263264;5;2021-06-27;83802
2021-06-26;"Banskobystrický kraj";0;4289;4;4293;NA;263264;4;2021-06-26;83797
2021-06-25;"Banskobystrický kraj";2;6717;2;6719;NA;263264;4;2021-06-25;83793
2021-06-24;"Banskobystrický kraj";6;4585;2;4587;NA;263264;8;2021-06-24;83789
2021-06-23;"Banskobystrický kraj";4;4947;0;4947;NA;263264;4;2021-06-23;83781
2021-06-22;"Banskobystrický kraj";7;4527;0;4527;NA;263264;7;2021-06-22;83777
2021-06-21;"Banskobystrický kraj";6;5836;8;5844;NA;263264;14;2021-06-21;83770
2021-06-20;"Banskobystrický kraj";0;5055;7;5062;NA;263264;7;2021-06-20;83756
2021-06-19;"Banskobystrický kraj";0;5639;4;5643;NA;263264;4;2021-06-19;83749
2021-06-18;"Banskobystrický kraj";4;7642;1;7643;NA;263264;5;2021-06-18;83745
2021-06-17;"Banskobystrický kraj";2;5245;3;5248;NA;263264;5;2021-06-17;83740
2021-06-16;"Banskobystrický kraj";10;5951;5;5956;NA;263264;15;2021-06-16;83735
2021-06-15;"Banskobystrický kraj";9;5576;6;5582;NA;263264;15;2021-06-15;83720
2021-06-14;"Banskobystrický kraj";8;6922;7;6929;NA;263264;15;2021-06-14;83705
2021-06-13;"Banskobystrický kraj";0;6407;7;6414;NA;263264;7;2021-06-13;83690
2021-06-12;"Banskobystrický kraj";3;6338;6;6344;NA;263264;9;2021-06-12;83683
2021-06-11;"Banskobystrický kraj";5;9693;15;9708;NA;263264;20;2021-06-11;83674
2021-06-10;"Banskobystrický kraj";10;5726;8;5734;NA;263264;18;2021-06-10;83654
2021-06-09;"Banskobystrický kraj";9;5720;4;5724;NA;263264;13;2021-06-09;83636
2021-06-08;"Banskobystrický kraj";15;5645;10;5655;NA;263264;25;2021-06-08;83623
2021-06-07;"Banskobystrický kraj";4;7582;21;7603;NA;263264;25;2021-06-07;83598
2021-06-06;"Banskobystrický kraj";1;7497;12;7509;NA;263264;13;2021-06-06;83573
2021-06-05;"Banskobystrický kraj";15;7531;9;7540;NA;263264;24;2021-06-05;83560
2021-06-04;"Banskobystrický kraj";2;9352;14;9366;NA;263264;16;2021-06-04;83536
2021-06-03;"Banskobystrický kraj";8;6507;24;6531;NA;263264;32;2021-06-03;83520
2021-06-02;"Banskobystrický kraj";7;6837;6;6843;NA;263264;13;2021-06-02;83488
2021-06-01;"Banskobystrický kraj";12;7146;14;7160;NA;263264;26;2021-06-01;83475
2021-05-31;"Banskobystrický kraj";4;9546;31;9577;NA;263264;35;2021-05-31;83449
2021-05-30;"Banskobystrický kraj";3;8959;19;8978;NA;263264;22;2021-05-30;83414
2021-05-29;"Banskobystrický kraj";11;9763;18;9781;NA;263264;29;2021-05-29;83392
2021-05-28;"Banskobystrický kraj";13;11905;27;11932;NA;263264;40;2021-05-28;83363
2021-05-27;"Banskobystrický kraj";7;8760;12;8772;NA;263264;19;2021-05-27;83323
2021-05-26;"Banskobystrický kraj";18;7905;17;7922;NA;263264;35;2021-05-26;83304
2021-05-25;"Banskobystrický kraj";27;8951;30;8981;NA;263264;57;2021-05-25;83269
2021-05-24;"Banskobystrický kraj";9;12469;44;12513;NA;263264;53;2021-05-24;83212
2021-05-23;"Banskobystrický kraj";0;9798;27;9825;NA;263264;27;2021-05-23;83159
2021-05-22;"Banskobystrický kraj";20;9608;26;9634;NA;263264;46;2021-05-22;83132
2021-05-21;"Banskobystrický kraj";22;12796;25;12821;NA;263264;47;2021-05-21;83086
2021-05-20;"Banskobystrický kraj";14;8994;25;9019;NA;263264;39;2021-05-20;83039
2021-05-19;"Banskobystrický kraj";42;8608;21;8629;NA;263264;63;2021-05-19;83000
2021-05-18;"Banskobystrický kraj";27;9450;25;9475;NA;263264;52;2021-05-18;82937
2021-05-17;"Banskobystrický kraj";11;13399;33;13432;NA;263264;44;2021-05-17;82885
2021-05-16;"Banskobystrický kraj";15;14072;26;14098;NA;263264;41;2021-05-16;82841
2021-05-15;"Banskobystrický kraj";11;15356;29;15385;NA;263264;40;2021-05-15;82800
2021-05-14;"Banskobystrický kraj";35;18939;45;18984;NA;263264;80;2021-05-14;82760
2021-05-13;"Banskobystrický kraj";37;10605;40;10645;NA;263264;77;2021-05-13;82680
2021-05-12;"Banskobystrický kraj";31;10857;45;10902;NA;263264;76;2021-05-12;82603
2021-05-11;"Banskobystrický kraj";42;11325;48;11373;NA;263264;90;2021-05-11;82527
2021-05-10;"Banskobystrický kraj";28;17621;68;17689;NA;263264;96;2021-05-10;82437
2021-05-09;"Banskobystrický kraj";25;21902;68;21970;NA;263264;93;2021-05-09;82341
2021-05-08;"Banskobystrický kraj";11;14285;26;14311;NA;263264;37;2021-05-08;82248
2021-05-07;"Banskobystrický kraj";41;21806;78;21884;NA;263264;119;2021-05-07;82211
2021-05-06;"Banskobystrický kraj";36;12251;70;12321;NA;263264;106;2021-05-06;82092
2021-05-05;"Banskobystrický kraj";34;12592;63;12655;NA;263264;97;2021-05-05;81986
2021-05-04;"Banskobystrický kraj";83;13888;47;13935;NA;263264;130;2021-05-04;81889
2021-05-03;"Banskobystrický kraj";30;20872;80;20952;NA;263264;110;2021-05-03;81759
2021-05-02;"Banskobystrický kraj";6;33040;60;33100;NA;263264;66;2021-05-02;81649
2021-05-01;"Banskobystrický kraj";54;36900;67;36967;NA;263264;121;2021-05-01;81583
2021-04-30;"Banskobystrický kraj";38;34957;86;35043;NA;263264;124;2021-04-30;81462
2021-04-29;"Banskobystrický kraj";55;16839;68;16907;NA;263264;123;2021-04-29;81338
2021-04-28;"Banskobystrický kraj";66;17959;67;18026;NA;263264;133;2021-04-28;81215
2021-04-27;"Banskobystrický kraj";70;19152;73;19225;NA;263264;143;2021-04-27;81082
2021-04-26;"Banskobystrický kraj";34;28517;101;28618;NA;263264;135;2021-04-26;80939
2021-04-25;"Banskobystrický kraj";14;40601;106;40707;NA;263264;120;2021-04-25;80804
2021-04-24;"Banskobystrický kraj";40;51944;98;52042;NA;263264;138;2021-04-24;80684
2021-04-23;"Banskobystrický kraj";78;37922;88;38010;NA;263264;166;2021-04-23;80546
2021-04-22;"Banskobystrický kraj";51;17415;57;17472;NA;263264;108;2021-04-22;80380
2021-04-21;"Banskobystrický kraj";76;19218;94;19312;NA;263264;170;2021-04-21;80272
2021-04-20;"Banskobystrický kraj";116;21234;98;21332;NA;263264;214;2021-04-20;80102
2021-04-19;"Banskobystrický kraj";48;31408;105;31513;NA;263264;153;2021-04-19;79888
2021-04-18;"Banskobystrický kraj";16;43375;90;43465;NA;263264;106;2021-04-18;79735
2021-04-17;"Banskobystrický kraj";42;64939;92;65031;NA;263264;134;2021-04-17;79629
2021-04-16;"Banskobystrický kraj";72;37307;100;37407;NA;263264;172;2021-04-16;79495
2021-04-15;"Banskobystrický kraj";67;20127;83;20210;NA;263264;150;2021-04-15;79323
2021-04-14;"Banskobystrický kraj";69;21260;86;21346;NA;263264;155;2021-04-14;79173
2021-04-13;"Banskobystrický kraj";130;23076;77;23153;NA;263264;207;2021-04-13;79018
2021-04-12;"Banskobystrický kraj";60;32272;130;32402;NA;263264;190;2021-04-12;78811
2021-04-11;"Banskobystrický kraj";0;41367;88;41455;NA;263264;88;2021-04-11;78621
2021-04-10;"Banskobystrický kraj";56;64728;141;64869;NA;263264;197;2021-04-10;78533
2021-04-09;"Banskobystrický kraj";106;31570;118;31688;NA;263264;224;2021-04-09;78336
2021-04-08;"Banskobystrický kraj";132;19000;148;19148;NA;263264;280;2021-04-08;78112
2021-04-07;"Banskobystrický kraj";226;25121;94;25215;NA;263264;320;2021-04-07;77832
2021-04-06;"Banskobystrický kraj";93;42496;187;42683;NA;263264;280;2021-04-06;77512
2021-04-05;"Banskobystrický kraj";15;11797;87;11884;NA;263264;102;2021-04-05;77232
2021-04-04;"Banskobystrický kraj";24;19683;79;19762;NA;263264;103;2021-04-04;77130
2021-04-03;"Banskobystrický kraj";5;72553;211;72764;NA;263264;216;2021-04-03;77027
2021-04-02;"Banskobystrický kraj";71;13455;66;13521;NA;263264;137;2021-04-02;76811
2021-04-01;"Banskobystrický kraj";171;39407;200;39607;NA;263264;371;2021-04-01;76674
2021-03-31;"Banskobystrický kraj";147;25543;161;25704;NA;263264;308;2021-03-31;76303
2021-03-30;"Banskobystrický kraj";167;21442;159;21601;NA;263264;326;2021-03-30;75995
2021-03-29;"Banskobystrický kraj";119;29492;218;29710;NA;263264;337;2021-03-29;75669
2021-03-28;"Banskobystrický kraj";25;40610;189;40799;NA;263264;214;2021-03-28;75332
2021-03-27;"Banskobystrický kraj";85;63414;260;63674;NA;263264;345;2021-03-27;75118
2021-03-26;"Banskobystrický kraj";122;43671;240;43911;NA;263264;362;2021-03-26;74773
2021-03-25;"Banskobystrický kraj";120;21598;240;21838;NA;263264;360;2021-03-25;74411
2021-03-24;"Banskobystrický kraj";200;19337;227;19564;NA;263264;427;2021-03-24;74051
2021-03-23;"Banskobystrický kraj";241;21541;257;21798;NA;263264;498;2021-03-23;73624
2021-03-22;"Banskobystrický kraj";65;30480;274;30754;NA;263264;339;2021-03-22;73126
2021-03-21;"Banskobystrický kraj";31;40039;280;40319;NA;263264;311;2021-03-21;72787
2021-03-20;"Banskobystrický kraj";119;67926;383;68309;NA;263264;502;2021-03-20;72476
2021-03-19;"Banskobystrický kraj";240;44038;306;44344;NA;263264;546;2021-03-19;71974
2021-03-18;"Banskobystrický kraj";160;22469;273;22742;NA;263264;433;2021-03-18;71428
2021-03-17;"Banskobystrický kraj";262;21573;245;21818;NA;263264;507;2021-03-17;70995
2021-03-16;"Banskobystrický kraj";340;23349;224;23573;NA;263264;564;2021-03-16;70488
2021-03-15;"Banskobystrický kraj";95;32306;366;32672;NA;263264;461;2021-03-15;69924
2021-03-14;"Banskobystrický kraj";39;39212;218;39430;NA;263264;257;2021-03-14;69463
2021-03-13;"Banskobystrický kraj";209;67463;395;67858;NA;263264;604;2021-03-13;69206
2021-03-12;"Banskobystrický kraj";206;41444;330;41774;NA;263264;536;2021-03-12;68602
2021-03-11;"Banskobystrický kraj";228;21338;274;21612;NA;263264;502;2021-03-11;68066
2021-03-10;"Banskobystrický kraj";260;20400;238;20638;NA;263264;498;2021-03-10;67564
2021-03-09;"Banskobystrický kraj";352;21790;284;22074;NA;263264;636;2021-03-09;67066
2021-03-08;"Banskobystrický kraj";191;31471;427;31898;NA;263264;618;2021-03-08;66430
2021-03-07;"Banskobystrický kraj";60;39191;295;39486;NA;263264;355;2021-03-07;65812
2021-03-06;"Banskobystrický kraj";164;70897;410;71307;NA;263264;574;2021-03-06;65457
2021-03-05;"Banskobystrický kraj";221;42336;389;42725;NA;263264;610;2021-03-05;64883
2021-03-04;"Banskobystrický kraj";226;22009;334;22343;NA;263264;560;2021-03-04;64273
2021-03-03;"Banskobystrický kraj";317;21949;331;22280;NA;263264;648;2021-03-03;63713
2021-03-02;"Banskobystrický kraj";291;23160;354;23514;NA;263264;645;2021-03-02;63065
2021-03-01;"Banskobystrický kraj";151;31773;434;32207;NA;263264;585;2021-03-01;62420
2021-02-28;"Banskobystrický kraj";45;38665;336;39001;NA;263264;381;2021-02-28;61835
2021-02-27;"Banskobystrický kraj";289;66667;529;67196;NA;263264;818;2021-02-27;61454
2021-02-26;"Banskobystrický kraj";326;39674;468;40142;NA;263264;794;2021-02-26;60636
2021-02-25;"Banskobystrický kraj";375;18081;366;18447;NA;263264;741;2021-02-25;59842
2021-02-24;"Banskobystrický kraj";332;16735;373;17108;NA;263264;705;2021-02-24;59101
2021-02-23;"Banskobystrický kraj";462;19932;439;20371;NA;263264;901;2021-02-23;58396
2021-02-22;"Banskobystrický kraj";67;28643;598;29241;NA;263264;665;2021-02-22;57495
2021-02-21;"Banskobystrický kraj";68;37619;444;38063;NA;263264;512;2021-02-21;56830
2021-02-20;"Banskobystrický kraj";280;68851;598;69449;NA;263264;878;2021-02-20;56318
2021-02-19;"Banskobystrický kraj";420;39888;511;40399;NA;263264;931;2021-02-19;55440
2021-02-18;"Banskobystrický kraj";241;18618;396;19014;NA;263264;637;2021-02-18;54509
2021-02-17;"Banskobystrický kraj";415;16740;389;17129;NA;263264;804;2021-02-17;53872
2021-02-16;"Banskobystrický kraj";338;19731;368;20099;NA;263264;706;2021-02-16;53068
2021-02-15;"Banskobystrický kraj";118;35835;591;36426;NA;263264;709;2021-02-15;52362
2021-02-14;"Banskobystrický kraj";60;31894;386;32280;NA;263264;446;2021-02-14;51653
2021-02-13;"Banskobystrický kraj";202;53889;492;54381;NA;263264;694;2021-02-13;51207
2021-02-12;"Banskobystrický kraj";312;37270;533;37803;NA;263264;845;2021-02-12;50513
2021-02-11;"Banskobystrický kraj";305;21196;386;21582;NA;263264;691;2021-02-11;49668
2021-02-10;"Banskobystrický kraj";333;14790;344;15134;NA;263264;677;2021-02-10;48977
2021-02-09;"Banskobystrický kraj";329;18504;362;18866;NA;263264;691;2021-02-09;48300
2021-02-08;"Banskobystrický kraj";103;49716;695;50411;NA;263264;798;2021-02-08;47609
2021-02-07;"Banskobystrický kraj";70;37659;335;37994;NA;263264;405;2021-02-07;46811
2021-02-06;"Banskobystrický kraj";178;69388;570;69958;NA;263264;748;2021-02-06;46406
2021-02-05;"Banskobystrický kraj";282;24577;363;24940;NA;263264;645;2021-02-05;45658
2021-02-04;"Banskobystrický kraj";240;14367;430;14797;NA;263264;670;2021-02-04;45013
2021-02-03;"Banskobystrický kraj";350;9459;255;9714;NA;263264;605;2021-02-03;44343
2021-02-02;"Banskobystrický kraj";277;15741;334;16075;NA;263264;611;2021-02-02;43738
2021-02-01;"Banskobystrický kraj";75;24346;489;24835;NA;263264;564;2021-02-01;43127
2021-01-31;"Banskobystrický kraj";34;19983;201;20184;NA;263264;235;2021-01-31;42563
2021-01-30;"Banskobystrický kraj";163;63896;525;64421;NA;263264;688;2021-01-30;42328
2021-01-29;"Banskobystrický kraj";196;17368;274;17642;NA;263264;470;2021-01-29;41640
2021-01-28;"Banskobystrický kraj";218;15613;382;15995;NA;263264;600;2021-01-28;41170
2021-01-27;"Banskobystrický kraj";191;8132;200;8332;NA;263264;391;2021-01-27;40570
2021-01-26;"Banskobystrický kraj";238;19795;283;20078;NA;263264;521;2021-01-26;40179
2021-01-25;"Banskobystrický kraj";82;33666;412;34078;NA;263264;494;2021-01-25;39658
2021-01-24;"Banskobystrický kraj";38;35587;278;35865;NA;263264;316;2021-01-24;39164
2021-01-23;"Banskobystrický kraj";142;89058;523;89581;NA;263264;665;2021-01-23;38848
2021-01-22;"Banskobystrický kraj";175;25887;355;26242;NA;263264;530;2021-01-22;38183
2021-01-21;"Banskobystrický kraj";194;17063;279;17342;NA;263264;473;2021-01-21;37653
2021-01-20;"Banskobystrický kraj";231;9142;186;9328;NA;263264;417;2021-01-20;37180
2021-01-19;"Banskobystrický kraj";213;10708;311;11019;NA;263264;524;2021-01-19;36763
2021-01-18;"Banskobystrický kraj";94;7402;401;7803;NA;263264;495;2021-01-18;36239
2021-01-17;"Banskobystrický kraj";110;8154;77;8231;NA;263264;187;2021-01-17;35744
2021-01-16;"Banskobystrický kraj";58;2274;57;2331;NA;263264;115;2021-01-16;35557
2021-01-15;"Banskobystrický kraj";164;7673;217;7890;NA;263264;381;2021-01-15;35442
2021-01-14;"Banskobystrický kraj";220;5760;325;6085;NA;263264;545;2021-01-14;35061
2021-01-13;"Banskobystrický kraj";235;5974;217;6191;NA;263264;452;2021-01-13;34516
2021-01-12;"Banskobystrický kraj";194;6600;290;6890;NA;263264;484;2021-01-12;34064
2021-01-11;"Banskobystrický kraj";76;8231;481;8712;NA;263264;557;2021-01-11;33580
2021-01-10;"Banskobystrický kraj";110;433;4;437;NA;263264;114;2021-01-10;33023
2021-01-09;"Banskobystrický kraj";297;2378;81;2459;NA;263264;378;2021-01-09;32909
2021-01-08;"Banskobystrický kraj";435;9805;443;10248;NA;263264;878;2021-01-08;32531
2021-01-07;"Banskobystrický kraj";127;6322;366;6688;NA;263264;493;2021-01-07;31653
2021-01-06;"Banskobystrický kraj";305;3374;185;3559;NA;263264;490;2021-01-06;31160
2021-01-05;"Banskobystrický kraj";372;7349;533;7882;NA;263264;905;2021-01-05;30670
2021-01-04;"Banskobystrický kraj";130;7087;700;7787;NA;263264;830;2021-01-04;29765
2021-01-03;"Banskobystrický kraj";199;320;19;339;NA;263264;218;2021-01-03;28935
2021-01-02;"Banskobystrický kraj";123;702;85;787;NA;263264;208;2021-01-02;28717
2021-01-01;"Banskobystrický kraj";220;1958;132;2090;NA;263264;352;2021-01-01;28509
2020-12-31;"Banskobystrický kraj";499;7679;633;8312;NA;263264;1132;2020-12-31;28157
2020-12-30;"Banskobystrický kraj";593;7407;541;7948;NA;263264;1134;2020-12-30;27025
2020-12-29;"Banskobystrický kraj";240;7876;660;8536;NA;263264;900;2020-12-29;25891
2020-12-28;"Banskobystrický kraj";131;6120;720;6840;NA;263264;851;2020-12-28;24991
2020-12-27;"Banskobystrický kraj";116;541;25;566;NA;263264;141;2020-12-27;24140
2020-12-26;"Banskobystrický kraj";61;295;35;330;NA;263264;96;2020-12-26;23999
2020-12-25;"Banskobystrický kraj";65;888;10;898;NA;263264;75;2020-12-25;23903
2020-12-24;"Banskobystrický kraj";452;3685;135;3820;NA;263264;587;2020-12-24;23828
2020-12-23;"Banskobystrický kraj";368;9892;473;10365;NA;263264;841;2020-12-23;23241
2020-12-22;"Banskobystrický kraj";307;8468;619;9087;NA;263264;926;2020-12-22;22400
2020-12-21;"Banskobystrický kraj";286;4922;455;5377;NA;263264;741;2020-12-21;21474
2020-12-20;"Banskobystrický kraj";155;250;14;264;NA;263264;169;2020-12-20;20733
2020-12-19;"Banskobystrický kraj";170;3084;138;3222;NA;263264;308;2020-12-19;20564
2020-12-18;"Banskobystrický kraj";432;5959;331;6290;NA;263264;763;2020-12-18;20256
2020-12-17;"Banskobystrický kraj";468;8753;653;9406;NA;263264;1121;2020-12-17;19493
2020-12-16;"Banskobystrický kraj";379;10184;567;10751;NA;263264;946;2020-12-16;18372
2020-12-15;"Banskobystrický kraj";336;5281;425;5706;NA;263264;761;2020-12-15;17426
2020-12-14;"Banskobystrický kraj";148;4012;259;4271;NA;263264;407;2020-12-14;16665
2020-12-13;"Banskobystrický kraj";122;142;1;143;NA;263264;123;2020-12-13;16258
2020-12-12;"Banskobystrický kraj";137;2714;138;2852;NA;263264;275;2020-12-12;16135
2020-12-11;"Banskobystrický kraj";468;6633;362;6995;NA;263264;830;2020-12-11;15860
2020-12-10;"Banskobystrický kraj";280;5501;369;5870;NA;263264;649;2020-12-10;15030
2020-12-09;"Banskobystrický kraj";323;3941;205;4146;NA;263264;528;2020-12-09;14381
2020-12-08;"Banskobystrický kraj";256;3782;272;4054;NA;263264;528;2020-12-08;13853
2020-12-07;"Banskobystrický kraj";175;2633;177;2810;NA;263264;352;2020-12-07;13325
2020-12-06;"Banskobystrický kraj";121;507;11;518;NA;263264;132;2020-12-06;12973
2020-12-05;"Banskobystrický kraj";109;1099;34;1133;NA;263264;143;2020-12-05;12841
2020-12-04;"Banskobystrický kraj";339;3828;174;4002;NA;263264;513;2020-12-04;12698
2020-12-03;"Banskobystrický kraj";240;3193;234;3427;NA;263264;474;2020-12-03;12185
2020-12-02;"Banskobystrický kraj";217;4442;186;4628;NA;263264;403;2020-12-02;11711
2020-12-01;"Banskobystrický kraj";215;2702;134;2836;NA;263264;349;2020-12-01;11308
2020-11-30;"Banskobystrický kraj";74;4314;241;4555;NA;263264;315;2020-11-30;10959
2020-11-29;"Banskobystrický kraj";19;208;7;215;NA;263264;26;2020-11-29;10644
2020-11-28;"Banskobystrický kraj";81;1408;55;1463;NA;263264;136;2020-11-28;10618
2020-11-27;"Banskobystrický kraj";219;2566;123;2689;NA;263264;342;2020-11-27;10482
2020-11-26;"Banskobystrický kraj";208;2124;93;2217;NA;263264;301;2020-11-26;10140
2020-11-25;"Banskobystrický kraj";170;1952;86;2038;NA;263264;256;2020-11-25;9839
2020-11-24;"Banskobystrický kraj";166;2566;69;2635;NA;263264;235;2020-11-24;9583
2020-11-23;"Banskobystrický kraj";66;10147;193;10340;NA;263264;259;2020-11-23;9348
2020-11-22;"Banskobystrický kraj";38;104;1;105;NA;263264;39;2020-11-22;9089
2020-11-21;"Banskobystrický kraj";52;904;14;918;NA;263264;66;2020-11-21;9050
2020-11-20;"Banskobystrický kraj";127;2005;107;2112;NA;263264;234;2020-11-20;8984
2020-11-19;"Banskobystrický kraj";170;1218;82;1300;NA;263264;252;2020-11-19;8750
2020-11-18;"Banskobystrický kraj";153;698;65;763;NA;263264;218;2020-11-18;8498
2020-11-17;"Banskobystrický kraj";52;578;35;613;NA;263264;87;2020-11-17;8280
2020-11-16;"Banskobystrický kraj";106;470;25;495;NA;263264;131;2020-11-16;8193
2020-11-15;"Banskobystrický kraj";52;301;4;305;NA;263264;56;2020-11-15;8062
2020-11-14;"Banskobystrický kraj";73;305;2;307;NA;263264;75;2020-11-14;8006
2020-11-13;"Banskobystrický kraj";157;552;11;563;NA;263264;168;2020-11-13;7931
2020-11-12;"Banskobystrický kraj";218;952;44;996;NA;263264;262;2020-11-12;7763
2020-11-11;"Banskobystrický kraj";224;437;9;446;NA;263264;233;2020-11-11;7501
2020-11-10;"Banskobystrický kraj";263;463;18;481;NA;263264;281;2020-11-10;7268
2020-11-09;"Banskobystrický kraj";80;2678;31;2709;NA;263264;111;2020-11-09;6987
2020-11-08;"Banskobystrický kraj";82;981;16;997;NA;263264;98;2020-11-08;6876
2020-11-07;"Banskobystrický kraj";164;8828;94;8922;NA;263264;258;2020-11-07;6778
2020-11-06;"Banskobystrický kraj";227;2496;16;2512;NA;263264;243;2020-11-06;6520
2020-11-05;"Banskobystrický kraj";240;290;33;323;NA;263264;273;2020-11-05;6277
2020-11-04;"Banskobystrický kraj";254;1366;13;1379;NA;263264;267;2020-11-04;6004
2020-11-03;"Banskobystrický kraj";246;1332;4;1336;NA;263264;250;2020-11-03;5737
2020-11-02;"Banskobystrický kraj";90;2909;65;2974;NA;263264;155;2020-11-02;5487
2020-11-01;"Banskobystrický kraj";101;2671;42;2713;NA;263264;143;2020-11-01;5332
2020-10-31;"Banskobystrický kraj";199;13516;116;13632;NA;263264;315;2020-10-31;5189
2020-10-30;"Banskobystrický kraj";254;2829;20;2849;NA;263264;274;2020-10-30;4874
2020-10-29;"Banskobystrický kraj";372;969;42;1011;NA;263264;414;2020-10-29;4600
2020-10-28;"Banskobystrický kraj";285;302;30;332;NA;263264;315;2020-10-28;4186
2020-10-27;"Banskobystrický kraj";266;654;40;694;NA;263264;306;2020-10-27;3871
2020-10-26;"Banskobystrický kraj";38;234;29;263;NA;263264;67;2020-10-26;3565
2020-10-25;"Banskobystrický kraj";50;140;11;151;NA;263264;61;2020-10-25;3498
2020-10-24;"Banskobystrický kraj";315;114;12;126;NA;263264;327;2020-10-24;3437
2020-10-23;"Banskobystrický kraj";231;230;29;259;NA;263264;260;2020-10-23;3110
2020-10-22;"Banskobystrický kraj";264;253;24;277;NA;263264;288;2020-10-22;2850
2020-10-21;"Banskobystrický kraj";209;266;3;269;NA;263264;212;2020-10-21;2562
2020-10-20;"Banskobystrický kraj";210;66;3;69;NA;263264;213;2020-10-20;2350
2020-10-19;"Banskobystrický kraj";27;73;12;85;NA;263264;39;2020-10-19;2137
2020-10-18;"Banskobystrický kraj";49;0;0;0;NA;263264;49;2020-10-18;2098
2020-10-17;"Banskobystrický kraj";27;0;0;0;NA;263264;27;2020-10-17;2049
2022-03-27;"Bratislavský kraj";961;885;130;1015;230034;320185;1091;2022-03-27;320185
2022-03-26;"Bratislavský kraj";1391;828;89;917;NA;320185;1480;2022-03-26;319094
2022-03-25;"Bratislavský kraj";1793;2154;158;2312;NA;320185;1951;2022-03-25;317614
2022-03-24;"Bratislavský kraj";1708;2564;190;2754;NA;320185;1898;2022-03-24;315663
2022-03-23;"Bratislavský kraj";2093;2781;189;2970;NA;320185;2282;2022-03-23;313765
2022-03-22;"Bratislavský kraj";1857;2848;221;3069;NA;320185;2078;2022-03-22;311483
2022-03-21;"Bratislavský kraj";1469;4326;371;4697;NA;320185;1840;2022-03-21;309405
2022-03-20;"Bratislavský kraj";935;1344;175;1519;NA;320185;1110;2022-03-20;307565
2022-03-19;"Bratislavský kraj";1672;1481;136;1617;NA;320185;1808;2022-03-19;306455
2022-03-18;"Bratislavský kraj";1977;2930;208;3138;NA;320185;2185;2022-03-18;304647
2022-03-17;"Bratislavský kraj";2024;3477;245;3722;NA;320185;2269;2022-03-17;302462
2022-03-16;"Bratislavský kraj";1895;2748;257;3005;NA;320185;2152;2022-03-16;300193
2022-03-15;"Bratislavský kraj";1982;3779;338;4117;NA;320185;2320;2022-03-15;298041
2022-03-14;"Bratislavský kraj";1557;4095;342;4437;NA;320185;1899;2022-03-14;295721
2022-03-13;"Bratislavský kraj";738;1311;161;1472;NA;320185;899;2022-03-13;293822
2022-03-12;"Bratislavský kraj";1632;1250;110;1360;NA;320185;1742;2022-03-12;292923
2022-03-11;"Bratislavský kraj";1184;3141;316;3457;NA;320185;1500;2022-03-11;291181
2022-03-10;"Bratislavský kraj";1706;3576;347;3923;NA;320185;2053;2022-03-10;289681
2022-03-09;"Bratislavský kraj";1723;2810;276;3086;NA;320185;1999;2022-03-09;287628
2022-03-08;"Bratislavský kraj";1925;3821;342;4163;NA;320185;2267;2022-03-08;285629
2022-03-07;"Bratislavský kraj";1451;4273;478;4751;NA;320185;1929;2022-03-07;283362
2022-03-06;"Bratislavský kraj";850;1541;213;1754;NA;320185;1063;2022-03-06;281433
2022-03-05;"Bratislavský kraj";1203;1331;178;1509;NA;320185;1381;2022-03-05;280370
2022-03-04;"Bratislavský kraj";1443;2994;307;3301;NA;320185;1750;2022-03-04;278989
2022-03-03;"Bratislavský kraj";1599;3281;328;3609;NA;320185;1927;2022-03-03;277239
2022-03-02;"Bratislavský kraj";1677;2536;309;2845;NA;320185;1986;2022-03-02;275312
2022-03-01;"Bratislavský kraj";1560;3651;341;3992;NA;320185;1901;2022-03-01;273326
2022-02-28;"Bratislavský kraj";1593;4052;472;4524;NA;320185;2065;2022-02-28;271425
2022-02-27;"Bratislavský kraj";1156;1746;227;1973;NA;320185;1383;2022-02-27;269360
2022-02-26;"Bratislavský kraj";1228;1749;209;1958;NA;320185;1437;2022-02-26;267977
2022-02-25;"Bratislavský kraj";1692;3604;323;3927;NA;320185;2015;2022-02-25;266540
2022-02-24;"Bratislavský kraj";1760;3992;324;4316;NA;320185;2084;2022-02-24;264525
2022-02-23;"Bratislavský kraj";2105;3450;393;3843;NA;320185;2498;2022-02-23;262441
2022-02-22;"Bratislavský kraj";2951;4213;384;4597;NA;320185;3335;2022-02-22;259943
2022-02-21;"Bratislavský kraj";781;5116;517;5633;NA;320185;1298;2022-02-21;256608
2022-02-20;"Bratislavský kraj";1314;2005;294;2299;NA;320185;1608;2022-02-20;255310
2022-02-19;"Bratislavský kraj";1510;1929;235;2164;NA;320185;1745;2022-02-19;253702
2022-02-18;"Bratislavský kraj";2315;3835;378;4213;NA;320185;2693;2022-02-18;251957
2022-02-17;"Bratislavský kraj";2279;4412;416;4828;NA;320185;2695;2022-02-17;249264
2022-02-16;"Bratislavský kraj";2137;3749;419;4168;NA;320185;2556;2022-02-16;246569
2022-02-15;"Bratislavský kraj";2276;4894;475;5369;NA;320185;2751;2022-02-15;244013
2022-02-14;"Bratislavský kraj";2700;6170;601;6771;NA;320185;3301;2022-02-14;241262
2022-02-13;"Bratislavský kraj";1343;2248;395;2643;NA;320185;1738;2022-02-13;237961
2022-02-12;"Bratislavský kraj";1872;2273;336;2609;NA;320185;2208;2022-02-12;236223
2022-02-11;"Bratislavský kraj";2431;5054;419;5473;NA;320185;2850;2022-02-11;234015
2022-02-10;"Bratislavský kraj";2595;4563;427;4990;NA;320185;3022;2022-02-10;231165
2022-02-09;"Bratislavský kraj";2414;4706;477;5183;NA;320185;2891;2022-02-09;228143
2022-02-08;"Bratislavský kraj";2878;5134;512;5646;NA;320185;3390;2022-02-08;225252
2022-02-07;"Bratislavský kraj";2636;6970;668;7638;NA;320185;3304;2022-02-07;221862
2022-02-06;"Bratislavský kraj";1680;3005;382;3387;NA;320185;2062;2022-02-06;218558
2022-02-05;"Bratislavský kraj";2156;2456;315;2771;NA;320185;2471;2022-02-05;216496
2022-02-04;"Bratislavský kraj";2586;4679;408;5087;NA;320185;2994;2022-02-04;214025
2022-02-03;"Bratislavský kraj";2540;6005;435;6440;NA;320185;2975;2022-02-03;211031
2022-02-02;"Bratislavský kraj";2655;5035;465;5500;NA;320185;3120;2022-02-02;208056
2022-02-01;"Bratislavský kraj";2758;6001;469;6470;NA;320185;3227;2022-02-01;204936
2022-01-31;"Bratislavský kraj";2172;8357;712;9069;NA;320185;2884;2022-01-31;201709
2022-01-30;"Bratislavský kraj";1418;3314;362;3676;NA;320185;1780;2022-01-30;198825
2022-01-29;"Bratislavský kraj";1762;3138;326;3464;NA;320185;2088;2022-01-29;197045
2022-01-28;"Bratislavský kraj";2237;5047;389;5436;NA;320185;2626;2022-01-28;194957
2022-01-27;"Bratislavský kraj";2014;5975;334;6309;NA;320185;2348;2022-01-27;192331
2022-01-26;"Bratislavský kraj";1792;4895;367;5262;NA;320185;2159;2022-01-26;189983
2022-01-25;"Bratislavský kraj";1933;5551;385;5936;NA;320185;2318;2022-01-25;187824
2022-01-24;"Bratislavský kraj";1173;7911;315;8226;NA;320185;1488;2022-01-24;185506
2022-01-23;"Bratislavský kraj";862;3289;151;3440;NA;320185;1013;2022-01-23;184018
2022-01-22;"Bratislavský kraj";1130;2802;125;2927;NA;320185;1255;2022-01-22;183005
2022-01-21;"Bratislavský kraj";1057;4656;166;4822;NA;320185;1223;2022-01-21;181750
2022-01-20;"Bratislavský kraj";940;4893;146;5039;NA;320185;1086;2022-01-20;180527
2022-01-19;"Bratislavský kraj";857;4618;169;4787;NA;320185;1026;2022-01-19;179441
2022-01-18;"Bratislavský kraj";794;5002;163;5165;NA;320185;957;2022-01-18;178415
2022-01-17;"Bratislavský kraj";534;7242;150;7392;NA;320185;684;2022-01-17;177458
2022-01-16;"Bratislavský kraj";300;2854;77;2931;NA;320185;377;2022-01-16;176774
2022-01-15;"Bratislavský kraj";543;2139;71;2210;NA;320185;614;2022-01-15;176397
2022-01-14;"Bratislavský kraj";356;3692;70;3762;NA;320185;426;2022-01-14;175783
2022-01-13;"Bratislavský kraj";382;4579;82;4661;NA;320185;464;2022-01-13;175357
2022-01-12;"Bratislavský kraj";415;4014;71;4085;NA;320185;486;2022-01-12;174893
2022-01-11;"Bratislavský kraj";407;4910;110;5020;NA;320185;517;2022-01-11;174407
2022-01-10;"Bratislavský kraj";413;6380;101;6481;NA;320185;514;2022-01-10;173890
2022-01-09;"Bratislavský kraj";187;3080;71;3151;NA;320185;258;2022-01-09;173376
2022-01-08;"Bratislavský kraj";323;1951;58;2009;NA;320185;381;2022-01-08;173118
2022-01-07;"Bratislavský kraj";436;3809;100;3909;NA;320185;536;2022-01-07;172737
2022-01-06;"Bratislavský kraj";192;2163;51;2214;NA;320185;243;2022-01-06;172201
2022-01-05;"Bratislavský kraj";426;4047;69;4116;NA;320185;495;2022-01-05;171958
2022-01-04;"Bratislavský kraj";446;4467;101;4568;NA;320185;547;2022-01-04;171463
2022-01-03;"Bratislavský kraj";578;5672;129;5801;NA;320185;707;2022-01-03;170916
2022-01-02;"Bratislavský kraj";198;3137;80;3217;NA;320185;278;2022-01-02;170209
2022-01-01;"Bratislavský kraj";7;1103;36;1139;NA;320185;43;2022-01-01;169931
2021-12-31;"Bratislavský kraj";371;3443;92;3535;NA;320185;463;2021-12-31;169888
2021-12-30;"Bratislavský kraj";468;3619;119;3738;NA;320185;587;2021-12-30;169425
2021-12-29;"Bratislavský kraj";404;3598;85;3683;NA;320185;489;2021-12-29;168838
2021-12-28;"Bratislavský kraj";578;4329;121;4450;NA;320185;699;2021-12-28;168349
2021-12-27;"Bratislavský kraj";656;4693;108;4801;NA;320185;764;2021-12-27;167650
2021-12-26;"Bratislavský kraj";198;2549;83;2632;NA;320185;281;2021-12-26;166886
2021-12-25;"Bratislavský kraj";34;1160;53;1213;NA;320185;87;2021-12-25;166605
2021-12-24;"Bratislavský kraj";171;2214;55;2269;NA;320185;226;2021-12-24;166518
2021-12-23;"Bratislavský kraj";678;4134;115;4249;NA;320185;793;2021-12-23;166292
2021-12-22;"Bratislavský kraj";575;4919;118;5037;NA;320185;693;2021-12-22;165499
2021-12-21;"Bratislavský kraj";625;5628;167;5795;NA;320185;792;2021-12-21;164806
2021-12-20;"Bratislavský kraj";528;6163;158;6321;NA;320185;686;2021-12-20;164014
2021-12-19;"Bratislavský kraj";250;3042;98;3140;NA;320185;348;2021-12-19;163328
2021-12-18;"Bratislavský kraj";528;2654;103;2757;NA;320185;631;2021-12-18;162980
2021-12-17;"Bratislavský kraj";683;4917;145;5062;NA;320185;828;2021-12-17;162349
2021-12-16;"Bratislavský kraj";730;5576;162;5738;NA;320185;892;2021-12-16;161521
2021-12-15;"Bratislavský kraj";881;4884;158;5042;NA;320185;1039;2021-12-15;160629
2021-12-14;"Bratislavský kraj";869;5397;179;5576;NA;320185;1048;2021-12-14;159590
2021-12-13;"Bratislavský kraj";648;7614;239;7853;NA;320185;887;2021-12-13;158542
2021-12-12;"Bratislavský kraj";534;3474;129;3603;NA;320185;663;2021-12-12;157655
2021-12-11;"Bratislavský kraj";698;2377;153;2530;NA;320185;851;2021-12-11;156992
2021-12-10;"Bratislavský kraj";796;4728;186;4914;NA;320185;982;2021-12-10;156141
2021-12-09;"Bratislavský kraj";1040;4152;174;4326;NA;320185;1214;2021-12-09;155159
2021-12-08;"Bratislavský kraj";1172;4602;196;4798;NA;320185;1368;2021-12-08;153945
2021-12-07;"Bratislavský kraj";1236;5173;257;5430;NA;320185;1493;2021-12-07;152577
2021-12-06;"Bratislavský kraj";1434;8714;312;9026;NA;320185;1746;2021-12-06;151084
2021-12-05;"Bratislavský kraj";633;3874;197;4071;NA;320185;830;2021-12-05;149338
2021-12-04;"Bratislavský kraj";936;4332;195;4527;NA;320185;1131;2021-12-04;148508
2021-12-03;"Bratislavský kraj";1222;4351;269;4620;NA;320185;1491;2021-12-03;147377
2021-12-02;"Bratislavský kraj";2053;5097;311;5408;NA;320185;2364;2021-12-02;145886
2021-12-01;"Bratislavský kraj";1161;9058;295;9353;NA;320185;1456;2021-12-01;143522
2021-11-30;"Bratislavský kraj";1442;6508;355;6863;NA;320185;1797;2021-11-30;142066
2021-11-29;"Bratislavský kraj";863;8823;452;9275;NA;320185;1315;2021-11-29;140269
2021-11-28;"Bratislavský kraj";617;5102;295;5397;NA;320185;912;2021-11-28;138954
2021-11-27;"Bratislavský kraj";1026;3497;329;3826;NA;320185;1355;2021-11-27;138042
2021-11-26;"Bratislavský kraj";1346;5483;422;5905;NA;320185;1768;2021-11-26;136687
2021-11-25;"Bratislavský kraj";1415;6383;451;6834;NA;320185;1866;2021-11-25;134919
2021-11-24;"Bratislavský kraj";1286;6849;467;7316;NA;320185;1753;2021-11-24;133053
2021-11-23;"Bratislavský kraj";1651;6351;433;6784;NA;320185;2084;2021-11-23;131300
2021-11-22;"Bratislavský kraj";1197;8722;584;9306;NA;320185;1781;2021-11-22;129216
2021-11-21;"Bratislavský kraj";702;4324;320;4644;NA;320185;1022;2021-11-21;127435
2021-11-20;"Bratislavský kraj";1005;3514;360;3874;NA;320185;1365;2021-11-20;126413
2021-11-19;"Bratislavský kraj";1444;5927;549;6476;NA;320185;1993;2021-11-19;125048
2021-11-18;"Bratislavský kraj";1052;6358;548;6906;NA;320185;1600;2021-11-18;123055
2021-11-17;"Bratislavský kraj";832;2439;308;2747;NA;320185;1140;2021-11-17;121455
2021-11-16;"Bratislavský kraj";1067;5792;443;6235;NA;320185;1510;2021-11-16;120315
2021-11-15;"Bratislavský kraj";1014;6330;519;6849;NA;320185;1533;2021-11-15;118805
2021-11-14;"Bratislavský kraj";448;3202;335;3537;NA;320185;783;2021-11-14;117272
2021-11-13;"Bratislavský kraj";587;3251;313;3564;NA;320185;900;2021-11-13;116489
2021-11-12;"Bratislavský kraj";856;5723;357;6080;NA;320185;1213;2021-11-12;115589
2021-11-11;"Bratislavský kraj";787;6028;355;6383;NA;320185;1142;2021-11-11;114376
2021-11-10;"Bratislavský kraj";840;5903;385;6288;NA;320185;1225;2021-11-10;113234
2021-11-09;"Bratislavský kraj";939;5733;350;6083;NA;320185;1289;2021-11-09;112009
2021-11-08;"Bratislavský kraj";579;5641;404;6045;NA;320185;983;2021-11-08;110720
2021-11-07;"Bratislavský kraj";363;2836;244;3080;NA;320185;607;2021-11-07;109737
2021-11-06;"Bratislavský kraj";538;2901;243;3144;NA;320185;781;2021-11-06;109130
2021-11-05;"Bratislavský kraj";801;5640;318;5958;NA;320185;1119;2021-11-05;108349
2021-11-04;"Bratislavský kraj";768;5233;273;5506;NA;320185;1041;2021-11-04;107230
2021-11-03;"Bratislavský kraj";690;5120;290;5410;NA;320185;980;2021-11-03;106189
2021-11-02;"Bratislavský kraj";422;6356;327;6683;NA;320185;749;2021-11-02;105209
2021-11-01;"Bratislavský kraj";395;1733;136;1869;NA;320185;531;2021-11-01;104460
2021-10-31;"Bratislavský kraj";209;2280;163;2443;NA;320185;372;2021-10-31;103929
2021-10-30;"Bratislavský kraj";429;2138;118;2256;NA;320185;547;2021-10-30;103557
2021-10-29;"Bratislavský kraj";445;4757;219;4976;NA;320185;664;2021-10-29;103010
2021-10-28;"Bratislavský kraj";372;4777;179;4956;NA;320185;551;2021-10-28;102346
2021-10-27;"Bratislavský kraj";376;4522;164;4686;NA;320185;540;2021-10-27;101795
2021-10-26;"Bratislavský kraj";461;4492;188;4680;NA;320185;649;2021-10-26;101255
2021-10-25;"Bratislavský kraj";379;5347;192;5539;NA;320185;571;2021-10-25;100606
2021-10-24;"Bratislavský kraj";114;2369;91;2460;NA;320185;205;2021-10-24;100035
2021-10-23;"Bratislavský kraj";301;2666;91;2757;NA;320185;392;2021-10-23;99830
2021-10-22;"Bratislavský kraj";309;4466;122;4588;NA;320185;431;2021-10-22;99438
2021-10-21;"Bratislavský kraj";244;4544;101;4645;NA;320185;345;2021-10-21;99007
2021-10-20;"Bratislavský kraj";262;3897;95;3992;NA;320185;357;2021-10-20;98662
2021-10-19;"Bratislavský kraj";260;4116;68;4184;NA;320185;328;2021-10-19;98305
2021-10-18;"Bratislavský kraj";250;5014;114;5128;NA;320185;364;2021-10-18;97977
2021-10-17;"Bratislavský kraj";54;2460;73;2533;NA;320185;127;2021-10-17;97613
2021-10-16;"Bratislavský kraj";185;2687;63;2750;NA;320185;248;2021-10-16;97486
2021-10-15;"Bratislavský kraj";169;4200;64;4264;NA;320185;233;2021-10-15;97238
2021-10-14;"Bratislavský kraj";173;4714;61;4775;NA;320185;234;2021-10-14;97005
2021-10-13;"Bratislavský kraj";143;3671;76;3747;NA;320185;219;2021-10-13;96771
2021-10-12;"Bratislavský kraj";183;4037;78;4115;NA;320185;261;2021-10-12;96552
2021-10-11;"Bratislavský kraj";191;4798;88;4886;NA;320185;279;2021-10-11;96291
2021-10-10;"Bratislavský kraj";29;2176;43;2219;NA;320185;72;2021-10-10;96012
2021-10-09;"Bratislavský kraj";141;2419;34;2453;NA;320185;175;2021-10-09;95940
2021-10-08;"Bratislavský kraj";130;4511;63;4574;NA;320185;193;2021-10-08;95765
2021-10-07;"Bratislavský kraj";92;4137;61;4198;NA;320185;153;2021-10-07;95572
2021-10-06;"Bratislavský kraj";147;4028;68;4096;NA;320185;215;2021-10-06;95419
2021-10-05;"Bratislavský kraj";164;4468;70;4538;NA;320185;234;2021-10-05;95204
2021-10-04;"Bratislavský kraj";129;4653;79;4732;NA;320185;208;2021-10-04;94970
2021-10-03;"Bratislavský kraj";41;2144;42;2186;NA;320185;83;2021-10-03;94762
2021-10-02;"Bratislavský kraj";104;2605;40;2645;NA;320185;144;2021-10-02;94679
2021-10-01;"Bratislavský kraj";108;4818;57;4875;NA;320185;165;2021-10-01;94535
2021-09-30;"Bratislavský kraj";90;3854;60;3914;NA;320185;150;2021-09-30;94370
2021-09-29;"Bratislavský kraj";115;3508;58;3566;NA;320185;173;2021-09-29;94220
2021-09-28;"Bratislavský kraj";144;4003;48;4051;NA;320185;192;2021-09-28;94047
2021-09-27;"Bratislavský kraj";123;4427;70;4497;NA;320185;193;2021-09-27;93855
2021-09-26;"Bratislavský kraj";32;2194;31;2225;NA;320185;63;2021-09-26;93662
2021-09-25;"Bratislavský kraj";85;2742;38;2780;NA;320185;123;2021-09-25;93599
2021-09-24;"Bratislavský kraj";82;4212;59;4271;NA;320185;141;2021-09-24;93476
2021-09-23;"Bratislavský kraj";90;3975;51;4026;NA;320185;141;2021-09-23;93335
2021-09-22;"Bratislavský kraj";84;3757;63;3820;NA;320185;147;2021-09-22;93194
2021-09-21;"Bratislavský kraj";95;3574;39;3613;NA;320185;134;2021-09-21;93047
2021-09-20;"Bratislavský kraj";84;3937;31;3968;NA;320185;115;2021-09-20;92913
2021-09-19;"Bratislavský kraj";31;1850;28;1878;NA;320185;59;2021-09-19;92798
2021-09-18;"Bratislavský kraj";60;1989;19;2008;NA;320185;79;2021-09-18;92739
2021-09-17;"Bratislavský kraj";87;3443;27;3470;NA;320185;114;2021-09-17;92660
2021-09-16;"Bratislavský kraj";57;3781;43;3824;NA;320185;100;2021-09-16;92546
2021-09-15;"Bratislavský kraj";41;1104;21;1125;NA;320185;62;2021-09-15;92446
2021-09-14;"Bratislavský kraj";78;3518;31;3549;NA;320185;109;2021-09-14;92384
2021-09-13;"Bratislavský kraj";47;3191;28;3219;NA;320185;75;2021-09-13;92275
2021-09-12;"Bratislavský kraj";13;1713;21;1734;NA;320185;34;2021-09-12;92200
2021-09-11;"Bratislavský kraj";36;2064;13;2077;NA;320185;49;2021-09-11;92166
2021-09-10;"Bratislavský kraj";47;3628;18;3646;NA;320185;65;2021-09-10;92117
2021-09-09;"Bratislavský kraj";50;3010;30;3040;NA;320185;80;2021-09-09;92052
2021-09-08;"Bratislavský kraj";56;2925;20;2945;NA;320185;76;2021-09-08;91972
2021-09-07;"Bratislavský kraj";50;3272;18;3290;NA;320185;68;2021-09-07;91896
2021-09-06;"Bratislavský kraj";63;2821;29;2850;NA;320185;92;2021-09-06;91828
2021-09-05;"Bratislavský kraj";10;1682;14;1696;NA;320185;24;2021-09-05;91736
2021-09-04;"Bratislavský kraj";41;2612;11;2623;NA;320185;52;2021-09-04;91712
2021-09-03;"Bratislavský kraj";55;3016;14;3030;NA;320185;69;2021-09-03;91660
2021-09-02;"Bratislavský kraj";35;2423;23;2446;NA;320185;58;2021-09-02;91591
2021-09-01;"Bratislavský kraj";16;929;9;938;NA;320185;25;2021-09-01;91533
2021-08-31;"Bratislavský kraj";28;5197;22;5219;NA;320185;50;2021-08-31;91508
2021-08-30;"Bratislavský kraj";24;2403;13;2416;NA;320185;37;2021-08-30;91458
2021-08-29;"Bratislavský kraj";11;1016;6;1022;NA;320185;17;2021-08-29;91421
2021-08-28;"Bratislavský kraj";24;1714;11;1725;NA;320185;35;2021-08-28;91404
2021-08-27;"Bratislavský kraj";19;2850;9;2859;NA;320185;28;2021-08-27;91369
2021-08-26;"Bratislavský kraj";15;2382;19;2401;NA;320185;34;2021-08-26;91341
2021-08-25;"Bratislavský kraj";29;1888;10;1898;NA;320185;39;2021-08-25;91307
2021-08-24;"Bratislavský kraj";22;1785;4;1789;NA;320185;26;2021-08-24;91268
2021-08-23;"Bratislavský kraj";21;2183;7;2190;NA;320185;28;2021-08-23;91242
2021-08-22;"Bratislavský kraj";5;1383;8;1391;NA;320185;13;2021-08-22;91214
2021-08-21;"Bratislavský kraj";18;1681;4;1685;NA;320185;22;2021-08-21;91201
2021-08-20;"Bratislavský kraj";27;2747;19;2766;NA;320185;46;2021-08-20;91179
2021-08-19;"Bratislavský kraj";15;2122;9;2131;NA;320185;24;2021-08-19;91133
2021-08-18;"Bratislavský kraj";16;1659;11;1670;NA;320185;27;2021-08-18;91109
2021-08-17;"Bratislavský kraj";18;1608;5;1613;NA;320185;23;2021-08-17;91082
2021-08-16;"Bratislavský kraj";18;2559;12;2571;NA;320185;30;2021-08-16;91059
2021-08-15;"Bratislavský kraj";3;1169;6;1175;NA;320185;9;2021-08-15;91029
2021-08-14;"Bratislavský kraj";11;1519;4;1523;NA;320185;15;2021-08-14;91020
2021-08-13;"Bratislavský kraj";32;2634;7;2641;NA;320185;39;2021-08-13;91005
2021-08-12;"Bratislavský kraj";16;1824;9;1833;NA;320185;25;2021-08-12;90966
2021-08-11;"Bratislavský kraj";22;1621;5;1626;NA;320185;27;2021-08-11;90941
2021-08-10;"Bratislavský kraj";15;1630;7;1637;NA;320185;22;2021-08-10;90914
2021-08-09;"Bratislavský kraj";35;1927;9;1936;NA;320185;44;2021-08-09;90892
2021-08-08;"Bratislavský kraj";3;1152;4;1156;NA;320185;7;2021-08-08;90848
2021-08-07;"Bratislavský kraj";6;1572;9;1581;NA;320185;15;2021-08-07;90841
2021-08-06;"Bratislavský kraj";9;2510;10;2520;NA;320185;19;2021-08-06;90826
2021-08-05;"Bratislavský kraj";10;1651;7;1658;NA;320185;17;2021-08-05;90807
2021-08-04;"Bratislavský kraj";9;1578;0;1578;NA;320185;9;2021-08-04;90790
2021-08-03;"Bratislavský kraj";11;1507;5;1512;NA;320185;16;2021-08-03;90781
2021-08-02;"Bratislavský kraj";15;1749;11;1760;NA;320185;26;2021-08-02;90765
2021-08-01;"Bratislavský kraj";4;1224;8;1232;NA;320185;12;2021-08-01;90739
2021-07-31;"Bratislavský kraj";7;1623;2;1625;NA;320185;9;2021-07-31;90727
2021-07-30;"Bratislavský kraj";15;2540;7;2547;NA;320185;22;2021-07-30;90718
2021-07-29;"Bratislavský kraj";19;1790;7;1797;NA;320185;26;2021-07-29;90696
2021-07-28;"Bratislavský kraj";8;1538;11;1549;NA;320185;19;2021-07-28;90670
2021-07-27;"Bratislavský kraj";9;1476;5;1481;NA;320185;14;2021-07-27;90651
2021-07-26;"Bratislavský kraj";17;1806;7;1813;NA;320185;24;2021-07-26;90637
2021-07-25;"Bratislavský kraj";4;1411;2;1413;NA;320185;6;2021-07-25;90613
2021-07-24;"Bratislavský kraj";9;1732;3;1735;NA;320185;12;2021-07-24;90607
2021-07-23;"Bratislavský kraj";6;2400;3;2403;NA;320185;9;2021-07-23;90595
2021-07-22;"Bratislavský kraj";12;1944;6;1950;NA;320185;18;2021-07-22;90586
2021-07-21;"Bratislavský kraj";5;1860;6;1866;NA;320185;11;2021-07-21;90568
2021-07-20;"Bratislavský kraj";19;1559;1;1560;NA;320185;20;2021-07-20;90557
2021-07-19;"Bratislavský kraj";15;2259;3;2262;NA;320185;18;2021-07-19;90537
2021-07-18;"Bratislavský kraj";2;1462;3;1465;NA;320185;5;2021-07-18;90519
2021-07-17;"Bratislavský kraj";3;1870;2;1872;NA;320185;5;2021-07-17;90514
2021-07-16;"Bratislavský kraj";8;2834;4;2838;NA;320185;12;2021-07-16;90509
2021-07-15;"Bratislavský kraj";5;1677;0;1677;NA;320185;5;2021-07-15;90497
2021-07-14;"Bratislavský kraj";5;1904;3;1907;NA;320185;8;2021-07-14;90492
2021-07-13;"Bratislavský kraj";4;1584;4;1588;NA;320185;8;2021-07-13;90484
2021-07-12;"Bratislavský kraj";6;1780;5;1785;NA;320185;11;2021-07-12;90476
2021-07-11;"Bratislavský kraj";3;1896;3;1899;NA;320185;6;2021-07-11;90465
2021-07-10;"Bratislavský kraj";5;2240;3;2243;NA;320185;8;2021-07-10;90459
2021-07-09;"Bratislavský kraj";13;3546;7;3553;NA;320185;20;2021-07-09;90451
2021-07-08;"Bratislavský kraj";9;2433;4;2437;NA;320185;13;2021-07-08;90431
2021-07-07;"Bratislavský kraj";5;2792;4;2796;NA;320185;9;2021-07-07;90418
2021-07-06;"Bratislavský kraj";19;2771;4;2775;NA;320185;23;2021-07-06;90409
2021-07-05;"Bratislavský kraj";5;2481;5;2486;NA;320185;10;2021-07-05;90386
2021-07-04;"Bratislavský kraj";3;1824;2;1826;NA;320185;5;2021-07-04;90376
2021-07-03;"Bratislavský kraj";8;2205;5;2210;NA;320185;13;2021-07-03;90371
2021-07-02;"Bratislavský kraj";4;2227;4;2231;NA;320185;8;2021-07-02;90358
2021-07-01;"Bratislavský kraj";6;1809;5;1814;NA;320185;11;2021-07-01;90350
2021-06-30;"Bratislavský kraj";2;11548;11;11559;NA;320185;13;2021-06-30;90339
2021-06-29;"Bratislavský kraj";5;6831;7;6838;NA;320185;12;2021-06-29;90326
2021-06-28;"Bratislavský kraj";16;6654;24;6678;NA;320185;40;2021-06-28;90314
2021-06-27;"Bratislavský kraj";4;6689;11;6700;NA;320185;15;2021-06-27;90274
2021-06-26;"Bratislavský kraj";3;8741;6;8747;NA;320185;9;2021-06-26;90259
2021-06-25;"Bratislavský kraj";7;10285;15;10300;NA;320185;22;2021-06-25;90250
2021-06-24;"Bratislavský kraj";3;7384;16;7400;NA;320185;19;2021-06-24;90228
2021-06-23;"Bratislavský kraj";4;7346;12;7358;NA;320185;16;2021-06-23;90209
2021-06-22;"Bratislavský kraj";6;7244;10;7254;NA;320185;16;2021-06-22;90193
2021-06-21;"Bratislavský kraj";5;7641;9;7650;NA;320185;14;2021-06-21;90177
2021-06-20;"Bratislavský kraj";0;7369;5;7374;NA;320185;5;2021-06-20;90163
2021-06-19;"Bratislavský kraj";3;9226;4;9230;NA;320185;7;2021-06-19;90158
2021-06-18;"Bratislavský kraj";5;12763;9;12772;NA;320185;14;2021-06-18;90151
2021-06-17;"Bratislavský kraj";3;8625;13;8638;NA;320185;16;2021-06-17;90137
2021-06-16;"Bratislavský kraj";3;7105;4;7109;NA;320185;7;2021-06-16;90121
2021-06-15;"Bratislavský kraj";7;7309;17;7326;NA;320185;24;2021-06-15;90114
2021-06-14;"Bratislavský kraj";4;8231;9;8240;NA;320185;13;2021-06-14;90090
2021-06-13;"Bratislavský kraj";2;8791;11;8802;NA;320185;13;2021-06-13;90077
2021-06-12;"Bratislavský kraj";4;11152;11;11163;NA;320185;15;2021-06-12;90064
2021-06-11;"Bratislavský kraj";9;13644;21;13665;NA;320185;30;2021-06-11;90049
2021-06-10;"Bratislavský kraj";12;8637;15;8652;NA;320185;27;2021-06-10;90019
2021-06-09;"Bratislavský kraj";12;7596;12;7608;NA;320185;24;2021-06-09;89992
2021-06-08;"Bratislavský kraj";13;7907;29;7936;NA;320185;42;2021-06-08;89968
2021-06-07;"Bratislavský kraj";13;9247;43;9290;NA;320185;56;2021-06-07;89926
2021-06-06;"Bratislavský kraj";3;10350;20;10370;NA;320185;23;2021-06-06;89870
2021-06-05;"Bratislavský kraj";2;12692;15;12707;NA;320185;17;2021-06-05;89847
2021-06-04;"Bratislavský kraj";10;13846;31;13877;NA;320185;41;2021-06-04;89830
2021-06-03;"Bratislavský kraj";12;9615;19;9634;NA;320185;31;2021-06-03;89789
2021-06-02;"Bratislavský kraj";10;8684;17;8701;NA;320185;27;2021-06-02;89758
2021-06-01;"Bratislavský kraj";3;8812;25;8837;NA;320185;28;2021-06-01;89731
2021-05-31;"Bratislavský kraj";18;11248;32;11280;NA;320185;50;2021-05-31;89703
2021-05-30;"Bratislavský kraj";1;11758;17;11775;NA;320185;18;2021-05-30;89653
2021-05-29;"Bratislavský kraj";4;12245;8;12253;NA;320185;12;2021-05-29;89635
2021-05-28;"Bratislavský kraj";14;15865;23;15888;NA;320185;37;2021-05-28;89623
2021-05-27;"Bratislavský kraj";5;11321;18;11339;NA;320185;23;2021-05-27;89586
2021-05-26;"Bratislavský kraj";20;10709;17;10726;NA;320185;37;2021-05-26;89563
2021-05-25;"Bratislavský kraj";19;11864;31;11895;NA;320185;50;2021-05-25;89526
2021-05-24;"Bratislavský kraj";12;12966;23;12989;NA;320185;35;2021-05-24;89476
2021-05-23;"Bratislavský kraj";7;13074;24;13098;NA;320185;31;2021-05-23;89441
2021-05-22;"Bratislavský kraj";6;14044;22;14066;NA;320185;28;2021-05-22;89410
2021-05-21;"Bratislavský kraj";15;18996;22;19018;NA;320185;37;2021-05-21;89382
2021-05-20;"Bratislavský kraj";15;14112;17;14129;NA;320185;32;2021-05-20;89345
2021-05-19;"Bratislavský kraj";21;11958;24;11982;NA;320185;45;2021-05-19;89313
2021-05-18;"Bratislavský kraj";14;13005;33;13038;NA;320185;47;2021-05-18;89268
2021-05-17;"Bratislavský kraj";15;13854;29;13883;NA;320185;44;2021-05-17;89221
2021-05-16;"Bratislavský kraj";12;19797;32;19829;NA;320185;44;2021-05-16;89177
2021-05-15;"Bratislavský kraj";1;18113;30;18143;NA;320185;31;2021-05-15;89133
2021-05-14;"Bratislavský kraj";15;22228;30;22258;NA;320185;45;2021-05-14;89102
2021-05-13;"Bratislavský kraj";9;16211;17;16228;NA;320185;26;2021-05-13;89057
2021-05-12;"Bratislavský kraj";11;14638;28;14666;NA;320185;39;2021-05-12;89031
2021-05-11;"Bratislavský kraj";29;16741;32;16773;NA;320185;61;2021-05-11;88992
2021-05-10;"Bratislavský kraj";27;19991;64;20055;NA;320185;91;2021-05-10;88931
2021-05-09;"Bratislavský kraj";9;29358;32;29390;NA;320185;41;2021-05-09;88840
2021-05-08;"Bratislavský kraj";5;19451;24;19475;NA;320185;29;2021-05-08;88799
2021-05-07;"Bratislavský kraj";32;28211;65;28276;NA;320185;97;2021-05-07;88770
2021-05-06;"Bratislavský kraj";19;20079;52;20131;NA;320185;71;2021-05-06;88673
2021-05-05;"Bratislavský kraj";29;15526;31;15557;NA;320185;60;2021-05-05;88602
2021-05-04;"Bratislavský kraj";46;19143;53;19196;NA;320185;99;2021-05-04;88542
2021-05-03;"Bratislavský kraj";37;22322;64;22386;NA;320185;101;2021-05-03;88443
2021-05-02;"Bratislavský kraj";38;43064;75;43139;NA;320185;113;2021-05-02;88342
2021-05-01;"Bratislavský kraj";11;39905;40;39945;NA;320185;51;2021-05-01;88229
2021-04-30;"Bratislavský kraj";43;47403;82;47485;NA;320185;125;2021-04-30;88178
2021-04-29;"Bratislavský kraj";48;30257;96;30353;NA;320185;144;2021-04-29;88053
2021-04-28;"Bratislavský kraj";40;28905;78;28983;NA;320185;118;2021-04-28;87909
2021-04-27;"Bratislavský kraj";41;30168;52;30220;NA;320185;93;2021-04-27;87791
2021-04-26;"Bratislavský kraj";59;34733;97;34830;NA;320185;156;2021-04-26;87698
2021-04-25;"Bratislavský kraj";8;57615;74;57689;NA;320185;82;2021-04-25;87542
2021-04-24;"Bratislavský kraj";28;74858;66;74924;NA;320185;94;2021-04-24;87460
2021-04-23;"Bratislavský kraj";70;48614;62;48676;NA;320185;132;2021-04-23;87366
2021-04-22;"Bratislavský kraj";39;31037;72;31109;NA;320185;111;2021-04-22;87234
2021-04-21;"Bratislavský kraj";48;30442;62;30504;NA;320185;110;2021-04-21;87123
2021-04-20;"Bratislavský kraj";58;35216;63;35279;NA;320185;121;2021-04-20;87013
2021-04-19;"Bratislavský kraj";48;39500;80;39580;NA;320185;128;2021-04-19;86892
2021-04-18;"Bratislavský kraj";35;62300;76;62376;NA;320185;111;2021-04-18;86764
2021-04-17;"Bratislavský kraj";13;80359;111;80470;NA;320185;124;2021-04-17;86653
2021-04-16;"Bratislavský kraj";62;47296;80;47376;NA;320185;142;2021-04-16;86529
2021-04-15;"Bratislavský kraj";34;32176;74;32250;NA;320185;108;2021-04-15;86387
2021-04-14;"Bratislavský kraj";65;33961;88;34049;NA;320185;153;2021-04-14;86279
2021-04-13;"Bratislavský kraj";82;35512;82;35594;NA;320185;164;2021-04-13;86126
2021-04-12;"Bratislavský kraj";77;42286;115;42401;NA;320185;192;2021-04-12;85962
2021-04-11;"Bratislavský kraj";42;61151;123;61274;NA;320185;165;2021-04-11;85770
2021-04-10;"Bratislavský kraj";14;77874;167;78041;NA;320185;181;2021-04-10;85605
2021-04-09;"Bratislavský kraj";72;41556;97;41653;NA;320185;169;2021-04-09;85424
2021-04-08;"Bratislavský kraj";71;28866;95;28961;NA;320185;166;2021-04-08;85255
2021-04-07;"Bratislavský kraj";96;38061;101;38162;NA;320185;197;2021-04-07;85089
2021-04-06;"Bratislavský kraj";94;56204;179;56383;NA;320185;273;2021-04-06;84892
2021-04-05;"Bratislavský kraj";85;18538;85;18623;NA;320185;170;2021-04-05;84619
2021-04-04;"Bratislavský kraj";37;29225;75;29300;NA;320185;112;2021-04-04;84449
2021-04-03;"Bratislavský kraj";52;79865;220;80085;NA;320185;272;2021-04-03;84337
2021-04-02;"Bratislavský kraj";33;23790;104;23894;NA;320185;137;2021-04-02;84065
2021-04-01;"Bratislavský kraj";119;57388;159;57547;NA;320185;278;2021-04-01;83928
2021-03-31;"Bratislavský kraj";105;46371;177;46548;NA;320185;282;2021-03-31;83650
2021-03-30;"Bratislavský kraj";100;39599;144;39743;NA;320185;244;2021-03-30;83368
2021-03-29;"Bratislavský kraj";153;40364;178;40542;NA;320185;331;2021-03-29;83124
2021-03-28;"Bratislavský kraj";59;53372;137;53509;NA;320185;196;2021-03-28;82793
2021-03-27;"Bratislavský kraj";53;79834;240;80074;NA;320185;293;2021-03-27;82597
2021-03-26;"Bratislavský kraj";114;56108;191;56299;NA;320185;305;2021-03-26;82304
2021-03-25;"Bratislavský kraj";76;36859;172;37031;NA;320185;248;2021-03-25;81999
2021-03-24;"Bratislavský kraj";120;30567;201;30768;NA;320185;321;2021-03-24;81751
2021-03-23;"Bratislavský kraj";138;36438;190;36628;NA;320185;328;2021-03-23;81430
2021-03-22;"Bratislavský kraj";110;42756;220;42976;NA;320185;330;2021-03-22;81102
2021-03-21;"Bratislavský kraj";54;61299;212;61511;NA;320185;266;2021-03-21;80772
2021-03-20;"Bratislavský kraj";59;73300;228;73528;NA;320185;287;2021-03-20;80506
2021-03-19;"Bratislavský kraj";139;54576;257;54833;NA;320185;396;2021-03-19;80219
2021-03-18;"Bratislavský kraj";142;34611;192;34803;NA;320185;334;2021-03-18;79823
2021-03-17;"Bratislavský kraj";177;30482;217;30699;NA;320185;394;2021-03-17;79489
2021-03-16;"Bratislavský kraj";258;36798;287;37085;NA;320185;545;2021-03-16;79095
2021-03-15;"Bratislavský kraj";180;38226;255;38481;NA;320185;435;2021-03-15;78550
2021-03-14;"Bratislavský kraj";75;52611;275;52886;NA;320185;350;2021-03-14;78115
2021-03-13;"Bratislavský kraj";110;81405;341;81746;NA;320185;451;2021-03-13;77765
2021-03-12;"Bratislavský kraj";152;55233;312;55545;NA;320185;464;2021-03-12;77314
2021-03-11;"Bratislavský kraj";178;34678;286;34964;NA;320185;464;2021-03-11;76850
2021-03-10;"Bratislavský kraj";164;31061;280;31341;NA;320185;444;2021-03-10;76386
2021-03-09;"Bratislavský kraj";242;37687;267;37954;NA;320185;509;2021-03-09;75942
2021-03-08;"Bratislavský kraj";255;41199;348;41547;NA;320185;603;2021-03-08;75433
2021-03-07;"Bratislavský kraj";142;52812;301;53113;NA;320185;443;2021-03-07;74830
2021-03-06;"Bratislavský kraj";79;71821;415;72236;NA;320185;494;2021-03-06;74387
2021-03-05;"Bratislavský kraj";238;50653;293;50946;NA;320185;531;2021-03-05;73893
2021-03-04;"Bratislavský kraj";204;34544;344;34888;NA;320185;548;2021-03-04;73362
2021-03-03;"Bratislavský kraj";250;30527;364;30891;NA;320185;614;2021-03-03;72814
2021-03-02;"Bratislavský kraj";267;39735;388;40123;NA;320185;655;2021-03-02;72200
2021-03-01;"Bratislavský kraj";320;38222;432;38654;NA;320185;752;2021-03-01;71545
2021-02-28;"Bratislavský kraj";184;50323;323;50646;NA;320185;507;2021-02-28;70793
2021-02-27;"Bratislavský kraj";151;76580;464;77044;NA;320185;615;2021-02-27;70286
2021-02-26;"Bratislavský kraj";277;47326;401;47727;NA;320185;678;2021-02-26;69671
2021-02-25;"Bratislavský kraj";277;28769;405;29174;NA;320185;682;2021-02-25;68993
2021-02-24;"Bratislavský kraj";217;27095;412;27507;NA;320185;629;2021-02-24;68311
2021-02-23;"Bratislavský kraj";257;31297;395;31692;NA;320185;652;2021-02-23;67682
2021-02-22;"Bratislavský kraj";353;36607;483;37090;NA;320185;836;2021-02-22;67030
2021-02-21;"Bratislavský kraj";185;54150;396;54546;NA;320185;581;2021-02-21;66194
2021-02-20;"Bratislavský kraj";167;74814;550;75364;NA;320185;717;2021-02-20;65613
2021-02-19;"Bratislavský kraj";280;44882;416;45298;NA;320185;696;2021-02-19;64896
2021-02-18;"Bratislavský kraj";263;26379;371;26750;NA;320185;634;2021-02-18;64200
2021-02-17;"Bratislavský kraj";264;22820;316;23136;NA;320185;580;2021-02-17;63566
2021-02-16;"Bratislavský kraj";289;28262;352;28614;NA;320185;641;2021-02-16;62986
2021-02-15;"Bratislavský kraj";248;36893;396;37289;NA;320185;644;2021-02-15;62345
2021-02-14;"Bratislavský kraj";153;47948;323;48271;NA;320185;476;2021-02-14;61701
2021-02-13;"Bratislavský kraj";173;68589;515;69104;NA;320185;688;2021-02-13;61225
2021-02-12;"Bratislavský kraj";282;35729;327;36056;NA;320185;609;2021-02-12;60537
2021-02-11;"Bratislavský kraj";337;24565;285;24850;NA;320185;622;2021-02-11;59928
2021-02-10;"Bratislavský kraj";314;22944;356;23300;NA;320185;670;2021-02-10;59306
2021-02-09;"Bratislavský kraj";288;36565;454;37019;NA;320185;742;2021-02-09;58636
2021-02-08;"Bratislavský kraj";484;31896;397;32293;NA;320185;881;2021-02-08;57894
2021-02-07;"Bratislavský kraj";243;51290;425;51715;NA;320185;668;2021-02-07;57013
2021-02-06;"Bratislavský kraj";116;61682;501;62183;NA;320185;617;2021-02-06;56345
2021-02-05;"Bratislavský kraj";327;27033;375;27408;NA;320185;702;2021-02-05;55728
2021-02-04;"Bratislavský kraj";555;17260;348;17608;NA;320185;903;2021-02-04;55026
2021-02-03;"Bratislavský kraj";161;13020;352;13372;NA;320185;513;2021-02-03;54123
2021-02-02;"Bratislavský kraj";397;25947;480;26427;NA;320185;877;2021-02-02;53610
2021-02-01;"Bratislavský kraj";221;35541;513;36054;NA;320185;734;2021-02-01;52733
2021-01-31;"Bratislavský kraj";180;35693;425;36118;NA;320185;605;2021-01-31;51999
2021-01-30;"Bratislavský kraj";310;49588;521;50109;NA;320185;831;2021-01-30;51394
2021-01-29;"Bratislavský kraj";344;16568;344;16912;NA;320185;688;2021-01-29;50563
2021-01-28;"Bratislavský kraj";307;10715;297;11012;NA;320185;604;2021-01-28;49875
2021-01-27;"Bratislavský kraj";336;22222;345;22567;NA;320185;681;2021-01-27;49271
2021-01-26;"Bratislavský kraj";297;21894;300;22194;NA;320185;597;2021-01-26;48590
2021-01-25;"Bratislavský kraj";356;23335;249;23584;NA;320185;605;2021-01-25;47993
2021-01-24;"Bratislavský kraj";175;37903;404;38307;NA;320185;579;2021-01-24;47388
2021-01-23;"Bratislavský kraj";396;79453;690;80143;NA;320185;1086;2021-01-23;46809
2021-01-22;"Bratislavský kraj";199;42055;365;42420;NA;320185;564;2021-01-22;45723
2021-01-21;"Bratislavský kraj";255;105746;1317;107063;NA;320185;1572;2021-01-21;45159
2021-01-20;"Bratislavský kraj";360;27289;452;27741;NA;320185;812;2021-01-20;43587
2021-01-19;"Bratislavský kraj";375;15318;346;15664;NA;320185;721;2021-01-19;42775
2021-01-18;"Bratislavský kraj";357;12533;707;13240;NA;320185;1064;2021-01-18;42054
2021-01-17;"Bratislavský kraj";244;482;26;508;NA;320185;270;2021-01-17;40990
2021-01-16;"Bratislavský kraj";70;3016;156;3172;NA;320185;226;2021-01-16;40720
2021-01-15;"Bratislavský kraj";251;7896;256;8152;NA;320185;507;2021-01-15;40494
2021-01-14;"Bratislavský kraj";363;8523;273;8796;NA;320185;636;2021-01-14;39987
2021-01-13;"Bratislavský kraj";336;8490;327;8817;NA;320185;663;2021-01-13;39351
2021-01-12;"Bratislavský kraj";450;10509;455;10964;NA;320185;905;2021-01-12;38688
2021-01-11;"Bratislavský kraj";397;19863;364;20227;NA;320185;761;2021-01-11;37783
2021-01-10;"Bratislavský kraj";252;1507;79;1586;NA;320185;331;2021-01-10;37022
2021-01-09;"Bratislavský kraj";351;4721;277;4998;NA;320185;628;2021-01-09;36691
2021-01-08;"Bratislavský kraj";556;10045;436;10481;NA;320185;992;2021-01-08;36063
2021-01-07;"Bratislavský kraj";537;6872;352;7224;NA;320185;889;2021-01-07;35071
2021-01-06;"Bratislavský kraj";271;3329;216;3545;NA;320185;487;2021-01-06;34182
2021-01-05;"Bratislavský kraj";619;10635;814;11449;NA;320185;1433;2021-01-05;33695
2021-01-04;"Bratislavský kraj";601;8226;538;8764;NA;320185;1139;2021-01-04;32262
2021-01-03;"Bratislavský kraj";77;433;41;474;NA;320185;118;2021-01-03;31123
2021-01-02;"Bratislavský kraj";185;462;57;519;NA;320185;242;2021-01-02;31005
2021-01-01;"Bratislavský kraj";235;3277;131;3408;NA;320185;366;2021-01-01;30763
2020-12-31;"Bratislavský kraj";925;14135;519;14654;NA;320185;1444;2020-12-31;30397
2020-12-30;"Bratislavský kraj";650;9164;533;9697;NA;320185;1183;2020-12-30;28953
2020-12-29;"Bratislavský kraj";303;10108;699;10807;NA;320185;1002;2020-12-29;27770
2020-12-28;"Bratislavský kraj";255;7784;473;8257;NA;320185;728;2020-12-28;26768
2020-12-27;"Bratislavský kraj";160;709;76;785;NA;320185;236;2020-12-27;26040
2020-12-26;"Bratislavský kraj";75;480;27;507;NA;320185;102;2020-12-26;25804
2020-12-25;"Bratislavský kraj";114;503;38;541;NA;320185;152;2020-12-25;25702
2020-12-24;"Bratislavský kraj";536;3367;104;3471;NA;320185;640;2020-12-24;25550
2020-12-23;"Bratislavský kraj";416;12590;447;13037;NA;320185;863;2020-12-23;24910
2020-12-22;"Bratislavský kraj";327;14587;699;15286;NA;320185;1026;2020-12-22;24047
2020-12-21;"Bratislavský kraj";392;14972;1946;16918;NA;320185;2338;2020-12-21;23021
2020-12-20;"Bratislavský kraj";180;797;57;854;NA;320185;237;2020-12-20;20683
2020-12-19;"Bratislavský kraj";396;3314;130;3444;NA;320185;526;2020-12-19;20446
2020-12-18;"Bratislavský kraj";306;9938;345;10283;NA;320185;651;2020-12-18;19920
2020-12-17;"Bratislavský kraj";502;9739;386;10125;NA;320185;888;2020-12-17;19269
2020-12-16;"Bratislavský kraj";282;10201;418;10619;NA;320185;700;2020-12-16;18381
2020-12-15;"Bratislavský kraj";423;10450;454;10904;NA;320185;877;2020-12-15;17681
2020-12-14;"Bratislavský kraj";279;6793;261;7054;NA;320185;540;2020-12-14;16804
2020-12-13;"Bratislavský kraj";125;139;10;149;NA;320185;135;2020-12-13;16264
2020-12-12;"Bratislavský kraj";361;3886;157;4043;NA;320185;518;2020-12-12;16129
2020-12-11;"Bratislavský kraj";326;6824;235;7059;NA;320185;561;2020-12-11;15611
2020-12-10;"Bratislavský kraj";286;5279;166;5445;NA;320185;452;2020-12-10;15050
2020-12-09;"Bratislavský kraj";382;4778;177;4955;NA;320185;559;2020-12-09;14598
2020-12-08;"Bratislavský kraj";234;6243;207;6450;NA;320185;441;2020-12-08;14039
2020-12-07;"Bratislavský kraj";272;4639;152;4791;NA;320185;424;2020-12-07;13598
2020-12-06;"Bratislavský kraj";61;1625;52;1677;NA;320185;113;2020-12-06;13174
2020-12-05;"Bratislavský kraj";266;2221;41;2262;NA;320185;307;2020-12-05;13061
2020-12-04;"Bratislavský kraj";200;4954;99;5053;NA;320185;299;2020-12-04;12754
2020-12-03;"Bratislavský kraj";213;5672;95;5767;NA;320185;308;2020-12-03;12455
2020-12-02;"Bratislavský kraj";205;3462;103;3565;NA;320185;308;2020-12-02;12147
2020-12-01;"Bratislavský kraj";255;3889;172;4061;NA;320185;427;2020-12-01;11839
2020-11-30;"Bratislavský kraj";152;2153;121;2274;NA;320185;273;2020-11-30;11412
2020-11-29;"Bratislavský kraj";52;201;24;225;NA;320185;76;2020-11-29;11139
2020-11-28;"Bratislavský kraj";232;2624;33;2657;NA;320185;265;2020-11-28;11063
2020-11-27;"Bratislavský kraj";54;2540;64;2604;NA;320185;118;2020-11-27;10798
2020-11-26;"Bratislavský kraj";129;1976;60;2036;NA;320185;189;2020-11-26;10680
2020-11-25;"Bratislavský kraj";140;1770;47;1817;NA;320185;187;2020-11-25;10491
2020-11-24;"Bratislavský kraj";81;2988;67;3055;NA;320185;148;2020-11-24;10304
2020-11-23;"Bratislavský kraj";67;7083;58;7141;NA;320185;125;2020-11-23;10156
2020-11-22;"Bratislavský kraj";36;81;7;88;NA;320185;43;2020-11-22;10031
2020-11-21;"Bratislavský kraj";109;2126;47;2173;NA;320185;156;2020-11-21;9988
2020-11-20;"Bratislavský kraj";118;2876;48;2924;NA;320185;166;2020-11-20;9832
2020-11-19;"Bratislavský kraj";173;987;29;1016;NA;320185;202;2020-11-19;9666
2020-11-18;"Bratislavský kraj";118;616;75;691;NA;320185;193;2020-11-18;9464
2020-11-17;"Bratislavský kraj";108;928;23;951;NA;320185;131;2020-11-17;9271
2020-11-16;"Bratislavský kraj";82;651;9;660;NA;320185;91;2020-11-16;9140
2020-11-15;"Bratislavský kraj";47;236;0;236;NA;320185;47;2020-11-15;9049
2020-11-14;"Bratislavský kraj";53;1834;15;1849;NA;320185;68;2020-11-14;9002
2020-11-13;"Bratislavský kraj";94;2096;21;2117;NA;320185;115;2020-11-13;8934
2020-11-12;"Bratislavský kraj";141;1727;6;1733;NA;320185;147;2020-11-12;8819
2020-11-11;"Bratislavský kraj";159;1429;12;1441;NA;320185;171;2020-11-11;8672
2020-11-10;"Bratislavský kraj";136;805;14;819;NA;320185;150;2020-11-10;8501
2020-11-09;"Bratislavský kraj";70;616;8;624;NA;320185;78;2020-11-09;8351
2020-11-08;"Bratislavský kraj";82;869;6;875;NA;320185;88;2020-11-08;8273
2020-11-07;"Bratislavský kraj";88;4039;17;4056;NA;320185;105;2020-11-07;8185
2020-11-06;"Bratislavský kraj";281;6441;25;6466;NA;320185;306;2020-11-06;8080
2020-11-05;"Bratislavský kraj";175;476;11;487;NA;320185;186;2020-11-05;7774
2020-11-04;"Bratislavský kraj";65;411;10;421;NA;320185;75;2020-11-04;7588
2020-11-03;"Bratislavský kraj";251;1085;12;1097;NA;320185;263;2020-11-03;7513
2020-11-02;"Bratislavský kraj";202;3365;22;3387;NA;320185;224;2020-11-02;7250
2020-11-01;"Bratislavský kraj";227;8694;39;8733;NA;320185;266;2020-11-01;7026
2020-10-31;"Bratislavský kraj";173;22407;123;22530;NA;320185;296;2020-10-31;6760
2020-10-30;"Bratislavský kraj";158;17350;138;17488;NA;320185;296;2020-10-30;6464
2020-10-29;"Bratislavský kraj";262;116;4;120;NA;320185;266;2020-10-29;6168
2020-10-28;"Bratislavský kraj";220;260;15;275;NA;320185;235;2020-10-28;5902
2020-10-27;"Bratislavský kraj";256;145;4;149;NA;320185;260;2020-10-27;5667
2020-10-26;"Bratislavský kraj";123;229;11;240;NA;320185;134;2020-10-26;5407
2020-10-25;"Bratislavský kraj";152;33;2;35;NA;320185;154;2020-10-25;5273
2020-10-24;"Bratislavský kraj";170;221;6;227;NA;320185;176;2020-10-24;5119
2020-10-23;"Bratislavský kraj";151;144;8;152;NA;320185;159;2020-10-23;4943
2020-10-22;"Bratislavský kraj";192;204;15;219;NA;320185;207;2020-10-22;4784
2020-10-21;"Bratislavský kraj";66;90;6;96;NA;320185;72;2020-10-21;4577
2020-10-20;"Bratislavský kraj";183;97;4;101;NA;320185;187;2020-10-20;4505
2020-10-19;"Bratislavský kraj";148;80;3;83;NA;320185;151;2020-10-19;4318
2020-10-18;"Bratislavský kraj";75;92;0;92;NA;320185;75;2020-10-18;4167
2020-10-17;"Bratislavský kraj";41;0;0;0;NA;320185;41;2020-10-17;4092
2022-03-27;"Košický kraj";355;585;166;751;223122;328114;521;2022-03-27;328114
2022-03-26;"Košický kraj";593;518;112;630;NA;328114;705;2022-03-26;327593
2022-03-25;"Košický kraj";958;1198;236;1434;NA;328114;1194;2022-03-25;326888
2022-03-24;"Košický kraj";998;2331;354;2685;NA;328114;1352;2022-03-24;325694
2022-03-23;"Košický kraj";1143;2585;342;2927;NA;328114;1485;2022-03-23;324342
2022-03-22;"Košický kraj";1508;2725;372;3097;NA;328114;1880;2022-03-22;322857
2022-03-21;"Košický kraj";1241;3427;518;3945;NA;328114;1759;2022-03-21;320977
2022-03-20;"Košický kraj";199;1496;309;1805;NA;328114;508;2022-03-20;319218
2022-03-19;"Košický kraj";952;1122;235;1357;NA;328114;1187;2022-03-19;318710
2022-03-18;"Košický kraj";1382;2086;326;2412;NA;328114;1708;2022-03-18;317523
2022-03-17;"Košický kraj";1181;2696;347;3043;NA;328114;1528;2022-03-17;315815
2022-03-16;"Košický kraj";1631;4782;365;5147;NA;328114;1996;2022-03-16;314287
2022-03-15;"Košický kraj";1591;2859;425;3284;NA;328114;2016;2022-03-15;312291
2022-03-14;"Košický kraj";1424;3466;560;4026;NA;328114;1984;2022-03-14;310275
2022-03-13;"Košický kraj";565;1699;361;2060;NA;328114;926;2022-03-13;308291
2022-03-12;"Košický kraj";1227;1263;218;1481;NA;328114;1445;2022-03-12;307365
2022-03-11;"Košický kraj";1451;2815;513;3328;NA;328114;1964;2022-03-11;305920
2022-03-10;"Košický kraj";990;3153;406;3559;NA;328114;1396;2022-03-10;303956
2022-03-09;"Košický kraj";1545;3322;397;3719;NA;328114;1942;2022-03-09;302560
2022-03-08;"Košický kraj";1487;3633;441;4074;NA;328114;1928;2022-03-08;300618
2022-03-07;"Košický kraj";1347;4964;713;5677;NA;328114;2060;2022-03-07;298690
2022-03-06;"Košický kraj";297;1811;372;2183;NA;328114;669;2022-03-06;296630
2022-03-05;"Košický kraj";874;1317;264;1581;NA;328114;1138;2022-03-05;295961
2022-03-04;"Košický kraj";1255;3126;424;3550;NA;328114;1679;2022-03-04;294823
2022-03-03;"Košický kraj";1111;3543;433;3976;NA;328114;1544;2022-03-03;293144
2022-03-02;"Košický kraj";1458;3437;455;3892;NA;328114;1913;2022-03-02;291600
2022-03-01;"Košický kraj";1723;3716;487;4203;NA;328114;2210;2022-03-01;289687
2022-02-28;"Košický kraj";1345;5497;805;6302;NA;328114;2150;2022-02-28;287477
2022-02-27;"Košický kraj";465;2397;440;2837;NA;328114;905;2022-02-27;285327
2022-02-26;"Košický kraj";979;1348;329;1677;NA;328114;1308;2022-02-26;284422
2022-02-25;"Košický kraj";1691;3274;510;3784;NA;328114;2201;2022-02-25;283114
2022-02-24;"Košický kraj";1988;4033;594;4627;NA;328114;2582;2022-02-24;280913
2022-02-23;"Košický kraj";1787;4151;558;4709;NA;328114;2345;2022-02-23;278331
2022-02-22;"Košický kraj";2649;4695;660;5355;NA;328114;3309;2022-02-22;275986
2022-02-21;"Košický kraj";1646;6499;910;7409;NA;328114;2556;2022-02-21;272677
2022-02-20;"Košický kraj";577;2919;578;3497;NA;328114;1155;2022-02-20;270121
2022-02-19;"Košický kraj";1941;2169;409;2578;NA;328114;2350;2022-02-19;268966
2022-02-18;"Košický kraj";2210;4534;640;5174;NA;328114;2850;2022-02-18;266616
2022-02-17;"Košický kraj";2555;4668;675;5343;NA;328114;3230;2022-02-17;263766
2022-02-16;"Košický kraj";2153;5477;736;6213;NA;328114;2889;2022-02-16;260536
2022-02-15;"Košický kraj";2768;5507;830;6337;NA;328114;3598;2022-02-15;257647
2022-02-14;"Košický kraj";2337;8076;1104;9180;NA;328114;3441;2022-02-14;254049
2022-02-13;"Košický kraj";1235;4248;809;5057;NA;328114;2044;2022-02-13;250608
2022-02-12;"Košický kraj";1728;2014;524;2538;NA;328114;2252;2022-02-12;248564
2022-02-11;"Košický kraj";2665;4797;633;5430;NA;328114;3298;2022-02-11;246312
2022-02-10;"Košický kraj";2135;5323;728;6051;NA;328114;2863;2022-02-10;243014
2022-02-09;"Košický kraj";2067;5940;743;6683;NA;328114;2810;2022-02-09;240151
2022-02-08;"Košický kraj";2993;6143;762;6905;NA;328114;3755;2022-02-08;237341
2022-02-07;"Košický kraj";1939;7973;978;8951;NA;328114;2917;2022-02-07;233586
2022-02-06;"Košický kraj";998;4482;680;5162;NA;328114;1678;2022-02-06;230669
2022-02-05;"Košický kraj";2209;2454;434;2888;NA;328114;2643;2022-02-05;228991
2022-02-04;"Košický kraj";2563;5634;632;6266;NA;328114;3195;2022-02-04;226348
2022-02-03;"Košický kraj";1916;6379;659;7038;NA;328114;2575;2022-02-03;223153
2022-02-02;"Košický kraj";2498;6923;629;7552;NA;328114;3127;2022-02-02;220578
2022-02-01;"Košický kraj";2173;6706;678;7384;NA;328114;2851;2022-02-01;217451
2022-01-31;"Košický kraj";2020;9960;841;10801;NA;328114;2861;2022-01-31;214600
2022-01-30;"Košický kraj";1002;5716;541;6257;NA;328114;1543;2022-01-30;211739
2022-01-29;"Košický kraj";1731;2720;387;3107;NA;328114;2118;2022-01-29;210196
2022-01-28;"Košický kraj";1743;5571;492;6063;NA;328114;2235;2022-01-28;208078
2022-01-27;"Košický kraj";1553;5792;413;6205;NA;328114;1966;2022-01-27;205843
2022-01-26;"Košický kraj";1683;5613;399;6012;NA;328114;2082;2022-01-26;203877
2022-01-25;"Košický kraj";1409;6210;404;6614;NA;328114;1813;2022-01-25;201795
2022-01-24;"Košický kraj";1141;8669;431;9100;NA;328114;1572;2022-01-24;199982
2022-01-23;"Košický kraj";516;5418;287;5705;NA;328114;803;2022-01-23;198410
2022-01-22;"Košický kraj";914;2528;177;2705;NA;328114;1091;2022-01-22;197607
2022-01-21;"Košický kraj";589;5194;227;5421;NA;328114;816;2022-01-21;196516
2022-01-20;"Košický kraj";769;5379;200;5579;NA;328114;969;2022-01-20;195700
2022-01-19;"Košický kraj";629;5329;178;5507;NA;328114;807;2022-01-19;194731
2022-01-18;"Košický kraj";716;5758;140;5898;NA;328114;856;2022-01-18;193924
2022-01-17;"Košický kraj";486;9004;187;9191;NA;328114;673;2022-01-17;193068
2022-01-16;"Košický kraj";51;5264;137;5401;NA;328114;188;2022-01-16;192395
2022-01-15;"Košický kraj";422;2208;69;2277;NA;328114;491;2022-01-15;192207
2022-01-14;"Košický kraj";175;4208;93;4301;NA;328114;268;2022-01-14;191716
2022-01-13;"Košický kraj";165;4919;77;4996;NA;328114;242;2022-01-13;191448
2022-01-12;"Košický kraj";295;4609;78;4687;NA;328114;373;2022-01-12;191206
2022-01-11;"Košický kraj";349;5295;70;5365;NA;328114;419;2022-01-11;190833
2022-01-10;"Košický kraj";290;8254;128;8382;NA;328114;418;2022-01-10;190414
2022-01-09;"Košický kraj";230;5838;86;5924;NA;328114;316;2022-01-09;189996
2022-01-08;"Košický kraj";157;2417;57;2474;NA;328114;214;2022-01-08;189680
2022-01-07;"Košický kraj";388;5017;129;5146;NA;328114;517;2022-01-07;189466
2022-01-06;"Košický kraj";118;1576;55;1631;NA;328114;173;2022-01-06;188949
2022-01-05;"Košický kraj";354;5082;102;5184;NA;328114;456;2022-01-05;188776
2022-01-04;"Košický kraj";450;5273;84;5357;NA;328114;534;2022-01-04;188320
2022-01-03;"Košický kraj";439;7970;140;8110;NA;328114;579;2022-01-03;187786
2022-01-02;"Košický kraj";284;4614;109;4723;NA;328114;393;2022-01-02;187207
2022-01-01;"Košický kraj";28;360;18;378;NA;328114;46;2022-01-01;186814
2021-12-31;"Košický kraj";122;2999;86;3085;NA;328114;208;2021-12-31;186768
2021-12-30;"Košický kraj";401;3949;118;4067;NA;328114;519;2021-12-30;186560
2021-12-29;"Košický kraj";378;4194;111;4305;NA;328114;489;2021-12-29;186041
2021-12-28;"Košický kraj";509;4450;125;4575;NA;328114;634;2021-12-28;185552
2021-12-27;"Košický kraj";495;6822;205;7027;NA;328114;700;2021-12-27;184918
2021-12-26;"Košický kraj";109;2510;115;2625;NA;328114;224;2021-12-26;184218
2021-12-25;"Košický kraj";30;644;43;687;NA;328114;73;2021-12-25;183994
2021-12-24;"Košický kraj";95;1055;50;1105;NA;328114;145;2021-12-24;183921
2021-12-23;"Košický kraj";644;4479;131;4610;NA;328114;775;2021-12-23;183776
2021-12-22;"Košický kraj";224;4309;106;4415;NA;328114;330;2021-12-22;183001
2021-12-21;"Košický kraj";544;6491;138;6629;NA;328114;682;2021-12-21;182671
2021-12-20;"Košický kraj";464;8630;196;8826;NA;328114;660;2021-12-20;181989
2021-12-19;"Košický kraj";137;5447;177;5624;NA;328114;314;2021-12-19;181329
2021-12-18;"Košický kraj";414;2555;102;2657;NA;328114;516;2021-12-18;181015
2021-12-17;"Košický kraj";428;4832;145;4977;NA;328114;573;2021-12-17;180499
2021-12-16;"Košický kraj";476;5845;168;6013;NA;328114;644;2021-12-16;179926
2021-12-15;"Košický kraj";508;5956;172;6128;NA;328114;680;2021-12-15;179282
2021-12-14;"Košický kraj";957;5789;172;5961;NA;328114;1129;2021-12-14;178602
2021-12-13;"Košický kraj";679;9657;248;9905;NA;328114;927;2021-12-13;177473
2021-12-12;"Košický kraj";243;6657;198;6855;NA;328114;441;2021-12-12;176546
2021-12-11;"Košický kraj";519;2996;134;3130;NA;328114;653;2021-12-11;176105
2021-12-10;"Košický kraj";936;5465;185;5650;NA;328114;1121;2021-12-10;175452
2021-12-09;"Košický kraj";755;5779;198;5977;NA;328114;953;2021-12-09;174331
2021-12-08;"Košický kraj";1095;6574;275;6849;NA;328114;1370;2021-12-08;173378
2021-12-07;"Košický kraj";1212;6323;267;6590;NA;328114;1479;2021-12-07;172008
2021-12-06;"Košický kraj";904;10627;313;10940;NA;328114;1217;2021-12-06;170529
2021-12-05;"Košický kraj";404;7756;263;8019;NA;328114;667;2021-12-05;169312
2021-12-04;"Košický kraj";1007;3097;180;3277;NA;328114;1187;2021-12-04;168645
2021-12-03;"Košický kraj";1338;6065;271;6336;NA;328114;1609;2021-12-03;167458
2021-12-02;"Košický kraj";2209;5654;302;5956;NA;328114;2511;2021-12-02;165849
2021-12-01;"Košický kraj";1016;6483;388;6871;NA;328114;1404;2021-12-01;163338
2021-11-30;"Košický kraj";1125;8173;471;8644;NA;328114;1596;2021-11-30;161934
2021-11-29;"Košický kraj";993;14057;634;14691;NA;328114;1627;2021-11-29;160338
2021-11-28;"Košický kraj";972;10211;473;10684;NA;328114;1445;2021-11-28;158711
2021-11-27;"Košický kraj";1103;3566;219;3785;NA;328114;1322;2021-11-27;157266
2021-11-26;"Košický kraj";1395;6059;383;6442;NA;328114;1778;2021-11-26;155944
2021-11-25;"Košický kraj";1373;7016;499;7515;NA;328114;1872;2021-11-25;154166
2021-11-24;"Košický kraj";1194;7067;473;7540;NA;328114;1667;2021-11-24;152294
2021-11-23;"Košický kraj";1178;7185;488;7673;NA;328114;1666;2021-11-23;150627
2021-11-22;"Košický kraj";861;10709;741;11450;NA;328114;1602;2021-11-22;148961
2021-11-21;"Košický kraj";985;7394;657;8051;NA;328114;1642;2021-11-21;147359
2021-11-20;"Košický kraj";1083;2859;295;3154;NA;328114;1378;2021-11-20;145717
2021-11-19;"Košický kraj";1078;7543;516;8059;NA;328114;1594;2021-11-19;144339
2021-11-18;"Košický kraj";1061;9410;719;10129;NA;328114;1780;2021-11-18;142745
2021-11-17;"Košický kraj";1319;2824;262;3086;NA;328114;1581;2021-11-17;140965
2021-11-16;"Košický kraj";1484;7135;543;7678;NA;328114;2027;2021-11-16;139384
2021-11-15;"Košický kraj";902;10812;754;11566;NA;328114;1656;2021-11-15;137357
2021-11-14;"Košický kraj";715;5756;455;6211;NA;328114;1170;2021-11-14;135701
2021-11-13;"Košický kraj";869;2686;312;2998;NA;328114;1181;2021-11-13;134531
2021-11-12;"Košický kraj";1132;5616;410;6026;NA;328114;1542;2021-11-12;133350
2021-11-11;"Košický kraj";1035;6139;460;6599;NA;328114;1495;2021-11-11;131808
2021-11-10;"Košický kraj";933;6633;497;7130;NA;328114;1430;2021-11-10;130313
2021-11-09;"Košický kraj";967;5540;389;5929;NA;328114;1356;2021-11-09;128883
2021-11-08;"Košický kraj";701;7838;601;8439;NA;328114;1302;2021-11-08;127527
2021-11-07;"Košický kraj";691;4578;425;5003;NA;328114;1116;2021-11-07;126225
2021-11-06;"Košický kraj";996;2276;217;2493;NA;328114;1213;2021-11-06;125109
2021-11-05;"Košický kraj";1029;4905;367;5272;NA;328114;1396;2021-11-05;123896
2021-11-04;"Košický kraj";1000;5354;360;5714;NA;328114;1360;2021-11-04;122500
2021-11-03;"Košický kraj";1051;5749;361;6110;NA;328114;1412;2021-11-03;121140
2021-11-02;"Košický kraj";915;8775;566;9341;NA;328114;1481;2021-11-02;119728
2021-11-01;"Košický kraj";181;1999;265;2264;NA;328114;446;2021-11-01;118247
2021-10-31;"Košický kraj";385;2337;227;2564;NA;328114;612;2021-10-31;117801
2021-10-30;"Košický kraj";641;2380;180;2560;NA;328114;821;2021-10-30;117189
2021-10-29;"Košický kraj";750;4608;289;4897;NA;328114;1039;2021-10-29;116368
2021-10-28;"Košický kraj";823;5115;255;5370;NA;328114;1078;2021-10-28;115329
2021-10-27;"Košický kraj";723;4831;259;5090;NA;328114;982;2021-10-27;114251
2021-10-26;"Košický kraj";618;5049;225;5274;NA;328114;843;2021-10-26;113269
2021-10-25;"Košický kraj";268;6747;292;7039;NA;328114;560;2021-10-25;112426
2021-10-24;"Košický kraj";170;3447;205;3652;NA;328114;375;2021-10-24;111866
2021-10-23;"Košický kraj";397;1953;86;2039;NA;328114;483;2021-10-23;111491
2021-10-22;"Košický kraj";474;4679;130;4809;NA;328114;604;2021-10-22;111008
2021-10-21;"Košický kraj";669;5094;172;5266;NA;328114;841;2021-10-21;110404
2021-10-20;"Košický kraj";398;4963;152;5115;NA;328114;550;2021-10-20;109563
2021-10-19;"Košický kraj";579;4870;161;5031;NA;328114;740;2021-10-19;109013
2021-10-18;"Košický kraj";180;7090;171;7261;NA;328114;351;2021-10-18;108273
2021-10-17;"Košický kraj";70;3614;125;3739;NA;328114;195;2021-10-17;107922
2021-10-16;"Košický kraj";312;1839;40;1879;NA;328114;352;2021-10-16;107727
2021-10-15;"Košický kraj";312;4530;77;4607;NA;328114;389;2021-10-15;107375
2021-10-14;"Košický kraj";327;4652;95;4747;NA;328114;422;2021-10-14;106986
2021-10-13;"Košický kraj";168;4168;88;4256;NA;328114;256;2021-10-13;106564
2021-10-12;"Košický kraj";391;4119;75;4194;NA;328114;466;2021-10-12;106308
2021-10-11;"Košický kraj";119;6351;121;6472;NA;328114;240;2021-10-11;105842
2021-10-10;"Košický kraj";104;2921;63;2984;NA;328114;167;2021-10-10;105602
2021-10-09;"Košický kraj";111;1687;43;1730;NA;328114;154;2021-10-09;105435
2021-10-08;"Košický kraj";274;4143;68;4211;NA;328114;342;2021-10-08;105281
2021-10-07;"Košický kraj";277;4399;74;4473;NA;328114;351;2021-10-07;104939
2021-10-06;"Košický kraj";178;4369;89;4458;NA;328114;267;2021-10-06;104588
2021-10-05;"Košický kraj";345;4542;78;4620;NA;328114;423;2021-10-05;104321
2021-10-04;"Košický kraj";122;6094;110;6204;NA;328114;232;2021-10-04;103898
2021-10-03;"Košický kraj";133;3176;74;3250;NA;328114;207;2021-10-03;103666
2021-10-02;"Košický kraj";124;2567;41;2608;NA;328114;165;2021-10-02;103459
2021-10-01;"Košický kraj";181;4251;73;4324;NA;328114;254;2021-10-01;103294
2021-09-30;"Košický kraj";244;4780;71;4851;NA;328114;315;2021-09-30;103040
2021-09-29;"Košický kraj";183;3824;64;3888;NA;328114;247;2021-09-29;102725
2021-09-28;"Košický kraj";303;4339;80;4419;NA;328114;383;2021-09-28;102478
2021-09-27;"Košický kraj";117;6358;77;6435;NA;328114;194;2021-09-27;102095
2021-09-26;"Košický kraj";13;2809;44;2853;NA;328114;57;2021-09-26;101901
2021-09-25;"Košický kraj";162;2521;35;2556;NA;328114;197;2021-09-25;101844
2021-09-24;"Košický kraj";183;4756;43;4799;NA;328114;226;2021-09-24;101647
2021-09-23;"Košický kraj";142;3880;51;3931;NA;328114;193;2021-09-23;101421
2021-09-22;"Košický kraj";151;4436;52;4488;NA;328114;203;2021-09-22;101228
2021-09-21;"Košický kraj";234;4441;44;4485;NA;328114;278;2021-09-21;101025
2021-09-20;"Košický kraj";158;6017;73;6090;NA;328114;231;2021-09-20;100747
2021-09-19;"Košický kraj";15;2487;30;2517;NA;328114;45;2021-09-19;100516
2021-09-18;"Košický kraj";187;2504;24;2528;NA;328114;211;2021-09-18;100471
2021-09-17;"Košický kraj";121;4797;41;4838;NA;328114;162;2021-09-17;100260
2021-09-16;"Košický kraj";228;4503;71;4574;NA;328114;299;2021-09-16;100098
2021-09-15;"Košický kraj";52;989;16;1005;NA;328114;68;2021-09-15;99799
2021-09-14;"Košický kraj";142;3456;47;3503;NA;328114;189;2021-09-14;99731
2021-09-13;"Košický kraj";96;4949;48;4997;NA;328114;144;2021-09-13;99542
2021-09-12;"Košický kraj";14;2003;31;2034;NA;328114;45;2021-09-12;99398
2021-09-11;"Košický kraj";105;2186;19;2205;NA;328114;124;2021-09-11;99353
2021-09-10;"Košický kraj";125;4293;42;4335;NA;328114;167;2021-09-10;99229
2021-09-09;"Košický kraj";115;3226;30;3256;NA;328114;145;2021-09-09;99062
2021-09-08;"Košický kraj";86;2753;36;2789;NA;328114;122;2021-09-08;98917
2021-09-07;"Košický kraj";79;2686;53;2739;NA;328114;132;2021-09-07;98795
2021-09-06;"Košický kraj";41;2786;36;2822;NA;328114;77;2021-09-06;98663
2021-09-05;"Košický kraj";52;1393;18;1411;NA;328114;70;2021-09-05;98586
2021-09-04;"Košický kraj";37;1678;12;1690;NA;328114;49;2021-09-04;98516
2021-09-03;"Košický kraj";47;2913;35;2948;NA;328114;82;2021-09-03;98467
2021-09-02;"Košický kraj";56;2686;26;2712;NA;328114;82;2021-09-02;98385
2021-09-01;"Košický kraj";95;629;13;642;NA;328114;108;2021-09-01;98303
2021-08-31;"Košický kraj";30;2525;22;2547;NA;328114;52;2021-08-31;98195
2021-08-30;"Košický kraj";8;2404;28;2432;NA;328114;36;2021-08-30;98143
2021-08-29;"Košický kraj";16;603;1;604;NA;328114;17;2021-08-29;98107
2021-08-28;"Košický kraj";14;2103;11;2114;NA;328114;25;2021-08-28;98090
2021-08-27;"Košický kraj";22;2908;16;2924;NA;328114;38;2021-08-27;98065
2021-08-26;"Košický kraj";19;2292;13;2305;NA;328114;32;2021-08-26;98027
2021-08-25;"Košický kraj";33;2010;6;2016;NA;328114;39;2021-08-25;97995
2021-08-24;"Košický kraj";14;2337;3;2340;NA;328114;17;2021-08-24;97956
2021-08-23;"Košický kraj";33;2461;5;2466;NA;328114;38;2021-08-23;97939
2021-08-22;"Košický kraj";4;1457;8;1465;NA;328114;12;2021-08-22;97901
2021-08-21;"Košický kraj";35;2134;5;2139;NA;328114;40;2021-08-21;97889
2021-08-20;"Košický kraj";13;3215;5;3220;NA;328114;18;2021-08-20;97849
2021-08-19;"Košický kraj";14;2178;6;2184;NA;328114;20;2021-08-19;97831
2021-08-18;"Košický kraj";30;1827;8;1835;NA;328114;38;2021-08-18;97811
2021-08-17;"Košický kraj";24;1619;3;1622;NA;328114;27;2021-08-17;97773
2021-08-16;"Košický kraj";3;2236;10;2246;NA;328114;13;2021-08-16;97746
2021-08-15;"Košický kraj";1;778;5;783;NA;328114;6;2021-08-15;97733
2021-08-14;"Košický kraj";15;1222;1;1223;NA;328114;16;2021-08-14;97727
2021-08-13;"Košický kraj";14;1928;8;1936;NA;328114;22;2021-08-13;97711
2021-08-12;"Košický kraj";10;1248;3;1251;NA;328114;13;2021-08-12;97689
2021-08-11;"Košický kraj";6;1368;5;1373;NA;328114;11;2021-08-11;97676
2021-08-10;"Košický kraj";10;1352;8;1360;NA;328114;18;2021-08-10;97665
2021-08-09;"Košický kraj";12;1651;3;1654;NA;328114;15;2021-08-09;97647
2021-08-08;"Košický kraj";8;688;1;689;NA;328114;9;2021-08-08;97632
2021-08-07;"Košický kraj";3;1125;3;1128;NA;328114;6;2021-08-07;97623
2021-08-06;"Košický kraj";9;1614;6;1620;NA;328114;15;2021-08-06;97617
2021-08-05;"Košický kraj";26;1254;6;1260;NA;328114;32;2021-08-05;97602
2021-08-04;"Košický kraj";8;1373;5;1378;NA;328114;13;2021-08-04;97570
2021-08-03;"Košický kraj";33;1121;3;1124;NA;328114;36;2021-08-03;97557
2021-08-02;"Košický kraj";6;1702;8;1710;NA;328114;14;2021-08-02;97521
2021-08-01;"Košický kraj";1;662;1;663;NA;328114;2;2021-08-01;97507
2021-07-31;"Košický kraj";17;1153;2;1155;NA;328114;19;2021-07-31;97505
2021-07-30;"Košický kraj";12;1657;7;1664;NA;328114;19;2021-07-30;97486
2021-07-29;"Košický kraj";7;1242;5;1247;NA;328114;12;2021-07-29;97467
2021-07-28;"Košický kraj";15;956;5;961;NA;328114;20;2021-07-28;97455
2021-07-27;"Košický kraj";17;1180;7;1187;NA;328114;24;2021-07-27;97435
2021-07-26;"Košický kraj";3;1666;9;1675;NA;328114;12;2021-07-26;97411
2021-07-25;"Košický kraj";0;719;3;722;NA;328114;3;2021-07-25;97399
2021-07-24;"Košický kraj";18;996;4;1000;NA;328114;22;2021-07-24;97396
2021-07-23;"Košický kraj";9;1524;5;1529;NA;328114;14;2021-07-23;97374
2021-07-22;"Košický kraj";1;1254;4;1258;NA;328114;5;2021-07-22;97360
2021-07-21;"Košický kraj";4;1117;3;1120;NA;328114;7;2021-07-21;97355
2021-07-20;"Košický kraj";6;1355;1;1356;NA;328114;7;2021-07-20;97348
2021-07-19;"Košický kraj";2;1517;2;1519;NA;328114;4;2021-07-19;97341
2021-07-18;"Košický kraj";0;644;0;644;NA;328114;0;2021-07-18;97337
2021-07-17;"Košický kraj";3;1101;5;1106;NA;328114;8;2021-07-17;97337
2021-07-16;"Košický kraj";3;1609;4;1613;NA;328114;7;2021-07-16;97329
2021-07-15;"Košický kraj";4;1383;4;1387;NA;328114;8;2021-07-15;97322
2021-07-14;"Košický kraj";2;1175;4;1179;NA;328114;6;2021-07-14;97314
2021-07-13;"Košický kraj";4;1331;1;1332;NA;328114;5;2021-07-13;97308
2021-07-12;"Košický kraj";3;1894;3;1897;NA;328114;6;2021-07-12;97303
2021-07-11;"Košický kraj";1;537;2;539;NA;328114;3;2021-07-11;97297
2021-07-10;"Košický kraj";9;1167;0;1167;NA;328114;9;2021-07-10;97294
2021-07-09;"Košický kraj";5;2005;5;2010;NA;328114;10;2021-07-09;97285
2021-07-08;"Košický kraj";13;1282;2;1284;NA;328114;15;2021-07-08;97275
2021-07-07;"Košický kraj";6;1524;1;1525;NA;328114;7;2021-07-07;97260
2021-07-06;"Košický kraj";4;1886;2;1888;NA;328114;6;2021-07-06;97253
2021-07-05;"Košický kraj";1;573;1;574;NA;328114;2;2021-07-05;97247
2021-07-04;"Košický kraj";0;482;2;484;NA;328114;2;2021-07-04;97245
2021-07-03;"Košický kraj";2;1227;0;1227;NA;328114;2;2021-07-03;97243
2021-07-02;"Košický kraj";2;1883;3;1886;NA;328114;5;2021-07-02;97241
2021-07-01;"Košický kraj";0;1211;2;1213;NA;328114;2;2021-07-01;97236
2021-06-30;"Košický kraj";5;9306;7;9313;NA;328114;12;2021-06-30;97234
2021-06-29;"Košický kraj";6;5692;7;5699;NA;328114;13;2021-06-29;97222
2021-06-28;"Košický kraj";5;6129;2;6131;NA;328114;7;2021-06-28;97209
2021-06-27;"Košický kraj";8;4636;3;4639;NA;328114;11;2021-06-27;97202
2021-06-26;"Košický kraj";4;5699;14;5713;NA;328114;18;2021-06-26;97191
2021-06-25;"Košický kraj";5;6981;2;6983;NA;328114;7;2021-06-25;97173
2021-06-24;"Košický kraj";1;5072;3;5075;NA;328114;4;2021-06-24;97166
2021-06-23;"Košický kraj";8;5373;3;5376;NA;328114;11;2021-06-23;97162
2021-06-22;"Košický kraj";1;5269;3;5272;NA;328114;4;2021-06-22;97151
2021-06-21;"Košický kraj";5;6830;11;6841;NA;328114;16;2021-06-21;97147
2021-06-20;"Košický kraj";0;4882;6;4888;NA;328114;6;2021-06-20;97131
2021-06-19;"Košický kraj";7;6473;1;6474;NA;328114;8;2021-06-19;97125
2021-06-18;"Košický kraj";4;7969;8;7977;NA;328114;12;2021-06-18;97117
2021-06-17;"Košický kraj";6;6128;3;6131;NA;328114;9;2021-06-17;97105
2021-06-16;"Košický kraj";11;6059;7;6066;NA;328114;18;2021-06-16;97096
2021-06-15;"Košický kraj";12;6301;2;6303;NA;328114;14;2021-06-15;97078
2021-06-14;"Košický kraj";10;7076;9;7085;NA;328114;19;2021-06-14;97064
2021-06-13;"Košický kraj";7;6948;8;6956;NA;328114;15;2021-06-13;97045
2021-06-12;"Košický kraj";7;7485;9;7494;NA;328114;16;2021-06-12;97030
2021-06-11;"Košický kraj";15;8973;6;8979;NA;328114;21;2021-06-11;97014
2021-06-10;"Košický kraj";11;6588;16;6604;NA;328114;27;2021-06-10;96993
2021-06-09;"Košický kraj";37;6056;7;6063;NA;328114;44;2021-06-09;96966
2021-06-08;"Košický kraj";33;7019;13;7032;NA;328114;46;2021-06-08;96922
2021-06-07;"Košický kraj";11;8106;22;8128;NA;328114;33;2021-06-07;96876
2021-06-06;"Košický kraj";1;7843;7;7850;NA;328114;8;2021-06-06;96843
2021-06-05;"Košický kraj";21;9286;3;9289;NA;328114;24;2021-06-05;96835
2021-06-04;"Košický kraj";26;11418;20;11438;NA;328114;46;2021-06-04;96811
2021-06-03;"Košický kraj";23;6467;14;6481;NA;328114;37;2021-06-03;96765
2021-06-02;"Košický kraj";15;7180;24;7204;NA;328114;39;2021-06-02;96728
2021-06-01;"Košický kraj";13;7562;10;7572;NA;328114;23;2021-06-01;96689
2021-05-31;"Košický kraj";13;9256;18;9274;NA;328114;31;2021-05-31;96666
2021-05-30;"Košický kraj";3;11215;10;11225;NA;328114;13;2021-05-30;96635
2021-05-29;"Košický kraj";25;10942;22;10964;NA;328114;47;2021-05-29;96622
2021-05-28;"Košický kraj";17;13055;29;13084;NA;328114;46;2021-05-28;96575
2021-05-27;"Košický kraj";19;7924;26;7950;NA;328114;45;2021-05-27;96529
2021-05-26;"Košický kraj";35;8118;27;8145;NA;328114;62;2021-05-26;96484
2021-05-25;"Košický kraj";33;9296;29;9325;NA;328114;62;2021-05-25;96422
2021-05-24;"Košický kraj";10;10855;27;10882;NA;328114;37;2021-05-24;96360
2021-05-23;"Košický kraj";4;12151;15;12166;NA;328114;19;2021-05-23;96323
2021-05-22;"Košický kraj";27;12601;19;12620;NA;328114;46;2021-05-22;96304
2021-05-21;"Košický kraj";24;14910;27;14937;NA;328114;51;2021-05-21;96258
2021-05-20;"Košický kraj";20;9422;28;9450;NA;328114;48;2021-05-20;96207
2021-05-19;"Košický kraj";30;10421;21;10442;NA;328114;51;2021-05-19;96159
2021-05-18;"Košický kraj";34;10254;36;10290;NA;328114;70;2021-05-18;96108
2021-05-17;"Košický kraj";20;12686;38;12724;NA;328114;58;2021-05-17;96038
2021-05-16;"Košický kraj";37;17865;20;17885;NA;328114;57;2021-05-16;95980
2021-05-15;"Košický kraj";22;25602;28;25630;NA;328114;50;2021-05-15;95923
2021-05-14;"Košický kraj";32;21824;42;21866;NA;328114;74;2021-05-14;95873
2021-05-13;"Košický kraj";39;10172;32;10204;NA;328114;71;2021-05-13;95799
2021-05-12;"Košický kraj";85;10868;33;10901;NA;328114;118;2021-05-12;95728
2021-05-11;"Košický kraj";68;11166;32;11198;NA;328114;100;2021-05-11;95610
2021-05-10;"Košický kraj";25;17044;42;17086;NA;328114;67;2021-05-10;95510
2021-05-09;"Košický kraj";84;25594;55;25649;NA;328114;139;2021-05-09;95443
2021-05-08;"Košický kraj";18;23399;23;23422;NA;328114;41;2021-05-08;95304
2021-05-07;"Košický kraj";51;24497;57;24554;NA;328114;108;2021-05-07;95263
2021-05-06;"Košický kraj";55;11847;43;11890;NA;328114;98;2021-05-06;95155
2021-05-05;"Košický kraj";23;12124;35;12159;NA;328114;58;2021-05-05;95057
2021-05-04;"Košický kraj";143;13562;38;13600;NA;328114;181;2021-05-04;94999
2021-05-03;"Košický kraj";37;16944;68;17012;NA;328114;105;2021-05-03;94818
2021-05-02;"Košický kraj";45;36096;56;36152;NA;328114;101;2021-05-02;94713
2021-05-01;"Košický kraj";54;52075;76;52151;NA;328114;130;2021-05-01;94612
2021-04-30;"Košický kraj";59;44602;94;44696;NA;328114;153;2021-04-30;94482
2021-04-29;"Košický kraj";76;17014;53;17067;NA;328114;129;2021-04-29;94329
2021-04-28;"Košický kraj";99;17970;52;18022;NA;328114;151;2021-04-28;94200
2021-04-27;"Košický kraj";108;20670;43;20713;NA;328114;151;2021-04-27;94049
2021-04-26;"Košický kraj";39;25915;96;26011;NA;328114;135;2021-04-26;93898
2021-04-25;"Košický kraj";23;48355;57;48412;NA;328114;80;2021-04-25;93763
2021-04-24;"Košický kraj";68;90124;114;90238;NA;328114;182;2021-04-24;93683
2021-04-23;"Košický kraj";110;41232;72;41304;NA;328114;182;2021-04-23;93501
2021-04-22;"Košický kraj";56;16772;44;16816;NA;328114;100;2021-04-22;93319
2021-04-21;"Košický kraj";114;19519;61;19580;NA;328114;175;2021-04-21;93219
2021-04-20;"Košický kraj";81;25432;63;25495;NA;328114;144;2021-04-20;93044
2021-04-19;"Košický kraj";93;29950;108;30058;NA;328114;201;2021-04-19;92900
2021-04-18;"Košický kraj";10;48913;82;48995;NA;328114;92;2021-04-18;92699
2021-04-17;"Košický kraj";187;83856;103;83959;NA;328114;290;2021-04-17;92607
2021-04-16;"Košický kraj";83;41568;127;41695;NA;328114;210;2021-04-16;92317
2021-04-15;"Košický kraj";104;18522;93;18615;NA;328114;197;2021-04-15;92107
2021-04-14;"Košický kraj";119;20089;64;20153;NA;328114;183;2021-04-14;91910
2021-04-13;"Košický kraj";81;23175;120;23295;NA;328114;201;2021-04-13;91727
2021-04-12;"Košický kraj";129;26573;124;26697;NA;328114;253;2021-04-12;91526
2021-04-11;"Košický kraj";29;46949;80;47029;NA;328114;109;2021-04-11;91273
2021-04-10;"Košický kraj";138;100114;183;100297;NA;328114;321;2021-04-10;91164
2021-04-09;"Košický kraj";168;35206;133;35339;NA;328114;301;2021-04-09;90843
2021-04-08;"Košický kraj";81;18530;90;18620;NA;328114;171;2021-04-08;90542
2021-04-07;"Košický kraj";232;28027;194;28221;NA;328114;426;2021-04-07;90371
2021-04-06;"Košický kraj";121;36495;164;36659;NA;328114;285;2021-04-06;89945
2021-04-05;"Košický kraj";19;14361;66;14427;NA;328114;85;2021-04-05;89660
2021-04-04;"Košický kraj";33;15089;66;15155;NA;328114;99;2021-04-04;89575
2021-04-03;"Košický kraj";138;97664;241;97905;NA;328114;379;2021-04-03;89476
2021-04-02;"Košický kraj";128;24515;76;24591;NA;328114;204;2021-04-02;89097
2021-04-01;"Košický kraj";165;46151;156;46307;NA;328114;321;2021-04-01;88893
2021-03-31;"Košický kraj";160;29659;124;29783;NA;328114;284;2021-03-31;88572
2021-03-30;"Košický kraj";229;24038;163;24201;NA;328114;392;2021-03-30;88288
2021-03-29;"Košický kraj";78;28843;194;29037;NA;328114;272;2021-03-29;87896
2021-03-28;"Košický kraj";39;44263;128;44391;NA;328114;167;2021-03-28;87624
2021-03-27;"Košický kraj";222;96602;265;96867;NA;328114;487;2021-03-27;87457
2021-03-26;"Košický kraj";233;45252;202;45454;NA;328114;435;2021-03-26;86970
2021-03-25;"Košický kraj";133;23804;175;23979;NA;328114;308;2021-03-25;86535
2021-03-24;"Košický kraj";165;20696;155;20851;NA;328114;320;2021-03-24;86227
2021-03-23;"Košický kraj";202;22434;192;22626;NA;328114;394;2021-03-23;85907
2021-03-22;"Košický kraj";169;26890;228;27118;NA;328114;397;2021-03-22;85513
2021-03-21;"Košický kraj";109;46746;167;46913;NA;328114;276;2021-03-21;85116
2021-03-20;"Košický kraj";126;101334;311;101645;NA;328114;437;2021-03-20;84840
2021-03-19;"Košický kraj";205;45632;260;45892;NA;328114;465;2021-03-19;84403
2021-03-18;"Košický kraj";274;23827;212;24039;NA;328114;486;2021-03-18;83938
2021-03-17;"Košický kraj";177;21548;195;21743;NA;328114;372;2021-03-17;83452
2021-03-16;"Košický kraj";386;23454;226;23680;NA;328114;612;2021-03-16;83080
2021-03-15;"Košický kraj";173;27900;297;28197;NA;328114;470;2021-03-15;82468
2021-03-14;"Košický kraj";145;44354;220;44574;NA;328114;365;2021-03-14;81998
2021-03-13;"Košický kraj";146;103790;483;104273;NA;328114;629;2021-03-13;81633
2021-03-12;"Košický kraj";366;47871;321;48192;NA;328114;687;2021-03-12;81004
2021-03-11;"Košický kraj";396;23229;263;23492;NA;328114;659;2021-03-11;80317
2021-03-10;"Košický kraj";121;22205;269;22474;NA;328114;390;2021-03-10;79658
2021-03-09;"Košický kraj";676;24509;300;24809;NA;328114;976;2021-03-09;79268
2021-03-08;"Košický kraj";559;29852;344;30196;NA;328114;903;2021-03-08;78292
2021-03-07;"Košický kraj";45;44230;299;44529;NA;328114;344;2021-03-07;77389
2021-03-06;"Košický kraj";177;105598;532;106130;NA;328114;709;2021-03-06;77045
2021-03-05;"Košický kraj";439;45567;424;45991;NA;328114;863;2021-03-05;76336
2021-03-04;"Košický kraj";417;23862;320;24182;NA;328114;737;2021-03-04;75473
2021-03-03;"Košický kraj";390;23169;298;23467;NA;328114;688;2021-03-03;74736
2021-03-02;"Košický kraj";464;24158;368;24526;NA;328114;832;2021-03-02;74048
2021-03-01;"Košický kraj";389;30013;514;30527;NA;328114;903;2021-03-01;73216
2021-02-28;"Košický kraj";265;43053;334;43387;NA;328114;599;2021-02-28;72313
2021-02-27;"Košický kraj";301;100559;784;101343;NA;328114;1085;2021-02-27;71714
2021-02-26;"Košický kraj";440;45466;492;45958;NA;328114;932;2021-02-26;70629
2021-02-25;"Košický kraj";331;19872;342;20214;NA;328114;673;2021-02-25;69697
2021-02-24;"Košický kraj";263;18751;505;19256;NA;328114;768;2021-02-24;69024
2021-02-23;"Košický kraj";642;21605;341;21946;NA;328114;983;2021-02-23;68256
2021-02-22;"Košický kraj";362;30858;434;31292;NA;328114;796;2021-02-22;67273
2021-02-21;"Košický kraj";170;40464;385;40849;NA;328114;555;2021-02-21;66477
2021-02-20;"Košický kraj";283;92550;770;93320;NA;328114;1053;2021-02-20;65922
2021-02-19;"Košický kraj";507;41579;583;42162;NA;328114;1090;2021-02-19;64869
2021-02-18;"Košický kraj";397;18442;345;18787;NA;328114;742;2021-02-18;63779
2021-02-17;"Košický kraj";322;18080;387;18467;NA;328114;709;2021-02-17;63037
2021-02-16;"Košický kraj";600;22111;463;22574;NA;328114;1063;2021-02-16;62328
2021-02-15;"Košický kraj";216;27633;419;28052;NA;328114;635;2021-02-15;61265
2021-02-14;"Košický kraj";241;56743;524;57267;NA;328114;765;2021-02-14;60630
2021-02-13;"Košický kraj";206;93745;765;94510;NA;328114;971;2021-02-13;59865
2021-02-12;"Košický kraj";448;49924;611;50535;NA;328114;1059;2021-02-12;58894
2021-02-11;"Košický kraj";435;14524;323;14847;NA;328114;758;2021-02-11;57835
2021-02-10;"Košický kraj";360;18475;431;18906;NA;328114;791;2021-02-10;57077
2021-02-09;"Košický kraj";544;24841;463;25304;NA;328114;1007;2021-02-09;56286
2021-02-08;"Košický kraj";237;24836;392;25228;NA;328114;629;2021-02-08;55279
2021-02-07;"Košický kraj";208;56897;612;57509;NA;328114;820;2021-02-07;54650
2021-02-06;"Košický kraj";318;104357;884;105241;NA;328114;1202;2021-02-06;53830
2021-02-05;"Košický kraj";384;43186;494;43680;NA;328114;878;2021-02-05;52628
2021-02-04;"Košický kraj";391;14512;371;14883;NA;328114;762;2021-02-04;51750
2021-02-03;"Košický kraj";296;12599;339;12938;NA;328114;635;2021-02-03;50988
2021-02-02;"Košický kraj";473;43883;1212;45095;NA;328114;1685;2021-02-02;50353
2021-02-01;"Košický kraj";415;21984;362;22346;NA;328114;777;2021-02-01;48668
2021-01-31;"Košický kraj";142;54690;617;55307;NA;328114;759;2021-01-31;47891
2021-01-30;"Košický kraj";320;76722;661;77383;NA;328114;981;2021-01-30;47132
2021-01-29;"Košický kraj";311;37164;466;37630;NA;328114;777;2021-01-29;46151
2021-01-28;"Košický kraj";540;9006;244;9250;NA;328114;784;2021-01-28;45374
2021-01-27;"Košický kraj";265;7575;211;7786;NA;328114;476;2021-01-27;44590
2021-01-26;"Košický kraj";530;14210;245;14455;NA;328114;775;2021-01-26;44114
2021-01-25;"Košický kraj";226;26431;413;26844;NA;328114;639;2021-01-25;43339
2021-01-24;"Košický kraj";150;44419;581;45000;NA;328114;731;2021-01-24;42700
2021-01-23;"Košický kraj";232;82705;857;83562;NA;328114;1089;2021-01-23;41969
2021-01-22;"Košický kraj";316;19997;265;20262;NA;328114;581;2021-01-22;40880
2021-01-21;"Košický kraj";274;14053;159;14212;NA;328114;433;2021-01-21;40299
2021-01-20;"Košický kraj";374;10844;201;11045;NA;328114;575;2021-01-20;39866
2021-01-19;"Košický kraj";248;9717;181;9898;NA;328114;429;2021-01-19;39291
2021-01-18;"Košický kraj";333;7659;262;7921;NA;328114;595;2021-01-18;38862
2021-01-17;"Košický kraj";155;535;14;549;NA;328114;169;2021-01-17;38267
2021-01-16;"Košický kraj";153;1403;47;1450;NA;328114;200;2021-01-16;38098
2021-01-15;"Košický kraj";308;6443;213;6656;NA;328114;521;2021-01-15;37898
2021-01-14;"Košický kraj";358;5471;221;5692;NA;328114;579;2021-01-14;37377
2021-01-13;"Košický kraj";421;4897;226;5123;NA;328114;647;2021-01-13;36798
2021-01-12;"Košický kraj";482;6473;237;6710;NA;328114;719;2021-01-12;36151
2021-01-11;"Košický kraj";309;7553;286;7839;NA;328114;595;2021-01-11;35432
2021-01-10;"Košický kraj";193;136;6;142;NA;328114;199;2021-01-10;34837
2021-01-09;"Košický kraj";469;1134;45;1179;NA;328114;514;2021-01-09;34638
2021-01-08;"Košický kraj";551;7106;348;7454;NA;328114;899;2021-01-08;34124
2021-01-07;"Košický kraj";251;5853;398;6251;NA;328114;649;2021-01-07;33225
2021-01-06;"Košický kraj";442;429;33;462;NA;328114;475;2021-01-06;32576
2021-01-05;"Košický kraj";584;7633;527;8160;NA;328114;1111;2021-01-05;32101
2021-01-04;"Košický kraj";407;6479;660;7139;NA;328114;1067;2021-01-04;30990
2021-01-03;"Košický kraj";118;661;22;683;NA;328114;140;2021-01-03;29923
2021-01-02;"Košický kraj";88;440;52;492;NA;328114;140;2021-01-02;29783
2021-01-01;"Košický kraj";398;725;49;774;NA;328114;447;2021-01-01;29643
2020-12-31;"Košický kraj";625;7509;453;7962;NA;328114;1078;2020-12-31;29196
2020-12-30;"Košický kraj";590;6076;395;6471;NA;328114;985;2020-12-30;28118
2020-12-29;"Košický kraj";419;7454;596;8050;NA;328114;1015;2020-12-29;27133
2020-12-28;"Košický kraj";356;7933;756;8689;NA;328114;1112;2020-12-28;26118
2020-12-27;"Košický kraj";159;147;16;163;NA;328114;175;2020-12-27;25006
2020-12-26;"Košický kraj";163;274;23;297;NA;328114;186;2020-12-26;24831
2020-12-25;"Košický kraj";237;140;10;150;NA;328114;247;2020-12-25;24645
2020-12-24;"Košický kraj";564;1470;90;1560;NA;328114;654;2020-12-24;24398
2020-12-23;"Košický kraj";304;7339;327;7666;NA;328114;631;2020-12-23;23744
2020-12-22;"Košický kraj";438;7284;429;7713;NA;328114;867;2020-12-22;23113
2020-12-21;"Košický kraj";405;6703;504;7207;NA;328114;909;2020-12-21;22246
2020-12-20;"Košický kraj";215;73;11;84;NA;328114;226;2020-12-20;21337
2020-12-19;"Košický kraj";207;1309;63;1372;NA;328114;270;2020-12-19;21111
2020-12-18;"Košický kraj";310;7707;292;7999;NA;328114;602;2020-12-18;20841
2020-12-17;"Košický kraj";463;5101;253;5354;NA;328114;716;2020-12-17;20239
2020-12-16;"Košický kraj";455;5725;295;6020;NA;328114;750;2020-12-16;19523
2020-12-15;"Košický kraj";319;4787;327;5114;NA;328114;646;2020-12-15;18773
2020-12-14;"Košický kraj";256;2905;225;3130;NA;328114;481;2020-12-14;18127
2020-12-13;"Košický kraj";47;181;2;183;NA;328114;49;2020-12-13;17646
2020-12-12;"Košický kraj";369;1587;118;1705;NA;328114;487;2020-12-12;17597
2020-12-11;"Košický kraj";354;5328;256;5584;NA;328114;610;2020-12-11;17110
2020-12-10;"Košický kraj";283;3987;174;4161;NA;328114;457;2020-12-10;16500
2020-12-09;"Košický kraj";279;3786;166;3952;NA;328114;445;2020-12-09;16043
2020-12-08;"Košický kraj";226;4105;355;4460;NA;328114;581;2020-12-08;15598
2020-12-07;"Košický kraj";270;2383;106;2489;NA;328114;376;2020-12-07;15017
2020-12-06;"Košický kraj";121;482;33;515;NA;328114;154;2020-12-06;14641
2020-12-05;"Košický kraj";90;1096;48;1144;NA;328114;138;2020-12-05;14487
2020-12-04;"Košický kraj";224;2680;82;2762;NA;328114;306;2020-12-04;14349
2020-12-03;"Košický kraj";211;7717;173;7890;NA;328114;384;2020-12-03;14043
2020-12-02;"Košický kraj";193;8132;496;8628;NA;328114;689;2020-12-02;13659
2020-12-01;"Košický kraj";178;2237;124;2361;NA;328114;302;2020-12-01;12970
2020-11-30;"Košický kraj";171;3598;59;3657;NA;328114;230;2020-11-30;12668
2020-11-29;"Košický kraj";31;325;17;342;NA;328114;48;2020-11-29;12438
2020-11-28;"Košický kraj";69;721;52;773;NA;328114;121;2020-11-28;12390
2020-11-27;"Košický kraj";149;2921;78;2999;NA;328114;227;2020-11-27;12269
2020-11-26;"Košický kraj";239;1234;60;1294;NA;328114;299;2020-11-26;12042
2020-11-25;"Košický kraj";237;1785;123;1908;NA;328114;360;2020-11-25;11743
2020-11-24;"Košický kraj";196;1976;67;2043;NA;328114;263;2020-11-24;11383
2020-11-23;"Košický kraj";51;4115;63;4178;NA;328114;114;2020-11-23;11120
2020-11-22;"Košický kraj";57;57;5;62;NA;328114;62;2020-11-22;11006
2020-11-21;"Košický kraj";87;858;36;894;NA;328114;123;2020-11-21;10944
2020-11-20;"Košický kraj";176;3084;49;3133;NA;328114;225;2020-11-20;10821
2020-11-19;"Košický kraj";206;1736;48;1784;NA;328114;254;2020-11-19;10596
2020-11-18;"Košický kraj";122;532;17;549;NA;328114;139;2020-11-18;10342
2020-11-17;"Košický kraj";152;82;9;91;NA;328114;161;2020-11-17;10203
2020-11-16;"Košický kraj";114;596;27;623;NA;328114;141;2020-11-16;10042
2020-11-15;"Košický kraj";15;338;7;345;NA;328114;22;2020-11-15;9901
2020-11-14;"Košický kraj";234;520;12;532;NA;328114;246;2020-11-14;9879
2020-11-13;"Košický kraj";207;664;29;693;NA;328114;236;2020-11-13;9633
2020-11-12;"Košický kraj";192;736;13;749;NA;328114;205;2020-11-12;9397
2020-11-11;"Košický kraj";301;593;7;600;NA;328114;308;2020-11-11;9192
2020-11-10;"Košický kraj";190;541;11;552;NA;328114;201;2020-11-10;8884
2020-11-09;"Košický kraj";129;380;17;397;NA;328114;146;2020-11-09;8683
2020-11-08;"Košický kraj";78;1306;8;1314;NA;328114;86;2020-11-08;8537
2020-11-07;"Košický kraj";192;3909;22;3931;NA;328114;214;2020-11-07;8451
2020-11-06;"Košický kraj";195;5310;34;5344;NA;328114;229;2020-11-06;8237
2020-11-05;"Košický kraj";342;330;31;361;NA;328114;373;2020-11-05;8008
2020-11-04;"Košický kraj";101;154;6;160;NA;328114;107;2020-11-04;7635
2020-11-03;"Košický kraj";358;1122;13;1135;NA;328114;371;2020-11-03;7528
2020-11-02;"Košický kraj";111;6125;56;6181;NA;328114;167;2020-11-02;7157
2020-11-01;"Košický kraj";346;6522;34;6556;NA;328114;380;2020-11-01;6990
2020-10-31;"Košický kraj";82;14035;106;14141;NA;328114;188;2020-10-31;6610
2020-10-30;"Košický kraj";379;2835;27;2862;NA;328114;406;2020-10-30;6422
2020-10-29;"Košický kraj";333;983;13;996;NA;328114;346;2020-10-29;6016
2020-10-28;"Košický kraj";224;305;13;318;NA;328114;237;2020-10-28;5670
2020-10-27;"Košický kraj";386;439;21;460;NA;328114;407;2020-10-27;5433
2020-10-26;"Košický kraj";56;212;12;224;NA;328114;68;2020-10-26;5026
2020-10-25;"Košický kraj";154;79;2;81;NA;328114;156;2020-10-25;4958
2020-10-24;"Košický kraj";313;118;16;134;NA;328114;329;2020-10-24;4802
2020-10-23;"Košický kraj";315;331;8;339;NA;328114;323;2020-10-23;4473
2020-10-22;"Košický kraj";349;530;16;546;NA;328114;365;2020-10-22;4150
2020-10-21;"Košický kraj";129;84;2;86;NA;328114;131;2020-10-21;3785
2020-10-20;"Košický kraj";181;14;1;15;NA;328114;182;2020-10-20;3654
2020-10-19;"Košický kraj";64;38;1;39;NA;328114;65;2020-10-19;3472
2020-10-18;"Košický kraj";158;0;0;0;NA;328114;158;2020-10-18;3407
2020-10-17;"Košický kraj";51;0;0;0;NA;328114;51;2020-10-17;3249
2022-03-27;"Nitriansky kraj";463;312;82;394;174670;270962;545;2022-03-27;270962
2022-03-26;"Nitriansky kraj";653;243;67;310;NA;270962;720;2022-03-26;270417
2022-03-25;"Nitriansky kraj";918;938;189;1127;NA;270962;1107;2022-03-25;269697
2022-03-24;"Nitriansky kraj";1391;1234;186;1420;NA;270962;1577;2022-03-24;268590
2022-03-23;"Nitriansky kraj";1401;1490;455;1945;NA;270962;1856;2022-03-23;267013
2022-03-22;"Nitriansky kraj";1360;1533;191;1724;NA;270962;1551;2022-03-22;265157
2022-03-21;"Nitriansky kraj";1304;2086;332;2418;NA;270962;1636;2022-03-21;263606
2022-03-20;"Nitriansky kraj";552;933;226;1159;NA;270962;778;2022-03-20;261970
2022-03-19;"Nitriansky kraj";839;424;146;570;NA;270962;985;2022-03-19;261192
2022-03-18;"Nitriansky kraj";1205;1201;271;1472;NA;270962;1476;2022-03-18;260207
2022-03-17;"Nitriansky kraj";1734;1457;236;1693;NA;270962;1970;2022-03-17;258731
2022-03-16;"Nitriansky kraj";1214;1472;232;1704;NA;270962;1446;2022-03-16;256761
2022-03-15;"Nitriansky kraj";1590;1566;256;1822;NA;270962;1846;2022-03-15;255315
2022-03-14;"Nitriansky kraj";1325;2630;384;3014;NA;270962;1709;2022-03-14;253469
2022-03-13;"Nitriansky kraj";527;992;202;1194;NA;270962;729;2022-03-13;251760
2022-03-12;"Nitriansky kraj";711;739;169;908;NA;270962;880;2022-03-12;251031
2022-03-11;"Nitriansky kraj";1085;1890;365;2255;NA;270962;1450;2022-03-11;250151
2022-03-10;"Nitriansky kraj";1403;2015;313;2328;NA;270962;1716;2022-03-10;248701
2022-03-09;"Nitriansky kraj";1452;2118;323;2441;NA;270962;1775;2022-03-09;246985
2022-03-08;"Nitriansky kraj";1695;2542;350;2892;NA;270962;2045;2022-03-08;245210
2022-03-07;"Nitriansky kraj";1115;3386;521;3907;NA;270962;1636;2022-03-07;243165
2022-03-06;"Nitriansky kraj";566;1509;350;1859;NA;270962;916;2022-03-06;241529
2022-03-05;"Nitriansky kraj";614;1239;214;1453;NA;270962;828;2022-03-05;240613
2022-03-04;"Nitriansky kraj";1315;1597;323;1920;NA;270962;1638;2022-03-04;239785
2022-03-03;"Nitriansky kraj";1405;2944;379;3323;NA;270962;1784;2022-03-03;238147
2022-03-02;"Nitriansky kraj";1417;2717;422;3139;NA;270962;1839;2022-03-02;236363
2022-03-01;"Nitriansky kraj";1380;2422;412;2834;NA;270962;1792;2022-03-01;234524
2022-02-28;"Nitriansky kraj";1577;4819;599;5418;NA;270962;2176;2022-02-28;232732
2022-02-27;"Nitriansky kraj";797;1271;294;1565;NA;270962;1091;2022-02-27;230556
2022-02-26;"Nitriansky kraj";895;799;217;1016;NA;270962;1112;2022-02-26;229465
2022-02-25;"Nitriansky kraj";1400;2314;339;2653;NA;270962;1739;2022-02-25;228353
2022-02-24;"Nitriansky kraj";1592;3586;389;3975;NA;270962;1981;2022-02-24;226614
2022-02-23;"Nitriansky kraj";1885;3930;476;4406;NA;270962;2361;2022-02-23;224633
2022-02-22;"Nitriansky kraj";2323;3849;502;4351;NA;270962;2825;2022-02-22;222272
2022-02-21;"Nitriansky kraj";1593;6250;816;7066;NA;270962;2409;2022-02-21;219447
2022-02-20;"Nitriansky kraj";1049;1987;439;2426;NA;270962;1488;2022-02-20;217038
2022-02-19;"Nitriansky kraj";1084;1341;336;1677;NA;270962;1420;2022-02-19;215550
2022-02-18;"Nitriansky kraj";2021;3277;583;3860;NA;270962;2604;2022-02-18;214130
2022-02-17;"Nitriansky kraj";2134;3890;480;4370;NA;270962;2614;2022-02-17;211526
2022-02-16;"Nitriansky kraj";2152;3945;532;4477;NA;270962;2684;2022-02-16;208912
2022-02-15;"Nitriansky kraj";2093;4069;780;4849;NA;270962;2873;2022-02-15;206228
2022-02-14;"Nitriansky kraj";2094;6253;921;7174;NA;270962;3015;2022-02-14;203355
2022-02-13;"Nitriansky kraj";1146;2832;547;3379;NA;270962;1693;2022-02-13;200340
2022-02-12;"Nitriansky kraj";1301;1171;343;1514;NA;270962;1644;2022-02-12;198647
2022-02-11;"Nitriansky kraj";2042;2942;561;3503;NA;270962;2603;2022-02-11;197003
2022-02-10;"Nitriansky kraj";2374;3366;537;3903;NA;270962;2911;2022-02-10;194400
2022-02-09;"Nitriansky kraj";2133;4802;653;5455;NA;270962;2786;2022-02-09;191489
2022-02-08;"Nitriansky kraj";1801;4935;736;5671;NA;270962;2537;2022-02-08;188703
2022-02-07;"Nitriansky kraj";2240;6803;762;7565;NA;270962;3002;2022-02-07;186166
2022-02-06;"Nitriansky kraj";1309;2690;494;3184;NA;270962;1803;2022-02-06;183164
2022-02-05;"Nitriansky kraj";1609;1504;358;1862;NA;270962;1967;2022-02-05;181361
2022-02-04;"Nitriansky kraj";1848;4185;510;4695;NA;270962;2358;2022-02-04;179394
2022-02-03;"Nitriansky kraj";2425;4186;491;4677;NA;270962;2916;2022-02-03;177036
2022-02-02;"Nitriansky kraj";1903;5318;766;6084;NA;270962;2669;2022-02-02;174120
2022-02-01;"Nitriansky kraj";2288;4717;597;5314;NA;270962;2885;2022-02-01;171451
2022-01-31;"Nitriansky kraj";1329;8991;746;9737;NA;270962;2075;2022-01-31;168566
2022-01-30;"Nitriansky kraj";777;3498;471;3969;NA;270962;1248;2022-01-30;166491
2022-01-29;"Nitriansky kraj";1099;1670;298;1968;NA;270962;1397;2022-01-29;165243
2022-01-28;"Nitriansky kraj";1610;4217;374;4591;NA;270962;1984;2022-01-28;163846
2022-01-27;"Nitriansky kraj";1429;3796;289;4085;NA;270962;1718;2022-01-27;161862
2022-01-26;"Nitriansky kraj";1392;4444;306;4750;NA;270962;1698;2022-01-26;160144
2022-01-25;"Nitriansky kraj";1591;4624;426;5050;NA;270962;2017;2022-01-25;158446
2022-01-24;"Nitriansky kraj";770;7459;359;7818;NA;270962;1129;2022-01-24;156429
2022-01-23;"Nitriansky kraj";327;3109;205;3314;NA;270962;532;2022-01-23;155300
2022-01-22;"Nitriansky kraj";596;1974;153;2127;NA;270962;749;2022-01-22;154768
2022-01-21;"Nitriansky kraj";532;3472;141;3613;NA;270962;673;2022-01-21;154019
2022-01-20;"Nitriansky kraj";737;3537;129;3666;NA;270962;866;2022-01-20;153346
2022-01-19;"Nitriansky kraj";614;4581;121;4702;NA;270962;735;2022-01-19;152480
2022-01-18;"Nitriansky kraj";650;3329;125;3454;NA;270962;775;2022-01-18;151745
2022-01-17;"Nitriansky kraj";439;7781;152;7933;NA;270962;591;2022-01-17;150970
2022-01-16;"Nitriansky kraj";140;3191;71;3262;NA;270962;211;2022-01-16;150379
2022-01-15;"Nitriansky kraj";268;1651;50;1701;NA;270962;318;2022-01-15;150168
2022-01-14;"Nitriansky kraj";167;2900;68;2968;NA;270962;235;2022-01-14;149850
2022-01-13;"Nitriansky kraj";244;3297;53;3350;NA;270962;297;2022-01-13;149615
2022-01-12;"Nitriansky kraj";298;4325;66;4391;NA;270962;364;2022-01-12;149318
2022-01-11;"Nitriansky kraj";424;3990;50;4040;NA;270962;474;2022-01-11;148954
2022-01-10;"Nitriansky kraj";292;7648;71;7719;NA;270962;363;2022-01-10;148480
2022-01-09;"Nitriansky kraj";100;3419;48;3467;NA;270962;148;2022-01-09;148117
2022-01-08;"Nitriansky kraj";206;1352;47;1399;NA;270962;253;2022-01-08;147969
2022-01-07;"Nitriansky kraj";326;2970;74;3044;NA;270962;400;2022-01-07;147716
2022-01-06;"Nitriansky kraj";125;910;33;943;NA;270962;158;2022-01-06;147316
2022-01-05;"Nitriansky kraj";357;4227;66;4293;NA;270962;423;2022-01-05;147158
2022-01-04;"Nitriansky kraj";453;3697;85;3782;NA;270962;538;2022-01-04;146735
2022-01-03;"Nitriansky kraj";353;7361;117;7478;NA;270962;470;2022-01-03;146197
2022-01-02;"Nitriansky kraj";25;3035;95;3130;NA;270962;120;2022-01-02;145727
2022-01-01;"Nitriansky kraj";71;177;9;186;NA;270962;80;2022-01-01;145607
2021-12-31;"Nitriansky kraj";382;1506;69;1575;NA;270962;451;2021-12-31;145527
2021-12-30;"Nitriansky kraj";325;3330;89;3419;NA;270962;414;2021-12-30;145076
2021-12-29;"Nitriansky kraj";347;2371;61;2432;NA;270962;408;2021-12-29;144662
2021-12-28;"Nitriansky kraj";628;2501;88;2589;NA;270962;716;2021-12-28;144254
2021-12-27;"Nitriansky kraj";402;4253;169;4422;NA;270962;571;2021-12-27;143538
2021-12-26;"Nitriansky kraj";84;1039;53;1092;NA;270962;137;2021-12-26;142967
2021-12-25;"Nitriansky kraj";22;499;31;530;NA;270962;53;2021-12-25;142830
2021-12-24;"Nitriansky kraj";175;448;26;474;NA;270962;201;2021-12-24;142777
2021-12-23;"Nitriansky kraj";472;3420;110;3530;NA;270962;582;2021-12-23;142576
2021-12-22;"Nitriansky kraj";398;3517;95;3612;NA;270962;493;2021-12-22;141994
2021-12-21;"Nitriansky kraj";735;2913;93;3006;NA;270962;828;2021-12-21;141501
2021-12-20;"Nitriansky kraj";407;6754;169;6923;NA;270962;576;2021-12-20;140673
2021-12-19;"Nitriansky kraj";198;3587;98;3685;NA;270962;296;2021-12-19;140097
2021-12-18;"Nitriansky kraj";361;1456;96;1552;NA;270962;457;2021-12-18;139801
2021-12-17;"Nitriansky kraj";409;4934;153;5087;NA;270962;562;2021-12-17;139344
2021-12-16;"Nitriansky kraj";429;4230;144;4374;NA;270962;573;2021-12-16;138782
2021-12-15;"Nitriansky kraj";639;5682;143;5825;NA;270962;782;2021-12-15;138209
2021-12-14;"Nitriansky kraj";907;4720;200;4920;NA;270962;1107;2021-12-14;137427
2021-12-13;"Nitriansky kraj";524;7388;291;7679;NA;270962;815;2021-12-13;136320
2021-12-12;"Nitriansky kraj";289;3893;174;4067;NA;270962;463;2021-12-12;135505
2021-12-11;"Nitriansky kraj";458;1754;121;1875;NA;270962;579;2021-12-11;135042
2021-12-10;"Nitriansky kraj";591;4868;177;5045;NA;270962;768;2021-12-10;134463
2021-12-09;"Nitriansky kraj";741;3428;202;3630;NA;270962;943;2021-12-09;133695
2021-12-08;"Nitriansky kraj";954;5136;200;5336;NA;270962;1154;2021-12-08;132752
2021-12-07;"Nitriansky kraj";900;4045;197;4242;NA;270962;1097;2021-12-07;131598
2021-12-06;"Nitriansky kraj";699;8196;339;8535;NA;270962;1038;2021-12-06;130501
2021-12-05;"Nitriansky kraj";337;4314;192;4506;NA;270962;529;2021-12-05;129463
2021-12-04;"Nitriansky kraj";758;2045;180;2225;NA;270962;938;2021-12-04;128934
2021-12-03;"Nitriansky kraj";920;5783;237;6020;NA;270962;1157;2021-12-03;127996
2021-12-02;"Nitriansky kraj";1388;3898;267;4165;NA;270962;1655;2021-12-02;126839
2021-12-01;"Nitriansky kraj";982;4107;261;4368;NA;270962;1243;2021-12-01;125184
2021-11-30;"Nitriansky kraj";751;5575;241;5816;NA;270962;992;2021-11-30;123941
2021-11-29;"Nitriansky kraj";665;10153;499;10652;NA;270962;1164;2021-11-29;122949
2021-11-28;"Nitriansky kraj";357;6214;300;6514;NA;270962;657;2021-11-28;121785
2021-11-27;"Nitriansky kraj";560;2879;281;3160;NA;270962;841;2021-11-27;121128
2021-11-26;"Nitriansky kraj";824;5529;290;5819;NA;270962;1114;2021-11-26;120287
2021-11-25;"Nitriansky kraj";847;4154;342;4496;NA;270962;1189;2021-11-25;119173
2021-11-24;"Nitriansky kraj";875;4422;325;4747;NA;270962;1200;2021-11-24;117984
2021-11-23;"Nitriansky kraj";1103;5148;353;5501;NA;270962;1456;2021-11-23;116784
2021-11-22;"Nitriansky kraj";545;7105;465;7570;NA;270962;1010;2021-11-22;115328
2021-11-21;"Nitriansky kraj";345;3410;314;3724;NA;270962;659;2021-11-21;114318
2021-11-20;"Nitriansky kraj";579;1865;252;2117;NA;270962;831;2021-11-20;113659
2021-11-19;"Nitriansky kraj";571;4256;349;4605;NA;270962;920;2021-11-19;112828
2021-11-18;"Nitriansky kraj";677;4883;420;5303;NA;270962;1097;2021-11-18;111908
2021-11-17;"Nitriansky kraj";479;1622;207;1829;NA;270962;686;2021-11-17;110811
2021-11-16;"Nitriansky kraj";668;3882;266;4148;NA;270962;934;2021-11-16;110125
2021-11-15;"Nitriansky kraj";556;6033;440;6473;NA;270962;996;2021-11-15;109191
2021-11-14;"Nitriansky kraj";229;2796;259;3055;NA;270962;488;2021-11-14;108195
2021-11-13;"Nitriansky kraj";387;1473;201;1674;NA;270962;588;2021-11-13;107707
2021-11-12;"Nitriansky kraj";552;3096;270;3366;NA;270962;822;2021-11-12;107119
2021-11-11;"Nitriansky kraj";539;3545;238;3783;NA;270962;777;2021-11-11;106297
2021-11-10;"Nitriansky kraj";411;3494;234;3728;NA;270962;645;2021-11-10;105520
2021-11-09;"Nitriansky kraj";413;3313;210;3523;NA;270962;623;2021-11-09;104875
2021-11-08;"Nitriansky kraj";464;4936;331;5267;NA;270962;795;2021-11-08;104252
2021-11-07;"Nitriansky kraj";209;2074;161;2235;NA;270962;370;2021-11-07;103457
2021-11-06;"Nitriansky kraj";236;1407;114;1521;NA;270962;350;2021-11-06;103087
2021-11-05;"Nitriansky kraj";407;2583;185;2768;NA;270962;592;2021-11-05;102737
2021-11-04;"Nitriansky kraj";437;3083;168;3251;NA;270962;605;2021-11-04;102145
2021-11-03;"Nitriansky kraj";525;2891;157;3048;NA;270962;682;2021-11-03;101540
2021-11-02;"Nitriansky kraj";320;4279;239;4518;NA;270962;559;2021-11-02;100858
2021-11-01;"Nitriansky kraj";136;712;61;773;NA;270962;197;2021-11-01;100299
2021-10-31;"Nitriansky kraj";109;1234;114;1348;NA;270962;223;2021-10-31;100102
2021-10-30;"Nitriansky kraj";202;1218;82;1300;NA;270962;284;2021-10-30;99879
2021-10-29;"Nitriansky kraj";347;2481;120;2601;NA;270962;467;2021-10-29;99595
2021-10-28;"Nitriansky kraj";281;2603;95;2698;NA;270962;376;2021-10-28;99128
2021-10-27;"Nitriansky kraj";340;2923;112;3035;NA;270962;452;2021-10-27;98752
2021-10-26;"Nitriansky kraj";297;2926;117;3043;NA;270962;414;2021-10-26;98300
2021-10-25;"Nitriansky kraj";171;3599;124;3723;NA;270962;295;2021-10-25;97886
2021-10-24;"Nitriansky kraj";58;1914;74;1988;NA;270962;132;2021-10-24;97591
2021-10-23;"Nitriansky kraj";173;1815;77;1892;NA;270962;250;2021-10-23;97459
2021-10-22;"Nitriansky kraj";202;2216;68;2284;NA;270962;270;2021-10-22;97209
2021-10-21;"Nitriansky kraj";214;2793;65;2858;NA;270962;279;2021-10-21;96939
2021-10-20;"Nitriansky kraj";218;2328;74;2402;NA;270962;292;2021-10-20;96660
2021-10-19;"Nitriansky kraj";250;2929;65;2994;NA;270962;315;2021-10-19;96368
2021-10-18;"Nitriansky kraj";81;3259;90;3349;NA;270962;171;2021-10-18;96053
2021-10-17;"Nitriansky kraj";36;3010;92;3102;NA;270962;128;2021-10-17;95882
2021-10-16;"Nitriansky kraj";37;1477;38;1515;NA;270962;75;2021-10-16;95754
2021-10-15;"Nitriansky kraj";145;2653;34;2687;NA;270962;179;2021-10-15;95679
2021-10-14;"Nitriansky kraj";95;2389;30;2419;NA;270962;125;2021-10-14;95500
2021-10-13;"Nitriansky kraj";91;2248;36;2284;NA;270962;127;2021-10-13;95375
2021-10-12;"Nitriansky kraj";119;2905;34;2939;NA;270962;153;2021-10-12;95248
2021-10-11;"Nitriansky kraj";91;2703;42;2745;NA;270962;133;2021-10-11;95095
2021-10-10;"Nitriansky kraj";33;1527;22;1549;NA;270962;55;2021-10-10;94962
2021-10-09;"Nitriansky kraj";17;1395;17;1412;NA;270962;34;2021-10-09;94907
2021-10-08;"Nitriansky kraj";61;3004;37;3041;NA;270962;98;2021-10-08;94873
2021-10-07;"Nitriansky kraj";59;2829;30;2859;NA;270962;89;2021-10-07;94775
2021-10-06;"Nitriansky kraj";66;2657;28;2685;NA;270962;94;2021-10-06;94686
2021-10-05;"Nitriansky kraj";97;2536;32;2568;NA;270962;129;2021-10-05;94592
2021-10-04;"Nitriansky kraj";56;3263;49;3312;NA;270962;105;2021-10-04;94463
2021-10-03;"Nitriansky kraj";10;1591;24;1615;NA;270962;34;2021-10-03;94358
2021-10-02;"Nitriansky kraj";46;1567;20;1587;NA;270962;66;2021-10-02;94324
2021-10-01;"Nitriansky kraj";26;2860;34;2894;NA;270962;60;2021-10-01;94258
2021-09-30;"Nitriansky kraj";66;2468;15;2483;NA;270962;81;2021-09-30;94198
2021-09-29;"Nitriansky kraj";92;2266;16;2282;NA;270962;108;2021-09-29;94117
2021-09-28;"Nitriansky kraj";86;2893;27;2920;NA;270962;113;2021-09-28;94009
2021-09-27;"Nitriansky kraj";50;3633;41;3674;NA;270962;91;2021-09-27;93896
2021-09-26;"Nitriansky kraj";12;1635;20;1655;NA;270962;32;2021-09-26;93805
2021-09-25;"Nitriansky kraj";43;1456;20;1476;NA;270962;63;2021-09-25;93773
2021-09-24;"Nitriansky kraj";35;2783;15;2798;NA;270962;50;2021-09-24;93710
2021-09-23;"Nitriansky kraj";69;2503;20;2523;NA;270962;89;2021-09-23;93660
2021-09-22;"Nitriansky kraj";68;2380;17;2397;NA;270962;85;2021-09-22;93571
2021-09-21;"Nitriansky kraj";70;2684;30;2714;NA;270962;100;2021-09-21;93486
2021-09-20;"Nitriansky kraj";41;2497;21;2518;NA;270962;62;2021-09-20;93386
2021-09-19;"Nitriansky kraj";16;1553;20;1573;NA;270962;36;2021-09-19;93324
2021-09-18;"Nitriansky kraj";42;1421;19;1440;NA;270962;61;2021-09-18;93288
2021-09-17;"Nitriansky kraj";54;2757;30;2787;NA;270962;84;2021-09-17;93227
2021-09-16;"Nitriansky kraj";55;2499;44;2543;NA;270962;99;2021-09-16;93143
2021-09-15;"Nitriansky kraj";34;538;12;550;NA;270962;46;2021-09-15;93044
2021-09-14;"Nitriansky kraj";52;1821;20;1841;NA;270962;72;2021-09-14;92998
2021-09-13;"Nitriansky kraj";27;2373;27;2400;NA;270962;54;2021-09-13;92926
2021-09-12;"Nitriansky kraj";4;1182;17;1199;NA;270962;21;2021-09-12;92872
2021-09-11;"Nitriansky kraj";36;1181;8;1189;NA;270962;44;2021-09-11;92851
2021-09-10;"Nitriansky kraj";25;2133;12;2145;NA;270962;37;2021-09-10;92807
2021-09-09;"Nitriansky kraj";15;1611;20;1631;NA;270962;35;2021-09-09;92770
2021-09-08;"Nitriansky kraj";30;1463;22;1485;NA;270962;52;2021-09-08;92735
2021-09-07;"Nitriansky kraj";35;1460;9;1469;NA;270962;44;2021-09-07;92683
2021-09-06;"Nitriansky kraj";19;1668;27;1695;NA;270962;46;2021-09-06;92639
2021-09-05;"Nitriansky kraj";10;1007;8;1015;NA;270962;18;2021-09-05;92593
2021-09-04;"Nitriansky kraj";18;1119;10;1129;NA;270962;28;2021-09-04;92575
2021-09-03;"Nitriansky kraj";20;1743;17;1760;NA;270962;37;2021-09-03;92547
2021-09-02;"Nitriansky kraj";16;1389;14;1403;NA;270962;30;2021-09-02;92510
2021-09-01;"Nitriansky kraj";9;337;2;339;NA;270962;11;2021-09-01;92480
2021-08-31;"Nitriansky kraj";10;1360;6;1366;NA;270962;16;2021-08-31;92469
2021-08-30;"Nitriansky kraj";8;1381;10;1391;NA;270962;18;2021-08-30;92453
2021-08-29;"Nitriansky kraj";2;450;1;451;NA;270962;3;2021-08-29;92435
2021-08-28;"Nitriansky kraj";5;1071;3;1074;NA;270962;8;2021-08-28;92432
2021-08-27;"Nitriansky kraj";7;1804;4;1808;NA;270962;11;2021-08-27;92424
2021-08-26;"Nitriansky kraj";2;1255;6;1261;NA;270962;8;2021-08-26;92413
2021-08-25;"Nitriansky kraj";15;1087;3;1090;NA;270962;18;2021-08-25;92405
2021-08-24;"Nitriansky kraj";6;990;2;992;NA;270962;8;2021-08-24;92387
2021-08-23;"Nitriansky kraj";13;1271;4;1275;NA;270962;17;2021-08-23;92379
2021-08-22;"Nitriansky kraj";0;1167;3;1170;NA;270962;3;2021-08-22;92362
2021-08-21;"Nitriansky kraj";1;853;2;855;NA;270962;3;2021-08-21;92359
2021-08-20;"Nitriansky kraj";8;1580;5;1585;NA;270962;13;2021-08-20;92356
2021-08-19;"Nitriansky kraj";11;1167;4;1171;NA;270962;15;2021-08-19;92343
2021-08-18;"Nitriansky kraj";8;1180;7;1187;NA;270962;15;2021-08-18;92328
2021-08-17;"Nitriansky kraj";4;1035;3;1038;NA;270962;7;2021-08-17;92313
2021-08-16;"Nitriansky kraj";7;1129;4;1133;NA;270962;11;2021-08-16;92306
2021-08-15;"Nitriansky kraj";2;662;1;663;NA;270962;3;2021-08-15;92295
2021-08-14;"Nitriansky kraj";1;878;5;883;NA;270962;6;2021-08-14;92292
2021-08-13;"Nitriansky kraj";0;957;1;958;NA;270962;1;2021-08-13;92286
2021-08-12;"Nitriansky kraj";5;765;0;765;NA;270962;5;2021-08-12;92285
2021-08-11;"Nitriansky kraj";3;527;1;528;NA;270962;4;2021-08-11;92280
2021-08-10;"Nitriansky kraj";3;570;1;571;NA;270962;4;2021-08-10;92276
2021-08-09;"Nitriansky kraj";3;992;1;993;NA;270962;4;2021-08-09;92272
2021-08-08;"Nitriansky kraj";0;668;1;669;NA;270962;1;2021-08-08;92268
2021-08-07;"Nitriansky kraj";0;557;1;558;NA;270962;1;2021-08-07;92267
2021-08-06;"Nitriansky kraj";5;799;0;799;NA;270962;5;2021-08-06;92266
2021-08-05;"Nitriansky kraj";6;612;0;612;NA;270962;6;2021-08-05;92261
2021-08-04;"Nitriansky kraj";1;497;2;499;NA;270962;3;2021-08-04;92255
2021-08-03;"Nitriansky kraj";5;1455;0;1455;NA;270962;5;2021-08-03;92252
2021-08-02;"Nitriansky kraj";1;683;4;687;NA;270962;5;2021-08-02;92247
2021-08-01;"Nitriansky kraj";1;606;0;606;NA;270962;1;2021-08-01;92242
2021-07-31;"Nitriansky kraj";1;514;1;515;NA;270962;2;2021-07-31;92241
2021-07-30;"Nitriansky kraj";2;827;0;827;NA;270962;2;2021-07-30;92239
2021-07-29;"Nitriansky kraj";3;720;2;722;NA;270962;5;2021-07-29;92237
2021-07-28;"Nitriansky kraj";4;598;0;598;NA;270962;4;2021-07-28;92232
2021-07-27;"Nitriansky kraj";12;602;1;603;NA;270962;13;2021-07-27;92228
2021-07-26;"Nitriansky kraj";7;970;1;971;NA;270962;8;2021-07-26;92215
2021-07-25;"Nitriansky kraj";1;654;1;655;NA;270962;2;2021-07-25;92207
2021-07-24;"Nitriansky kraj";0;620;0;620;NA;270962;0;2021-07-24;92205
2021-07-23;"Nitriansky kraj";3;851;1;852;NA;270962;4;2021-07-23;92205
2021-07-22;"Nitriansky kraj";5;689;0;689;NA;270962;5;2021-07-22;92201
2021-07-21;"Nitriansky kraj";6;650;2;652;NA;270962;8;2021-07-21;92196
2021-07-20;"Nitriansky kraj";1;527;1;528;NA;270962;2;2021-07-20;92188
2021-07-19;"Nitriansky kraj";2;965;0;965;NA;270962;2;2021-07-19;92186
2021-07-18;"Nitriansky kraj";1;747;0;747;NA;270962;1;2021-07-18;92184
2021-07-17;"Nitriansky kraj";5;612;0;612;NA;270962;5;2021-07-17;92183
2021-07-16;"Nitriansky kraj";2;876;0;876;NA;270962;2;2021-07-16;92178
2021-07-15;"Nitriansky kraj";11;708;0;708;NA;270962;11;2021-07-15;92176
2021-07-14;"Nitriansky kraj";4;646;0;646;NA;270962;4;2021-07-14;92165
2021-07-13;"Nitriansky kraj";2;697;2;699;NA;270962;4;2021-07-13;92161
2021-07-12;"Nitriansky kraj";1;819;0;819;NA;270962;1;2021-07-12;92157
2021-07-11;"Nitriansky kraj";1;961;0;961;NA;270962;1;2021-07-11;92156
2021-07-10;"Nitriansky kraj";1;630;0;630;NA;270962;1;2021-07-10;92155
2021-07-09;"Nitriansky kraj";3;1000;0;1000;NA;270962;3;2021-07-09;92154
2021-07-08;"Nitriansky kraj";0;683;0;683;NA;270962;0;2021-07-08;92151
2021-07-07;"Nitriansky kraj";2;935;2;937;NA;270962;4;2021-07-07;92151
2021-07-06;"Nitriansky kraj";1;1269;1;1270;NA;270962;2;2021-07-06;92147
2021-07-05;"Nitriansky kraj";1;507;0;507;NA;270962;1;2021-07-05;92145
2021-07-04;"Nitriansky kraj";0;821;1;822;NA;270962;1;2021-07-04;92144
2021-07-03;"Nitriansky kraj";0;611;0;611;NA;270962;0;2021-07-03;92143
2021-07-02;"Nitriansky kraj";0;1259;0;1259;NA;270962;0;2021-07-02;92143
2021-07-01;"Nitriansky kraj";0;369;1;370;NA;270962;1;2021-07-01;92143
2021-06-30;"Nitriansky kraj";1;6777;2;6779;NA;270962;3;2021-06-30;92142
2021-06-29;"Nitriansky kraj";1;3536;0;3536;NA;270962;1;2021-06-29;92139
2021-06-28;"Nitriansky kraj";3;4393;0;4393;NA;270962;3;2021-06-28;92138
2021-06-27;"Nitriansky kraj";0;3263;0;3263;NA;270962;0;2021-06-27;92135
2021-06-26;"Nitriansky kraj";1;4979;3;4982;NA;270962;4;2021-06-26;92135
2021-06-25;"Nitriansky kraj";8;5182;1;5183;NA;270962;9;2021-06-25;92131
2021-06-24;"Nitriansky kraj";1;3354;0;3354;NA;270962;1;2021-06-24;92122
2021-06-23;"Nitriansky kraj";1;3033;0;3033;NA;270962;1;2021-06-23;92121
2021-06-22;"Nitriansky kraj";1;3240;3;3243;NA;270962;4;2021-06-22;92120
2021-06-21;"Nitriansky kraj";8;5362;8;5370;NA;270962;16;2021-06-21;92116
2021-06-20;"Nitriansky kraj";0;4437;6;4443;NA;270962;6;2021-06-20;92100
2021-06-19;"Nitriansky kraj";0;5983;4;5987;NA;270962;4;2021-06-19;92094
2021-06-18;"Nitriansky kraj";4;6453;3;6456;NA;270962;7;2021-06-18;92090
2021-06-17;"Nitriansky kraj";5;4152;1;4153;NA;270962;6;2021-06-17;92083
2021-06-16;"Nitriansky kraj";4;3694;3;3697;NA;270962;7;2021-06-16;92077
2021-06-15;"Nitriansky kraj";1;3995;0;3995;NA;270962;1;2021-06-15;92070
2021-06-14;"Nitriansky kraj";0;5875;3;5878;NA;270962;3;2021-06-14;92069
2021-06-13;"Nitriansky kraj";0;6073;3;6076;NA;270962;3;2021-06-13;92066
2021-06-12;"Nitriansky kraj";1;8293;1;8294;NA;270962;2;2021-06-12;92063
2021-06-11;"Nitriansky kraj";3;6891;4;6895;NA;270962;7;2021-06-11;92061
2021-06-10;"Nitriansky kraj";7;4539;1;4540;NA;270962;8;2021-06-10;92054
2021-06-09;"Nitriansky kraj";2;4706;2;4708;NA;270962;4;2021-06-09;92046
2021-06-08;"Nitriansky kraj";8;4239;3;4242;NA;270962;11;2021-06-08;92042
2021-06-07;"Nitriansky kraj";6;5841;8;5849;NA;270962;14;2021-06-07;92031
2021-06-06;"Nitriansky kraj";0;6981;4;6985;NA;270962;4;2021-06-06;92017
2021-06-05;"Nitriansky kraj";6;9089;9;9098;NA;270962;15;2021-06-05;92013
2021-06-04;"Nitriansky kraj";9;7639;5;7644;NA;270962;14;2021-06-04;91998
2021-06-03;"Nitriansky kraj";2;5064;6;5070;NA;270962;8;2021-06-03;91984
2021-06-02;"Nitriansky kraj";11;5119;11;5130;NA;270962;22;2021-06-02;91976
2021-06-01;"Nitriansky kraj";3;4847;2;4849;NA;270962;5;2021-06-01;91954
2021-05-31;"Nitriansky kraj";8;8933;8;8941;NA;270962;16;2021-05-31;91949
2021-05-30;"Nitriansky kraj";1;9067;8;9075;NA;270962;9;2021-05-30;91933
2021-05-29;"Nitriansky kraj";2;13610;7;13617;NA;270962;9;2021-05-29;91924
2021-05-28;"Nitriansky kraj";10;8872;6;8878;NA;270962;16;2021-05-28;91915
2021-05-27;"Nitriansky kraj";4;6164;5;6169;NA;270962;9;2021-05-27;91899
2021-05-26;"Nitriansky kraj";11;8509;10;8519;NA;270962;21;2021-05-26;91890
2021-05-25;"Nitriansky kraj";15;7350;8;7358;NA;270962;23;2021-05-25;91869
2021-05-24;"Nitriansky kraj";14;9816;17;9833;NA;270962;31;2021-05-24;91846
2021-05-23;"Nitriansky kraj";1;9456;13;9469;NA;270962;14;2021-05-23;91815
2021-05-22;"Nitriansky kraj";7;16939;11;16950;NA;270962;18;2021-05-22;91801
2021-05-21;"Nitriansky kraj";18;10632;15;10647;NA;270962;33;2021-05-21;91783
2021-05-20;"Nitriansky kraj";8;7185;7;7192;NA;270962;15;2021-05-20;91750
2021-05-19;"Nitriansky kraj";20;6787;14;6801;NA;270962;34;2021-05-19;91735
2021-05-18;"Nitriansky kraj";23;7797;18;7815;NA;270962;41;2021-05-18;91701
2021-05-17;"Nitriansky kraj";22;9774;20;9794;NA;270962;42;2021-05-17;91660
2021-05-16;"Nitriansky kraj";4;13830;15;13845;NA;270962;19;2021-05-16;91618
2021-05-15;"Nitriansky kraj";5;25389;23;25412;NA;270962;28;2021-05-15;91599
2021-05-14;"Nitriansky kraj";18;13385;23;13408;NA;270962;41;2021-05-14;91571
2021-05-13;"Nitriansky kraj";24;8289;19;8308;NA;270962;43;2021-05-13;91530
2021-05-12;"Nitriansky kraj";10;7682;26;7708;NA;270962;36;2021-05-12;91487
2021-05-11;"Nitriansky kraj";36;8169;13;8182;NA;270962;49;2021-05-11;91451
2021-05-10;"Nitriansky kraj";16;13800;42;13842;NA;270962;58;2021-05-10;91402
2021-05-09;"Nitriansky kraj";8;21879;35;21914;NA;270962;43;2021-05-09;91344
2021-05-08;"Nitriansky kraj";0;24318;29;24347;NA;270962;29;2021-05-08;91301
2021-05-07;"Nitriansky kraj";32;14915;20;14935;NA;270962;52;2021-05-07;91272
2021-05-06;"Nitriansky kraj";30;9463;20;9483;NA;270962;50;2021-05-06;91220
2021-05-05;"Nitriansky kraj";19;8527;23;8550;NA;270962;42;2021-05-05;91170
2021-05-04;"Nitriansky kraj";46;9385;27;9412;NA;270962;73;2021-05-04;91128
2021-05-03;"Nitriansky kraj";32;14490;44;14534;NA;270962;76;2021-05-03;91055
2021-05-02;"Nitriansky kraj";4;31751;46;31797;NA;270962;50;2021-05-02;90979
2021-05-01;"Nitriansky kraj";23;60451;43;60494;NA;270962;66;2021-05-01;90929
2021-04-30;"Nitriansky kraj";28;31803;53;31856;NA;270962;81;2021-04-30;90863
2021-04-29;"Nitriansky kraj";27;14265;34;14299;NA;270962;61;2021-04-29;90782
2021-04-28;"Nitriansky kraj";36;14716;45;14761;NA;270962;81;2021-04-28;90721
2021-04-27;"Nitriansky kraj";51;13154;35;13189;NA;270962;86;2021-04-27;90640
2021-04-26;"Nitriansky kraj";38;21029;44;21073;NA;270962;82;2021-04-26;90554
2021-04-25;"Nitriansky kraj";7;44312;46;44358;NA;270962;53;2021-04-25;90472
2021-04-24;"Nitriansky kraj";23;93455;72;93527;NA;270962;95;2021-04-24;90419
2021-04-23;"Nitriansky kraj";54;35145;51;35196;NA;270962;105;2021-04-23;90324
2021-04-22;"Nitriansky kraj";32;15435;44;15479;NA;270962;76;2021-04-22;90219
2021-04-21;"Nitriansky kraj";38;14228;45;14273;NA;270962;83;2021-04-21;90143
2021-04-20;"Nitriansky kraj";67;16058;51;16109;NA;270962;118;2021-04-20;90060
2021-04-19;"Nitriansky kraj";35;24819;59;24878;NA;270962;94;2021-04-19;89942
2021-04-18;"Nitriansky kraj";0;39569;27;39596;NA;270962;27;2021-04-18;89848
2021-04-17;"Nitriansky kraj";34;92102;82;92184;NA;270962;116;2021-04-17;89821
2021-04-16;"Nitriansky kraj";46;32348;37;32385;NA;270962;83;2021-04-16;89705
2021-04-15;"Nitriansky kraj";75;16215;52;16267;NA;270962;127;2021-04-15;89622
2021-04-14;"Nitriansky kraj";43;15303;42;15345;NA;270962;85;2021-04-14;89495
2021-04-13;"Nitriansky kraj";110;15104;44;15148;NA;270962;154;2021-04-13;89410
2021-04-12;"Nitriansky kraj";29;22817;50;22867;NA;270962;79;2021-04-12;89256
2021-04-11;"Nitriansky kraj";1;37537;31;37568;NA;270962;32;2021-04-11;89177
2021-04-10;"Nitriansky kraj";35;95851;115;95966;NA;270962;150;2021-04-10;89145
2021-04-09;"Nitriansky kraj";69;30669;58;30727;NA;270962;127;2021-04-09;88995
2021-04-08;"Nitriansky kraj";71;15361;36;15397;NA;270962;107;2021-04-08;88868
2021-04-07;"Nitriansky kraj";64;18541;47;18588;NA;270962;111;2021-04-07;88761
2021-04-06;"Nitriansky kraj";65;33218;112;33330;NA;270962;177;2021-04-06;88650
2021-04-05;"Nitriansky kraj";37;12673;48;12721;NA;270962;85;2021-04-05;88473
2021-04-04;"Nitriansky kraj";5;17887;35;17922;NA;270962;40;2021-04-04;88388
2021-04-03;"Nitriansky kraj";26;85465;153;85618;NA;270962;179;2021-04-03;88348
2021-04-02;"Nitriansky kraj";32;18743;46;18789;NA;270962;78;2021-04-02;88169
2021-04-01;"Nitriansky kraj";63;24610;83;24693;NA;270962;146;2021-04-01;88091
2021-03-31;"Nitriansky kraj";73;21752;94;21846;NA;270962;167;2021-03-31;87945
2021-03-30;"Nitriansky kraj";125;17122;83;17205;NA;270962;208;2021-03-30;87778
2021-03-29;"Nitriansky kraj";81;25139;100;25239;NA;270962;181;2021-03-29;87570
2021-03-28;"Nitriansky kraj";6;45581;106;45687;NA;270962;112;2021-03-28;87389
2021-03-27;"Nitriansky kraj";39;104104;174;104278;NA;270962;213;2021-03-27;87277
2021-03-26;"Nitriansky kraj";90;40444;115;40559;NA;270962;205;2021-03-26;87064
2021-03-25;"Nitriansky kraj";95;19219;94;19313;NA;270962;189;2021-03-25;86859
2021-03-24;"Nitriansky kraj";90;14787;91;14878;NA;270962;181;2021-03-24;86670
2021-03-23;"Nitriansky kraj";167;16753;66;16819;NA;270962;233;2021-03-23;86489
2021-03-22;"Nitriansky kraj";101;24886;125;25011;NA;270962;226;2021-03-22;86256
2021-03-21;"Nitriansky kraj";27;42773;99;42872;NA;270962;126;2021-03-21;86030
2021-03-20;"Nitriansky kraj";36;100640;207;100847;NA;270962;243;2021-03-20;85904
2021-03-19;"Nitriansky kraj";76;37312;102;37414;NA;270962;178;2021-03-19;85661
2021-03-18;"Nitriansky kraj";103;20051;113;20164;NA;270962;216;2021-03-18;85483
2021-03-17;"Nitriansky kraj";87;15839;127;15966;NA;270962;214;2021-03-17;85267
2021-03-16;"Nitriansky kraj";172;18085;121;18206;NA;270962;293;2021-03-16;85053
2021-03-15;"Nitriansky kraj";130;24481;165;24646;NA;270962;295;2021-03-15;84760
2021-03-14;"Nitriansky kraj";3;45770;107;45877;NA;270962;110;2021-03-14;84465
2021-03-13;"Nitriansky kraj";65;112573;242;112815;NA;270962;307;2021-03-13;84355
2021-03-12;"Nitriansky kraj";127;40777;159;40936;NA;270962;286;2021-03-12;84048
2021-03-11;"Nitriansky kraj";131;18686;130;18816;NA;270962;261;2021-03-11;83762
2021-03-10;"Nitriansky kraj";96;17422;143;17565;NA;270962;239;2021-03-10;83501
2021-03-09;"Nitriansky kraj";260;17635;149;17784;NA;270962;409;2021-03-09;83262
2021-03-08;"Nitriansky kraj";145;27214;172;27386;NA;270962;317;2021-03-08;82853
2021-03-07;"Nitriansky kraj";48;46867;185;47052;NA;270962;233;2021-03-07;82536
2021-03-06;"Nitriansky kraj";86;112027;327;112354;NA;270962;413;2021-03-06;82303
2021-03-05;"Nitriansky kraj";133;39068;200;39268;NA;270962;333;2021-03-05;81890
2021-03-04;"Nitriansky kraj";176;18340;173;18513;NA;270962;349;2021-03-04;81557
2021-03-03;"Nitriansky kraj";172;17210;177;17387;NA;270962;349;2021-03-03;81208
2021-03-02;"Nitriansky kraj";274;21003;366;21369;NA;270962;640;2021-03-02;80859
2021-03-01;"Nitriansky kraj";133;27881;279;28160;NA;270962;412;2021-03-01;80219
2021-02-28;"Nitriansky kraj";80;40866;218;41084;NA;270962;298;2021-02-28;79807
2021-02-27;"Nitriansky kraj";101;106352;496;106848;NA;270962;597;2021-02-27;79509
2021-02-26;"Nitriansky kraj";109;36788;308;37096;NA;270962;417;2021-02-26;78912
2021-02-25;"Nitriansky kraj";188;15243;212;15455;NA;270962;400;2021-02-25;78495
2021-02-24;"Nitriansky kraj";125;13833;260;14093;NA;270962;385;2021-02-24;78095
2021-02-23;"Nitriansky kraj";273;15402;273;15675;NA;270962;546;2021-02-23;77710
2021-02-22;"Nitriansky kraj";154;26478;330;26808;NA;270962;484;2021-02-22;77164
2021-02-21;"Nitriansky kraj";22;43664;320;43984;NA;270962;342;2021-02-21;76680
2021-02-20;"Nitriansky kraj";128;109038;586;109624;NA;270962;714;2021-02-20;76338
2021-02-19;"Nitriansky kraj";173;36849;328;37177;NA;270962;501;2021-02-19;75624
2021-02-18;"Nitriansky kraj";202;17045;275;17320;NA;270962;477;2021-02-18;75123
2021-02-17;"Nitriansky kraj";198;12080;310;12390;NA;270962;508;2021-02-17;74646
2021-02-16;"Nitriansky kraj";284;16066;288;16354;NA;270962;572;2021-02-16;74138
2021-02-15;"Nitriansky kraj";122;28636;474;29110;NA;270962;596;2021-02-15;73566
2021-02-14;"Nitriansky kraj";8;49392;315;49707;NA;270962;323;2021-02-14;72970
2021-02-13;"Nitriansky kraj";127;110294;690;110984;NA;270962;817;2021-02-13;72647
2021-02-12;"Nitriansky kraj";162;33405;407;33812;NA;270962;569;2021-02-12;71830
2021-02-11;"Nitriansky kraj";195;12406;270;12676;NA;270962;465;2021-02-11;71261
2021-02-10;"Nitriansky kraj";186;17770;644;18414;NA;270962;830;2021-02-10;70796
2021-02-09;"Nitriansky kraj";260;18530;385;18915;NA;270962;645;2021-02-09;69966
2021-02-08;"Nitriansky kraj";177;37530;569;38099;NA;270962;746;2021-02-08;69321
2021-02-07;"Nitriansky kraj";20;52307;513;52820;NA;270962;533;2021-02-07;68575
2021-02-06;"Nitriansky kraj";129;101439;764;102203;NA;270962;893;2021-02-06;68042
2021-02-05;"Nitriansky kraj";244;26137;491;26628;NA;270962;735;2021-02-05;67149
2021-02-04;"Nitriansky kraj";308;15681;512;16193;NA;270962;820;2021-02-04;66414
2021-02-03;"Nitriansky kraj";191;13459;382;13841;NA;270962;573;2021-02-03;65594
2021-02-02;"Nitriansky kraj";327;17880;382;18262;NA;270962;709;2021-02-02;65021
2021-02-01;"Nitriansky kraj";221;24002;460;24462;NA;270962;681;2021-02-01;64312
2021-01-31;"Nitriansky kraj";9;46215;507;46722;NA;270962;516;2021-01-31;63631
2021-01-30;"Nitriansky kraj";152;99241;1090;100331;NA;270962;1242;2021-01-30;63115
2021-01-29;"Nitriansky kraj";302;22461;477;22938;NA;270962;779;2021-01-29;61873
2021-01-28;"Nitriansky kraj";269;11370;398;11768;NA;270962;667;2021-01-28;61094
2021-01-27;"Nitriansky kraj";235;6758;299;7057;NA;270962;534;2021-01-27;60427
2021-01-26;"Nitriansky kraj";345;16015;454;16469;NA;270962;799;2021-01-26;59893
2021-01-25;"Nitriansky kraj";201;21909;434;22343;NA;270962;635;2021-01-25;59094
2021-01-24;"Nitriansky kraj";12;79041;897;79938;NA;270962;909;2021-01-24;58459
2021-01-23;"Nitriansky kraj";277;97845;1446;99291;NA;270962;1723;2021-01-23;57550
2021-01-22;"Nitriansky kraj";139;35924;619;36543;NA;270962;758;2021-01-22;55827
2021-01-21;"Nitriansky kraj";305;14649;412;15061;NA;270962;717;2021-01-21;55069
2021-01-20;"Nitriansky kraj";326;11991;625;12616;NA;270962;951;2021-01-20;54352
2021-01-19;"Nitriansky kraj";344;11015;633;11648;NA;270962;977;2021-01-19;53401
2021-01-18;"Nitriansky kraj";367;8901;519;9420;NA;270962;886;2021-01-18;52424
2021-01-17;"Nitriansky kraj";97;15061;275;15336;NA;270962;372;2021-01-17;51538
2021-01-16;"Nitriansky kraj";64;36838;679;37517;NA;270962;743;2021-01-16;51166
2021-01-15;"Nitriansky kraj";373;15940;474;16414;NA;270962;847;2021-01-15;50423
2021-01-14;"Nitriansky kraj";627;10577;452;11029;NA;270962;1079;2021-01-14;49576
2021-01-13;"Nitriansky kraj";663;9234;484;9718;NA;270962;1147;2021-01-13;48497
2021-01-12;"Nitriansky kraj";642;8805;545;9350;NA;270962;1187;2021-01-12;47350
2021-01-11;"Nitriansky kraj";422;8347;513;8860;NA;270962;935;2021-01-11;46163
2021-01-10;"Nitriansky kraj";44;19841;730;20571;NA;270962;774;2021-01-10;45228
2021-01-09;"Nitriansky kraj";532;36823;1071;37894;NA;270962;1603;2021-01-09;44454
2021-01-08;"Nitriansky kraj";817;14001;691;14692;NA;270962;1508;2021-01-08;42851
2021-01-07;"Nitriansky kraj";438;10121;795;10916;NA;270962;1233;2021-01-07;41343
2021-01-06;"Nitriansky kraj";259;3192;197;3389;NA;270962;456;2021-01-06;40110
2021-01-05;"Nitriansky kraj";732;8918;1208;10126;NA;270962;1940;2021-01-05;39654
2021-01-04;"Nitriansky kraj";362;8375;1287;9662;NA;270962;1649;2021-01-04;37714
2021-01-03;"Nitriansky kraj";42;84;20;104;NA;270962;62;2021-01-03;36065
2021-01-02;"Nitriansky kraj";249;1090;26;1116;NA;270962;275;2021-01-02;36003
2021-01-01;"Nitriansky kraj";119;781;95;876;NA;270962;214;2021-01-01;35728
2020-12-31;"Nitriansky kraj";786;7646;962;8608;NA;270962;1748;2020-12-31;35514
2020-12-30;"Nitriansky kraj";1094;9619;1165;10784;NA;270962;2259;2020-12-30;33766
2020-12-29;"Nitriansky kraj";607;8028;1245;9273;NA;270962;1852;2020-12-29;31507
2020-12-28;"Nitriansky kraj";83;6804;1220;8024;NA;270962;1303;2020-12-28;29655
2020-12-27;"Nitriansky kraj";22;60;8;68;NA;270962;30;2020-12-27;28352
2020-12-26;"Nitriansky kraj";54;297;56;353;NA;270962;110;2020-12-26;28322
2020-12-25;"Nitriansky kraj";35;60;11;71;NA;270962;46;2020-12-25;28212
2020-12-24;"Nitriansky kraj";514;1861;176;2037;NA;270962;690;2020-12-24;28166
2020-12-23;"Nitriansky kraj";349;14679;782;15461;NA;270962;1131;2020-12-23;27476
2020-12-22;"Nitriansky kraj";673;10623;949;11572;NA;270962;1622;2020-12-22;26345
2020-12-21;"Nitriansky kraj";128;7587;931;8518;NA;270962;1059;2020-12-21;24723
2020-12-20;"Nitriansky kraj";77;50;10;60;NA;270962;87;2020-12-20;23664
2020-12-19;"Nitriansky kraj";262;2259;159;2418;NA;270962;421;2020-12-19;23577
2020-12-18;"Nitriansky kraj";512;7946;518;8464;NA;270962;1030;2020-12-18;23156
2020-12-17;"Nitriansky kraj";586;6519;486;7005;NA;270962;1072;2020-12-17;22126
2020-12-16;"Nitriansky kraj";357;8097;500;8597;NA;270962;857;2020-12-16;21054
2020-12-15;"Nitriansky kraj";461;9084;750;9834;NA;270962;1211;2020-12-15;20197
2020-12-14;"Nitriansky kraj";217;7816;797;8613;NA;270962;1014;2020-12-14;18986
2020-12-13;"Nitriansky kraj";12;69;6;75;NA;270962;18;2020-12-13;17972
2020-12-12;"Nitriansky kraj";341;1832;125;1957;NA;270962;466;2020-12-12;17954
2020-12-11;"Nitriansky kraj";409;5117;384;5501;NA;270962;793;2020-12-11;17488
2020-12-10;"Nitriansky kraj";360;5239;345;5584;NA;270962;705;2020-12-10;16695
2020-12-09;"Nitriansky kraj";362;5494;529;6023;NA;270962;891;2020-12-09;15990
2020-12-08;"Nitriansky kraj";340;8168;548;8716;NA;270962;888;2020-12-08;15099
2020-12-07;"Nitriansky kraj";139;6243;573;6816;NA;270962;712;2020-12-07;14211
2020-12-06;"Nitriansky kraj";15;89;4;93;NA;270962;19;2020-12-06;13499
2020-12-05;"Nitriansky kraj";136;1388;19;1407;NA;270962;155;2020-12-05;13480
2020-12-04;"Nitriansky kraj";232;2884;74;2958;NA;270962;306;2020-12-04;13325
2020-12-03;"Nitriansky kraj";248;2471;110;2581;NA;270962;358;2020-12-03;13019
2020-12-02;"Nitriansky kraj";252;2580;151;2731;NA;270962;403;2020-12-02;12661
2020-12-01;"Nitriansky kraj";331;2891;131;3022;NA;270962;462;2020-12-01;12258
2020-11-30;"Nitriansky kraj";91;4228;188;4416;NA;270962;279;2020-11-30;11796
2020-11-29;"Nitriansky kraj";3;634;42;676;NA;270962;45;2020-11-29;11517
2020-11-28;"Nitriansky kraj";135;892;31;923;NA;270962;166;2020-11-28;11472
2020-11-27;"Nitriansky kraj";177;2069;73;2142;NA;270962;250;2020-11-27;11306
2020-11-26;"Nitriansky kraj";191;2813;80;2893;NA;270962;271;2020-11-26;11056
2020-11-25;"Nitriansky kraj";325;2478;91;2569;NA;270962;416;2020-11-25;10785
2020-11-24;"Nitriansky kraj";147;1641;64;1705;NA;270962;211;2020-11-24;10369
2020-11-23;"Nitriansky kraj";102;9891;212;10103;NA;270962;314;2020-11-23;10158
2020-11-22;"Nitriansky kraj";7;1176;25;1201;NA;270962;32;2020-11-22;9844
2020-11-21;"Nitriansky kraj";86;1083;38;1121;NA;270962;124;2020-11-21;9812
2020-11-20;"Nitriansky kraj";264;4180;103;4283;NA;270962;367;2020-11-20;9688
2020-11-19;"Nitriansky kraj";185;3065;134;3199;NA;270962;319;2020-11-19;9321
2020-11-18;"Nitriansky kraj";188;2214;79;2293;NA;270962;267;2020-11-18;9002
2020-11-17;"Nitriansky kraj";178;596;29;625;NA;270962;207;2020-11-17;8735
2020-11-16;"Nitriansky kraj";139;1877;75;1952;NA;270962;214;2020-11-16;8528
2020-11-15;"Nitriansky kraj";14;180;5;185;NA;270962;19;2020-11-15;8314
2020-11-14;"Nitriansky kraj";114;1131;32;1163;NA;270962;146;2020-11-14;8295
2020-11-13;"Nitriansky kraj";210;936;46;982;NA;270962;256;2020-11-13;8149
2020-11-12;"Nitriansky kraj";256;1195;35;1230;NA;270962;291;2020-11-12;7893
2020-11-11;"Nitriansky kraj";279;1247;22;1269;NA;270962;301;2020-11-11;7602
2020-11-10;"Nitriansky kraj";192;2623;39;2662;NA;270962;231;2020-11-10;7301
2020-11-09;"Nitriansky kraj";128;3136;43;3179;NA;270962;171;2020-11-09;7070
2020-11-08;"Nitriansky kraj";43;1462;32;1494;NA;270962;75;2020-11-08;6899
2020-11-07;"Nitriansky kraj";130;1046;4;1050;NA;270962;134;2020-11-07;6824
2020-11-06;"Nitriansky kraj";210;2264;32;2296;NA;270962;242;2020-11-06;6690
2020-11-05;"Nitriansky kraj";178;313;14;327;NA;270962;192;2020-11-05;6448
2020-11-04;"Nitriansky kraj";211;297;16;313;NA;270962;227;2020-11-04;6256
2020-11-03;"Nitriansky kraj";216;435;25;460;NA;270962;241;2020-11-03;6029
2020-11-02;"Nitriansky kraj";171;4208;46;4254;NA;270962;217;2020-11-02;5788
2020-11-01;"Nitriansky kraj";130;2546;27;2573;NA;270962;157;2020-11-01;5571
2020-10-31;"Nitriansky kraj";261;10466;134;10600;NA;270962;395;2020-10-31;5414
2020-10-30;"Nitriansky kraj";204;2593;42;2635;NA;270962;246;2020-10-30;5019
2020-10-29;"Nitriansky kraj";293;841;39;880;NA;270962;332;2020-10-29;4773
2020-10-28;"Nitriansky kraj";216;608;59;667;NA;270962;275;2020-10-28;4441
2020-10-27;"Nitriansky kraj";296;550;47;597;NA;270962;343;2020-10-27;4166
2020-10-26;"Nitriansky kraj";69;633;56;689;NA;270962;125;2020-10-26;3823
2020-10-25;"Nitriansky kraj";50;62;8;70;NA;270962;58;2020-10-25;3698
2020-10-24;"Nitriansky kraj";169;237;11;248;NA;270962;180;2020-10-24;3640
2020-10-23;"Nitriansky kraj";282;762;41;803;NA;270962;323;2020-10-23;3460
2020-10-22;"Nitriansky kraj";137;444;39;483;NA;270962;176;2020-10-22;3137
2020-10-21;"Nitriansky kraj";146;208;3;211;NA;270962;149;2020-10-21;2961
2020-10-20;"Nitriansky kraj";197;78;6;84;NA;270962;203;2020-10-20;2812
2020-10-19;"Nitriansky kraj";148;79;1;80;NA;270962;149;2020-10-19;2609
2020-10-18;"Nitriansky kraj";22;0;0;0;NA;270962;22;2020-10-18;2460
2020-10-17;"Nitriansky kraj";26;0;0;0;NA;270962;26;2020-10-17;2438
2022-03-27;"Prešovský kraj";256;227;39;266;250385;350076;295;2022-03-27;350076
2022-03-26;"Prešovský kraj";719;327;63;390;NA;350076;782;2022-03-26;349781
2022-03-25;"Prešovský kraj";895;1029;169;1198;NA;350076;1064;2022-03-25;348999
2022-03-24;"Prešovský kraj";909;2097;185;2282;NA;350076;1094;2022-03-24;347935
2022-03-23;"Prešovský kraj";1291;2100;195;2295;NA;350076;1486;2022-03-23;346841
2022-03-22;"Prešovský kraj";1398;2200;180;2380;NA;350076;1578;2022-03-22;345355
2022-03-21;"Prešovský kraj";1234;2887;270;3157;NA;350076;1504;2022-03-21;343777
2022-03-20;"Prešovský kraj";262;781;120;901;NA;350076;382;2022-03-20;342273
2022-03-19;"Prešovský kraj";802;887;106;993;NA;350076;908;2022-03-19;341891
2022-03-18;"Prešovský kraj";1217;2092;221;2313;NA;350076;1438;2022-03-18;340983
2022-03-17;"Prešovský kraj";1118;2425;178;2603;NA;350076;1296;2022-03-17;339545
2022-03-16;"Prešovský kraj";1585;2072;212;2284;NA;350076;1797;2022-03-16;338249
2022-03-15;"Prešovský kraj";1460;2311;209;2520;NA;350076;1669;2022-03-15;336452
2022-03-14;"Prešovský kraj";1438;3305;380;3685;NA;350076;1818;2022-03-14;334783
2022-03-13;"Prešovský kraj";432;1045;190;1235;NA;350076;622;2022-03-13;332965
2022-03-12;"Prešovský kraj";1150;857;117;974;NA;350076;1267;2022-03-12;332343
2022-03-11;"Prešovský kraj";1271;2550;287;2837;NA;350076;1558;2022-03-11;331076
2022-03-10;"Prešovský kraj";1114;2576;278;2854;NA;350076;1392;2022-03-10;329518
2022-03-09;"Prešovský kraj";1477;2811;345;3156;NA;350076;1822;2022-03-09;328126
2022-03-08;"Prešovský kraj";1716;2996;308;3304;NA;350076;2024;2022-03-08;326304
2022-03-07;"Prešovský kraj";1326;4193;509;4702;NA;350076;1835;2022-03-07;324280
2022-03-06;"Prešovský kraj";278;1650;232;1882;NA;350076;510;2022-03-06;322445
2022-03-05;"Prešovský kraj";785;1194;136;1330;NA;350076;921;2022-03-05;321935
2022-03-04;"Prešovský kraj";1263;2809;303;3112;NA;350076;1566;2022-03-04;321014
2022-03-03;"Prešovský kraj";1049;3015;373;3388;NA;350076;1422;2022-03-03;319448
2022-03-02;"Prešovský kraj";1526;2954;335;3289;NA;350076;1861;2022-03-02;318026
2022-03-01;"Prešovský kraj";1612;3298;338;3636;NA;350076;1950;2022-03-01;316165
2022-02-28;"Prešovský kraj";1234;4963;538;5501;NA;350076;1772;2022-02-28;314215
2022-02-27;"Prešovský kraj";523;1467;278;1745;NA;350076;801;2022-02-27;312443
2022-02-26;"Prešovský kraj";867;1317;167;1484;NA;350076;1034;2022-02-26;311642
2022-02-25;"Prešovský kraj";1740;2768;346;3114;NA;350076;2086;2022-02-25;310608
2022-02-24;"Prešovský kraj";1435;3301;399;3700;NA;350076;1834;2022-02-24;308522
2022-02-23;"Prešovský kraj";1837;3516;404;3920;NA;350076;2241;2022-02-23;306688
2022-02-22;"Prešovský kraj";2294;3893;407;4300;NA;350076;2701;2022-02-22;304447
2022-02-21;"Prešovský kraj";1609;5165;618;5783;NA;350076;2227;2022-02-21;301746
2022-02-20;"Prešovský kraj";759;1877;319;2196;NA;350076;1078;2022-02-20;299519
2022-02-19;"Prešovský kraj";1535;1556;247;1803;NA;350076;1782;2022-02-19;298441
2022-02-18;"Prešovský kraj";2332;3580;393;3973;NA;350076;2725;2022-02-18;296659
2022-02-17;"Prešovský kraj";2293;3740;457;4197;NA;350076;2750;2022-02-17;293934
2022-02-16;"Prešovský kraj";2494;4049;484;4533;NA;350076;2978;2022-02-16;291184
2022-02-15;"Prešovský kraj";2992;4583;551;5134;NA;350076;3543;2022-02-15;288206
2022-02-14;"Prešovský kraj";2122;6203;845;7048;NA;350076;2967;2022-02-14;284663
2022-02-13;"Prešovský kraj";1338;2452;434;2886;NA;350076;1772;2022-02-13;281696
2022-02-12;"Prešovský kraj";2333;1867;352;2219;NA;350076;2685;2022-02-12;279924
2022-02-11;"Prešovský kraj";2666;3930;520;4450;NA;350076;3186;2022-02-11;277239
2022-02-10;"Prešovský kraj";2977;4516;599;5115;NA;350076;3576;2022-02-10;274053
2022-02-09;"Prešovský kraj";2644;4502;634;5136;NA;350076;3278;2022-02-09;270477
2022-02-08;"Prešovský kraj";3387;4890;651;5541;NA;350076;4038;2022-02-08;267199
2022-02-07;"Prešovský kraj";2132;6919;941;7860;NA;350076;3073;2022-02-07;263161
2022-02-06;"Prešovský kraj";1360;2884;490;3374;NA;350076;1850;2022-02-06;260088
2022-02-05;"Prešovský kraj";2813;1993;334;2327;NA;350076;3147;2022-02-05;258238
2022-02-04;"Prešovský kraj";2944;4556;573;5129;NA;350076;3517;2022-02-04;255091
2022-02-03;"Prešovský kraj";3375;5205;487;5692;NA;350076;3862;2022-02-03;251574
2022-02-02;"Prešovský kraj";3150;5686;562;6248;NA;350076;3712;2022-02-02;247712
2022-02-01;"Prešovský kraj";2791;5693;631;6324;NA;350076;3422;2022-02-01;244000
2022-01-31;"Prešovský kraj";2444;9142;929;10071;NA;350076;3373;2022-01-31;240578
2022-01-30;"Prešovský kraj";1311;3437;495;3932;NA;350076;1806;2022-01-30;237205
2022-01-29;"Prešovský kraj";2291;1949;282;2231;NA;350076;2573;2022-01-29;235399
2022-01-28;"Prešovský kraj";2473;4784;486;5270;NA;350076;2959;2022-01-28;232826
2022-01-27;"Prešovský kraj";2353;4558;412;4970;NA;350076;2765;2022-01-27;229867
2022-01-26;"Prešovský kraj";2311;5628;405;6033;NA;350076;2716;2022-01-26;227102
2022-01-25;"Prešovský kraj";2127;5284;346;5630;NA;350076;2473;2022-01-25;224386
2022-01-24;"Prešovský kraj";1324;7619;410;8029;NA;350076;1734;2022-01-24;221913
2022-01-23;"Prešovský kraj";262;3584;218;3802;NA;350076;480;2022-01-23;220179
2022-01-22;"Prešovský kraj";1448;1764;157;1921;NA;350076;1605;2022-01-22;219699
2022-01-21;"Prešovský kraj";1128;4312;196;4508;NA;350076;1324;2022-01-21;218094
2022-01-20;"Prešovský kraj";1184;4012;156;4168;NA;350076;1340;2022-01-20;216770
2022-01-19;"Prešovský kraj";822;4781;173;4954;NA;350076;995;2022-01-19;215430
2022-01-18;"Prešovský kraj";1032;4918;163;5081;NA;350076;1195;2022-01-18;214435
2022-01-17;"Prešovský kraj";784;7143;150;7293;NA;350076;934;2022-01-17;213240
2022-01-16;"Prešovský kraj";113;3113;98;3211;NA;350076;211;2022-01-16;212306
2022-01-15;"Prešovský kraj";675;1546;64;1610;NA;350076;739;2022-01-15;212095
2022-01-14;"Prešovský kraj";202;3792;78;3870;NA;350076;280;2022-01-14;211356
2022-01-13;"Prešovský kraj";252;3550;89;3639;NA;350076;341;2022-01-13;211076
2022-01-12;"Prešovský kraj";431;4183;77;4260;NA;350076;508;2022-01-12;210735
2022-01-11;"Prešovský kraj";438;4812;80;4892;NA;350076;518;2022-01-11;210227
2022-01-10;"Prešovský kraj";469;7561;135;7696;NA;350076;604;2022-01-10;209709
2022-01-09;"Prešovský kraj";114;4129;78;4207;NA;350076;192;2022-01-09;209105
2022-01-08;"Prešovský kraj";291;2097;39;2136;NA;350076;330;2022-01-08;208913
2022-01-07;"Prešovský kraj";370;3882;106;3988;NA;350076;476;2022-01-07;208583
2022-01-06;"Prešovský kraj";104;1000;43;1043;NA;350076;147;2022-01-06;208107
2022-01-05;"Prešovský kraj";373;4752;100;4852;NA;350076;473;2022-01-05;207960
2022-01-04;"Prešovský kraj";428;4558;77;4635;NA;350076;505;2022-01-04;207487
2022-01-03;"Prešovský kraj";390;6868;105;6973;NA;350076;495;2022-01-03;206982
2022-01-02;"Prešovský kraj";158;3180;75;3255;NA;350076;233;2022-01-02;206487
2022-01-01;"Prešovský kraj";55;379;8;387;NA;350076;63;2022-01-01;206254
2021-12-31;"Prešovský kraj";220;2178;77;2255;NA;350076;297;2021-12-31;206191
2021-12-30;"Prešovský kraj";230;2985;81;3066;NA;350076;311;2021-12-30;205894
2021-12-29;"Prešovský kraj";298;3924;73;3997;NA;350076;371;2021-12-29;205583
2021-12-28;"Prešovský kraj";365;3625;60;3685;NA;350076;425;2021-12-28;205212
2021-12-27;"Prešovský kraj";593;5336;93;5429;NA;350076;686;2021-12-27;204787
2021-12-26;"Prešovský kraj";112;1584;62;1646;NA;350076;174;2021-12-26;204101
2021-12-25;"Prešovský kraj";12;600;29;629;NA;350076;41;2021-12-25;203927
2021-12-24;"Prešovský kraj";27;463;26;489;NA;350076;53;2021-12-24;203886
2021-12-23;"Prešovský kraj";623;3125;76;3201;NA;350076;699;2021-12-23;203833
2021-12-22;"Prešovský kraj";234;3600;86;3686;NA;350076;320;2021-12-22;203134
2021-12-21;"Prešovský kraj";520;4571;78;4649;NA;350076;598;2021-12-21;202814
2021-12-20;"Prešovský kraj";371;7190;107;7297;NA;350076;478;2021-12-20;202216
2021-12-19;"Prešovský kraj";110;3166;74;3240;NA;350076;184;2021-12-19;201738
2021-12-18;"Prešovský kraj";313;1562;61;1623;NA;350076;374;2021-12-18;201554
2021-12-17;"Prešovský kraj";429;4482;96;4578;NA;350076;525;2021-12-17;201180
2021-12-16;"Prešovský kraj";401;4557;95;4652;NA;350076;496;2021-12-16;200655
2021-12-15;"Prešovský kraj";473;4499;79;4578;NA;350076;552;2021-12-15;200159
2021-12-14;"Prešovský kraj";662;5468;125;5593;NA;350076;787;2021-12-14;199607
2021-12-13;"Prešovský kraj";588;8085;175;8260;NA;350076;763;2021-12-13;198820
2021-12-12;"Prešovský kraj";160;3852;106;3958;NA;350076;266;2021-12-12;198057
2021-12-11;"Prešovský kraj";483;2040;91;2131;NA;350076;574;2021-12-11;197791
2021-12-10;"Prešovský kraj";649;5018;140;5158;NA;350076;789;2021-12-10;197217
2021-12-09;"Prešovský kraj";669;4702;135;4837;NA;350076;804;2021-12-09;196428
2021-12-08;"Prešovský kraj";944;4794;167;4961;NA;350076;1111;2021-12-08;195624
2021-12-07;"Prešovský kraj";1217;5853;188;6041;NA;350076;1405;2021-12-07;194513
2021-12-06;"Prešovský kraj";784;8604;247;8851;NA;350076;1031;2021-12-06;193108
2021-12-05;"Prešovský kraj";145;4439;133;4572;NA;350076;278;2021-12-05;192077
2021-12-04;"Prešovský kraj";1025;2290;127;2417;NA;350076;1152;2021-12-04;191799
2021-12-03;"Prešovský kraj";1040;5268;231;5499;NA;350076;1271;2021-12-03;190647
2021-12-02;"Prešovský kraj";2255;5291;183;5474;NA;350076;2438;2021-12-02;189376
2021-12-01;"Prešovský kraj";826;5267;239;5506;NA;350076;1065;2021-12-01;186938
2021-11-30;"Prešovský kraj";1123;6651;265;6916;NA;350076;1388;2021-11-30;185873
2021-11-29;"Prešovský kraj";583;11478;473;11951;NA;350076;1056;2021-11-29;184485
2021-11-28;"Prešovský kraj";919;5898;234;6132;NA;350076;1153;2021-11-28;183429
2021-11-27;"Prešovský kraj";884;2977;219;3196;NA;350076;1103;2021-11-27;182276
2021-11-26;"Prešovský kraj";1311;5890;328;6218;NA;350076;1639;2021-11-26;181173
2021-11-25;"Prešovský kraj";1285;5051;307;5358;NA;350076;1592;2021-11-25;179534
2021-11-24;"Prešovský kraj";1209;6120;357;6477;NA;350076;1566;2021-11-24;177942
2021-11-23;"Prešovský kraj";1099;6631;314;6945;NA;350076;1413;2021-11-23;176376
2021-11-22;"Prešovský kraj";905;8209;529;8738;NA;350076;1434;2021-11-22;174963
2021-11-21;"Prešovský kraj";950;3766;316;4082;NA;350076;1266;2021-11-21;173529
2021-11-20;"Prešovský kraj";1372;2193;222;2415;NA;350076;1594;2021-11-20;172263
2021-11-19;"Prešovský kraj";1629;5864;452;6316;NA;350076;2081;2021-11-19;170669
2021-11-18;"Prešovský kraj";823;6696;518;7214;NA;350076;1341;2021-11-18;168588
2021-11-17;"Prešovský kraj";1648;1336;148;1484;NA;350076;1796;2021-11-17;167247
2021-11-16;"Prešovský kraj";1346;5511;398;5909;NA;350076;1744;2021-11-16;165451
2021-11-15;"Prešovský kraj";897;7804;577;8381;NA;350076;1474;2021-11-15;163707
2021-11-14;"Prešovský kraj";603;3168;311;3479;NA;350076;914;2021-11-14;162233
2021-11-13;"Prešovský kraj";1255;2068;262;2330;NA;350076;1517;2021-11-13;161319
2021-11-12;"Prešovský kraj";1358;5236;371;5607;NA;350076;1729;2021-11-12;159802
2021-11-11;"Prešovský kraj";1218;5087;438;5525;NA;350076;1656;2021-11-11;158073
2021-11-10;"Prešovský kraj";1278;4966;380;5346;NA;350076;1658;2021-11-10;156417
2021-11-09;"Prešovský kraj";1038;5431;407;5838;NA;350076;1445;2021-11-09;154759
2021-11-08;"Prešovský kraj";1068;6987;574;7561;NA;350076;1642;2021-11-08;153314
2021-11-07;"Prešovský kraj";421;2500;242;2742;NA;350076;663;2021-11-07;151672
2021-11-06;"Prešovský kraj";1389;1899;234;2133;NA;350076;1623;2021-11-06;151009
2021-11-05;"Prešovský kraj";1080;4974;367;5341;NA;350076;1447;2021-11-05;149386
2021-11-04;"Prešovský kraj";1743;5162;322;5484;NA;350076;2065;2021-11-04;147939
2021-11-03;"Prešovský kraj";1326;5337;387;5724;NA;350076;1713;2021-11-03;145874
2021-11-02;"Prešovský kraj";1002;7553;556;8109;NA;350076;1558;2021-11-02;144161
2021-11-01;"Prešovský kraj";347;1402;131;1533;NA;350076;478;2021-11-01;142603
2021-10-31;"Prešovský kraj";447;2045;210;2255;NA;350076;657;2021-10-31;142125
2021-10-30;"Prešovský kraj";1148;1928;183;2111;NA;350076;1331;2021-10-30;141468
2021-10-29;"Prešovský kraj";1360;4460;253;4713;NA;350076;1613;2021-10-29;140137
2021-10-28;"Prešovský kraj";960;4500;300;4800;NA;350076;1260;2021-10-28;138524
2021-10-27;"Prešovský kraj";1444;4325;221;4546;NA;350076;1665;2021-10-27;137264
2021-10-26;"Prešovský kraj";940;5125;217;5342;NA;350076;1157;2021-10-26;135599
2021-10-25;"Prešovský kraj";673;6077;348;6425;NA;350076;1021;2021-10-25;134442
2021-10-24;"Prešovský kraj";110;2180;149;2329;NA;350076;259;2021-10-24;133421
2021-10-23;"Prešovský kraj";1145;1928;141;2069;NA;350076;1286;2021-10-23;133162
2021-10-22;"Prešovský kraj";792;4876;177;5053;NA;350076;969;2021-10-22;131876
2021-10-21;"Prešovský kraj";901;4738;191;4929;NA;350076;1092;2021-10-21;130907
2021-10-20;"Prešovský kraj";833;4199;195;4394;NA;350076;1028;2021-10-20;129815
2021-10-19;"Prešovský kraj";830;4728;175;4903;NA;350076;1005;2021-10-19;128787
2021-10-18;"Prešovský kraj";454;5752;240;5992;NA;350076;694;2021-10-18;127782
2021-10-17;"Prešovský kraj";181;2430;131;2561;NA;350076;312;2021-10-17;127088
2021-10-16;"Prešovský kraj";561;1924;94;2018;NA;350076;655;2021-10-16;126776
2021-10-15;"Prešovský kraj";533;4735;107;4842;NA;350076;640;2021-10-15;126121
2021-10-14;"Prešovský kraj";506;3948;85;4033;NA;350076;591;2021-10-14;125481
2021-10-13;"Prešovský kraj";549;3794;98;3892;NA;350076;647;2021-10-13;124890
2021-10-12;"Prešovský kraj";520;3966;101;4067;NA;350076;621;2021-10-12;124243
2021-10-11;"Prešovský kraj";433;5421;131;5552;NA;350076;564;2021-10-11;123622
2021-10-10;"Prešovský kraj";78;2099;64;2163;NA;350076;142;2021-10-10;123058
2021-10-09;"Prešovský kraj";311;2077;47;2124;NA;350076;358;2021-10-09;122916
2021-10-08;"Prešovský kraj";636;4934;94;5028;NA;350076;730;2021-10-08;122558
2021-10-07;"Prešovský kraj";487;3919;101;4020;NA;350076;588;2021-10-07;121828
2021-10-06;"Prešovský kraj";296;3851;104;3955;NA;350076;400;2021-10-06;121240
2021-10-05;"Prešovský kraj";430;4151;90;4241;NA;350076;520;2021-10-05;120840
2021-10-04;"Prešovský kraj";353;5569;125;5694;NA;350076;478;2021-10-04;120320
2021-10-03;"Prešovský kraj";19;2324;47;2371;NA;350076;66;2021-10-03;119842
2021-10-02;"Prešovský kraj";269;2238;58;2296;NA;350076;327;2021-10-02;119776
2021-10-01;"Prešovský kraj";325;4997;63;5060;NA;350076;388;2021-10-01;119449
2021-09-30;"Prešovský kraj";265;4044;83;4127;NA;350076;348;2021-09-30;119061
2021-09-29;"Prešovský kraj";381;3825;55;3880;NA;350076;436;2021-09-29;118713
2021-09-28;"Prešovský kraj";312;4714;69;4783;NA;350076;381;2021-09-28;118277
2021-09-27;"Prešovský kraj";257;5062;104;5166;NA;350076;361;2021-09-27;117896
2021-09-26;"Prešovský kraj";8;2422;67;2489;NA;350076;75;2021-09-26;117535
2021-09-25;"Prešovský kraj";134;2540;46;2586;NA;350076;180;2021-09-25;117460
2021-09-24;"Prešovský kraj";297;4822;61;4883;NA;350076;358;2021-09-24;117280
2021-09-23;"Prešovský kraj";109;4105;45;4150;NA;350076;154;2021-09-23;116922
2021-09-22;"Prešovský kraj";177;3836;41;3877;NA;350076;218;2021-09-22;116768
2021-09-21;"Prešovský kraj";219;5059;66;5125;NA;350076;285;2021-09-21;116550
2021-09-20;"Prešovský kraj";180;5183;68;5251;NA;350076;248;2021-09-20;116265
2021-09-19;"Prešovský kraj";7;2726;30;2756;NA;350076;37;2021-09-19;116017
2021-09-18;"Prešovský kraj";169;2406;37;2443;NA;350076;206;2021-09-18;115980
2021-09-17;"Prešovský kraj";157;4402;52;4454;NA;350076;209;2021-09-17;115774
2021-09-16;"Prešovský kraj";146;4371;71;4442;NA;350076;217;2021-09-16;115565
2021-09-15;"Prešovský kraj";68;701;19;720;NA;350076;87;2021-09-15;115348
2021-09-14;"Prešovský kraj";133;3369;38;3407;NA;350076;171;2021-09-14;115261
2021-09-13;"Prešovský kraj";105;4225;37;4262;NA;350076;142;2021-09-13;115090
2021-09-12;"Prešovský kraj";4;1776;29;1805;NA;350076;33;2021-09-12;114948
2021-09-11;"Prešovský kraj";65;2012;24;2036;NA;350076;89;2021-09-11;114915
2021-09-10;"Prešovský kraj";105;3241;30;3271;NA;350076;135;2021-09-10;114826
2021-09-09;"Prešovský kraj";29;3090;27;3117;NA;350076;56;2021-09-09;114691
2021-09-08;"Prešovský kraj";73;2444;20;2464;NA;350076;93;2021-09-08;114635
2021-09-07;"Prešovský kraj";82;2449;24;2473;NA;350076;106;2021-09-07;114542
2021-09-06;"Prešovský kraj";61;3282;20;3302;NA;350076;81;2021-09-06;114436
2021-09-05;"Prešovský kraj";5;1338;11;1349;NA;350076;16;2021-09-05;114355
2021-09-04;"Prešovský kraj";27;1864;14;1878;NA;350076;41;2021-09-04;114339
2021-09-03;"Prešovský kraj";39;2976;15;2991;NA;350076;54;2021-09-03;114298
2021-09-02;"Prešovský kraj";39;2558;20;2578;NA;350076;59;2021-09-02;114244
2021-09-01;"Prešovský kraj";14;575;6;581;NA;350076;20;2021-09-01;114185
2021-08-31;"Prešovský kraj";47;2438;13;2451;NA;350076;60;2021-08-31;114165
2021-08-30;"Prešovský kraj";23;2827;19;2846;NA;350076;42;2021-08-30;114105
2021-08-29;"Prešovský kraj";3;781;1;782;NA;350076;4;2021-08-29;114063
2021-08-28;"Prešovský kraj";5;2101;8;2109;NA;350076;13;2021-08-28;114059
2021-08-27;"Prešovský kraj";32;3084;8;3092;NA;350076;40;2021-08-27;114046
2021-08-26;"Prešovský kraj";13;2094;8;2102;NA;350076;21;2021-08-26;114006
2021-08-25;"Prešovský kraj";18;1947;4;1951;NA;350076;22;2021-08-25;113985
2021-08-24;"Prešovský kraj";10;2138;5;2143;NA;350076;15;2021-08-24;113963
2021-08-23;"Prešovský kraj";16;2576;6;2582;NA;350076;22;2021-08-23;113948
2021-08-22;"Prešovský kraj";0;1440;6;1446;NA;350076;6;2021-08-22;113926
2021-08-21;"Prešovský kraj";28;2018;4;2022;NA;350076;32;2021-08-21;113920
2021-08-20;"Prešovský kraj";15;2906;7;2913;NA;350076;22;2021-08-20;113888
2021-08-19;"Prešovský kraj";22;2242;8;2250;NA;350076;30;2021-08-19;113866
2021-08-18;"Prešovský kraj";6;1752;11;1763;NA;350076;17;2021-08-18;113836
2021-08-17;"Prešovský kraj";29;1829;6;1835;NA;350076;35;2021-08-17;113819
2021-08-16;"Prešovský kraj";11;2524;7;2531;NA;350076;18;2021-08-16;113784
2021-08-15;"Prešovský kraj";0;896;2;898;NA;350076;2;2021-08-15;113766
2021-08-14;"Prešovský kraj";14;1662;1;1663;NA;350076;15;2021-08-14;113764
2021-08-13;"Prešovský kraj";24;1646;12;1658;NA;350076;36;2021-08-13;113749
2021-08-12;"Prešovský kraj";9;1752;3;1755;NA;350076;12;2021-08-12;113713
2021-08-11;"Prešovský kraj";15;1193;3;1196;NA;350076;18;2021-08-11;113701
2021-08-10;"Prešovský kraj";10;1102;4;1106;NA;350076;14;2021-08-10;113683
2021-08-09;"Prešovský kraj";13;2156;4;2160;NA;350076;17;2021-08-09;113669
2021-08-08;"Prešovský kraj";2;675;2;677;NA;350076;4;2021-08-08;113652
2021-08-07;"Prešovský kraj";5;1114;3;1117;NA;350076;8;2021-08-07;113648
2021-08-06;"Prešovský kraj";9;1459;4;1463;NA;350076;13;2021-08-06;113640
2021-08-05;"Prešovský kraj";9;1370;2;1372;NA;350076;11;2021-08-05;113627
2021-08-04;"Prešovský kraj";6;1007;1;1008;NA;350076;7;2021-08-04;113616
2021-08-03;"Prešovský kraj";8;976;1;977;NA;350076;9;2021-08-03;113609
2021-08-02;"Prešovský kraj";5;1477;6;1483;NA;350076;11;2021-08-02;113600
2021-08-01;"Prešovský kraj";0;738;2;740;NA;350076;2;2021-08-01;113589
2021-07-31;"Prešovský kraj";20;1080;0;1080;NA;350076;20;2021-07-31;113587
2021-07-30;"Prešovský kraj";2;1518;1;1519;NA;350076;3;2021-07-30;113567
2021-07-29;"Prešovský kraj";6;1302;1;1303;NA;350076;7;2021-07-29;113564
2021-07-28;"Prešovský kraj";6;1106;1;1107;NA;350076;7;2021-07-28;113557
2021-07-27;"Prešovský kraj";5;1140;2;1142;NA;350076;7;2021-07-27;113550
2021-07-26;"Prešovský kraj";12;1583;1;1584;NA;350076;13;2021-07-26;113543
2021-07-25;"Prešovský kraj";0;687;1;688;NA;350076;1;2021-07-25;113530
2021-07-24;"Prešovský kraj";8;1040;0;1040;NA;350076;8;2021-07-24;113529
2021-07-23;"Prešovský kraj";8;1608;1;1609;NA;350076;9;2021-07-23;113521
2021-07-22;"Prešovský kraj";13;1431;10;1441;NA;350076;23;2021-07-22;113512
2021-07-21;"Prešovský kraj";5;1076;1;1077;NA;350076;6;2021-07-21;113489
2021-07-20;"Prešovský kraj";4;1064;0;1064;NA;350076;4;2021-07-20;113483
2021-07-19;"Prešovský kraj";2;1644;4;1648;NA;350076;6;2021-07-19;113479
2021-07-18;"Prešovský kraj";1;647;0;647;NA;350076;1;2021-07-18;113473
2021-07-17;"Prešovský kraj";6;1245;1;1246;NA;350076;7;2021-07-17;113472
2021-07-16;"Prešovský kraj";4;1558;2;1560;NA;350076;6;2021-07-16;113465
2021-07-15;"Prešovský kraj";5;1310;4;1314;NA;350076;9;2021-07-15;113459
2021-07-14;"Prešovský kraj";1;1051;2;1053;NA;350076;3;2021-07-14;113450
2021-07-13;"Prešovský kraj";1;1071;2;1073;NA;350076;3;2021-07-13;113447
2021-07-12;"Prešovský kraj";1;1949;2;1951;NA;350076;3;2021-07-12;113444
2021-07-11;"Prešovský kraj";0;660;1;661;NA;350076;1;2021-07-11;113441
2021-07-10;"Prešovský kraj";4;1229;2;1231;NA;350076;6;2021-07-10;113440
2021-07-09;"Prešovský kraj";6;1957;1;1958;NA;350076;7;2021-07-09;113434
2021-07-08;"Prešovský kraj";5;1192;0;1192;NA;350076;5;2021-07-08;113427
2021-07-07;"Prešovský kraj";7;1468;3;1471;NA;350076;10;2021-07-07;113422
2021-07-06;"Prešovský kraj";5;1423;2;1425;NA;350076;7;2021-07-06;113412
2021-07-05;"Prešovský kraj";2;645;0;645;NA;350076;2;2021-07-05;113405
2021-07-04;"Prešovský kraj";0;788;0;788;NA;350076;0;2021-07-04;113403
2021-07-03;"Prešovský kraj";2;1391;0;1391;NA;350076;2;2021-07-03;113403
2021-07-02;"Prešovský kraj";4;1796;0;1796;NA;350076;4;2021-07-02;113401
2021-07-01;"Prešovský kraj";2;1590;1;1591;NA;350076;3;2021-07-01;113397
2021-06-30;"Prešovský kraj";3;8829;4;8833;NA;350076;7;2021-06-30;113394
2021-06-29;"Prešovský kraj";1;4935;3;4938;NA;350076;4;2021-06-29;113387
2021-06-28;"Prešovský kraj";5;6109;2;6111;NA;350076;7;2021-06-28;113383
2021-06-27;"Prešovský kraj";0;3852;1;3853;NA;350076;1;2021-06-27;113376
2021-06-26;"Prešovský kraj";4;5815;1;5816;NA;350076;5;2021-06-26;113375
2021-06-25;"Prešovský kraj";7;7321;4;7325;NA;350076;11;2021-06-25;113370
2021-06-24;"Prešovský kraj";10;5406;5;5411;NA;350076;15;2021-06-24;113359
2021-06-23;"Prešovský kraj";4;5124;2;5126;NA;350076;6;2021-06-23;113344
2021-06-22;"Prešovský kraj";5;5143;1;5144;NA;350076;6;2021-06-22;113338
2021-06-21;"Prešovský kraj";13;7033;6;7039;NA;350076;19;2021-06-21;113332
2021-06-20;"Prešovský kraj";0;5204;3;5207;NA;350076;3;2021-06-20;113313
2021-06-19;"Prešovský kraj";1;7349;5;7354;NA;350076;6;2021-06-19;113310
2021-06-18;"Prešovský kraj";9;8682;10;8692;NA;350076;19;2021-06-18;113304
2021-06-17;"Prešovský kraj";9;6548;5;6553;NA;350076;14;2021-06-17;113285
2021-06-16;"Prešovský kraj";6;6422;3;6425;NA;350076;9;2021-06-16;113271
2021-06-15;"Prešovský kraj";2;5709;4;5713;NA;350076;6;2021-06-15;113262
2021-06-14;"Prešovský kraj";5;8229;13;8242;NA;350076;18;2021-06-14;113256
2021-06-13;"Prešovský kraj";1;6455;7;6462;NA;350076;8;2021-06-13;113238
2021-06-12;"Prešovský kraj";3;8904;9;8913;NA;350076;12;2021-06-12;113230
2021-06-11;"Prešovský kraj";21;9877;9;9886;NA;350076;30;2021-06-11;113218
2021-06-10;"Prešovský kraj";11;6512;10;6522;NA;350076;21;2021-06-10;113188
2021-06-09;"Prešovský kraj";16;6375;3;6378;NA;350076;19;2021-06-09;113167
2021-06-08;"Prešovský kraj";31;6495;12;6507;NA;350076;43;2021-06-08;113148
2021-06-07;"Prešovský kraj";11;9111;15;9126;NA;350076;26;2021-06-07;113105
2021-06-06;"Prešovský kraj";0;8016;5;8021;NA;350076;5;2021-06-06;113079
2021-06-05;"Prešovský kraj";17;10248;15;10263;NA;350076;32;2021-06-05;113074
2021-06-04;"Prešovský kraj";26;10375;18;10393;NA;350076;44;2021-06-04;113042
2021-06-03;"Prešovský kraj";14;6820;16;6836;NA;350076;30;2021-06-03;112998
2021-06-02;"Prešovský kraj";47;7372;14;7386;NA;350076;61;2021-06-02;112968
2021-06-01;"Prešovský kraj";15;6926;14;6940;NA;350076;29;2021-06-01;112907
2021-05-31;"Prešovský kraj";27;9951;22;9973;NA;350076;49;2021-05-31;112878
2021-05-30;"Prešovský kraj";2;9717;14;9731;NA;350076;16;2021-05-30;112829
2021-05-29;"Prešovský kraj";23;12733;24;12757;NA;350076;47;2021-05-29;112813
2021-05-28;"Prešovský kraj";30;12468;19;12487;NA;350076;49;2021-05-28;112766
2021-05-27;"Prešovský kraj";16;7653;37;7690;NA;350076;53;2021-05-27;112717
2021-05-26;"Prešovský kraj";32;8140;23;8163;NA;350076;55;2021-05-26;112664
2021-05-25;"Prešovský kraj";38;8690;20;8710;NA;350076;58;2021-05-25;112609
2021-05-24;"Prešovský kraj";17;13298;37;13335;NA;350076;54;2021-05-24;112551
2021-05-23;"Prešovský kraj";3;11947;20;11967;NA;350076;23;2021-05-23;112497
2021-05-22;"Prešovský kraj";11;14422;44;14466;NA;350076;55;2021-05-22;112474
2021-05-21;"Prešovský kraj";44;13803;24;13827;NA;350076;68;2021-05-21;112419
2021-05-20;"Prešovský kraj";13;9437;29;9466;NA;350076;42;2021-05-20;112351
2021-05-19;"Prešovský kraj";60;10756;36;10792;NA;350076;96;2021-05-19;112309
2021-05-18;"Prešovský kraj";44;9062;27;9089;NA;350076;71;2021-05-18;112213
2021-05-17;"Prešovský kraj";60;12856;47;12903;NA;350076;107;2021-05-17;112142
2021-05-16;"Prešovský kraj";20;16302;66;16368;NA;350076;86;2021-05-16;112035
2021-05-15;"Prešovský kraj";20;24604;81;24685;NA;350076;101;2021-05-15;111949
2021-05-14;"Prešovský kraj";49;18671;68;18739;NA;350076;117;2021-05-14;111848
2021-05-13;"Prešovský kraj";54;11166;71;11237;NA;350076;125;2021-05-13;111731
2021-05-12;"Prešovský kraj";59;10822;39;10861;NA;350076;98;2021-05-12;111606
2021-05-11;"Prešovský kraj";61;10728;48;10776;NA;350076;109;2021-05-11;111508
2021-05-10;"Prešovský kraj";79;15726;67;15793;NA;350076;146;2021-05-10;111399
2021-05-09;"Prešovský kraj";54;21658;82;21740;NA;350076;136;2021-05-09;111253
2021-05-08;"Prešovský kraj";39;23050;52;23102;NA;350076;91;2021-05-08;111117
2021-05-07;"Prešovský kraj";81;23543;66;23609;NA;350076;147;2021-05-07;111026
2021-05-06;"Prešovský kraj";107;12924;66;12990;NA;350076;173;2021-05-06;110879
2021-05-05;"Prešovský kraj";60;12808;84;12892;NA;350076;144;2021-05-05;110706
2021-05-04;"Prešovský kraj";203;13470;67;13537;NA;350076;270;2021-05-04;110562
2021-05-03;"Prešovský kraj";68;18458;109;18567;NA;350076;177;2021-05-03;110292
2021-05-02;"Prešovský kraj";29;36676;102;36778;NA;350076;131;2021-05-02;110115
2021-05-01;"Prešovský kraj";70;57153;183;57336;NA;350076;253;2021-05-01;109984
2021-04-30;"Prešovský kraj";135;39333;118;39451;NA;350076;253;2021-04-30;109731
2021-04-29;"Prešovský kraj";110;16635;97;16732;NA;350076;207;2021-04-29;109478
2021-04-28;"Prešovský kraj";122;18671;89;18760;NA;350076;211;2021-04-28;109271
2021-04-27;"Prešovský kraj";154;19994;120;20114;NA;350076;274;2021-04-27;109060
2021-04-26;"Prešovský kraj";99;27241;123;27364;NA;350076;222;2021-04-26;108786
2021-04-25;"Prešovský kraj";9;52776;156;52932;NA;350076;165;2021-04-25;108564
2021-04-24;"Prešovský kraj";61;85698;243;85941;NA;350076;304;2021-04-24;108399
2021-04-23;"Prešovský kraj";171;40365;137;40502;NA;350076;308;2021-04-23;108095
2021-04-22;"Prešovský kraj";86;18104;125;18229;NA;350076;211;2021-04-22;107787
2021-04-21;"Prešovský kraj";144;21550;139;21689;NA;350076;283;2021-04-21;107576
2021-04-20;"Prešovský kraj";115;23346;128;23474;NA;350076;243;2021-04-20;107293
2021-04-19;"Prešovský kraj";106;29133;145;29278;NA;350076;251;2021-04-19;107050
2021-04-18;"Prešovský kraj";4;51824;129;51953;NA;350076;133;2021-04-18;106799
2021-04-17;"Prešovský kraj";119;97970;238;98208;NA;350076;357;2021-04-17;106666
2021-04-16;"Prešovský kraj";135;40989;146;41135;NA;350076;281;2021-04-16;106309
2021-04-15;"Prešovský kraj";112;20179;137;20316;NA;350076;249;2021-04-15;106028
2021-04-14;"Prešovský kraj";199;23332;130;23462;NA;350076;329;2021-04-14;105779
2021-04-13;"Prešovský kraj";180;23907;116;24023;NA;350076;296;2021-04-13;105450
2021-04-12;"Prešovský kraj";172;30152;175;30327;NA;350076;347;2021-04-12;105154
2021-04-11;"Prešovský kraj";11;49955;187;50142;NA;350076;198;2021-04-11;104807
2021-04-10;"Prešovský kraj";94;90181;297;90478;NA;350076;391;2021-04-10;104609
2021-04-09;"Prešovský kraj";255;37163;200;37363;NA;350076;455;2021-04-09;104218
2021-04-08;"Prešovský kraj";192;18893;157;19050;NA;350076;349;2021-04-08;103763
2021-04-07;"Prešovský kraj";314;27797;154;27951;NA;350076;468;2021-04-07;103414
2021-04-06;"Prešovský kraj";231;41711;268;41979;NA;350076;499;2021-04-06;102946
2021-04-05;"Prešovský kraj";54;18454;132;18586;NA;350076;186;2021-04-05;102447
2021-04-04;"Prešovský kraj";31;18569;91;18660;NA;350076;122;2021-04-04;102261
2021-04-03;"Prešovský kraj";104;90664;321;90985;NA;350076;425;2021-04-03;102139
2021-04-02;"Prešovský kraj";194;23381;134;23515;NA;350076;328;2021-04-02;101714
2021-04-01;"Prešovský kraj";256;42879;195;43074;NA;350076;451;2021-04-01;101386
2021-03-31;"Prešovský kraj";311;30176;227;30403;NA;350076;538;2021-03-31;100935
2021-03-30;"Prešovský kraj";374;20751;203;20954;NA;350076;577;2021-03-30;100397
2021-03-29;"Prešovský kraj";219;28188;229;28417;NA;350076;448;2021-03-29;99820
2021-03-28;"Prešovský kraj";26;46811;256;47067;NA;350076;282;2021-03-28;99372
2021-03-27;"Prešovský kraj";181;88673;372;89045;NA;350076;553;2021-03-27;99090
2021-03-26;"Prešovský kraj";310;47751;299;48050;NA;350076;609;2021-03-26;98537
2021-03-25;"Prešovský kraj";248;22281;213;22494;NA;350076;461;2021-03-25;97928
2021-03-24;"Prešovský kraj";381;19590;213;19803;NA;350076;594;2021-03-24;97467
2021-03-23;"Prešovský kraj";241;20351;255;20606;NA;350076;496;2021-03-23;96873
2021-03-22;"Prešovský kraj";299;28634;287;28921;NA;350076;586;2021-03-22;96377
2021-03-21;"Prešovský kraj";32;49439;266;49705;NA;350076;298;2021-03-21;95791
2021-03-20;"Prešovský kraj";180;92529;426;92955;NA;350076;606;2021-03-20;95493
2021-03-19;"Prešovský kraj";373;46582;326;46908;NA;350076;699;2021-03-19;94887
2021-03-18;"Prešovský kraj";251;21721;217;21938;NA;350076;468;2021-03-18;94188
2021-03-17;"Prešovský kraj";331;20887;231;21118;NA;350076;562;2021-03-17;93720
2021-03-16;"Prešovský kraj";461;21094;278;21372;NA;350076;739;2021-03-16;93158
2021-03-15;"Prešovský kraj";370;28813;324;29137;NA;350076;694;2021-03-15;92419
2021-03-14;"Prešovský kraj";52;50410;356;50766;NA;350076;408;2021-03-14;91725
2021-03-13;"Prešovský kraj";200;94768;531;95299;NA;350076;731;2021-03-13;91317
2021-03-12;"Prešovský kraj";425;47691;368;48059;NA;350076;793;2021-03-12;90586
2021-03-11;"Prešovský kraj";463;22059;253;22312;NA;350076;716;2021-03-11;89793
2021-03-10;"Prešovský kraj";325;20821;293;21114;NA;350076;618;2021-03-10;89077
2021-03-09;"Prešovský kraj";505;21496;288;21784;NA;350076;793;2021-03-09;88459
2021-03-08;"Prešovský kraj";314;28903;333;29236;NA;350076;647;2021-03-08;87666
2021-03-07;"Prešovský kraj";19;48328;388;48716;NA;350076;407;2021-03-07;87019
2021-03-06;"Prešovský kraj";193;97527;591;98118;NA;350076;784;2021-03-06;86612
2021-03-05;"Prešovský kraj";497;46054;397;46451;NA;350076;894;2021-03-05;85828
2021-03-04;"Prešovský kraj";372;22670;359;23029;NA;350076;731;2021-03-04;84934
2021-03-03;"Prešovský kraj";397;21623;333;21956;NA;350076;730;2021-03-03;84203
2021-03-02;"Prešovský kraj";421;22682;357;23039;NA;350076;778;2021-03-02;83473
2021-03-01;"Prešovský kraj";303;27716;406;28122;NA;350076;709;2021-03-01;82695
2021-02-28;"Prešovský kraj";75;45000;387;45387;NA;350076;462;2021-02-28;81986
2021-02-27;"Prešovský kraj";273;90231;734;90965;NA;350076;1007;2021-02-27;81524
2021-02-26;"Prešovský kraj";455;41340;438;41778;NA;350076;893;2021-02-26;80517
2021-02-25;"Prešovský kraj";270;19496;337;19833;NA;350076;607;2021-02-25;79624
2021-02-24;"Prešovský kraj";328;19026;377;19403;NA;350076;705;2021-02-24;79017
2021-02-23;"Prešovský kraj";430;21277;345;21622;NA;350076;775;2021-02-23;78312
2021-02-22;"Prešovský kraj";351;27180;356;27536;NA;350076;707;2021-02-22;77537
2021-02-21;"Prešovský kraj";66;31453;301;31754;NA;350076;367;2021-02-21;76830
2021-02-20;"Prešovský kraj";129;71413;517;71930;NA;350076;646;2021-02-20;76463
2021-02-19;"Prešovský kraj";381;38995;430;39425;NA;350076;811;2021-02-19;75817
2021-02-18;"Prešovský kraj";268;16960;322;17282;NA;350076;590;2021-02-18;75006
2021-02-17;"Prešovský kraj";293;17392;246;17638;NA;350076;539;2021-02-17;74416
2021-02-16;"Prešovský kraj";422;18862;265;19127;NA;350076;687;2021-02-16;73877
2021-02-15;"Prešovský kraj";211;31366;303;31669;NA;350076;514;2021-02-15;73190
2021-02-14;"Prešovský kraj";27;39387;321;39708;NA;350076;348;2021-02-14;72676
2021-02-13;"Prešovský kraj";157;74747;402;75149;NA;350076;559;2021-02-13;72328
2021-02-12;"Prešovský kraj";308;38758;365;39123;NA;350076;673;2021-02-12;71769
2021-02-11;"Prešovský kraj";218;16207;238;16445;NA;350076;456;2021-02-11;71096
2021-02-10;"Prešovský kraj";220;18542;282;18824;NA;350076;502;2021-02-10;70640
2021-02-09;"Prešovský kraj";323;21497;370;21867;NA;350076;693;2021-02-09;70138
2021-02-08;"Prešovský kraj";161;36924;261;37185;NA;350076;422;2021-02-08;69445
2021-02-07;"Prešovský kraj";21;34227;209;34436;NA;350076;230;2021-02-07;69023
2021-02-06;"Prešovský kraj";176;69164;360;69524;NA;350076;536;2021-02-06;68793
2021-02-05;"Prešovský kraj";177;31271;262;31533;NA;350076;439;2021-02-05;68257
2021-02-04;"Prešovský kraj";176;13080;237;13317;NA;350076;413;2021-02-04;67818
2021-02-03;"Prešovský kraj";251;8421;236;8657;NA;350076;487;2021-02-03;67405
2021-02-02;"Prešovský kraj";249;11769;264;12033;NA;350076;513;2021-02-02;66918
2021-02-01;"Prešovský kraj";220;16059;316;16375;NA;350076;536;2021-02-01;66405
2021-01-31;"Prešovský kraj";42;10587;107;10694;NA;350076;149;2021-01-31;65869
2021-01-30;"Prešovský kraj";142;23939;215;24154;NA;350076;357;2021-01-30;65720
2021-01-29;"Prešovský kraj";185;17924;326;18250;NA;350076;511;2021-01-29;65363
2021-01-28;"Prešovský kraj";311;7348;150;7498;NA;350076;461;2021-01-28;64852
2021-01-27;"Prešovský kraj";153;9730;147;9877;NA;350076;300;2021-01-27;64391
2021-01-26;"Prešovský kraj";252;16653;151;16804;NA;350076;403;2021-01-26;64091
2021-01-25;"Prešovský kraj";196;30092;253;30345;NA;350076;449;2021-01-25;63688
2021-01-24;"Prešovský kraj";12;45706;304;46010;NA;350076;316;2021-01-24;63239
2021-01-23;"Prešovský kraj";189;96883;487;97370;NA;350076;676;2021-01-23;62923
2021-01-22;"Prešovský kraj";187;35383;261;35644;NA;350076;448;2021-01-22;62247
2021-01-21;"Prešovský kraj";187;20434;212;20646;NA;350076;399;2021-01-21;61799
2021-01-20;"Prešovský kraj";253;14782;195;14977;NA;350076;448;2021-01-20;61400
2021-01-19;"Prešovský kraj";281;12329;305;12634;NA;350076;586;2021-01-19;60952
2021-01-18;"Prešovský kraj";203;10422;336;10758;NA;350076;539;2021-01-18;60366
2021-01-17;"Prešovský kraj";107;14391;1008;15399;NA;350076;1115;2021-01-17;59827
2021-01-16;"Prešovský kraj";72;1838;81;1919;NA;350076;153;2021-01-16;58712
2021-01-15;"Prešovský kraj";159;7033;257;7290;NA;350076;416;2021-01-15;58559
2021-01-14;"Prešovský kraj";268;5534;256;5790;NA;350076;524;2021-01-14;58143
2021-01-13;"Prešovský kraj";342;5649;226;5875;NA;350076;568;2021-01-13;57619
2021-01-12;"Prešovský kraj";455;8251;386;8637;NA;350076;841;2021-01-12;57051
2021-01-11;"Prešovský kraj";343;8149;471;8620;NA;350076;814;2021-01-11;56210
2021-01-10;"Prešovský kraj";63;476;23;499;NA;350076;86;2021-01-10;55396
2021-01-09;"Prešovský kraj";439;2248;125;2373;NA;350076;564;2021-01-09;55310
2021-01-08;"Prešovský kraj";430;10416;561;10977;NA;350076;991;2021-01-08;54746
2021-01-07;"Prešovský kraj";268;7432;622;8054;NA;350076;890;2021-01-07;53755
2021-01-06;"Prešovský kraj";315;1484;134;1618;NA;350076;449;2021-01-06;52865
2021-01-05;"Prešovský kraj";655;11275;976;12251;NA;350076;1631;2021-01-05;52416
2021-01-04;"Prešovský kraj";371;16845;1789;18634;NA;350076;2160;2021-01-04;50785
2021-01-03;"Prešovský kraj";89;459;41;500;NA;350076;130;2021-01-03;48625
2021-01-02;"Prešovský kraj";65;1556;160;1716;NA;350076;225;2021-01-02;48495
2021-01-01;"Prešovský kraj";174;956;71;1027;NA;350076;245;2021-01-01;48270
2020-12-31;"Prešovský kraj";640;11959;783;12742;NA;350076;1423;2020-12-31;48025
2020-12-30;"Prešovský kraj";729;8729;769;9498;NA;350076;1498;2020-12-30;46602
2020-12-29;"Prešovský kraj";435;9273;949;10222;NA;350076;1384;2020-12-29;45104
2020-12-28;"Prešovský kraj";393;9046;1079;10125;NA;350076;1472;2020-12-28;43720
2020-12-27;"Prešovský kraj";40;613;45;658;NA;350076;85;2020-12-27;42248
2020-12-26;"Prešovský kraj";64;176;12;188;NA;350076;76;2020-12-26;42163
2020-12-25;"Prešovský kraj";208;274;11;285;NA;350076;219;2020-12-25;42087
2020-12-24;"Prešovský kraj";452;1214;85;1299;NA;350076;537;2020-12-24;41868
2020-12-23;"Prešovský kraj";361;11006;618;11624;NA;350076;979;2020-12-23;41331
2020-12-22;"Prešovský kraj";439;9023;695;9718;NA;350076;1134;2020-12-22;40352
2020-12-21;"Prešovský kraj";432;9577;847;10424;NA;350076;1279;2020-12-21;39218
2020-12-20;"Prešovský kraj";184;396;20;416;NA;350076;204;2020-12-20;37939
2020-12-19;"Prešovský kraj";276;1658;151;1809;NA;350076;427;2020-12-19;37735
2020-12-18;"Prešovský kraj";396;8246;566;8812;NA;350076;962;2020-12-18;37308
2020-12-17;"Prešovský kraj";427;10505;866;11371;NA;350076;1293;2020-12-17;36346
2020-12-16;"Prešovský kraj";466;5613;473;6086;NA;350076;939;2020-12-16;35053
2020-12-15;"Prešovský kraj";411;5406;574;5980;NA;350076;985;2020-12-15;34114
2020-12-14;"Prešovský kraj";334;5538;477;6015;NA;350076;811;2020-12-14;33129
2020-12-13;"Prešovský kraj";89;29;8;37;NA;350076;97;2020-12-13;32318
2020-12-12;"Prešovský kraj";319;2474;166;2640;NA;350076;485;2020-12-12;32221
2020-12-11;"Prešovský kraj";560;5602;402;6004;NA;350076;962;2020-12-11;31736
2020-12-10;"Prešovský kraj";337;5019;423;5442;NA;350076;760;2020-12-10;30774
2020-12-09;"Prešovský kraj";358;4357;314;4671;NA;350076;672;2020-12-09;30014
2020-12-08;"Prešovský kraj";350;6629;651;7280;NA;350076;1001;2020-12-08;29342
2020-12-07;"Prešovský kraj";309;4345;327;4672;NA;350076;636;2020-12-07;28341
2020-12-06;"Prešovský kraj";59;655;26;681;NA;350076;85;2020-12-06;27705
2020-12-05;"Prešovský kraj";218;984;87;1071;NA;350076;305;2020-12-05;27620
2020-12-04;"Prešovský kraj";352;5070;293;5363;NA;350076;645;2020-12-04;27315
2020-12-03;"Prešovský kraj";284;2456;179;2635;NA;350076;463;2020-12-03;26670
2020-12-02;"Prešovský kraj";232;2830;225;3055;NA;350076;457;2020-12-02;26207
2020-12-01;"Prešovský kraj";281;1884;196;2080;NA;350076;477;2020-12-01;25750
2020-11-30;"Prešovský kraj";196;5333;97;5430;NA;350076;293;2020-11-30;25273
2020-11-29;"Prešovský kraj";27;379;42;421;NA;350076;69;2020-11-29;24980
2020-11-28;"Prešovský kraj";199;772;77;849;NA;350076;276;2020-11-28;24911
2020-11-27;"Prešovský kraj";232;2350;130;2480;NA;350076;362;2020-11-27;24635
2020-11-26;"Prešovský kraj";263;3014;329;3343;NA;350076;592;2020-11-26;24273
2020-11-25;"Prešovský kraj";302;2174;103;2277;NA;350076;405;2020-11-25;23681
2020-11-24;"Prešovský kraj";365;1777;156;1933;NA;350076;521;2020-11-24;23276
2020-11-23;"Prešovský kraj";164;1099;60;1159;NA;350076;224;2020-11-23;22755
2020-11-22;"Prešovský kraj";46;44;1;45;NA;350076;47;2020-11-22;22531
2020-11-21;"Prešovský kraj";205;754;62;816;NA;350076;267;2020-11-21;22484
2020-11-20;"Prešovský kraj";363;2258;102;2360;NA;350076;465;2020-11-20;22217
2020-11-19;"Prešovský kraj";359;2096;238;2334;NA;350076;597;2020-11-19;21752
2020-11-18;"Prešovský kraj";270;488;43;531;NA;350076;313;2020-11-18;21155
2020-11-17;"Prešovský kraj";347;205;23;228;NA;350076;370;2020-11-17;20842
2020-11-16;"Prešovský kraj";226;540;58;598;NA;350076;284;2020-11-16;20472
2020-11-15;"Prešovský kraj";186;39;4;43;NA;350076;190;2020-11-15;20188
2020-11-14;"Prešovský kraj";261;54;4;58;NA;350076;265;2020-11-14;19998
2020-11-13;"Prešovský kraj";395;166;8;174;NA;350076;403;2020-11-13;19733
2020-11-12;"Prešovský kraj";397;229;50;279;NA;350076;447;2020-11-12;19330
2020-11-11;"Prešovský kraj";516;161;15;176;NA;350076;531;2020-11-11;18883
2020-11-10;"Prešovský kraj";437;197;9;206;NA;350076;446;2020-11-10;18352
2020-11-09;"Prešovský kraj";190;4110;945;5055;NA;350076;1135;2020-11-09;17906
2020-11-08;"Prešovský kraj";97;2817;32;2849;NA;350076;129;2020-11-08;16771
2020-11-07;"Prešovský kraj";416;8578;81;8659;NA;350076;497;2020-11-07;16642
2020-11-06;"Prešovský kraj";520;4791;76;4867;NA;350076;596;2020-11-06;16145
2020-11-05;"Prešovský kraj";397;180;5;185;NA;350076;402;2020-11-05;15549
2020-11-04;"Prešovský kraj";350;807;8;815;NA;350076;358;2020-11-04;15147
2020-11-03;"Prešovský kraj";565;98;12;110;NA;350076;577;2020-11-03;14789
2020-11-02;"Prešovský kraj";203;4158;1004;5162;NA;350076;1207;2020-11-02;14212
2020-11-01;"Prešovský kraj";386;2906;53;2959;NA;350076;439;2020-11-01;13005
2020-10-31;"Prešovský kraj";315;10497;170;10667;NA;350076;485;2020-10-31;12566
2020-10-30;"Prešovský kraj";552;2949;65;3014;NA;350076;617;2020-10-30;12081
2020-10-29;"Prešovský kraj";594;301;38;339;NA;350076;632;2020-10-29;11464
2020-10-28;"Prešovský kraj";617;291;46;337;NA;350076;663;2020-10-28;10832
2020-10-27;"Prešovský kraj";656;268;34;302;NA;350076;690;2020-10-27;10169
2020-10-26;"Prešovský kraj";137;363;57;420;NA;350076;194;2020-10-26;9479
2020-10-25;"Prešovský kraj";237;346;11;357;NA;350076;248;2020-10-25;9285
2020-10-24;"Prešovský kraj";719;200;12;212;NA;350076;731;2020-10-24;9037
2020-10-23;"Prešovský kraj";750;218;8;226;NA;350076;758;2020-10-23;8306
2020-10-22;"Prešovský kraj";646;396;30;426;NA;350076;676;2020-10-22;7548
2020-10-21;"Prešovský kraj";383;58;8;66;NA;350076;391;2020-10-21;6872
2020-10-20;"Prešovský kraj";493;65;7;72;NA;350076;500;2020-10-20;6481
2020-10-19;"Prešovský kraj";140;235;15;250;NA;350076;155;2020-10-19;5981
2020-10-18;"Prešovský kraj";209;0;0;0;NA;350076;209;2020-10-18;5826
2020-10-17;"Prešovský kraj";142;0;0;0;NA;350076;142;2020-10-17;5617
2022-03-27;"Trenčiansky kraj";167;287;46;333;202788;288961;213;2022-03-27;288961
2022-03-26;"Trenčiansky kraj";513;224;28;252;NA;288961;541;2022-03-26;288748
2022-03-25;"Trenčiansky kraj";534;641;72;713;NA;288961;606;2022-03-25;288207
2022-03-24;"Trenčiansky kraj";712;1112;104;1216;NA;288961;816;2022-03-24;287601
2022-03-23;"Trenčiansky kraj";903;895;93;988;NA;288961;996;2022-03-23;286785
2022-03-22;"Trenčiansky kraj";918;929;114;1043;NA;288961;1032;2022-03-22;285789
2022-03-21;"Trenčiansky kraj";745;1317;198;1515;NA;288961;943;2022-03-21;284757
2022-03-20;"Trenčiansky kraj";334;826;89;915;NA;288961;423;2022-03-20;283814
2022-03-19;"Trenčiansky kraj";560;510;77;587;NA;288961;637;2022-03-19;283391
2022-03-18;"Trenčiansky kraj";884;827;128;955;NA;288961;1012;2022-03-18;282754
2022-03-17;"Trenčiansky kraj";863;991;127;1118;NA;288961;990;2022-03-17;281742
2022-03-16;"Trenčiansky kraj";1147;1128;125;1253;NA;288961;1272;2022-03-16;280752
2022-03-15;"Trenčiansky kraj";1054;1155;122;1277;NA;288961;1176;2022-03-15;279480
2022-03-14;"Trenčiansky kraj";934;2078;253;2331;NA;288961;1187;2022-03-14;278304
2022-03-13;"Trenčiansky kraj";373;698;97;795;NA;288961;470;2022-03-13;277117
2022-03-12;"Trenčiansky kraj";674;550;94;644;NA;288961;768;2022-03-12;276647
2022-03-11;"Trenčiansky kraj";1131;1191;215;1406;NA;288961;1346;2022-03-11;275879
2022-03-10;"Trenčiansky kraj";1087;1178;220;1398;NA;288961;1307;2022-03-10;274533
2022-03-09;"Trenčiansky kraj";1515;1346;236;1582;NA;288961;1751;2022-03-09;273226
2022-03-08;"Trenčiansky kraj";1059;1589;247;1836;NA;288961;1306;2022-03-08;271475
2022-03-07;"Trenčiansky kraj";1079;1920;342;2262;NA;288961;1421;2022-03-07;270169
2022-03-06;"Trenčiansky kraj";354;832;134;966;NA;288961;488;2022-03-06;268748
2022-03-05;"Trenčiansky kraj";583;700;138;838;NA;288961;721;2022-03-05;268260
2022-03-04;"Trenčiansky kraj";1125;1158;204;1362;NA;288961;1329;2022-03-04;267539
2022-03-03;"Trenčiansky kraj";1346;1521;216;1737;NA;288961;1562;2022-03-03;266210
2022-03-02;"Trenčiansky kraj";1345;1548;239;1787;NA;288961;1584;2022-03-02;264648
2022-03-01;"Trenčiansky kraj";1409;1609;299;1908;NA;288961;1708;2022-03-01;263064
2022-02-28;"Trenčiansky kraj";1390;2383;363;2746;NA;288961;1753;2022-02-28;261356
2022-02-27;"Trenčiansky kraj";573;1043;218;1261;NA;288961;791;2022-02-27;259603
2022-02-26;"Trenčiansky kraj";934;784;147;931;NA;288961;1081;2022-02-26;258812
2022-02-25;"Trenčiansky kraj";1460;1422;271;1693;NA;288961;1731;2022-02-25;257731
2022-02-24;"Trenčiansky kraj";1372;2288;274;2562;NA;288961;1646;2022-02-24;256000
2022-02-23;"Trenčiansky kraj";1677;1895;291;2186;NA;288961;1968;2022-02-23;254354
2022-02-22;"Trenčiansky kraj";2073;2075;418;2493;NA;288961;2491;2022-02-22;252386
2022-02-21;"Trenčiansky kraj";2172;3615;547;4162;NA;288961;2719;2022-02-21;249895
2022-02-20;"Trenčiansky kraj";1079;1436;322;1758;NA;288961;1401;2022-02-20;247176
2022-02-19;"Trenčiansky kraj";1168;1008;244;1252;NA;288961;1412;2022-02-19;245775
2022-02-18;"Trenčiansky kraj";2456;2175;440;2615;NA;288961;2896;2022-02-18;244363
2022-02-17;"Trenčiansky kraj";2090;2540;388;2928;NA;288961;2478;2022-02-17;241467
2022-02-16;"Trenčiansky kraj";2928;2286;469;2755;NA;288961;3397;2022-02-16;238989
2022-02-15;"Trenčiansky kraj";2372;2408;534;2942;NA;288961;2906;2022-02-15;235592
2022-02-14;"Trenčiansky kraj";2401;3916;686;4602;NA;288961;3087;2022-02-14;232686
2022-02-13;"Trenčiansky kraj";1357;1777;454;2231;NA;288961;1811;2022-02-13;229599
2022-02-12;"Trenčiansky kraj";1802;1448;277;1725;NA;288961;2079;2022-02-12;227788
2022-02-11;"Trenčiansky kraj";2863;2376;456;2832;NA;288961;3319;2022-02-11;225709
2022-02-10;"Trenčiansky kraj";2853;2529;462;2991;NA;288961;3315;2022-02-10;222390
2022-02-09;"Trenčiansky kraj";2788;4158;559;4717;NA;288961;3347;2022-02-09;219075
2022-02-08;"Trenčiansky kraj";2592;2987;621;3608;NA;288961;3213;2022-02-08;215728
2022-02-07;"Trenčiansky kraj";2787;4732;862;5594;NA;288961;3649;2022-02-07;212515
2022-02-06;"Trenčiansky kraj";1431;2181;472;2653;NA;288961;1903;2022-02-06;208866
2022-02-05;"Trenčiansky kraj";1458;1689;323;2012;NA;288961;1781;2022-02-05;206963
2022-02-04;"Trenčiansky kraj";2480;3036;483;3519;NA;288961;2963;2022-02-04;205182
2022-02-03;"Trenčiansky kraj";2391;3381;462;3843;NA;288961;2853;2022-02-03;202219
2022-02-02;"Trenčiansky kraj";2486;4411;563;4974;NA;288961;3049;2022-02-02;199366
2022-02-01;"Trenčiansky kraj";2359;3701;509;4210;NA;288961;2868;2022-02-01;196317
2022-01-31;"Trenčiansky kraj";1823;7070;627;7697;NA;288961;2450;2022-01-31;193449
2022-01-30;"Trenčiansky kraj";680;2463;319;2782;NA;288961;999;2022-01-30;190999
2022-01-29;"Trenčiansky kraj";1227;1772;227;1999;NA;288961;1454;2022-01-29;190000
2022-01-28;"Trenčiansky kraj";1709;3602;322;3924;NA;288961;2031;2022-01-28;188546
2022-01-27;"Trenčiansky kraj";1533;3414;322;3736;NA;288961;1855;2022-01-27;186515
2022-01-26;"Trenčiansky kraj";1415;4533;311;4844;NA;288961;1726;2022-01-26;184660
2022-01-25;"Trenčiansky kraj";1553;3168;258;3426;NA;288961;1811;2022-01-25;182934
2022-01-24;"Trenčiansky kraj";755;6691;290;6981;NA;288961;1045;2022-01-24;181123
2022-01-23;"Trenčiansky kraj";337;2409;179;2588;NA;288961;516;2022-01-23;180078
2022-01-22;"Trenčiansky kraj";683;1675;103;1778;NA;288961;786;2022-01-22;179562
2022-01-21;"Trenčiansky kraj";576;3394;139;3533;NA;288961;715;2022-01-21;178776
2022-01-20;"Trenčiansky kraj";710;2578;104;2682;NA;288961;814;2022-01-20;178061
2022-01-19;"Trenčiansky kraj";621;3627;111;3738;NA;288961;732;2022-01-19;177247
2022-01-18;"Trenčiansky kraj";579;3455;101;3556;NA;288961;680;2022-01-18;176515
2022-01-17;"Trenčiansky kraj";380;6158;122;6280;NA;288961;502;2022-01-17;175835
2022-01-16;"Trenčiansky kraj";89;2319;72;2391;NA;288961;161;2022-01-16;175333
2022-01-15;"Trenčiansky kraj";194;1345;40;1385;NA;288961;234;2022-01-15;175172
2022-01-14;"Trenčiansky kraj";189;2755;48;2803;NA;288961;237;2022-01-14;174938
2022-01-13;"Trenčiansky kraj";134;3201;62;3263;NA;288961;196;2022-01-13;174701
2022-01-12;"Trenčiansky kraj";346;2953;53;3006;NA;288961;399;2022-01-12;174505
2022-01-11;"Trenčiansky kraj";300;2896;50;2946;NA;288961;350;2022-01-11;174106
2022-01-10;"Trenčiansky kraj";218;6882;81;6963;NA;288961;299;2022-01-10;173756
2022-01-09;"Trenčiansky kraj";40;2808;52;2860;NA;288961;92;2022-01-09;173457
2022-01-08;"Trenčiansky kraj";267;1601;45;1646;NA;288961;312;2022-01-08;173365
2022-01-07;"Trenčiansky kraj";334;2717;64;2781;NA;288961;398;2022-01-07;173053
2022-01-06;"Trenčiansky kraj";75;1111;45;1156;NA;288961;120;2022-01-06;172655
2022-01-05;"Trenčiansky kraj";496;2875;64;2939;NA;288961;560;2022-01-05;172535
2022-01-04;"Trenčiansky kraj";521;3760;73;3833;NA;288961;594;2022-01-04;171975
2022-01-03;"Trenčiansky kraj";357;5680;117;5797;NA;288961;474;2022-01-03;171381
2022-01-02;"Trenčiansky kraj";179;2403;74;2477;NA;288961;253;2022-01-02;170907
2022-01-01;"Trenčiansky kraj";4;526;28;554;NA;288961;32;2022-01-01;170654
2021-12-31;"Trenčiansky kraj";443;1426;77;1503;NA;288961;520;2021-12-31;170622
2021-12-30;"Trenčiansky kraj";370;2351;126;2477;NA;288961;496;2021-12-30;170102
2021-12-29;"Trenčiansky kraj";429;2436;83;2519;NA;288961;512;2021-12-29;169606
2021-12-28;"Trenčiansky kraj";609;2696;108;2804;NA;288961;717;2021-12-28;169094
2021-12-27;"Trenčiansky kraj";546;3200;100;3300;NA;288961;646;2021-12-27;168377
2021-12-26;"Trenčiansky kraj";147;1098;78;1176;NA;288961;225;2021-12-26;167731
2021-12-25;"Trenčiansky kraj";52;503;27;530;NA;288961;79;2021-12-25;167506
2021-12-24;"Trenčiansky kraj";176;652;37;689;NA;288961;213;2021-12-24;167427
2021-12-23;"Trenčiansky kraj";532;2380;103;2483;NA;288961;635;2021-12-23;167214
2021-12-22;"Trenčiansky kraj";512;2546;116;2662;NA;288961;628;2021-12-22;166579
2021-12-21;"Trenčiansky kraj";694;3219;119;3338;NA;288961;813;2021-12-21;165951
2021-12-20;"Trenčiansky kraj";488;6613;200;6813;NA;288961;688;2021-12-20;165138
2021-12-19;"Trenčiansky kraj";202;2574;118;2692;NA;288961;320;2021-12-19;164450
2021-12-18;"Trenčiansky kraj";438;1752;108;1860;NA;288961;546;2021-12-18;164130
2021-12-17;"Trenčiansky kraj";427;4006;135;4141;NA;288961;562;2021-12-17;163584
2021-12-16;"Trenčiansky kraj";649;3169;177;3346;NA;288961;826;2021-12-16;163022
2021-12-15;"Trenčiansky kraj";791;4596;165;4761;NA;288961;956;2021-12-15;162196
2021-12-14;"Trenčiansky kraj";885;3590;139;3729;NA;288961;1024;2021-12-14;161240
2021-12-13;"Trenčiansky kraj";573;7310;247;7557;NA;288961;820;2021-12-13;160216
2021-12-12;"Trenčiansky kraj";306;3156;156;3312;NA;288961;462;2021-12-12;159396
2021-12-11;"Trenčiansky kraj";706;1876;138;2014;NA;288961;844;2021-12-11;158934
2021-12-10;"Trenčiansky kraj";789;3643;199;3842;NA;288961;988;2021-12-10;158090
2021-12-09;"Trenčiansky kraj";967;3847;202;4049;NA;288961;1169;2021-12-09;157102
2021-12-08;"Trenčiansky kraj";1020;4428;201;4629;NA;288961;1221;2021-12-08;155933
2021-12-07;"Trenčiansky kraj";1241;6232;214;6446;NA;288961;1455;2021-12-07;154712
2021-12-06;"Trenčiansky kraj";751;8778;421;9199;NA;288961;1172;2021-12-06;153257
2021-12-05;"Trenčiansky kraj";510;3610;210;3820;NA;288961;720;2021-12-05;152085
2021-12-04;"Trenčiansky kraj";1058;2043;156;2199;NA;288961;1214;2021-12-04;151365
2021-12-03;"Trenčiansky kraj";1272;4379;304;4683;NA;288961;1576;2021-12-03;150151
2021-12-02;"Trenčiansky kraj";2007;4087;263;4350;NA;288961;2270;2021-12-02;148575
2021-12-01;"Trenčiansky kraj";1000;4935;296;5231;NA;288961;1296;2021-12-01;146305
2021-11-30;"Trenčiansky kraj";1086;4702;329;5031;NA;288961;1415;2021-11-30;145009
2021-11-29;"Trenčiansky kraj";1165;10325;540;10865;NA;288961;1705;2021-11-29;143594
2021-11-28;"Trenčiansky kraj";664;5566;308;5874;NA;288961;972;2021-11-28;141889
2021-11-27;"Trenčiansky kraj";1080;2782;301;3083;NA;288961;1381;2021-11-27;140917
2021-11-26;"Trenčiansky kraj";1238;4493;346;4839;NA;288961;1584;2021-11-26;139536
2021-11-25;"Trenčiansky kraj";1018;3590;343;3933;NA;288961;1361;2021-11-25;137952
2021-11-24;"Trenčiansky kraj";1362;5559;466;6025;NA;288961;1828;2021-11-24;136591
2021-11-23;"Trenčiansky kraj";1140;3717;347;4064;NA;288961;1487;2021-11-23;134763
2021-11-22;"Trenčiansky kraj";920;6467;566;7033;NA;288961;1486;2021-11-22;133276
2021-11-21;"Trenčiansky kraj";413;3233;377;3610;NA;288961;790;2021-11-21;131790
2021-11-20;"Trenčiansky kraj";914;2379;341;2720;NA;288961;1255;2021-11-20;131000
2021-11-19;"Trenčiansky kraj";1261;3785;445;4230;NA;288961;1706;2021-11-19;129745
2021-11-18;"Trenčiansky kraj";810;5024;524;5548;NA;288961;1334;2021-11-18;128039
2021-11-17;"Trenčiansky kraj";796;1852;237;2089;NA;288961;1033;2021-11-17;126705
2021-11-16;"Trenčiansky kraj";859;4060;401;4461;NA;288961;1260;2021-11-16;125672
2021-11-15;"Trenčiansky kraj";720;5114;550;5664;NA;288961;1270;2021-11-15;124412
2021-11-14;"Trenčiansky kraj";447;2462;343;2805;NA;288961;790;2021-11-14;123142
2021-11-13;"Trenčiansky kraj";478;1879;254;2133;NA;288961;732;2021-11-13;122352
2021-11-12;"Trenčiansky kraj";784;3855;338;4193;NA;288961;1122;2021-11-12;121620
2021-11-11;"Trenčiansky kraj";805;3561;345;3906;NA;288961;1150;2021-11-11;120498
2021-11-10;"Trenčiansky kraj";647;3358;279;3637;NA;288961;926;2021-11-10;119348
2021-11-09;"Trenčiansky kraj";752;2886;304;3190;NA;288961;1056;2021-11-09;118422
2021-11-08;"Trenčiansky kraj";489;4643;348;4991;NA;288961;837;2021-11-08;117366
2021-11-07;"Trenčiansky kraj";405;2043;220;2263;NA;288961;625;2021-11-07;116529
2021-11-06;"Trenčiansky kraj";542;1755;176;1931;NA;288961;718;2021-11-06;115904
2021-11-05;"Trenčiansky kraj";677;3083;238;3321;NA;288961;915;2021-11-05;115186
2021-11-04;"Trenčiansky kraj";563;2713;229;2942;NA;288961;792;2021-11-04;114271
2021-11-03;"Trenčiansky kraj";619;2955;222;3177;NA;288961;841;2021-11-03;113479
2021-11-02;"Trenčiansky kraj";663;3808;309;4117;NA;288961;972;2021-11-02;112638
2021-11-01;"Trenčiansky kraj";219;1029;101;1130;NA;288961;320;2021-11-01;111666
2021-10-31;"Trenčiansky kraj";151;1462;152;1614;NA;288961;303;2021-10-31;111346
2021-10-30;"Trenčiansky kraj";345;1770;130;1900;NA;288961;475;2021-10-30;111043
2021-10-29;"Trenčiansky kraj";415;2860;129;2989;NA;288961;544;2021-10-29;110568
2021-10-28;"Trenčiansky kraj";429;2653;157;2810;NA;288961;586;2021-10-28;110024
2021-10-27;"Trenčiansky kraj";463;2612;93;2705;NA;288961;556;2021-10-27;109438
2021-10-26;"Trenčiansky kraj";419;2635;133;2768;NA;288961;552;2021-10-26;108882
2021-10-25;"Trenčiansky kraj";192;3370;130;3500;NA;288961;322;2021-10-25;108330
2021-10-24;"Trenčiansky kraj";121;1643;79;1722;NA;288961;200;2021-10-24;108008
2021-10-23;"Trenčiansky kraj";326;1737;64;1801;NA;288961;390;2021-10-23;107808
2021-10-22;"Trenčiansky kraj";358;2694;78;2772;NA;288961;436;2021-10-22;107418
2021-10-21;"Trenčiansky kraj";247;2343;74;2417;NA;288961;321;2021-10-21;106982
2021-10-20;"Trenčiansky kraj";302;2101;70;2171;NA;288961;372;2021-10-20;106661
2021-10-19;"Trenčiansky kraj";227;2847;59;2906;NA;288961;286;2021-10-19;106289
2021-10-18;"Trenčiansky kraj";143;2453;71;2524;NA;288961;214;2021-10-18;106003
2021-10-17;"Trenčiansky kraj";46;1457;31;1488;NA;288961;77;2021-10-17;105789
2021-10-16;"Trenčiansky kraj";76;1671;35;1706;NA;288961;111;2021-10-16;105712
2021-10-15;"Trenčiansky kraj";126;2925;50;2975;NA;288961;176;2021-10-15;105601
2021-10-14;"Trenčiansky kraj";103;1717;27;1744;NA;288961;130;2021-10-14;105425
2021-10-13;"Trenčiansky kraj";171;2656;28;2684;NA;288961;199;2021-10-13;105295
2021-10-12;"Trenčiansky kraj";114;2350;32;2382;NA;288961;146;2021-10-12;105096
2021-10-11;"Trenčiansky kraj";109;2541;48;2589;NA;288961;157;2021-10-11;104950
2021-10-10;"Trenčiansky kraj";17;1487;23;1510;NA;288961;40;2021-10-10;104793
2021-10-09;"Trenčiansky kraj";157;1809;16;1825;NA;288961;173;2021-10-09;104753
2021-10-08;"Trenčiansky kraj";82;3087;37;3124;NA;288961;119;2021-10-08;104580
2021-10-07;"Trenčiansky kraj";107;2039;30;2069;NA;288961;137;2021-10-07;104461
2021-10-06;"Trenčiansky kraj";193;2289;36;2325;NA;288961;229;2021-10-06;104324
2021-10-05;"Trenčiansky kraj";119;2229;40;2269;NA;288961;159;2021-10-05;104095
2021-10-04;"Trenčiansky kraj";105;2769;52;2821;NA;288961;157;2021-10-04;103936
2021-10-03;"Trenčiansky kraj";30;1558;27;1585;NA;288961;57;2021-10-03;103779
2021-10-02;"Trenčiansky kraj";107;1794;35;1829;NA;288961;142;2021-10-02;103722
2021-10-01;"Trenčiansky kraj";119;2690;37;2727;NA;288961;156;2021-10-01;103580
2021-09-30;"Trenčiansky kraj";74;2327;50;2377;NA;288961;124;2021-09-30;103424
2021-09-29;"Trenčiansky kraj";170;2150;30;2180;NA;288961;200;2021-09-29;103300
2021-09-28;"Trenčiansky kraj";95;2267;31;2298;NA;288961;126;2021-09-28;103100
2021-09-27;"Trenčiansky kraj";56;2813;57;2870;NA;288961;113;2021-09-27;102974
2021-09-26;"Trenčiansky kraj";20;1675;33;1708;NA;288961;53;2021-09-26;102861
2021-09-25;"Trenčiansky kraj";76;1674;21;1695;NA;288961;97;2021-09-25;102808
2021-09-24;"Trenčiansky kraj";104;3220;35;3255;NA;288961;139;2021-09-24;102711
2021-09-23;"Trenčiansky kraj";91;2251;27;2278;NA;288961;118;2021-09-23;102572
2021-09-22;"Trenčiansky kraj";90;2146;24;2170;NA;288961;114;2021-09-22;102454
2021-09-21;"Trenčiansky kraj";79;2307;29;2336;NA;288961;108;2021-09-21;102340
2021-09-20;"Trenčiansky kraj";78;2612;37;2649;NA;288961;115;2021-09-20;102232
2021-09-19;"Trenčiansky kraj";11;1571;20;1591;NA;288961;31;2021-09-19;102117
2021-09-18;"Trenčiansky kraj";53;2099;14;2113;NA;288961;67;2021-09-18;102086
2021-09-17;"Trenčiansky kraj";55;3143;26;3169;NA;288961;81;2021-09-17;102019
2021-09-16;"Trenčiansky kraj";52;2160;20;2180;NA;288961;72;2021-09-16;101938
2021-09-15;"Trenčiansky kraj";63;1043;7;1050;NA;288961;70;2021-09-15;101866
2021-09-14;"Trenčiansky kraj";67;2449;25;2474;NA;288961;92;2021-09-14;101796
2021-09-13;"Trenčiansky kraj";33;2271;35;2306;NA;288961;68;2021-09-13;101704
2021-09-12;"Trenčiansky kraj";3;1411;11;1422;NA;288961;14;2021-09-12;101636
2021-09-11;"Trenčiansky kraj";55;1729;6;1735;NA;288961;61;2021-09-11;101622
2021-09-10;"Trenčiansky kraj";49;2246;15;2261;NA;288961;64;2021-09-10;101561
2021-09-09;"Trenčiansky kraj";24;1684;30;1714;NA;288961;54;2021-09-09;101497
2021-09-08;"Trenčiansky kraj";54;1770;15;1785;NA;288961;69;2021-09-08;101443
2021-09-07;"Trenčiansky kraj";43;1393;18;1411;NA;288961;61;2021-09-07;101374
2021-09-06;"Trenčiansky kraj";47;1398;15;1413;NA;288961;62;2021-09-06;101313
2021-09-05;"Trenčiansky kraj";2;966;23;989;NA;288961;25;2021-09-05;101251
2021-09-04;"Trenčiansky kraj";41;925;4;929;NA;288961;45;2021-09-04;101226
2021-09-03;"Trenčiansky kraj";53;1421;15;1436;NA;288961;68;2021-09-03;101181
2021-09-02;"Trenčiansky kraj";7;999;14;1013;NA;288961;21;2021-09-02;101113
2021-09-01;"Trenčiansky kraj";27;431;8;439;NA;288961;35;2021-09-01;101092
2021-08-31;"Trenčiansky kraj";21;1146;15;1161;NA;288961;36;2021-08-31;101057
2021-08-30;"Trenčiansky kraj";32;1166;10;1176;NA;288961;42;2021-08-30;101021
2021-08-29;"Trenčiansky kraj";1;482;11;493;NA;288961;12;2021-08-29;100979
2021-08-28;"Trenčiansky kraj";9;976;10;986;NA;288961;19;2021-08-28;100967
2021-08-27;"Trenčiansky kraj";21;1599;1;1600;NA;288961;22;2021-08-27;100948
2021-08-26;"Trenčiansky kraj";8;992;6;998;NA;288961;14;2021-08-26;100926
2021-08-25;"Trenčiansky kraj";40;875;7;882;NA;288961;47;2021-08-25;100912
2021-08-24;"Trenčiansky kraj";4;822;4;826;NA;288961;8;2021-08-24;100865
2021-08-23;"Trenčiansky kraj";6;1165;17;1182;NA;288961;23;2021-08-23;100857
2021-08-22;"Trenčiansky kraj";0;726;10;736;NA;288961;10;2021-08-22;100834
2021-08-21;"Trenčiansky kraj";5;964;7;971;NA;288961;12;2021-08-21;100824
2021-08-20;"Trenčiansky kraj";15;1537;2;1539;NA;288961;17;2021-08-20;100812
2021-08-19;"Trenčiansky kraj";2;985;2;987;NA;288961;4;2021-08-19;100795
2021-08-18;"Trenčiansky kraj";6;814;7;821;NA;288961;13;2021-08-18;100791
2021-08-17;"Trenčiansky kraj";9;633;1;634;NA;288961;10;2021-08-17;100778
2021-08-16;"Trenčiansky kraj";5;925;3;928;NA;288961;8;2021-08-16;100768
2021-08-15;"Trenčiansky kraj";0;558;1;559;NA;288961;1;2021-08-15;100760
2021-08-14;"Trenčiansky kraj";12;574;6;580;NA;288961;18;2021-08-14;100759
2021-08-13;"Trenčiansky kraj";2;933;0;933;NA;288961;2;2021-08-13;100741
2021-08-12;"Trenčiansky kraj";2;564;3;567;NA;288961;5;2021-08-12;100739
2021-08-11;"Trenčiansky kraj";1;680;0;680;NA;288961;1;2021-08-11;100734
2021-08-10;"Trenčiansky kraj";8;530;1;531;NA;288961;9;2021-08-10;100733
2021-08-09;"Trenčiansky kraj";8;694;1;695;NA;288961;9;2021-08-09;100724
2021-08-08;"Trenčiansky kraj";0;468;0;468;NA;288961;0;2021-08-08;100715
2021-08-07;"Trenčiansky kraj";3;464;0;464;NA;288961;3;2021-08-07;100715
2021-08-06;"Trenčiansky kraj";3;955;1;956;NA;288961;4;2021-08-06;100712
2021-08-05;"Trenčiansky kraj";3;579;1;580;NA;288961;4;2021-08-05;100708
2021-08-04;"Trenčiansky kraj";14;546;3;549;NA;288961;17;2021-08-04;100704
2021-08-03;"Trenčiansky kraj";9;508;5;513;NA;288961;14;2021-08-03;100687
2021-08-02;"Trenčiansky kraj";1;807;2;809;NA;288961;3;2021-08-02;100673
2021-08-01;"Trenčiansky kraj";0;458;1;459;NA;288961;1;2021-08-01;100670
2021-07-31;"Trenčiansky kraj";4;525;2;527;NA;288961;6;2021-07-31;100669
2021-07-30;"Trenčiansky kraj";2;1069;0;1069;NA;288961;2;2021-07-30;100663
2021-07-29;"Trenčiansky kraj";5;708;0;708;NA;288961;5;2021-07-29;100661
2021-07-28;"Trenčiansky kraj";3;517;2;519;NA;288961;5;2021-07-28;100656
2021-07-27;"Trenčiansky kraj";6;551;1;552;NA;288961;7;2021-07-27;100651
2021-07-26;"Trenčiansky kraj";7;772;1;773;NA;288961;8;2021-07-26;100644
2021-07-25;"Trenčiansky kraj";0;487;2;489;NA;288961;2;2021-07-25;100636
2021-07-24;"Trenčiansky kraj";3;643;1;644;NA;288961;4;2021-07-24;100634
2021-07-23;"Trenčiansky kraj";3;1151;0;1151;NA;288961;3;2021-07-23;100630
2021-07-22;"Trenčiansky kraj";2;844;2;846;NA;288961;4;2021-07-22;100627
2021-07-21;"Trenčiansky kraj";8;661;2;663;NA;288961;10;2021-07-21;100623
2021-07-20;"Trenčiansky kraj";4;525;1;526;NA;288961;5;2021-07-20;100613
2021-07-19;"Trenčiansky kraj";0;866;4;870;NA;288961;4;2021-07-19;100608
2021-07-18;"Trenčiansky kraj";0;526;0;526;NA;288961;0;2021-07-18;100604
2021-07-17;"Trenčiansky kraj";3;673;0;673;NA;288961;3;2021-07-17;100604
2021-07-16;"Trenčiansky kraj";4;1122;0;1122;NA;288961;4;2021-07-16;100601
2021-07-15;"Trenčiansky kraj";2;824;0;824;NA;288961;2;2021-07-15;100597
2021-07-14;"Trenčiansky kraj";8;645;0;645;NA;288961;8;2021-07-14;100595
2021-07-13;"Trenčiansky kraj";1;520;3;523;NA;288961;4;2021-07-13;100587
2021-07-12;"Trenčiansky kraj";9;820;2;822;NA;288961;11;2021-07-12;100583
2021-07-11;"Trenčiansky kraj";0;611;2;613;NA;288961;2;2021-07-11;100572
2021-07-10;"Trenčiansky kraj";2;535;0;535;NA;288961;2;2021-07-10;100570
2021-07-09;"Trenčiansky kraj";7;1379;0;1379;NA;288961;7;2021-07-09;100568
2021-07-08;"Trenčiansky kraj";2;815;1;816;NA;288961;3;2021-07-08;100561
2021-07-07;"Trenčiansky kraj";2;928;0;928;NA;288961;2;2021-07-07;100558
2021-07-06;"Trenčiansky kraj";4;1041;1;1042;NA;288961;5;2021-07-06;100556
2021-07-05;"Trenčiansky kraj";1;508;0;508;NA;288961;1;2021-07-05;100551
2021-07-04;"Trenčiansky kraj";0;612;1;613;NA;288961;1;2021-07-04;100550
2021-07-03;"Trenčiansky kraj";3;815;1;816;NA;288961;4;2021-07-03;100549
2021-07-02;"Trenčiansky kraj";5;1583;2;1585;NA;288961;7;2021-07-02;100545
2021-07-01;"Trenčiansky kraj";4;1152;1;1153;NA;288961;5;2021-07-01;100538
2021-06-30;"Trenčiansky kraj";2;7021;6;7027;NA;288961;8;2021-06-30;100533
2021-06-29;"Trenčiansky kraj";4;2773;5;2778;NA;288961;9;2021-06-29;100525
2021-06-28;"Trenčiansky kraj";5;3644;4;3648;NA;288961;9;2021-06-28;100516
2021-06-27;"Trenčiansky kraj";0;2861;1;2862;NA;288961;1;2021-06-27;100507
2021-06-26;"Trenčiansky kraj";1;3547;4;3551;NA;288961;5;2021-06-26;100506
2021-06-25;"Trenčiansky kraj";2;4626;1;4627;NA;288961;3;2021-06-25;100501
2021-06-24;"Trenčiansky kraj";3;3320;4;3324;NA;288961;7;2021-06-24;100498
2021-06-23;"Trenčiansky kraj";4;2808;2;2810;NA;288961;6;2021-06-23;100491
2021-06-22;"Trenčiansky kraj";7;3137;4;3141;NA;288961;11;2021-06-22;100485
2021-06-21;"Trenčiansky kraj";10;3891;4;3895;NA;288961;14;2021-06-21;100474
2021-06-20;"Trenčiansky kraj";0;3579;5;3584;NA;288961;5;2021-06-20;100460
2021-06-19;"Trenčiansky kraj";5;4528;1;4529;NA;288961;6;2021-06-19;100455
2021-06-18;"Trenčiansky kraj";7;6725;7;6732;NA;288961;14;2021-06-18;100449
2021-06-17;"Trenčiansky kraj";0;3469;6;3475;NA;288961;6;2021-06-17;100435
2021-06-16;"Trenčiansky kraj";4;3183;3;3186;NA;288961;7;2021-06-16;100429
2021-06-15;"Trenčiansky kraj";10;3697;2;3699;NA;288961;12;2021-06-15;100422
2021-06-14;"Trenčiansky kraj";10;4805;15;4820;NA;288961;25;2021-06-14;100410
2021-06-13;"Trenčiansky kraj";0;4643;4;4647;NA;288961;4;2021-06-13;100385
2021-06-12;"Trenčiansky kraj";4;5260;8;5268;NA;288961;12;2021-06-12;100381
2021-06-11;"Trenčiansky kraj";10;7365;11;7376;NA;288961;21;2021-06-11;100369
2021-06-10;"Trenčiansky kraj";5;4345;7;4352;NA;288961;12;2021-06-10;100348
2021-06-09;"Trenčiansky kraj";7;3693;7;3700;NA;288961;14;2021-06-09;100336
2021-06-08;"Trenčiansky kraj";21;3965;7;3972;NA;288961;28;2021-06-08;100322
2021-06-07;"Trenčiansky kraj";13;5560;10;5570;NA;288961;23;2021-06-07;100294
2021-06-06;"Trenčiansky kraj";0;5500;10;5510;NA;288961;10;2021-06-06;100271
2021-06-05;"Trenčiansky kraj";7;6511;5;6516;NA;288961;12;2021-06-05;100261
2021-06-04;"Trenčiansky kraj";16;7653;3;7656;NA;288961;19;2021-06-04;100249
2021-06-03;"Trenčiansky kraj";9;4485;10;4495;NA;288961;19;2021-06-03;100230
2021-06-02;"Trenčiansky kraj";28;4329;8;4337;NA;288961;36;2021-06-02;100211
2021-06-01;"Trenčiansky kraj";22;5396;18;5414;NA;288961;40;2021-06-01;100175
2021-05-31;"Trenčiansky kraj";30;6117;24;6141;NA;288961;54;2021-05-31;100135
2021-05-30;"Trenčiansky kraj";0;8258;16;8274;NA;288961;16;2021-05-30;100081
2021-05-29;"Trenčiansky kraj";13;7915;14;7929;NA;288961;27;2021-05-29;100065
2021-05-28;"Trenčiansky kraj";22;8995;25;9020;NA;288961;47;2021-05-28;100038
2021-05-27;"Trenčiansky kraj";6;5205;12;5217;NA;288961;18;2021-05-27;99991
2021-05-26;"Trenčiansky kraj";26;5069;15;5084;NA;288961;41;2021-05-26;99973
2021-05-25;"Trenčiansky kraj";18;6168;24;6192;NA;288961;42;2021-05-25;99932
2021-05-24;"Trenčiansky kraj";19;9292;37;9329;NA;288961;56;2021-05-24;99890
2021-05-23;"Trenčiansky kraj";0;9083;26;9109;NA;288961;26;2021-05-23;99834
2021-05-22;"Trenčiansky kraj";11;11314;21;11335;NA;288961;32;2021-05-22;99808
2021-05-21;"Trenčiansky kraj";23;11572;26;11598;NA;288961;49;2021-05-21;99776
2021-05-20;"Trenčiansky kraj";23;6320;25;6345;NA;288961;48;2021-05-20;99727
2021-05-19;"Trenčiansky kraj";16;5694;32;5726;NA;288961;48;2021-05-19;99679
2021-05-18;"Trenčiansky kraj";26;7779;28;7807;NA;288961;54;2021-05-18;99631
2021-05-17;"Trenčiansky kraj";37;7671;43;7714;NA;288961;80;2021-05-17;99577
2021-05-16;"Trenčiansky kraj";25;15615;41;15656;NA;288961;66;2021-05-16;99497
2021-05-15;"Trenčiansky kraj";3;21237;32;21269;NA;288961;35;2021-05-15;99431
2021-05-14;"Trenčiansky kraj";41;18676;42;18718;NA;288961;83;2021-05-14;99396
2021-05-13;"Trenčiansky kraj";41;8195;24;8219;NA;288961;65;2021-05-13;99313
2021-05-12;"Trenčiansky kraj";41;7409;31;7440;NA;288961;72;2021-05-12;99248
2021-05-11;"Trenčiansky kraj";66;10507;32;10539;NA;288961;98;2021-05-11;99176
2021-05-10;"Trenčiansky kraj";48;12989;55;13044;NA;288961;103;2021-05-10;99078
2021-05-09;"Trenčiansky kraj";52;17737;39;17776;NA;288961;91;2021-05-09;98975
2021-05-08;"Trenčiansky kraj";3;23822;33;23855;NA;288961;36;2021-05-08;98884
2021-05-07;"Trenčiansky kraj";45;23549;56;23605;NA;288961;101;2021-05-07;98848
2021-05-06;"Trenčiansky kraj";26;10771;44;10815;NA;288961;70;2021-05-06;98747
2021-05-05;"Trenčiansky kraj";73;9377;41;9418;NA;288961;114;2021-05-05;98677
2021-05-04;"Trenčiansky kraj";55;12733;53;12786;NA;288961;108;2021-05-04;98563
2021-05-03;"Trenčiansky kraj";60;15331;51;15382;NA;288961;111;2021-05-03;98455
2021-05-02;"Trenčiansky kraj";0;31152;65;31217;NA;288961;65;2021-05-02;98344
2021-05-01;"Trenčiansky kraj";71;56982;60;57042;NA;288961;131;2021-05-01;98279
2021-04-30;"Trenčiansky kraj";77;29427;61;29488;NA;288961;138;2021-04-30;98148
2021-04-29;"Trenčiansky kraj";49;13184;59;13243;NA;288961;108;2021-04-29;98010
2021-04-28;"Trenčiansky kraj";79;12537;52;12589;NA;288961;131;2021-04-28;97902
2021-04-27;"Trenčiansky kraj";107;15527;40;15567;NA;288961;147;2021-04-27;97771
2021-04-26;"Trenčiansky kraj";52;21070;63;21133;NA;288961;115;2021-04-26;97624
2021-04-25;"Trenčiansky kraj";0;34560;48;34608;NA;288961;48;2021-04-25;97509
2021-04-24;"Trenčiansky kraj";76;72398;100;72498;NA;288961;176;2021-04-24;97461
2021-04-23;"Trenčiansky kraj";143;29959;79;30038;NA;288961;222;2021-04-23;97285
2021-04-22;"Trenčiansky kraj";71;13847;64;13911;NA;288961;135;2021-04-22;97063
2021-04-21;"Trenčiansky kraj";79;13000;67;13067;NA;288961;146;2021-04-21;96928
2021-04-20;"Trenčiansky kraj";142;17740;80;17820;NA;288961;222;2021-04-20;96782
2021-04-19;"Trenčiansky kraj";102;22631;103;22734;NA;288961;205;2021-04-19;96560
2021-04-18;"Trenčiansky kraj";3;40879;97;40976;NA;288961;100;2021-04-18;96355
2021-04-17;"Trenčiansky kraj";77;81498;136;81634;NA;288961;213;2021-04-17;96255
2021-04-16;"Trenčiansky kraj";100;31961;90;32051;NA;288961;190;2021-04-16;96042
2021-04-15;"Trenčiansky kraj";71;14479;69;14548;NA;288961;140;2021-04-15;95852
2021-04-14;"Trenčiansky kraj";135;15563;72;15635;NA;288961;207;2021-04-14;95712
2021-04-13;"Trenčiansky kraj";189;18721;75;18796;NA;288961;264;2021-04-13;95505
2021-04-12;"Trenčiansky kraj";97;23743;91;23834;NA;288961;188;2021-04-12;95241
2021-04-11;"Trenčiansky kraj";1;34735;75;34810;NA;288961;76;2021-04-11;95053
2021-04-10;"Trenčiansky kraj";81;83093;145;83238;NA;288961;226;2021-04-10;94977
2021-04-09;"Trenčiansky kraj";120;28014;91;28105;NA;288961;211;2021-04-09;94751
2021-04-08;"Trenčiansky kraj";112;13283;85;13368;NA;288961;197;2021-04-08;94540
2021-04-07;"Trenčiansky kraj";204;17688;123;17811;NA;288961;327;2021-04-07;94343
2021-04-06;"Trenčiansky kraj";157;28567;178;28745;NA;288961;335;2021-04-06;94016
2021-04-05;"Trenčiansky kraj";15;9227;64;9291;NA;288961;79;2021-04-05;93681
2021-04-04;"Trenčiansky kraj";2;20291;85;20376;NA;288961;87;2021-04-04;93602
2021-04-03;"Trenčiansky kraj";86;80473;221;80694;NA;288961;307;2021-04-03;93515
2021-04-02;"Trenčiansky kraj";126;21620;81;21701;NA;288961;207;2021-04-02;93208
2021-04-01;"Trenčiansky kraj";159;32376;139;32515;NA;288961;298;2021-04-01;93001
2021-03-31;"Trenčiansky kraj";198;20100;130;20230;NA;288961;328;2021-03-31;92703
2021-03-30;"Trenčiansky kraj";272;17305;136;17441;NA;288961;408;2021-03-30;92375
2021-03-29;"Trenčiansky kraj";142;19479;170;19649;NA;288961;312;2021-03-29;91967
2021-03-28;"Trenčiansky kraj";3;34759;116;34875;NA;288961;119;2021-03-28;91655
2021-03-27;"Trenčiansky kraj";130;77314;293;77607;NA;288961;423;2021-03-27;91536
2021-03-26;"Trenčiansky kraj";211;35095;157;35252;NA;288961;368;2021-03-26;91113
2021-03-25;"Trenčiansky kraj";184;16580;176;16756;NA;288961;360;2021-03-25;90745
2021-03-24;"Trenčiansky kraj";259;13102;171;13273;NA;288961;430;2021-03-24;90385
2021-03-23;"Trenčiansky kraj";349;17589;174;17763;NA;288961;523;2021-03-23;89955
2021-03-22;"Trenčiansky kraj";141;21116;213;21329;NA;288961;354;2021-03-22;89432
2021-03-21;"Trenčiansky kraj";85;32711;164;32875;NA;288961;249;2021-03-21;89078
2021-03-20;"Trenčiansky kraj";128;80035;322;80357;NA;288961;450;2021-03-20;88829
2021-03-19;"Trenčiansky kraj";231;34783;232;35015;NA;288961;463;2021-03-19;88379
2021-03-18;"Trenčiansky kraj";262;16105;178;16283;NA;288961;440;2021-03-18;87916
2021-03-17;"Trenčiansky kraj";366;13435;164;13599;NA;288961;530;2021-03-17;87476
2021-03-16;"Trenčiansky kraj";450;15282;241;15523;NA;288961;691;2021-03-16;86946
2021-03-15;"Trenčiansky kraj";162;21235;261;21496;NA;288961;423;2021-03-15;86255
2021-03-14;"Trenčiansky kraj";42;34416;238;34654;NA;288961;280;2021-03-14;85832
2021-03-13;"Trenčiansky kraj";270;79186;453;79639;NA;288961;723;2021-03-13;85552
2021-03-12;"Trenčiansky kraj";366;34795;307;35102;NA;288961;673;2021-03-12;84829
2021-03-11;"Trenčiansky kraj";302;15558;213;15771;NA;288961;515;2021-03-11;84156
2021-03-10;"Trenčiansky kraj";402;13585;237;13822;NA;288961;639;2021-03-10;83641
2021-03-09;"Trenčiansky kraj";586;17982;285;18267;NA;288961;871;2021-03-09;83002
2021-03-08;"Trenčiansky kraj";174;21704;363;22067;NA;288961;537;2021-03-08;82131
2021-03-07;"Trenčiansky kraj";4;33660;313;33973;NA;288961;317;2021-03-07;81594
2021-03-06;"Trenčiansky kraj";260;79661;529;80190;NA;288961;789;2021-03-06;81277
2021-03-05;"Trenčiansky kraj";326;32969;415;33384;NA;288961;741;2021-03-05;80488
2021-03-04;"Trenčiansky kraj";323;16821;317;17138;NA;288961;640;2021-03-04;79747
2021-03-03;"Trenčiansky kraj";413;13960;347;14307;NA;288961;760;2021-03-03;79107
2021-03-02;"Trenčiansky kraj";612;17794;344;18138;NA;288961;956;2021-03-02;78347
2021-03-01;"Trenčiansky kraj";217;21104;445;21549;NA;288961;662;2021-03-01;77391
2021-02-28;"Trenčiansky kraj";45;30238;376;30614;NA;288961;421;2021-02-28;76729
2021-02-27;"Trenčiansky kraj";277;78735;686;79421;NA;288961;963;2021-02-27;76308
2021-02-26;"Trenčiansky kraj";420;32940;434;33374;NA;288961;854;2021-02-26;75345
2021-02-25;"Trenčiansky kraj";424;14029;328;14357;NA;288961;752;2021-02-25;74491
2021-02-24;"Trenčiansky kraj";427;12014;399;12413;NA;288961;826;2021-02-24;73739
2021-02-23;"Trenčiansky kraj";577;14904;390;15294;NA;288961;967;2021-02-23;72913
2021-02-22;"Trenčiansky kraj";160;19969;468;20437;NA;288961;628;2021-02-22;71946
2021-02-21;"Trenčiansky kraj";64;29478;392;29870;NA;288961;456;2021-02-21;71318
2021-02-20;"Trenčiansky kraj";274;77840;745;78585;NA;288961;1019;2021-02-20;70862
2021-02-19;"Trenčiansky kraj";272;30260;523;30783;NA;288961;795;2021-02-19;69843
2021-02-18;"Trenčiansky kraj";355;14094;403;14497;NA;288961;758;2021-02-18;69048
2021-02-17;"Trenčiansky kraj";363;11412;376;11788;NA;288961;739;2021-02-17;68290
2021-02-16;"Trenčiansky kraj";488;17761;406;18167;NA;288961;894;2021-02-16;67551
2021-02-15;"Trenčiansky kraj";151;21846;463;22309;NA;288961;614;2021-02-15;66657
2021-02-14;"Trenčiansky kraj";2;31255;324;31579;NA;288961;326;2021-02-14;66043
2021-02-13;"Trenčiansky kraj";274;63006;522;63528;NA;288961;796;2021-02-13;65717
2021-02-12;"Trenčiansky kraj";276;27979;412;28391;NA;288961;688;2021-02-12;64921
2021-02-11;"Trenčiansky kraj";291;11567;323;11890;NA;288961;614;2021-02-11;64233
2021-02-10;"Trenčiansky kraj";304;11408;317;11725;NA;288961;621;2021-02-10;63619
2021-02-09;"Trenčiansky kraj";514;18412;360;18772;NA;288961;874;2021-02-09;62998
2021-02-08;"Trenčiansky kraj";182;26832;430;27262;NA;288961;612;2021-02-08;62124
2021-02-07;"Trenčiansky kraj";31;36781;341;37122;NA;288961;372;2021-02-07;61512
2021-02-06;"Trenčiansky kraj";216;63931;560;64491;NA;288961;776;2021-02-06;61140
2021-02-05;"Trenčiansky kraj";202;18164;367;18531;NA;288961;569;2021-02-05;60364
2021-02-04;"Trenčiansky kraj";266;7253;311;7564;NA;288961;577;2021-02-04;59795
2021-02-03;"Trenčiansky kraj";162;6723;320;7043;NA;288961;482;2021-02-03;59218
2021-02-02;"Trenčiansky kraj";347;8074;381;8455;NA;288961;728;2021-02-02;58736
2021-02-01;"Trenčiansky kraj";167;8921;311;9232;NA;288961;478;2021-02-01;58008
2021-01-31;"Trenčiansky kraj";7;19103;159;19262;NA;288961;166;2021-01-31;57530
2021-01-30;"Trenčiansky kraj";228;38167;332;38499;NA;288961;560;2021-01-30;57364
2021-01-29;"Trenčiansky kraj";214;7590;235;7825;NA;288961;449;2021-01-29;56804
2021-01-28;"Trenčiansky kraj";307;5442;158;5600;NA;288961;465;2021-01-28;56355
2021-01-27;"Trenčiansky kraj";166;4842;181;5023;NA;288961;347;2021-01-27;55890
2021-01-26;"Trenčiansky kraj";303;14589;250;14839;NA;288961;553;2021-01-26;55543
2021-01-25;"Trenčiansky kraj";160;24310;207;24517;NA;288961;367;2021-01-25;54990
2021-01-24;"Trenčiansky kraj";51;38369;282;38651;NA;288961;333;2021-01-24;54623
2021-01-23;"Trenčiansky kraj";206;114125;749;114874;NA;288961;955;2021-01-23;54290
2021-01-22;"Trenčiansky kraj";148;21831;241;22072;NA;288961;389;2021-01-22;53335
2021-01-21;"Trenčiansky kraj";143;8586;166;8752;NA;288961;309;2021-01-21;52946
2021-01-20;"Trenčiansky kraj";181;8189;227;8416;NA;288961;408;2021-01-20;52637
2021-01-19;"Trenčiansky kraj";363;6600;262;6862;NA;288961;625;2021-01-19;52229
2021-01-18;"Trenčiansky kraj";72;4970;321;5291;NA;288961;393;2021-01-18;51604
2021-01-17;"Trenčiansky kraj";124;156;11;167;NA;288961;135;2021-01-17;51211
2021-01-16;"Trenčiansky kraj";39;1288;53;1341;NA;288961;92;2021-01-16;51076
2021-01-15;"Trenčiansky kraj";264;4031;214;4245;NA;288961;478;2021-01-15;50984
2021-01-14;"Trenčiansky kraj";275;3193;189;3382;NA;288961;464;2021-01-14;50506
2021-01-13;"Trenčiansky kraj";222;3893;215;4108;NA;288961;437;2021-01-13;50042
2021-01-12;"Trenčiansky kraj";508;4604;261;4865;NA;288961;769;2021-01-12;49605
2021-01-11;"Trenčiansky kraj";142;4367;354;4721;NA;288961;496;2021-01-11;48836
2021-01-10;"Trenčiansky kraj";89;4969;77;5046;NA;288961;166;2021-01-10;48340
2021-01-09;"Trenčiansky kraj";276;8280;128;8408;NA;288961;404;2021-01-09;48174
2021-01-08;"Trenčiansky kraj";489;6435;484;6919;NA;288961;973;2021-01-08;47770
2021-01-07;"Trenčiansky kraj";420;6138;577;6715;NA;288961;997;2021-01-07;46797
2021-01-06;"Trenčiansky kraj";221;1021;64;1085;NA;288961;285;2021-01-06;45800
2021-01-05;"Trenčiansky kraj";669;5753;706;6459;NA;288961;1375;2021-01-05;45515
2021-01-04;"Trenčiansky kraj";337;5248;782;6030;NA;288961;1119;2021-01-04;44140
2021-01-03;"Trenčiansky kraj";38;114;15;129;NA;288961;53;2021-01-03;43021
2021-01-02;"Trenčiansky kraj";129;196;23;219;NA;288961;152;2021-01-02;42968
2021-01-01;"Trenčiansky kraj";329;347;23;370;NA;288961;352;2021-01-01;42816
2020-12-31;"Trenčiansky kraj";597;4943;557;5500;NA;288961;1154;2020-12-31;42464
2020-12-30;"Trenčiansky kraj";836;7012;762;7774;NA;288961;1598;2020-12-30;41310
2020-12-29;"Trenčiansky kraj";459;6121;1009;7130;NA;288961;1468;2020-12-29;39712
2020-12-28;"Trenčiansky kraj";258;4195;777;4972;NA;288961;1035;2020-12-28;38244
2020-12-27;"Trenčiansky kraj";5;208;36;244;NA;288961;41;2020-12-27;37209
2020-12-26;"Trenčiansky kraj";174;74;10;84;NA;288961;184;2020-12-26;37168
2020-12-25;"Trenčiansky kraj";251;325;47;372;NA;288961;298;2020-12-25;36984
2020-12-24;"Trenčiansky kraj";552;2194;256;2450;NA;288961;808;2020-12-24;36686
2020-12-23;"Trenčiansky kraj";421;6552;661;7213;NA;288961;1082;2020-12-23;35878
2020-12-22;"Trenčiansky kraj";673;5760;694;6454;NA;288961;1367;2020-12-22;34796
2020-12-21;"Trenčiansky kraj";248;13395;979;14374;NA;288961;1227;2020-12-21;33429
2020-12-20;"Trenčiansky kraj";238;12504;292;12796;NA;288961;530;2020-12-20;32202
2020-12-19;"Trenčiansky kraj";341;1611;150;1761;NA;288961;491;2020-12-19;31672
2020-12-18;"Trenčiansky kraj";521;5199;615;5814;NA;288961;1136;2020-12-18;31181
2020-12-17;"Trenčiansky kraj";670;3843;524;4367;NA;288961;1194;2020-12-17;30045
2020-12-16;"Trenčiansky kraj";461;4474;648;5122;NA;288961;1109;2020-12-16;28851
2020-12-15;"Trenčiansky kraj";595;3805;670;4475;NA;288961;1265;2020-12-15;27742
2020-12-14;"Trenčiansky kraj";318;2907;552;3459;NA;288961;870;2020-12-14;26477
2020-12-13;"Trenčiansky kraj";77;49;6;55;NA;288961;83;2020-12-13;25607
2020-12-12;"Trenčiansky kraj";314;1191;136;1327;NA;288961;450;2020-12-12;25524
2020-12-11;"Trenčiansky kraj";751;3773;453;4226;NA;288961;1204;2020-12-11;25074
2020-12-10;"Trenčiansky kraj";271;3354;473;3827;NA;288961;744;2020-12-10;23870
2020-12-09;"Trenčiansky kraj";508;3788;466;4254;NA;288961;974;2020-12-09;23126
2020-12-08;"Trenčiansky kraj";546;3440;522;3962;NA;288961;1068;2020-12-08;22152
2020-12-07;"Trenčiansky kraj";258;3832;468;4300;NA;288961;726;2020-12-07;21084
2020-12-06;"Trenčiansky kraj";114;179;10;189;NA;288961;124;2020-12-06;20358
2020-12-05;"Trenčiansky kraj";223;610;56;666;NA;288961;279;2020-12-05;20234
2020-12-04;"Trenčiansky kraj";253;2943;273;3216;NA;288961;526;2020-12-04;19955
2020-12-03;"Trenčiansky kraj";503;1714;178;1892;NA;288961;681;2020-12-03;19429
2020-12-02;"Trenčiansky kraj";418;1844;232;2076;NA;288961;650;2020-12-02;18748
2020-12-01;"Trenčiansky kraj";321;5642;351;5993;NA;288961;672;2020-12-01;18098
2020-11-30;"Trenčiansky kraj";167;11514;520;12034;NA;288961;687;2020-11-30;17426
2020-11-29;"Trenčiansky kraj";29;30;5;35;NA;288961;34;2020-11-29;16739
2020-11-28;"Trenčiansky kraj";202;1051;93;1144;NA;288961;295;2020-11-28;16705
2020-11-27;"Trenčiansky kraj";330;1888;186;2074;NA;288961;516;2020-11-27;16410
2020-11-26;"Trenčiansky kraj";395;1252;122;1374;NA;288961;517;2020-11-26;15894
2020-11-25;"Trenčiansky kraj";322;1444;160;1604;NA;288961;482;2020-11-25;15377
2020-11-24;"Trenčiansky kraj";348;2553;308;2861;NA;288961;656;2020-11-24;14895
2020-11-23;"Trenčiansky kraj";159;1186;122;1308;NA;288961;281;2020-11-23;14239
2020-11-22;"Trenčiansky kraj";26;30;7;37;NA;288961;33;2020-11-22;13958
2020-11-21;"Trenčiansky kraj";255;1376;69;1445;NA;288961;324;2020-11-21;13925
2020-11-20;"Trenčiansky kraj";316;861;93;954;NA;288961;409;2020-11-20;13601
2020-11-19;"Trenčiansky kraj";316;740;113;853;NA;288961;429;2020-11-19;13192
2020-11-18;"Trenčiansky kraj";233;379;66;445;NA;288961;299;2020-11-18;12763
2020-11-17;"Trenčiansky kraj";222;106;15;121;NA;288961;237;2020-11-17;12464
2020-11-16;"Trenčiansky kraj";245;236;45;281;NA;288961;290;2020-11-16;12227
2020-11-15;"Trenčiansky kraj";109;29;6;35;NA;288961;115;2020-11-15;11937
2020-11-14;"Trenčiansky kraj";190;74;11;85;NA;288961;201;2020-11-14;11822
2020-11-13;"Trenčiansky kraj";308;131;13;144;NA;288961;321;2020-11-13;11621
2020-11-12;"Trenčiansky kraj";324;124;5;129;NA;288961;329;2020-11-12;11300
2020-11-11;"Trenčiansky kraj";366;113;10;123;NA;288961;376;2020-11-11;10971
2020-11-10;"Trenčiansky kraj";277;106;6;112;NA;288961;283;2020-11-10;10595
2020-11-09;"Trenčiansky kraj";115;1407;48;1455;NA;288961;163;2020-11-09;10312
2020-11-08;"Trenčiansky kraj";81;1271;8;1279;NA;288961;89;2020-11-08;10149
2020-11-07;"Trenčiansky kraj";319;3662;59;3721;NA;288961;378;2020-11-07;10060
2020-11-06;"Trenčiansky kraj";383;6893;84;6977;NA;288961;467;2020-11-06;9682
2020-11-05;"Trenčiansky kraj";399;98;15;113;NA;288961;414;2020-11-05;9215
2020-11-04;"Trenčiansky kraj";370;91;9;100;NA;288961;379;2020-11-04;8801
2020-11-03;"Trenčiansky kraj";575;97;8;105;NA;288961;583;2020-11-03;8422
2020-11-02;"Trenčiansky kraj";197;1833;68;1901;NA;288961;265;2020-11-02;7839
2020-11-01;"Trenčiansky kraj";257;808;24;832;NA;288961;281;2020-11-01;7574
2020-10-31;"Trenčiansky kraj";332;4719;82;4801;NA;288961;414;2020-10-31;7293
2020-10-30;"Trenčiansky kraj";299;5283;102;5385;NA;288961;401;2020-10-30;6879
2020-10-29;"Trenčiansky kraj";496;764;68;832;NA;288961;564;2020-10-29;6478
2020-10-28;"Trenčiansky kraj";269;192;33;225;NA;288961;302;2020-10-28;5914
2020-10-27;"Trenčiansky kraj";473;127;27;154;NA;288961;500;2020-10-27;5612
2020-10-26;"Trenčiansky kraj";177;107;36;143;NA;288961;213;2020-10-26;5112
2020-10-25;"Trenčiansky kraj";138;9;5;14;NA;288961;143;2020-10-25;4899
2020-10-24;"Trenčiansky kraj";395;128;6;134;NA;288961;401;2020-10-24;4756
2020-10-23;"Trenčiansky kraj";301;154;8;162;NA;288961;309;2020-10-23;4355
2020-10-22;"Trenčiansky kraj";273;82;12;94;NA;288961;285;2020-10-22;4046
2020-10-21;"Trenčiansky kraj";183;53;9;62;NA;288961;192;2020-10-21;3761
2020-10-20;"Trenčiansky kraj";212;47;6;53;NA;288961;218;2020-10-20;3569
2020-10-19;"Trenčiansky kraj";41;83;25;108;NA;288961;66;2020-10-19;3351
2020-10-18;"Trenčiansky kraj";104;0;0;0;NA;288961;104;2020-10-18;3285
2020-10-17;"Trenčiansky kraj";54;0;0;0;NA;288961;54;2020-10-17;3181
2022-03-27;"Trnavský kraj";341;79;18;97;192358;260273;359;2022-03-27;260273
2022-03-26;"Trnavský kraj";762;185;27;212;NA;260273;789;2022-03-26;259914
2022-03-25;"Trnavský kraj";859;587;56;643;NA;260273;915;2022-03-25;259125
2022-03-24;"Trnavský kraj";920;589;59;648;NA;260273;979;2022-03-24;258210
2022-03-23;"Trnavský kraj";1112;733;86;819;NA;260273;1198;2022-03-23;257231
2022-03-22;"Trnavský kraj";1096;745;67;812;NA;260273;1163;2022-03-22;256033
2022-03-21;"Trnavský kraj";1096;980;106;1086;NA;260273;1202;2022-03-21;254870
2022-03-20;"Trnavský kraj";229;244;42;286;NA;260273;271;2022-03-20;253668
2022-03-19;"Trnavský kraj";1000;233;55;288;NA;260273;1055;2022-03-19;253397
2022-03-18;"Trnavský kraj";1038;881;107;988;NA;260273;1145;2022-03-18;252342
2022-03-17;"Trnavský kraj";1148;703;86;789;NA;260273;1234;2022-03-17;251197
2022-03-16;"Trnavský kraj";1344;579;84;663;NA;260273;1428;2022-03-16;249963
2022-03-15;"Trnavský kraj";1179;1018;117;1135;NA;260273;1296;2022-03-15;248535
2022-03-14;"Trnavský kraj";890;1500;168;1668;NA;260273;1058;2022-03-14;247239
2022-03-13;"Trnavský kraj";290;411;53;464;NA;260273;343;2022-03-13;246181
2022-03-12;"Trnavský kraj";958;298;39;337;NA;260273;997;2022-03-12;245838
2022-03-11;"Trnavský kraj";961;1001;125;1126;NA;260273;1086;2022-03-11;244841
2022-03-10;"Trnavský kraj";1049;1177;141;1318;NA;260273;1190;2022-03-10;243755
2022-03-09;"Trnavský kraj";1271;1086;150;1236;NA;260273;1421;2022-03-09;242565
2022-03-08;"Trnavský kraj";1393;1299;165;1464;NA;260273;1558;2022-03-08;241144
2022-03-07;"Trnavský kraj";1005;2016;254;2270;NA;260273;1259;2022-03-07;239586
2022-03-06;"Trnavský kraj";395;552;115;667;NA;260273;510;2022-03-06;238327
2022-03-05;"Trnavský kraj";806;461;89;550;NA;260273;895;2022-03-05;237817
2022-03-04;"Trnavský kraj";1028;1043;122;1165;NA;260273;1150;2022-03-04;236922
2022-03-03;"Trnavský kraj";1513;1116;158;1274;NA;260273;1671;2022-03-03;235772
2022-03-02;"Trnavský kraj";1330;1484;189;1673;NA;260273;1519;2022-03-02;234101
2022-03-01;"Trnavský kraj";1527;1321;191;1512;NA;260273;1718;2022-03-01;232582
2022-02-28;"Trnavský kraj";1318;2104;264;2368;NA;260273;1582;2022-02-28;230864
2022-02-27;"Trnavský kraj";386;640;106;746;NA;260273;492;2022-02-27;229282
2022-02-26;"Trnavský kraj";1268;526;112;638;NA;260273;1380;2022-02-26;228790
2022-02-25;"Trnavský kraj";1439;1490;211;1701;NA;260273;1650;2022-02-25;227410
2022-02-24;"Trnavský kraj";1397;1419;183;1602;NA;260273;1580;2022-02-24;225760
2022-02-23;"Trnavský kraj";2032;1668;238;1906;NA;260273;2270;2022-02-23;224180
2022-02-22;"Trnavský kraj";2171;1891;271;2162;NA;260273;2442;2022-02-22;221910
2022-02-21;"Trnavský kraj";1983;2849;438;3287;NA;260273;2421;2022-02-21;219468
2022-02-20;"Trnavský kraj";888;829;186;1015;NA;260273;1074;2022-02-20;217047
2022-02-19;"Trnavský kraj";1838;707;149;856;NA;260273;1987;2022-02-19;215973
2022-02-18;"Trnavský kraj";2132;1723;269;1992;NA;260273;2401;2022-02-18;213986
2022-02-17;"Trnavský kraj";1987;1763;269;2032;NA;260273;2256;2022-02-17;211585
2022-02-16;"Trnavský kraj";2047;1809;317;2126;NA;260273;2364;2022-02-16;209329
2022-02-15;"Trnavský kraj";2228;2412;400;2812;NA;260273;2628;2022-02-15;206965
2022-02-14;"Trnavský kraj";2216;3424;492;3916;NA;260273;2708;2022-02-14;204337
2022-02-13;"Trnavský kraj";805;1129;247;1376;NA;260273;1052;2022-02-13;201629
2022-02-12;"Trnavský kraj";2081;966;175;1141;NA;260273;2256;2022-02-12;200577
2022-02-11;"Trnavský kraj";1665;2158;266;2424;NA;260273;1931;2022-02-11;198321
2022-02-10;"Trnavský kraj";2491;1942;256;2198;NA;260273;2747;2022-02-10;196390
2022-02-09;"Trnavský kraj";2205;2474;365;2839;NA;260273;2570;2022-02-09;193643
2022-02-08;"Trnavský kraj";1758;2352;353;2705;NA;260273;2111;2022-02-08;191073
2022-02-07;"Trnavský kraj";2581;3356;459;3815;NA;260273;3040;2022-02-07;188962
2022-02-06;"Trnavský kraj";1194;1309;276;1585;NA;260273;1470;2022-02-06;185922
2022-02-05;"Trnavský kraj";2165;1102;187;1289;NA;260273;2352;2022-02-05;184452
2022-02-04;"Trnavský kraj";2191;2179;253;2432;NA;260273;2444;2022-02-04;182100
2022-02-03;"Trnavský kraj";2124;3295;347;3642;NA;260273;2471;2022-02-03;179656
2022-02-02;"Trnavský kraj";1812;2684;281;2965;NA;260273;2093;2022-02-02;177185
2022-02-01;"Trnavský kraj";2344;2656;318;2974;NA;260273;2662;2022-02-01;175092
2022-01-31;"Trnavský kraj";1931;5001;489;5490;NA;260273;2420;2022-01-31;172430
2022-01-30;"Trnavský kraj";709;1672;176;1848;NA;260273;885;2022-01-30;170010
2022-01-29;"Trnavský kraj";2136;1174;159;1333;NA;260273;2295;2022-01-29;169125
2022-01-28;"Trnavský kraj";1734;2340;216;2556;NA;260273;1950;2022-01-28;166830
2022-01-27;"Trnavský kraj";1989;2333;246;2579;NA;260273;2235;2022-01-27;164880
2022-01-26;"Trnavský kraj";1906;2730;217;2947;NA;260273;2123;2022-01-26;162645
2022-01-25;"Trnavský kraj";1631;2422;195;2617;NA;260273;1826;2022-01-25;160522
2022-01-24;"Trnavský kraj";999;4194;236;4430;NA;260273;1235;2022-01-24;158696
2022-01-23;"Trnavský kraj";299;1897;105;2002;NA;260273;404;2022-01-23;157461
2022-01-22;"Trnavský kraj";1169;1197;81;1278;NA;260273;1250;2022-01-22;157057
2022-01-21;"Trnavský kraj";830;2134;104;2238;NA;260273;934;2022-01-21;155807
2022-01-20;"Trnavský kraj";917;2511;100;2611;NA;260273;1017;2022-01-20;154873
2022-01-19;"Trnavský kraj";832;2122;84;2206;NA;260273;916;2022-01-19;153856
2022-01-18;"Trnavský kraj";704;2051;74;2125;NA;260273;778;2022-01-18;152940
2022-01-17;"Trnavský kraj";366;3885;87;3972;NA;260273;453;2022-01-17;152162
2022-01-16;"Trnavský kraj";84;1696;44;1740;NA;260273;128;2022-01-16;151709
2022-01-15;"Trnavský kraj";421;1015;33;1048;NA;260273;454;2022-01-15;151581
2022-01-14;"Trnavský kraj";349;2040;50;2090;NA;260273;399;2022-01-14;151127
2022-01-13;"Trnavský kraj";234;2057;52;2109;NA;260273;286;2022-01-13;150728
2022-01-12;"Trnavský kraj";400;1927;35;1962;NA;260273;435;2022-01-12;150442
2022-01-11;"Trnavský kraj";384;2261;33;2294;NA;260273;417;2022-01-11;150007
2022-01-10;"Trnavský kraj";258;4357;71;4428;NA;260273;329;2022-01-10;149590
2022-01-09;"Trnavský kraj";35;1921;22;1943;NA;260273;57;2022-01-09;149261
2022-01-08;"Trnavský kraj";364;1005;29;1034;NA;260273;393;2022-01-08;149204
2022-01-07;"Trnavský kraj";332;1984;47;2031;NA;260273;379;2022-01-07;148811
2022-01-06;"Trnavský kraj";234;830;20;850;NA;260273;254;2022-01-06;148432
2022-01-05;"Trnavský kraj";416;1925;37;1962;NA;260273;453;2022-01-05;148178
2022-01-04;"Trnavský kraj";538;2337;37;2374;NA;260273;575;2022-01-04;147725
2022-01-03;"Trnavský kraj";441;3897;65;3962;NA;260273;506;2022-01-03;147150
2022-01-02;"Trnavský kraj";79;1561;21;1582;NA;260273;100;2022-01-02;146644
2022-01-01;"Trnavský kraj";4;190;7;197;NA;260273;11;2022-01-01;146544
2021-12-31;"Trnavský kraj";485;1246;60;1306;NA;260273;545;2021-12-31;146533
2021-12-30;"Trnavský kraj";401;1927;58;1985;NA;260273;459;2021-12-30;145988
2021-12-29;"Trnavský kraj";401;1756;70;1826;NA;260273;471;2021-12-29;145529
2021-12-28;"Trnavský kraj";633;1742;73;1815;NA;260273;706;2021-12-28;145058
2021-12-27;"Trnavský kraj";463;2814;134;2948;NA;260273;597;2021-12-27;144352
2021-12-26;"Trnavský kraj";253;1019;30;1049;NA;260273;283;2021-12-26;143755
2021-12-25;"Trnavský kraj";104;341;41;382;NA;260273;145;2021-12-25;143472
2021-12-24;"Trnavský kraj";216;369;27;396;NA;260273;243;2021-12-24;143327
2021-12-23;"Trnavský kraj";570;1825;102;1927;NA;260273;672;2021-12-23;143084
2021-12-22;"Trnavský kraj";545;1732;81;1813;NA;260273;626;2021-12-22;142412
2021-12-21;"Trnavský kraj";699;2577;89;2666;NA;260273;788;2021-12-21;141786
2021-12-20;"Trnavský kraj";438;3941;103;4044;NA;260273;541;2021-12-20;140998
2021-12-19;"Trnavský kraj";155;1762;63;1825;NA;260273;218;2021-12-19;140457
2021-12-18;"Trnavský kraj";627;1302;77;1379;NA;260273;704;2021-12-18;140239
2021-12-17;"Trnavský kraj";576;2276;109;2385;NA;260273;685;2021-12-17;139535
2021-12-16;"Trnavský kraj";653;2530;123;2653;NA;260273;776;2021-12-16;138850
2021-12-15;"Trnavský kraj";746;2198;120;2318;NA;260273;866;2021-12-15;138074
2021-12-14;"Trnavský kraj";976;2718;134;2852;NA;260273;1110;2021-12-14;137208
2021-12-13;"Trnavský kraj";521;4857;175;5032;NA;260273;696;2021-12-13;136098
2021-12-12;"Trnavský kraj";337;2117;87;2204;NA;260273;424;2021-12-12;135402
2021-12-11;"Trnavský kraj";720;1324;83;1407;NA;260273;803;2021-12-11;134978
2021-12-10;"Trnavský kraj";702;2909;136;3045;NA;260273;838;2021-12-10;134175
2021-12-09;"Trnavský kraj";926;2313;96;2409;NA;260273;1022;2021-12-09;133337
2021-12-08;"Trnavský kraj";1233;2547;137;2684;NA;260273;1370;2021-12-08;132315
2021-12-07;"Trnavský kraj";1159;3637;174;3811;NA;260273;1333;2021-12-07;130945
2021-12-06;"Trnavský kraj";911;3649;208;3857;NA;260273;1119;2021-12-06;129612
2021-12-05;"Trnavský kraj";269;2303;106;2409;NA;260273;375;2021-12-05;128493
2021-12-04;"Trnavský kraj";1225;1623;115;1738;NA;260273;1340;2021-12-04;128118
2021-12-03;"Trnavský kraj";1246;2998;201;3199;NA;260273;1447;2021-12-03;126778
2021-12-02;"Trnavský kraj";1809;2379;188;2567;NA;260273;1997;2021-12-02;125331
2021-12-01;"Trnavský kraj";738;3011;179;3190;NA;260273;917;2021-12-01;123334
2021-11-30;"Trnavský kraj";1166;4217;202;4419;NA;260273;1368;2021-11-30;122417
2021-11-29;"Trnavský kraj";814;5360;299;5659;NA;260273;1113;2021-11-29;121049
2021-11-28;"Trnavský kraj";482;3087;146;3233;NA;260273;628;2021-11-28;119936
2021-11-27;"Trnavský kraj";1186;2240;206;2446;NA;260273;1392;2021-11-27;119308
2021-11-26;"Trnavský kraj";880;2895;202;3097;NA;260273;1082;2021-11-26;117916
2021-11-25;"Trnavský kraj";1002;2680;158;2838;NA;260273;1160;2021-11-25;116834
2021-11-24;"Trnavský kraj";1060;3442;250;3692;NA;260273;1310;2021-11-24;115674
2021-11-23;"Trnavský kraj";1078;3714;273;3987;NA;260273;1351;2021-11-23;114364
2021-11-22;"Trnavský kraj";696;4028;295;4323;NA;260273;991;2021-11-22;113013
2021-11-21;"Trnavský kraj";298;2270;212;2482;NA;260273;510;2021-11-21;112022
2021-11-20;"Trnavský kraj";826;1529;196;1725;NA;260273;1022;2021-11-20;111512
2021-11-19;"Trnavský kraj";901;3369;315;3684;NA;260273;1216;2021-11-19;110490
2021-11-18;"Trnavský kraj";796;2872;240;3112;NA;260273;1036;2021-11-18;109274
2021-11-17;"Trnavský kraj";769;1201;139;1340;NA;260273;908;2021-11-17;108238
2021-11-16;"Trnavský kraj";591;2755;206;2961;NA;260273;797;2021-11-16;107330
2021-11-15;"Trnavský kraj";606;3350;239;3589;NA;260273;845;2021-11-15;106533
2021-11-14;"Trnavský kraj";236;1579;141;1720;NA;260273;377;2021-11-14;105688
2021-11-13;"Trnavský kraj";815;1314;132;1446;NA;260273;947;2021-11-13;105311
2021-11-12;"Trnavský kraj";563;2585;157;2742;NA;260273;720;2021-11-12;104364
2021-11-11;"Trnavský kraj";512;2426;161;2587;NA;260273;673;2021-11-11;103644
2021-11-10;"Trnavský kraj";590;2315;173;2488;NA;260273;763;2021-11-10;102971
2021-11-09;"Trnavský kraj";585;2538;187;2725;NA;260273;772;2021-11-09;102208
2021-11-08;"Trnavský kraj";357;2715;163;2878;NA;260273;520;2021-11-08;101436
2021-11-07;"Trnavský kraj";162;1349;111;1460;NA;260273;273;2021-11-07;100916
2021-11-06;"Trnavský kraj";391;1287;82;1369;NA;260273;473;2021-11-06;100643
2021-11-05;"Trnavský kraj";447;2202;102;2304;NA;260273;549;2021-11-05;100170
2021-11-04;"Trnavský kraj";432;2289;112;2401;NA;260273;544;2021-11-04;99621
2021-11-03;"Trnavský kraj";420;2091;97;2188;NA;260273;517;2021-11-03;99077
2021-11-02;"Trnavský kraj";365;2777;124;2901;NA;260273;489;2021-11-02;98560
2021-11-01;"Trnavský kraj";220;583;27;610;NA;260273;247;2021-11-01;98071
2021-10-31;"Trnavský kraj";61;887;62;949;NA;260273;123;2021-10-31;97824
2021-10-30;"Trnavský kraj";251;1099;50;1149;NA;260273;301;2021-10-30;97701
2021-10-29;"Trnavský kraj";312;2123;53;2176;NA;260273;365;2021-10-29;97400
2021-10-28;"Trnavský kraj";339;2034;65;2099;NA;260273;404;2021-10-28;97035
2021-10-27;"Trnavský kraj";232;1884;58;1942;NA;260273;290;2021-10-27;96631
2021-10-26;"Trnavský kraj";366;1964;54;2018;NA;260273;420;2021-10-26;96341
2021-10-25;"Trnavský kraj";142;2786;72;2858;NA;260273;214;2021-10-25;95921
2021-10-24;"Trnavský kraj";11;990;30;1020;NA;260273;41;2021-10-24;95707
2021-10-23;"Trnavský kraj";228;1126;27;1153;NA;260273;255;2021-10-23;95666
2021-10-22;"Trnavský kraj";204;2269;51;2320;NA;260273;255;2021-10-22;95411
2021-10-21;"Trnavský kraj";188;1671;46;1717;NA;260273;234;2021-10-21;95156
2021-10-20;"Trnavský kraj";212;1634;47;1681;NA;260273;259;2021-10-20;94922
2021-10-19;"Trnavský kraj";240;1848;30;1878;NA;260273;270;2021-10-19;94663
2021-10-18;"Trnavský kraj";95;2316;72;2388;NA;260273;167;2021-10-18;94393
2021-10-17;"Trnavský kraj";5;1218;17;1235;NA;260273;22;2021-10-17;94226
2021-10-16;"Trnavský kraj";129;1233;17;1250;NA;260273;146;2021-10-16;94204
2021-10-15;"Trnavský kraj";122;2121;24;2145;NA;260273;146;2021-10-15;94058
2021-10-14;"Trnavský kraj";131;1663;24;1687;NA;260273;155;2021-10-14;93912
2021-10-13;"Trnavský kraj";128;2072;23;2095;NA;260273;151;2021-10-13;93757
2021-10-12;"Trnavský kraj";189;2788;38;2826;NA;260273;227;2021-10-12;93606
2021-10-11;"Trnavský kraj";115;2621;35;2656;NA;260273;150;2021-10-11;93379
2021-10-10;"Trnavský kraj";2;993;15;1008;NA;260273;17;2021-10-10;93229
2021-10-09;"Trnavský kraj";151;1099;10;1109;NA;260273;161;2021-10-09;93212
2021-10-08;"Trnavský kraj";106;2326;34;2360;NA;260273;140;2021-10-08;93051
2021-10-07;"Trnavský kraj";151;1744;25;1769;NA;260273;176;2021-10-07;92911
2021-10-06;"Trnavský kraj";122;1929;27;1956;NA;260273;149;2021-10-06;92735
2021-10-05;"Trnavský kraj";220;3726;34;3760;NA;260273;254;2021-10-05;92586
2021-10-04;"Trnavský kraj";54;1963;47;2010;NA;260273;101;2021-10-04;92332
2021-10-03;"Trnavský kraj";1;1106;17;1123;NA;260273;18;2021-10-03;92231
2021-10-02;"Trnavský kraj";52;1055;12;1067;NA;260273;64;2021-10-02;92213
2021-10-01;"Trnavský kraj";113;2243;17;2260;NA;260273;130;2021-10-01;92149
2021-09-30;"Trnavský kraj";109;1872;18;1890;NA;260273;127;2021-09-30;92019
2021-09-29;"Trnavský kraj";83;1331;11;1342;NA;260273;94;2021-09-29;91892
2021-09-28;"Trnavský kraj";135;1934;31;1965;NA;260273;166;2021-09-28;91798
2021-09-27;"Trnavský kraj";80;2084;25;2109;NA;260273;105;2021-09-27;91632
2021-09-26;"Trnavský kraj";2;1048;12;1060;NA;260273;14;2021-09-26;91527
2021-09-25;"Trnavský kraj";61;1105;9;1114;NA;260273;70;2021-09-25;91513
2021-09-24;"Trnavský kraj";41;2229;15;2244;NA;260273;56;2021-09-24;91443
2021-09-23;"Trnavský kraj";89;1691;16;1707;NA;260273;105;2021-09-23;91387
2021-09-22;"Trnavský kraj";119;1706;28;1734;NA;260273;147;2021-09-22;91282
2021-09-21;"Trnavský kraj";108;1505;17;1522;NA;260273;125;2021-09-21;91135
2021-09-20;"Trnavský kraj";50;1652;20;1672;NA;260273;70;2021-09-20;91010
2021-09-19;"Trnavský kraj";2;924;8;932;NA;260273;10;2021-09-19;90940
2021-09-18;"Trnavský kraj";100;982;6;988;NA;260273;106;2021-09-18;90930
2021-09-17;"Trnavský kraj";77;1709;20;1729;NA;260273;97;2021-09-17;90824
2021-09-16;"Trnavský kraj";105;1279;32;1311;NA;260273;137;2021-09-16;90727
2021-09-15;"Trnavský kraj";59;841;5;846;NA;260273;64;2021-09-15;90590
2021-09-14;"Trnavský kraj";38;1583;12;1595;NA;260273;50;2021-09-14;90526
2021-09-13;"Trnavský kraj";56;1410;16;1426;NA;260273;72;2021-09-13;90476
2021-09-12;"Trnavský kraj";0;653;1;654;NA;260273;1;2021-09-12;90404
2021-09-11;"Trnavský kraj";37;971;10;981;NA;260273;47;2021-09-11;90403
2021-09-10;"Trnavský kraj";43;1441;9;1450;NA;260273;52;2021-09-10;90356
2021-09-09;"Trnavský kraj";42;954;13;967;NA;260273;55;2021-09-09;90304
2021-09-08;"Trnavský kraj";65;802;15;817;NA;260273;80;2021-09-08;90249
2021-09-07;"Trnavský kraj";29;844;5;849;NA;260273;34;2021-09-07;90169
2021-09-06;"Trnavský kraj";18;1234;14;1248;NA;260273;32;2021-09-06;90135
2021-09-05;"Trnavský kraj";2;580;4;584;NA;260273;6;2021-09-05;90103
2021-09-04;"Trnavský kraj";17;868;6;874;NA;260273;23;2021-09-04;90097
2021-09-03;"Trnavský kraj";14;1060;5;1065;NA;260273;19;2021-09-03;90074
2021-09-02;"Trnavský kraj";30;830;10;840;NA;260273;40;2021-09-02;90055
2021-09-01;"Trnavský kraj";6;409;4;413;NA;260273;10;2021-09-01;90015
2021-08-31;"Trnavský kraj";13;884;3;887;NA;260273;16;2021-08-31;90005
2021-08-30;"Trnavský kraj";7;904;1;905;NA;260273;8;2021-08-30;89989
2021-08-29;"Trnavský kraj";8;427;1;428;NA;260273;9;2021-08-29;89981
2021-08-28;"Trnavský kraj";17;694;2;696;NA;260273;19;2021-08-28;89972
2021-08-27;"Trnavský kraj";1;1186;4;1190;NA;260273;5;2021-08-27;89953
2021-08-26;"Trnavský kraj";8;713;3;716;NA;260273;11;2021-08-26;89948
2021-08-25;"Trnavský kraj";11;683;6;689;NA;260273;17;2021-08-25;89937
2021-08-24;"Trnavský kraj";7;801;1;802;NA;260273;8;2021-08-24;89920
2021-08-23;"Trnavský kraj";4;844;1;845;NA;260273;5;2021-08-23;89912
2021-08-22;"Trnavský kraj";0;474;0;474;NA;260273;0;2021-08-22;89907
2021-08-21;"Trnavský kraj";8;703;0;703;NA;260273;8;2021-08-21;89907
2021-08-20;"Trnavský kraj";4;1095;4;1099;NA;260273;8;2021-08-20;89899
2021-08-19;"Trnavský kraj";10;881;3;884;NA;260273;13;2021-08-19;89891
2021-08-18;"Trnavský kraj";6;789;2;791;NA;260273;8;2021-08-18;89878
2021-08-17;"Trnavský kraj";7;524;4;528;NA;260273;11;2021-08-17;89870
2021-08-16;"Trnavský kraj";9;966;3;969;NA;260273;12;2021-08-16;89859
2021-08-15;"Trnavský kraj";0;556;1;557;NA;260273;1;2021-08-15;89847
2021-08-14;"Trnavský kraj";10;801;3;804;NA;260273;13;2021-08-14;89846
2021-08-13;"Trnavský kraj";5;1077;6;1083;NA;260273;11;2021-08-13;89833
2021-08-12;"Trnavský kraj";3;666;3;669;NA;260273;6;2021-08-12;89822
2021-08-11;"Trnavský kraj";7;576;2;578;NA;260273;9;2021-08-11;89816
2021-08-10;"Trnavský kraj";3;757;3;760;NA;260273;6;2021-08-10;89807
2021-08-09;"Trnavský kraj";12;808;0;808;NA;260273;12;2021-08-09;89801
2021-08-08;"Trnavský kraj";1;545;0;545;NA;260273;1;2021-08-08;89789
2021-08-07;"Trnavský kraj";9;724;0;724;NA;260273;9;2021-08-07;89788
2021-08-06;"Trnavský kraj";3;988;0;988;NA;260273;3;2021-08-06;89779
2021-08-05;"Trnavský kraj";2;662;1;663;NA;260273;3;2021-08-05;89776
2021-08-04;"Trnavský kraj";1;891;1;892;NA;260273;2;2021-08-04;89773
2021-08-03;"Trnavský kraj";13;645;0;645;NA;260273;13;2021-08-03;89771
2021-08-02;"Trnavský kraj";2;725;1;726;NA;260273;3;2021-08-02;89758
2021-08-01;"Trnavský kraj";0;565;2;567;NA;260273;2;2021-08-01;89755
2021-07-31;"Trnavský kraj";3;886;0;886;NA;260273;3;2021-07-31;89753
2021-07-30;"Trnavský kraj";3;1084;3;1087;NA;260273;6;2021-07-30;89750
2021-07-29;"Trnavský kraj";1;775;0;775;NA;260273;1;2021-07-29;89744
2021-07-28;"Trnavský kraj";5;794;1;795;NA;260273;6;2021-07-28;89743
2021-07-27;"Trnavský kraj";7;623;2;625;NA;260273;9;2021-07-27;89737
2021-07-26;"Trnavský kraj";2;857;2;859;NA;260273;4;2021-07-26;89728
2021-07-25;"Trnavský kraj";0;707;0;707;NA;260273;0;2021-07-25;89724
2021-07-24;"Trnavský kraj";4;828;2;830;NA;260273;6;2021-07-24;89724
2021-07-23;"Trnavský kraj";3;1057;0;1057;NA;260273;3;2021-07-23;89718
2021-07-22;"Trnavský kraj";0;671;2;673;NA;260273;2;2021-07-22;89715
2021-07-21;"Trnavský kraj";2;660;2;662;NA;260273;4;2021-07-21;89713
2021-07-20;"Trnavský kraj";2;593;0;593;NA;260273;2;2021-07-20;89709
2021-07-19;"Trnavský kraj";9;886;0;886;NA;260273;9;2021-07-19;89707
2021-07-18;"Trnavský kraj";0;600;2;602;NA;260273;2;2021-07-18;89698
2021-07-17;"Trnavský kraj";8;796;0;796;NA;260273;8;2021-07-17;89696
2021-07-16;"Trnavský kraj";11;963;0;963;NA;260273;11;2021-07-16;89688
2021-07-15;"Trnavský kraj";4;832;1;833;NA;260273;5;2021-07-15;89677
2021-07-14;"Trnavský kraj";1;699;1;700;NA;260273;2;2021-07-14;89672
2021-07-13;"Trnavský kraj";1;693;1;694;NA;260273;2;2021-07-13;89670
2021-07-12;"Trnavský kraj";4;959;0;959;NA;260273;4;2021-07-12;89668
2021-07-11;"Trnavský kraj";0;692;0;692;NA;260273;0;2021-07-11;89664
2021-07-10;"Trnavský kraj";1;803;0;803;NA;260273;1;2021-07-10;89664
2021-07-09;"Trnavský kraj";3;1262;3;1265;NA;260273;6;2021-07-09;89663
2021-07-08;"Trnavský kraj";4;755;0;755;NA;260273;4;2021-07-08;89657
2021-07-07;"Trnavský kraj";9;924;2;926;NA;260273;11;2021-07-07;89653
2021-07-06;"Trnavský kraj";2;1401;1;1402;NA;260273;3;2021-07-06;89642
2021-07-05;"Trnavský kraj";1;503;2;505;NA;260273;3;2021-07-05;89639
2021-07-04;"Trnavský kraj";0;1129;3;1132;NA;260273;3;2021-07-04;89636
2021-07-03;"Trnavský kraj";4;815;0;815;NA;260273;4;2021-07-03;89633
2021-07-02;"Trnavský kraj";2;1137;2;1139;NA;260273;4;2021-07-02;89629
2021-07-01;"Trnavský kraj";4;487;0;487;NA;260273;4;2021-07-01;89625
2021-06-30;"Trnavský kraj";0;5135;1;5136;NA;260273;1;2021-06-30;89621
2021-06-29;"Trnavský kraj";4;2563;1;2564;NA;260273;5;2021-06-29;89620
2021-06-28;"Trnavský kraj";2;2600;1;2601;NA;260273;3;2021-06-28;89615
2021-06-27;"Trnavský kraj";0;3213;0;3213;NA;260273;0;2021-06-27;89612
2021-06-26;"Trnavský kraj";3;3871;1;3872;NA;260273;4;2021-06-26;89612
2021-06-25;"Trnavský kraj";2;4374;3;4377;NA;260273;5;2021-06-25;89608
2021-06-24;"Trnavský kraj";4;2520;3;2523;NA;260273;7;2021-06-24;89603
2021-06-23;"Trnavský kraj";4;2842;2;2844;NA;260273;6;2021-06-23;89596
2021-06-22;"Trnavský kraj";2;2996;1;2997;NA;260273;3;2021-06-22;89590
2021-06-21;"Trnavský kraj";6;3114;5;3119;NA;260273;11;2021-06-21;89587
2021-06-20;"Trnavský kraj";0;3952;1;3953;NA;260273;1;2021-06-20;89576
2021-06-19;"Trnavský kraj";3;4735;2;4737;NA;260273;5;2021-06-19;89575
2021-06-18;"Trnavský kraj";5;6125;4;6129;NA;260273;9;2021-06-18;89570
2021-06-17;"Trnavský kraj";3;3340;0;3340;NA;260273;3;2021-06-17;89561
2021-06-16;"Trnavský kraj";6;2926;3;2929;NA;260273;9;2021-06-16;89558
2021-06-15;"Trnavský kraj";8;3234;3;3237;NA;260273;11;2021-06-15;89549
2021-06-14;"Trnavský kraj";2;3829;1;3830;NA;260273;3;2021-06-14;89538
2021-06-13;"Trnavský kraj";0;5001;8;5009;NA;260273;8;2021-06-13;89535
2021-06-12;"Trnavský kraj";11;5807;2;5809;NA;260273;13;2021-06-12;89527
2021-06-11;"Trnavský kraj";17;5850;4;5854;NA;260273;21;2021-06-11;89514
2021-06-10;"Trnavský kraj";14;3476;1;3477;NA;260273;15;2021-06-10;89493
2021-06-09;"Trnavský kraj";10;3681;1;3682;NA;260273;11;2021-06-09;89478
2021-06-08;"Trnavský kraj";8;3344;4;3348;NA;260273;12;2021-06-08;89467
2021-06-07;"Trnavský kraj";12;4498;8;4506;NA;260273;20;2021-06-07;89455
2021-06-06;"Trnavský kraj";0;5517;2;5519;NA;260273;2;2021-06-06;89435
2021-06-05;"Trnavský kraj";20;6905;8;6913;NA;260273;28;2021-06-05;89433
2021-06-04;"Trnavský kraj";9;6735;10;6745;NA;260273;19;2021-06-04;89405
2021-06-03;"Trnavský kraj";14;4361;11;4372;NA;260273;25;2021-06-03;89386
2021-06-02;"Trnavský kraj";4;4148;11;4159;NA;260273;15;2021-06-02;89361
2021-06-01;"Trnavský kraj";18;3662;5;3667;NA;260273;23;2021-06-01;89346
2021-05-31;"Trnavský kraj";14;5515;16;5531;NA;260273;30;2021-05-31;89323
2021-05-30;"Trnavský kraj";0;6473;7;6480;NA;260273;7;2021-05-30;89293
2021-05-29;"Trnavský kraj";11;8964;4;8968;NA;260273;15;2021-05-29;89286
2021-05-28;"Trnavský kraj";14;7160;11;7171;NA;260273;25;2021-05-28;89271
2021-05-27;"Trnavský kraj";22;4753;8;4761;NA;260273;30;2021-05-27;89246
2021-05-26;"Trnavský kraj";6;4870;8;4878;NA;260273;14;2021-05-26;89216
2021-05-25;"Trnavský kraj";19;5026;27;5053;NA;260273;46;2021-05-25;89202
2021-05-24;"Trnavský kraj";15;6520;22;6542;NA;260273;37;2021-05-24;89156
2021-05-23;"Trnavský kraj";0;7920;8;7928;NA;260273;8;2021-05-23;89119
2021-05-22;"Trnavský kraj";13;13381;21;13402;NA;260273;34;2021-05-22;89111
2021-05-21;"Trnavský kraj";16;8525;19;8544;NA;260273;35;2021-05-21;89077
2021-05-20;"Trnavský kraj";15;5511;11;5522;NA;260273;26;2021-05-20;89042
2021-05-19;"Trnavský kraj";18;5431;13;5444;NA;260273;31;2021-05-19;89016
2021-05-18;"Trnavský kraj";26;5768;15;5783;NA;260273;41;2021-05-18;88985
2021-05-17;"Trnavský kraj";17;6262;24;6286;NA;260273;41;2021-05-17;88944
2021-05-16;"Trnavský kraj";10;9984;8;9992;NA;260273;18;2021-05-16;88903
2021-05-15;"Trnavský kraj";11;18525;14;18539;NA;260273;25;2021-05-15;88885
2021-05-14;"Trnavský kraj";34;10279;21;10300;NA;260273;55;2021-05-14;88860
2021-05-13;"Trnavský kraj";26;6913;12;6925;NA;260273;38;2021-05-13;88805
2021-05-12;"Trnavský kraj";34;6621;26;6647;NA;260273;60;2021-05-12;88767
2021-05-11;"Trnavský kraj";32;6393;13;6406;NA;260273;45;2021-05-11;88707
2021-05-10;"Trnavský kraj";58;9139;24;9163;NA;260273;82;2021-05-10;88662
2021-05-09;"Trnavský kraj";21;12570;12;12582;NA;260273;33;2021-05-09;88580
2021-05-08;"Trnavský kraj";4;23028;22;23050;NA;260273;26;2021-05-08;88547
2021-05-07;"Trnavský kraj";26;15465;30;15495;NA;260273;56;2021-05-07;88521
2021-05-06;"Trnavský kraj";22;8407;22;8429;NA;260273;44;2021-05-06;88465
2021-05-05;"Trnavský kraj";34;6273;22;6295;NA;260273;56;2021-05-05;88421
2021-05-04;"Trnavský kraj";51;8538;17;8555;NA;260273;68;2021-05-04;88365
2021-05-03;"Trnavský kraj";20;8957;22;8979;NA;260273;42;2021-05-03;88297
2021-05-02;"Trnavský kraj";0;25657;29;25686;NA;260273;29;2021-05-02;88255
2021-05-01;"Trnavský kraj";30;81353;64;81417;NA;260273;94;2021-05-01;88226
2021-04-30;"Trnavský kraj";45;26846;35;26881;NA;260273;80;2021-04-30;88132
2021-04-29;"Trnavský kraj";25;20323;28;20351;NA;260273;53;2021-04-29;88052
2021-04-28;"Trnavský kraj";46;8896;28;8924;NA;260273;74;2021-04-28;87999
2021-04-27;"Trnavský kraj";54;8756;37;8793;NA;260273;91;2021-04-27;87925
2021-04-26;"Trnavský kraj";53;16116;42;16158;NA;260273;95;2021-04-26;87834
2021-04-25;"Trnavský kraj";0;30183;24;30207;NA;260273;24;2021-04-25;87739
2021-04-24;"Trnavský kraj";46;126077;84;126161;NA;260273;130;2021-04-24;87715
2021-04-23;"Trnavský kraj";71;25741;53;25794;NA;260273;124;2021-04-23;87585
2021-04-22;"Trnavský kraj";40;10904;25;10929;NA;260273;65;2021-04-22;87461
2021-04-21;"Trnavský kraj";60;10748;45;10793;NA;260273;105;2021-04-21;87396
2021-04-20;"Trnavský kraj";57;13504;28;13532;NA;260273;85;2021-04-20;87291
2021-04-19;"Trnavský kraj";46;14603;18;14621;NA;260273;64;2021-04-19;87206
2021-04-18;"Trnavský kraj";7;40843;43;40886;NA;260273;50;2021-04-18;87142
2021-04-17;"Trnavský kraj";58;118102;89;118191;NA;260273;147;2021-04-17;87092
2021-04-16;"Trnavský kraj";67;25962;48;26010;NA;260273;115;2021-04-16;86945
2021-04-15;"Trnavský kraj";65;11373;36;11409;NA;260273;101;2021-04-15;86830
2021-04-14;"Trnavský kraj";78;18442;53;18495;NA;260273;131;2021-04-14;86729
2021-04-13;"Trnavský kraj";126;9871;44;9915;NA;260273;170;2021-04-13;86598
2021-04-12;"Trnavský kraj";40;15577;40;15617;NA;260273;80;2021-04-12;86428
2021-04-11;"Trnavský kraj";3;44420;44;44464;NA;260273;47;2021-04-11;86348
2021-04-10;"Trnavský kraj";60;123822;107;123929;NA;260273;167;2021-04-10;86301
2021-04-09;"Trnavský kraj";95;26191;34;26225;NA;260273;129;2021-04-09;86134
2021-04-08;"Trnavský kraj";85;10913;54;10967;NA;260273;139;2021-04-08;86005
2021-04-07;"Trnavský kraj";131;15979;81;16060;NA;260273;212;2021-04-07;85866
2021-04-06;"Trnavský kraj";92;20586;90;20676;NA;260273;182;2021-04-06;85654
2021-04-05;"Trnavský kraj";91;7542;17;7559;NA;260273;108;2021-04-05;85472
2021-04-04;"Trnavský kraj";9;28831;49;28880;NA;260273;58;2021-04-04;85364
2021-04-03;"Trnavský kraj";29;144452;186;144638;NA;260273;215;2021-04-03;85306
2021-04-02;"Trnavský kraj";91;17538;33;17571;NA;260273;124;2021-04-02;85091
2021-04-01;"Trnavský kraj";118;22279;71;22350;NA;260273;189;2021-04-01;84967
2021-03-31;"Trnavský kraj";140;15828;82;15910;NA;260273;222;2021-03-31;84778
2021-03-30;"Trnavský kraj";182;10482;79;10561;NA;260273;261;2021-03-30;84556
2021-03-29;"Trnavský kraj";126;19255;122;19377;NA;260273;248;2021-03-29;84295
2021-03-28;"Trnavský kraj";26;50664;134;50798;NA;260273;160;2021-03-28;84047
2021-03-27;"Trnavský kraj";64;130217;246;130463;NA;260273;310;2021-03-27;83887
2021-03-26;"Trnavský kraj";139;30217;130;30347;NA;260273;269;2021-03-26;83577
2021-03-25;"Trnavský kraj";135;14212;80;14292;NA;260273;215;2021-03-25;83308
2021-03-24;"Trnavský kraj";159;10521;89;10610;NA;260273;248;2021-03-24;83093
2021-03-23;"Trnavský kraj";221;12735;104;12839;NA;260273;325;2021-03-23;82845
2021-03-22;"Trnavský kraj";103;17118;110;17228;NA;260273;213;2021-03-22;82520
2021-03-21;"Trnavský kraj";31;49119;150;49269;NA;260273;181;2021-03-21;82307
2021-03-20;"Trnavský kraj";112;136963;317;137280;NA;260273;429;2021-03-20;82126
2021-03-19;"Trnavský kraj";174;29071;137;29208;NA;260273;311;2021-03-19;81697
2021-03-18;"Trnavský kraj";158;12217;136;12353;NA;260273;294;2021-03-18;81386
2021-03-17;"Trnavský kraj";245;10434;103;10537;NA;260273;348;2021-03-17;81092
2021-03-16;"Trnavský kraj";311;12811;135;12946;NA;260273;446;2021-03-16;80744
2021-03-15;"Trnavský kraj";127;18271;146;18417;NA;260273;273;2021-03-15;80298
2021-03-14;"Trnavský kraj";14;47608;164;47772;NA;260273;178;2021-03-14;80025
2021-03-13;"Trnavský kraj";155;139224;409;139633;NA;260273;564;2021-03-13;79847
2021-03-12;"Trnavský kraj";201;28566;181;28747;NA;260273;382;2021-03-12;79283
2021-03-11;"Trnavský kraj";204;13301;140;13441;NA;260273;344;2021-03-11;78901
2021-03-10;"Trnavský kraj";242;10583;135;10718;NA;260273;377;2021-03-10;78557
2021-03-09;"Trnavský kraj";442;12824;155;12979;NA;260273;597;2021-03-09;78180
2021-03-08;"Trnavský kraj";182;21812;166;21978;NA;260273;348;2021-03-08;77583
2021-03-07;"Trnavský kraj";30;45463;227;45690;NA;260273;257;2021-03-07;77235
2021-03-06;"Trnavský kraj";154;135784;531;136315;NA;260273;685;2021-03-06;76978
2021-03-05;"Trnavský kraj";299;27959;239;28198;NA;260273;538;2021-03-05;76293
2021-03-04;"Trnavský kraj";238;14505;176;14681;NA;260273;414;2021-03-04;75755
2021-03-03;"Trnavský kraj";413;11583;246;11829;NA;260273;659;2021-03-03;75341
2021-03-02;"Trnavský kraj";477;12367;191;12558;NA;260273;668;2021-03-02;74682
2021-03-01;"Trnavský kraj";189;18586;234;18820;NA;260273;423;2021-03-01;74014
2021-02-28;"Trnavský kraj";87;47709;321;48030;NA;260273;408;2021-02-28;73591
2021-02-27;"Trnavský kraj";264;140224;800;141024;NA;260273;1064;2021-02-27;73183
2021-02-26;"Trnavský kraj";362;26637;284;26921;NA;260273;646;2021-02-26;72119
2021-02-25;"Trnavský kraj";433;10490;227;10717;NA;260273;660;2021-02-25;71473
2021-02-24;"Trnavský kraj";407;9113;290;9403;NA;260273;697;2021-02-24;70813
2021-02-23;"Trnavský kraj";469;11322;284;11606;NA;260273;753;2021-02-23;70116
2021-02-22;"Trnavský kraj";206;19901;330;20231;NA;260273;536;2021-02-22;69363
2021-02-21;"Trnavský kraj";38;48221;329;48550;NA;260273;367;2021-02-21;68827
2021-02-20;"Trnavský kraj";273;135835;859;136694;NA;260273;1132;2021-02-20;68460
2021-02-19;"Trnavský kraj";335;26382;366;26748;NA;260273;701;2021-02-19;67328
2021-02-18;"Trnavský kraj";344;11264;348;11612;NA;260273;692;2021-02-18;66627
2021-02-17;"Trnavský kraj";431;8783;416;9199;NA;260273;847;2021-02-17;65935
2021-02-16;"Trnavský kraj";426;11236;294;11530;NA;260273;720;2021-02-16;65088
2021-02-15;"Trnavský kraj";146;18276;326;18602;NA;260273;472;2021-02-15;64368
2021-02-14;"Trnavský kraj";51;57642;495;58137;NA;260273;546;2021-02-14;63896
2021-02-13;"Trnavský kraj";218;137051;994;138045;NA;260273;1212;2021-02-13;63350
2021-02-12;"Trnavský kraj";300;24090;352;24442;NA;260273;652;2021-02-12;62138
2021-02-11;"Trnavský kraj";422;9831;349;10180;NA;260273;771;2021-02-11;61486
2021-02-10;"Trnavský kraj";511;9194;342;9536;NA;260273;853;2021-02-10;60715
2021-02-09;"Trnavský kraj";544;12755;369;13124;NA;260273;913;2021-02-09;59862
2021-02-08;"Trnavský kraj";220;33414;497;33911;NA;260273;717;2021-02-08;58949
2021-02-07;"Trnavský kraj";140;69694;628;70322;NA;260273;768;2021-02-07;58232
2021-02-06;"Trnavský kraj";348;112687;1482;114169;NA;260273;1830;2021-02-06;57464
2021-02-05;"Trnavský kraj";377;16063;373;16436;NA;260273;750;2021-02-05;55634
2021-02-04;"Trnavský kraj";456;7317;456;7773;NA;260273;912;2021-02-04;54884
2021-02-03;"Trnavský kraj";472;6583;434;7017;NA;260273;906;2021-02-03;53972
2021-02-02;"Trnavský kraj";446;14243;424;14667;NA;260273;870;2021-02-02;53066
2021-02-01;"Trnavský kraj";198;38882;679;39561;NA;260273;877;2021-02-01;52196
2021-01-31;"Trnavský kraj";19;64707;822;65529;NA;260273;841;2021-01-31;51319
2021-01-30;"Trnavský kraj";323;111483;1288;112771;NA;260273;1611;2021-01-30;50478
2021-01-29;"Trnavský kraj";421;9689;290;9979;NA;260273;711;2021-01-29;48867
2021-01-28;"Trnavský kraj";389;5817;289;6106;NA;260273;678;2021-01-28;48156
2021-01-27;"Trnavský kraj";433;5554;225;5779;NA;260273;658;2021-01-27;47478
2021-01-26;"Trnavský kraj";565;25411;636;26047;NA;260273;1201;2021-01-26;46820
2021-01-25;"Trnavský kraj";210;41805;620;42425;NA;260273;830;2021-01-25;45619
2021-01-24;"Trnavský kraj";91;66399;779;67178;NA;260273;870;2021-01-24;44789
2021-01-23;"Trnavský kraj";372;113375;1319;114694;NA;260273;1691;2021-01-23;43919
2021-01-22;"Trnavský kraj";217;32755;505;33260;NA;260273;722;2021-01-22;42228
2021-01-21;"Trnavský kraj";311;13913;377;14290;NA;260273;688;2021-01-21;41506
2021-01-20;"Trnavský kraj";503;8685;283;8968;NA;260273;786;2021-01-20;40818
2021-01-19;"Trnavský kraj";415;7013;347;7360;NA;260273;762;2021-01-19;40032
2021-01-18;"Trnavský kraj";247;6690;513;7203;NA;260273;760;2021-01-18;39270
2021-01-17;"Trnavský kraj";128;854;215;1069;NA;260273;343;2021-01-17;38510
2021-01-16;"Trnavský kraj";103;898;24;922;NA;260273;127;2021-01-16;38167
2021-01-15;"Trnavský kraj";278;5467;336;5803;NA;260273;614;2021-01-15;38040
2021-01-14;"Trnavský kraj";452;4001;338;4339;NA;260273;790;2021-01-14;37426
2021-01-13;"Trnavský kraj";457;4751;378;5129;NA;260273;835;2021-01-13;36636
2021-01-12;"Trnavský kraj";469;6860;470;7330;NA;260273;939;2021-01-12;35801
2021-01-11;"Trnavský kraj";370;4587;360;4947;NA;260273;730;2021-01-11;34862
2021-01-10;"Trnavský kraj";71;13;0;13;NA;260273;71;2021-01-10;34132
2021-01-09;"Trnavský kraj";417;1775;100;1875;NA;260273;517;2021-01-09;34061
2021-01-08;"Trnavský kraj";381;6016;506;6522;NA;260273;887;2021-01-08;33544
2021-01-07;"Trnavský kraj";501;3545;329;3874;NA;260273;830;2021-01-07;32657
2021-01-06;"Trnavský kraj";179;758;132;890;NA;260273;311;2021-01-06;31827
2021-01-05;"Trnavský kraj";611;5165;561;5726;NA;260273;1172;2021-01-05;31516
2021-01-04;"Trnavský kraj";302;5556;709;6265;NA;260273;1011;2021-01-04;30344
2021-01-03;"Trnavský kraj";60;53;7;60;NA;260273;67;2021-01-03;29333
2021-01-02;"Trnavský kraj";282;417;32;449;NA;260273;314;2021-01-02;29266
2021-01-01;"Trnavský kraj";143;455;76;531;NA;260273;219;2021-01-01;28952
2020-12-31;"Trnavský kraj";498;8325;820;9145;NA;260273;1318;2020-12-31;28733
2020-12-30;"Trnavský kraj";785;5318;612;5930;NA;260273;1397;2020-12-30;27415
2020-12-29;"Trnavský kraj";322;4913;565;5478;NA;260273;887;2020-12-29;26018
2020-12-28;"Trnavský kraj";213;4900;552;5452;NA;260273;765;2020-12-28;25131
2020-12-27;"Trnavský kraj";27;20;4;24;NA;260273;31;2020-12-27;24366
2020-12-26;"Trnavský kraj";148;44;1;45;NA;260273;149;2020-12-26;24335
2020-12-25;"Trnavský kraj";65;49;5;54;NA;260273;70;2020-12-25;24186
2020-12-24;"Trnavský kraj";333;1359;117;1476;NA;260273;450;2020-12-24;24116
2020-12-23;"Trnavský kraj";210;6672;414;7086;NA;260273;624;2020-12-23;23666
2020-12-22;"Trnavský kraj";311;5427;455;5882;NA;260273;766;2020-12-22;23042
2020-12-21;"Trnavský kraj";328;4092;350;4442;NA;260273;678;2020-12-21;22276
2020-12-20;"Trnavský kraj";134;133;12;145;NA;260273;146;2020-12-20;21598
2020-12-19;"Trnavský kraj";201;1407;103;1510;NA;260273;304;2020-12-19;21452
2020-12-18;"Trnavský kraj";341;4432;334;4766;NA;260273;675;2020-12-18;21148
2020-12-17;"Trnavský kraj";375;4880;414;5294;NA;260273;789;2020-12-17;20473
2020-12-16;"Trnavský kraj";312;4945;383;5328;NA;260273;695;2020-12-16;19684
2020-12-15;"Trnavský kraj";492;6240;598;6838;NA;260273;1090;2020-12-15;18989
2020-12-14;"Trnavský kraj";161;3505;292;3797;NA;260273;453;2020-12-14;17899
2020-12-13;"Trnavský kraj";7;7;0;7;NA;260273;7;2020-12-13;17446
2020-12-12;"Trnavský kraj";254;1456;114;1570;NA;260273;368;2020-12-12;17439
2020-12-11;"Trnavský kraj";384;4289;241;4530;NA;260273;625;2020-12-11;17071
2020-12-10;"Trnavský kraj";183;5197;320;5517;NA;260273;503;2020-12-10;16446
2020-12-09;"Trnavský kraj";521;4199;317;4516;NA;260273;838;2020-12-09;15943
2020-12-08;"Trnavský kraj";281;4090;304;4394;NA;260273;585;2020-12-08;15105
2020-12-07;"Trnavský kraj";178;2895;199;3094;NA;260273;377;2020-12-07;14520
2020-12-06;"Trnavský kraj";46;0;0;0;NA;260273;46;2020-12-06;14143
2020-12-05;"Trnavský kraj";129;2218;41;2259;NA;260273;170;2020-12-05;14097
2020-12-04;"Trnavský kraj";242;3948;158;4106;NA;260273;400;2020-12-04;13927
2020-12-03;"Trnavský kraj";248;2770;190;2960;NA;260273;438;2020-12-03;13527
2020-12-02;"Trnavský kraj";284;4516;176;4692;NA;260273;460;2020-12-02;13089
2020-12-01;"Trnavský kraj";253;3190;205;3395;NA;260273;458;2020-12-01;12629
2020-11-30;"Trnavský kraj";200;7360;186;7546;NA;260273;386;2020-11-30;12171
2020-11-29;"Trnavský kraj";17;738;36;774;NA;260273;53;2020-11-29;11785
2020-11-28;"Trnavský kraj";83;1453;77;1530;NA;260273;160;2020-11-28;11732
2020-11-27;"Trnavský kraj";148;1779;85;1864;NA;260273;233;2020-11-27;11572
2020-11-26;"Trnavský kraj";234;1123;68;1191;NA;260273;302;2020-11-26;11339
2020-11-25;"Trnavský kraj";232;1168;74;1242;NA;260273;306;2020-11-25;11037
2020-11-24;"Trnavský kraj";295;1909;96;2005;NA;260273;391;2020-11-24;10731
2020-11-23;"Trnavský kraj";242;7393;129;7522;NA;260273;371;2020-11-23;10340
2020-11-22;"Trnavský kraj";10;82;9;91;NA;260273;19;2020-11-22;9969
2020-11-21;"Trnavský kraj";129;1354;36;1390;NA;260273;165;2020-11-21;9950
2020-11-20;"Trnavský kraj";246;1154;64;1218;NA;260273;310;2020-11-20;9785
2020-11-19;"Trnavský kraj";157;823;64;887;NA;260273;221;2020-11-19;9475
2020-11-18;"Trnavský kraj";235;822;82;904;NA;260273;317;2020-11-18;9254
2020-11-17;"Trnavský kraj";129;705;74;779;NA;260273;203;2020-11-17;8937
2020-11-16;"Trnavský kraj";187;732;32;764;NA;260273;219;2020-11-16;8734
2020-11-15;"Trnavský kraj";23;73;4;77;NA;260273;27;2020-11-15;8515
2020-11-14;"Trnavský kraj";86;397;12;409;NA;260273;98;2020-11-14;8488
2020-11-13;"Trnavský kraj";219;1312;21;1333;NA;260273;240;2020-11-13;8390
2020-11-12;"Trnavský kraj";162;420;18;438;NA;260273;180;2020-11-12;8150
2020-11-11;"Trnavský kraj";257;392;15;407;NA;260273;272;2020-11-11;7970
2020-11-10;"Trnavský kraj";189;889;30;919;NA;260273;219;2020-11-10;7698
2020-11-09;"Trnavský kraj";196;369;23;392;NA;260273;219;2020-11-09;7479
2020-11-08;"Trnavský kraj";55;400;4;404;NA;260273;59;2020-11-08;7260
2020-11-07;"Trnavský kraj";207;6070;74;6144;NA;260273;281;2020-11-07;7201
2020-11-06;"Trnavský kraj";260;1531;19;1550;NA;260273;279;2020-11-06;6920
2020-11-05;"Trnavský kraj";150;220;27;247;NA;260273;177;2020-11-05;6641
2020-11-04;"Trnavský kraj";188;212;10;222;NA;260273;198;2020-11-04;6464
2020-11-03;"Trnavský kraj";317;127;8;135;NA;260273;325;2020-11-03;6266
2020-11-02;"Trnavský kraj";281;1728;31;1759;NA;260273;312;2020-11-02;5941
2020-11-01;"Trnavský kraj";87;494;27;521;NA;260273;114;2020-11-01;5629
2020-10-31;"Trnavský kraj";259;5024;41;5065;NA;260273;300;2020-10-31;5515
2020-10-30;"Trnavský kraj";198;3784;27;3811;NA;260273;225;2020-10-30;5215
2020-10-29;"Trnavský kraj";273;1461;16;1477;NA;260273;289;2020-10-29;4990
2020-10-28;"Trnavský kraj";319;117;16;133;NA;260273;335;2020-10-28;4701
2020-10-27;"Trnavský kraj";199;461;36;497;NA;260273;235;2020-10-27;4366
2020-10-26;"Trnavský kraj";153;29;2;31;NA;260273;155;2020-10-26;4131
2020-10-25;"Trnavský kraj";95;19;1;20;NA;260273;96;2020-10-25;3976
2020-10-24;"Trnavský kraj";158;109;2;111;NA;260273;160;2020-10-24;3880
2020-10-23;"Trnavský kraj";201;89;4;93;NA;260273;205;2020-10-23;3720
2020-10-22;"Trnavský kraj";195;55;2;57;NA;260273;197;2020-10-22;3515
2020-10-21;"Trnavský kraj";134;73;3;76;NA;260273;137;2020-10-21;3318
2020-10-20;"Trnavský kraj";202;82;3;85;NA;260273;205;2020-10-20;3181
2020-10-19;"Trnavský kraj";67;55;0;55;NA;260273;67;2020-10-19;2976
2020-10-18;"Trnavský kraj";84;0;0;0;NA;260273;84;2020-10-18;2909
2020-10-17;"Trnavský kraj";53;0;0;0;NA;260273;53;2020-10-17;2825
2022-03-27;"Žilinský kraj";88;253;71;324;242516;336285;159;2022-03-27;336285
2022-03-26;"Žilinský kraj";586;202;46;248;NA;336285;632;2022-03-26;336126
2022-03-25;"Žilinský kraj";601;834;89;923;NA;336285;690;2022-03-25;335494
2022-03-24;"Žilinský kraj";697;1399;94;1493;NA;336285;791;2022-03-24;334804
2022-03-23;"Žilinský kraj";883;896;98;994;NA;336285;981;2022-03-23;334013
2022-03-22;"Žilinský kraj";1102;2485;126;2611;NA;336285;1228;2022-03-22;333032
2022-03-21;"Žilinský kraj";969;1886;156;2042;NA;336285;1125;2022-03-21;331804
2022-03-20;"Žilinský kraj";157;419;79;498;NA;336285;236;2022-03-20;330679
2022-03-19;"Žilinský kraj";479;319;64;383;NA;336285;543;2022-03-19;330443
2022-03-18;"Žilinský kraj";864;773;119;892;NA;336285;983;2022-03-18;329900
2022-03-17;"Žilinský kraj";733;1098;148;1246;NA;336285;881;2022-03-17;328917
2022-03-16;"Žilinský kraj";995;1350;160;1510;NA;336285;1155;2022-03-16;328036
2022-03-15;"Žilinský kraj";1252;2492;206;2698;NA;336285;1458;2022-03-15;326881
2022-03-14;"Žilinský kraj";1138;1510;194;1704;NA;336285;1332;2022-03-14;325423
2022-03-13;"Žilinský kraj";226;503;104;607;NA;336285;330;2022-03-13;324091
2022-03-12;"Žilinský kraj";650;332;92;424;NA;336285;742;2022-03-12;323761
2022-03-11;"Žilinský kraj";824;1730;193;1923;NA;336285;1017;2022-03-11;323019
2022-03-10;"Žilinský kraj";1249;1494;164;1658;NA;336285;1413;2022-03-10;322002
2022-03-09;"Žilinský kraj";1713;1457;206;1663;NA;336285;1919;2022-03-09;320589
2022-03-08;"Žilinský kraj";699;2333;311;2644;NA;336285;1010;2022-03-08;318670
2022-03-07;"Žilinský kraj";1448;2192;294;2486;NA;336285;1742;2022-03-07;317660
2022-03-06;"Žilinský kraj";323;780;206;986;NA;336285;529;2022-03-06;315918
2022-03-05;"Žilinský kraj";576;551;123;674;NA;336285;699;2022-03-05;315389
2022-03-04;"Žilinský kraj";1194;1840;254;2094;NA;336285;1448;2022-03-04;314690
2022-03-03;"Žilinský kraj";1240;1825;244;2069;NA;336285;1484;2022-03-03;313242
2022-03-02;"Žilinský kraj";1194;1772;244;2016;NA;336285;1438;2022-03-02;311758
2022-03-01;"Žilinský kraj";1710;2949;340;3289;NA;336285;2050;2022-03-01;310320
2022-02-28;"Žilinský kraj";1700;2980;355;3335;NA;336285;2055;2022-02-28;308270
2022-02-27;"Žilinský kraj";224;940;221;1161;NA;336285;445;2022-02-27;306215
2022-02-26;"Žilinský kraj";1184;816;171;987;NA;336285;1355;2022-02-26;305770
2022-02-25;"Žilinský kraj";1371;2421;320;2741;NA;336285;1691;2022-02-25;304415
2022-02-24;"Žilinský kraj";1504;2589;314;2903;NA;336285;1818;2022-02-24;302724
2022-02-23;"Žilinský kraj";1766;3298;333;3631;NA;336285;2099;2022-02-23;300906
2022-02-22;"Žilinský kraj";2419;3369;406;3775;NA;336285;2825;2022-02-22;298807
2022-02-21;"Žilinský kraj";2227;4181;573;4754;NA;336285;2800;2022-02-21;295982
2022-02-20;"Žilinský kraj";541;1473;304;1777;NA;336285;845;2022-02-20;293182
2022-02-19;"Žilinský kraj";1656;944;273;1217;NA;336285;1929;2022-02-19;292337
2022-02-18;"Žilinský kraj";1994;3335;439;3774;NA;336285;2433;2022-02-18;290408
2022-02-17;"Žilinský kraj";2274;3013;424;3437;NA;336285;2698;2022-02-17;287975
2022-02-16;"Žilinský kraj";2676;3573;496;4069;NA;336285;3172;2022-02-16;285277
2022-02-15;"Žilinský kraj";2939;4226;604;4830;NA;336285;3543;2022-02-15;282105
2022-02-14;"Žilinský kraj";2955;4182;777;4959;NA;336285;3732;2022-02-14;278562
2022-02-13;"Žilinský kraj";751;1842;464;2306;NA;336285;1215;2022-02-13;274830
2022-02-12;"Žilinský kraj";1771;1431;319;1750;NA;336285;2090;2022-02-12;273615
2022-02-11;"Žilinský kraj";2856;3332;570;3902;NA;336285;3426;2022-02-11;271525
2022-02-10;"Žilinský kraj";2861;3472;583;4055;NA;336285;3444;2022-02-10;268099
2022-02-09;"Žilinský kraj";3365;3863;618;4481;NA;336285;3983;2022-02-09;264655
2022-02-08;"Žilinský kraj";3367;4866;780;5646;NA;336285;4147;2022-02-08;260672
2022-02-07;"Žilinský kraj";3242;5569;913;6482;NA;336285;4155;2022-02-07;256525
2022-02-06;"Žilinský kraj";1389;2587;529;3116;NA;336285;1918;2022-02-06;252370
2022-02-05;"Žilinský kraj";2107;1846;425;2271;NA;336285;2532;2022-02-05;250452
2022-02-04;"Žilinský kraj";3099;4389;631;5020;NA;336285;3730;2022-02-04;247920
2022-02-03;"Žilinský kraj";3201;4122;613;4735;NA;336285;3814;2022-02-03;244190
2022-02-02;"Žilinský kraj";3168;4616;666;5282;NA;336285;3834;2022-02-02;240376
2022-02-01;"Žilinský kraj";3593;5240;694;5934;NA;336285;4287;2022-02-01;236542
2022-01-31;"Žilinský kraj";2145;7492;931;8423;NA;336285;3076;2022-01-31;232255
2022-01-30;"Žilinský kraj";1487;2898;431;3329;NA;336285;1918;2022-01-30;229179
2022-01-29;"Žilinský kraj";2055;2033;365;2398;NA;336285;2420;2022-01-29;227261
2022-01-28;"Žilinský kraj";2572;4800;546;5346;NA;336285;3118;2022-01-28;224841
2022-01-27;"Žilinský kraj";2406;4038;537;4575;NA;336285;2943;2022-01-27;221723
2022-01-26;"Žilinský kraj";2693;5009;516;5525;NA;336285;3209;2022-01-26;218780
2022-01-25;"Žilinský kraj";2595;5626;416;6042;NA;336285;3011;2022-01-25;215571
2022-01-24;"Žilinský kraj";1401;7098;522;7620;NA;336285;1923;2022-01-24;212560
2022-01-23;"Žilinský kraj";654;2923;276;3199;NA;336285;930;2022-01-23;210637
2022-01-22;"Žilinský kraj";1256;1706;206;1912;NA;336285;1462;2022-01-22;209707
2022-01-21;"Žilinský kraj";1188;4187;265;4452;NA;336285;1453;2022-01-21;208245
2022-01-20;"Žilinský kraj";1288;3654;205;3859;NA;336285;1493;2022-01-20;206792
2022-01-19;"Žilinský kraj";1215;4086;206;4292;NA;336285;1421;2022-01-19;205299
2022-01-18;"Žilinský kraj";1191;4213;168;4381;NA;336285;1359;2022-01-18;203878
2022-01-17;"Žilinský kraj";675;6886;256;7142;NA;336285;931;2022-01-17;202519
2022-01-16;"Žilinský kraj";175;2418;106;2524;NA;336285;281;2022-01-16;201588
2022-01-15;"Žilinský kraj";398;1410;70;1480;NA;336285;468;2022-01-15;201307
2022-01-14;"Žilinský kraj";446;3716;106;3822;NA;336285;552;2022-01-14;200839
2022-01-13;"Žilinský kraj";295;2912;78;2990;NA;336285;373;2022-01-13;200287
2022-01-12;"Žilinský kraj";422;3168;72;3240;NA;336285;494;2022-01-12;199914
2022-01-11;"Žilinský kraj";622;4216;57;4273;NA;336285;679;2022-01-11;199420
2022-01-10;"Žilinský kraj";436;6344;102;6446;NA;336285;538;2022-01-10;198741
2022-01-09;"Žilinský kraj";95;2934;54;2988;NA;336285;149;2022-01-09;198203
2022-01-08;"Žilinský kraj";345;1650;45;1695;NA;336285;390;2022-01-08;198054
2022-01-07;"Žilinský kraj";525;4566;75;4641;NA;336285;600;2022-01-07;197664
2022-01-06;"Žilinský kraj";167;1214;40;1254;NA;336285;207;2022-01-06;197064
2022-01-05;"Žilinský kraj";471;3492;75;3567;NA;336285;546;2022-01-05;196857
2022-01-04;"Žilinský kraj";606;3762;87;3849;NA;336285;693;2022-01-04;196311
2022-01-03;"Žilinský kraj";601;6083;116;6199;NA;336285;717;2022-01-03;195618
2022-01-02;"Žilinský kraj";288;2596;85;2681;NA;336285;373;2022-01-02;194901
2022-01-01;"Žilinský kraj";14;439;15;454;NA;336285;29;2022-01-01;194528
2021-12-31;"Žilinský kraj";323;1608;70;1678;NA;336285;393;2021-12-31;194499
2021-12-30;"Žilinský kraj";492;2213;95;2308;NA;336285;587;2021-12-30;194106
2021-12-29;"Žilinský kraj";543;6864;83;6947;NA;336285;626;2021-12-29;193519
2021-12-28;"Žilinský kraj";641;3408;106;3514;NA;336285;747;2021-12-28;192893
2021-12-27;"Žilinský kraj";691;3961;145;4106;NA;336285;836;2021-12-27;192146
2021-12-26;"Žilinský kraj";242;1167;58;1225;NA;336285;300;2021-12-26;191310
2021-12-25;"Žilinský kraj";22;442;45;487;NA;336285;67;2021-12-25;191010
2021-12-24;"Žilinský kraj";98;518;21;539;NA;336285;119;2021-12-24;190943
2021-12-23;"Žilinský kraj";731;2678;105;2783;NA;336285;836;2021-12-23;190824
2021-12-22;"Žilinský kraj";510;2428;77;2505;NA;336285;587;2021-12-22;189988
2021-12-21;"Žilinský kraj";755;3641;102;3743;NA;336285;857;2021-12-21;189401
2021-12-20;"Žilinský kraj";563;4545;125;4670;NA;336285;688;2021-12-20;188544
2021-12-19;"Žilinský kraj";133;2215;90;2305;NA;336285;223;2021-12-19;187856
2021-12-18;"Žilinský kraj";417;1321;70;1391;NA;336285;487;2021-12-18;187633
2021-12-17;"Žilinský kraj";604;3895;127;4022;NA;336285;731;2021-12-17;187146
2021-12-16;"Žilinský kraj";660;3931;109;4040;NA;336285;769;2021-12-16;186415
2021-12-15;"Žilinský kraj";802;3491;122;3613;NA;336285;924;2021-12-15;185646
2021-12-14;"Žilinský kraj";798;4587;129;4716;NA;336285;927;2021-12-14;184722
2021-12-13;"Žilinský kraj";759;7755;212;7967;NA;336285;971;2021-12-13;183795
2021-12-12;"Žilinský kraj";340;2836;114;2950;NA;336285;454;2021-12-12;182824
2021-12-11;"Žilinský kraj";761;1849;112;1961;NA;336285;873;2021-12-11;182370
2021-12-10;"Žilinský kraj";638;4041;136;4177;NA;336285;774;2021-12-10;181497
2021-12-09;"Žilinský kraj";870;5842;161;6003;NA;336285;1031;2021-12-09;180723
2021-12-08;"Žilinský kraj";1018;3215;158;3373;NA;336285;1176;2021-12-08;179692
2021-12-07;"Žilinský kraj";1356;5148;160;5308;NA;336285;1516;2021-12-07;178516
2021-12-06;"Žilinský kraj";919;7441;226;7667;NA;336285;1145;2021-12-06;177000
2021-12-05;"Žilinský kraj";505;3306;134;3440;NA;336285;639;2021-12-05;175855
2021-12-04;"Žilinský kraj";704;1892;153;2045;NA;336285;857;2021-12-04;175216
2021-12-03;"Žilinský kraj";1204;4864;215;5079;NA;336285;1419;2021-12-03;174359
2021-12-02;"Žilinský kraj";1847;4131;199;4330;NA;336285;2046;2021-12-02;172940
2021-12-01;"Žilinský kraj";1183;4073;195;4268;NA;336285;1378;2021-12-01;170894
2021-11-30;"Žilinský kraj";1575;5467;252;5719;NA;336285;1827;2021-11-30;169516
2021-11-29;"Žilinský kraj";1395;9069;358;9427;NA;336285;1753;2021-11-29;167689
2021-11-28;"Žilinský kraj";625;4581;235;4816;NA;336285;860;2021-11-28;165936
2021-11-27;"Žilinský kraj";909;2557;192;2749;NA;336285;1101;2021-11-27;165076
2021-11-26;"Žilinský kraj";1195;6599;344;6943;NA;336285;1539;2021-11-26;163975
2021-11-25;"Žilinský kraj";1281;4701;331;5032;NA;336285;1612;2021-11-25;162436
2021-11-24;"Žilinský kraj";1792;4660;324;4984;NA;336285;2116;2021-11-24;160824
2021-11-23;"Žilinský kraj";1630;4654;353;5007;NA;336285;1983;2021-11-23;158708
2021-11-22;"Žilinský kraj";1126;6699;452;7151;NA;336285;1578;2021-11-22;156725
2021-11-21;"Žilinský kraj";443;2865;260;3125;NA;336285;703;2021-11-21;155147
2021-11-20;"Žilinský kraj";963;2104;241;2345;NA;336285;1204;2021-11-20;154444
2021-11-19;"Žilinský kraj";1281;4622;434;5056;NA;336285;1715;2021-11-19;153240
2021-11-18;"Žilinský kraj";1220;4432;376;4808;NA;336285;1596;2021-11-18;151525
2021-11-17;"Žilinský kraj";1001;1434;149;1583;NA;336285;1150;2021-11-17;149929
2021-11-16;"Žilinský kraj";1197;4058;323;4381;NA;336285;1520;2021-11-16;148779
2021-11-15;"Žilinský kraj";977;5050;476;5526;NA;336285;1453;2021-11-15;147259
2021-11-14;"Žilinský kraj";356;2287;262;2549;NA;336285;618;2021-11-14;145806
2021-11-13;"Žilinský kraj";652;1882;220;2102;NA;336285;872;2021-11-13;145188
2021-11-12;"Žilinský kraj";1027;4291;340;4631;NA;336285;1367;2021-11-12;144316
2021-11-11;"Žilinský kraj";924;4192;272;4464;NA;336285;1196;2021-11-11;142949
2021-11-10;"Žilinský kraj";897;4509;305;4814;NA;336285;1202;2021-11-10;141753
2021-11-09;"Žilinský kraj";1440;4619;256;4875;NA;336285;1696;2021-11-09;140551
2021-11-08;"Žilinský kraj";781;4438;425;4863;NA;336285;1206;2021-11-08;138855
2021-11-07;"Žilinský kraj";304;2130;231;2361;NA;336285;535;2021-11-07;137649
2021-11-06;"Žilinský kraj";741;2150;201;2351;NA;336285;942;2021-11-06;137114
2021-11-05;"Žilinský kraj";1064;4067;235;4302;NA;336285;1299;2021-11-05;136172
2021-11-04;"Žilinský kraj";776;3709;232;3941;NA;336285;1008;2021-11-04;134873
2021-11-03;"Žilinský kraj";1106;5550;338;5888;NA;336285;1444;2021-11-03;133865
2021-11-02;"Žilinský kraj";1136;4451;333;4784;NA;336285;1469;2021-11-02;132421
2021-11-01;"Žilinský kraj";399;1456;137;1593;NA;336285;536;2021-11-01;130952
2021-10-31;"Žilinský kraj";344;1387;145;1532;NA;336285;489;2021-10-31;130416
2021-10-30;"Žilinský kraj";571;1944;161;2105;NA;336285;732;2021-10-30;129927
2021-10-29;"Žilinský kraj";733;3339;194;3533;NA;336285;927;2021-10-29;129195
2021-10-28;"Žilinský kraj";639;4953;247;5200;NA;336285;886;2021-10-28;128268
2021-10-27;"Žilinský kraj";739;3446;173;3619;NA;336285;912;2021-10-27;127382
2021-10-26;"Žilinský kraj";945;4748;216;4964;NA;336285;1161;2021-10-26;126470
2021-10-25;"Žilinský kraj";649;5736;271;6007;NA;336285;920;2021-10-25;125309
2021-10-24;"Žilinský kraj";248;1679;107;1786;NA;336285;355;2021-10-24;124389
2021-10-23;"Žilinský kraj";399;2415;149;2564;NA;336285;548;2021-10-23;124034
2021-10-22;"Žilinský kraj";587;3898;151;4049;NA;336285;738;2021-10-22;123486
2021-10-21;"Žilinský kraj";591;3367;162;3529;NA;336285;753;2021-10-21;122748
2021-10-20;"Žilinský kraj";479;3864;154;4018;NA;336285;633;2021-10-20;121995
2021-10-19;"Žilinský kraj";675;3763;161;3924;NA;336285;836;2021-10-19;121362
2021-10-18;"Žilinský kraj";432;5160;271;5431;NA;336285;703;2021-10-18;120526
2021-10-17;"Žilinský kraj";135;1769;101;1870;NA;336285;236;2021-10-17;119823
2021-10-16;"Žilinský kraj";273;2341;100;2441;NA;336285;373;2021-10-16;119587
2021-10-15;"Žilinský kraj";347;3859;146;4005;NA;336285;493;2021-10-15;119214
2021-10-14;"Žilinský kraj";419;3035;110;3145;NA;336285;529;2021-10-14;118721
2021-10-13;"Žilinský kraj";404;3427;112;3539;NA;336285;516;2021-10-13;118192
2021-10-12;"Žilinský kraj";589;4000;141;4141;NA;336285;730;2021-10-12;117676
2021-10-11;"Žilinský kraj";323;4501;154;4655;NA;336285;477;2021-10-11;116946
2021-10-10;"Žilinský kraj";113;1577;77;1654;NA;336285;190;2021-10-10;116469
2021-10-09;"Žilinský kraj";201;1565;57;1622;NA;336285;258;2021-10-09;116279
2021-10-08;"Žilinský kraj";265;4227;99;4326;NA;336285;364;2021-10-08;116021
2021-10-07;"Žilinský kraj";338;3384;113;3497;NA;336285;451;2021-10-07;115657
2021-10-06;"Žilinský kraj";313;3901;89;3990;NA;336285;402;2021-10-06;115206
2021-10-05;"Žilinský kraj";387;4031;122;4153;NA;336285;509;2021-10-05;114804
2021-10-04;"Žilinský kraj";297;4449;121;4570;NA;336285;418;2021-10-04;114295
2021-10-03;"Žilinský kraj";22;1596;63;1659;NA;336285;85;2021-10-03;113877
2021-10-02;"Žilinský kraj";209;1990;45;2035;NA;336285;254;2021-10-02;113792
2021-10-01;"Žilinský kraj";263;4047;104;4151;NA;336285;367;2021-10-01;113538
2021-09-30;"Žilinský kraj";248;3531;71;3602;NA;336285;319;2021-09-30;113171
2021-09-29;"Žilinský kraj";285;3577;82;3659;NA;336285;367;2021-09-29;112852
2021-09-28;"Žilinský kraj";272;3656;73;3729;NA;336285;345;2021-09-28;112485
2021-09-27;"Žilinský kraj";239;4418;152;4570;NA;336285;391;2021-09-27;112140
2021-09-26;"Žilinský kraj";17;1665;42;1707;NA;336285;59;2021-09-26;111749
2021-09-25;"Žilinský kraj";111;1711;50;1761;NA;336285;161;2021-09-25;111690
2021-09-24;"Žilinský kraj";199;6127;98;6225;NA;336285;297;2021-09-24;111529
2021-09-23;"Žilinský kraj";176;2629;74;2703;NA;336285;250;2021-09-23;111232
2021-09-22;"Žilinský kraj";185;2728;77;2805;NA;336285;262;2021-09-22;110982
2021-09-21;"Žilinský kraj";250;3123;78;3201;NA;336285;328;2021-09-21;110720
2021-09-20;"Žilinský kraj";244;3231;95;3326;NA;336285;339;2021-09-20;110392
2021-09-19;"Žilinský kraj";26;1579;37;1616;NA;336285;63;2021-09-19;110053
2021-09-18;"Žilinský kraj";87;1441;45;1486;NA;336285;132;2021-09-18;109990
2021-09-17;"Žilinský kraj";192;3351;56;3407;NA;336285;248;2021-09-17;109858
2021-09-16;"Žilinský kraj";164;2744;87;2831;NA;336285;251;2021-09-16;109610
2021-09-15;"Žilinský kraj";31;555;11;566;NA;336285;42;2021-09-15;109359
2021-09-14;"Žilinský kraj";155;3268;61;3329;NA;336285;216;2021-09-14;109317
2021-09-13;"Žilinský kraj";81;3250;75;3325;NA;336285;156;2021-09-13;109101
2021-09-12;"Žilinský kraj";9;1138;24;1162;NA;336285;33;2021-09-12;108945
2021-09-11;"Žilinský kraj";47;1322;21;1343;NA;336285;68;2021-09-11;108912
2021-09-10;"Žilinský kraj";66;2439;34;2473;NA;336285;100;2021-09-10;108844
2021-09-09;"Žilinský kraj";56;2352;18;2370;NA;336285;74;2021-09-09;108744
2021-09-08;"Žilinský kraj";68;1560;24;1584;NA;336285;92;2021-09-08;108670
2021-09-07;"Žilinský kraj";72;1806;27;1833;NA;336285;99;2021-09-07;108578
2021-09-06;"Žilinský kraj";31;2381;45;2426;NA;336285;76;2021-09-06;108479
2021-09-05;"Žilinský kraj";11;785;8;793;NA;336285;19;2021-09-05;108403
2021-09-04;"Žilinský kraj";24;1080;5;1085;NA;336285;29;2021-09-04;108384
2021-09-03;"Žilinský kraj";52;2047;28;2075;NA;336285;80;2021-09-03;108355
2021-09-02;"Žilinský kraj";30;1432;22;1454;NA;336285;52;2021-09-02;108275
2021-09-01;"Žilinský kraj";5;461;6;467;NA;336285;11;2021-09-01;108223
2021-08-31;"Žilinský kraj";32;1710;15;1725;NA;336285;47;2021-08-31;108212
2021-08-30;"Žilinský kraj";7;1801;4;1805;NA;336285;11;2021-08-30;108165
2021-08-29;"Žilinský kraj";8;631;5;636;NA;336285;13;2021-08-29;108154
2021-08-28;"Žilinský kraj";2;1005;1;1006;NA;336285;3;2021-08-28;108141
2021-08-27;"Žilinský kraj";13;1765;12;1777;NA;336285;25;2021-08-27;108138
2021-08-26;"Žilinský kraj";17;1636;7;1643;NA;336285;24;2021-08-26;108113
2021-08-25;"Žilinský kraj";9;1203;11;1214;NA;336285;20;2021-08-25;108089
2021-08-24;"Žilinský kraj";6;1395;9;1404;NA;336285;15;2021-08-24;108069
2021-08-23;"Žilinský kraj";11;1877;7;1884;NA;336285;18;2021-08-23;108054
2021-08-22;"Žilinský kraj";2;733;3;736;NA;336285;5;2021-08-22;108036
2021-08-21;"Žilinský kraj";6;1183;2;1185;NA;336285;8;2021-08-21;108031
2021-08-20;"Žilinský kraj";7;2284;5;2289;NA;336285;12;2021-08-20;108023
2021-08-19;"Žilinský kraj";6;1281;3;1284;NA;336285;9;2021-08-19;108011
2021-08-18;"Žilinský kraj";4;1331;7;1338;NA;336285;11;2021-08-18;108002
2021-08-17;"Žilinský kraj";9;1219;3;1222;NA;336285;12;2021-08-17;107991
2021-08-16;"Žilinský kraj";14;1696;5;1701;NA;336285;19;2021-08-16;107979
2021-08-15;"Žilinský kraj";1;880;2;882;NA;336285;3;2021-08-15;107960
2021-08-14;"Žilinský kraj";5;1197;0;1197;NA;336285;5;2021-08-14;107957
2021-08-13;"Žilinský kraj";6;1685;0;1685;NA;336285;6;2021-08-13;107952
2021-08-12;"Žilinský kraj";4;1105;1;1106;NA;336285;5;2021-08-12;107946
2021-08-11;"Žilinský kraj";13;1250;3;1253;NA;336285;16;2021-08-11;107941
2021-08-10;"Žilinský kraj";12;1292;3;1295;NA;336285;15;2021-08-10;107925
2021-08-09;"Žilinský kraj";9;1142;1;1143;NA;336285;10;2021-08-09;107910
2021-08-08;"Žilinský kraj";1;748;5;753;NA;336285;6;2021-08-08;107900
2021-08-07;"Žilinský kraj";7;1192;1;1193;NA;336285;8;2021-08-07;107894
2021-08-06;"Žilinský kraj";1;1347;0;1347;NA;336285;1;2021-08-06;107886
2021-08-05;"Žilinský kraj";7;1148;3;1151;NA;336285;10;2021-08-05;107885
2021-08-04;"Žilinský kraj";12;895;0;895;NA;336285;12;2021-08-04;107875
2021-08-03;"Žilinský kraj";11;918;0;918;NA;336285;11;2021-08-03;107863
2021-08-02;"Žilinský kraj";5;1513;1;1514;NA;336285;6;2021-08-02;107852
2021-08-01;"Žilinský kraj";0;679;2;681;NA;336285;2;2021-08-01;107846
2021-07-31;"Žilinský kraj";4;1114;0;1114;NA;336285;4;2021-07-31;107844
2021-07-30;"Žilinský kraj";3;1671;0;1671;NA;336285;3;2021-07-30;107840
2021-07-29;"Žilinský kraj";1;1299;0;1299;NA;336285;1;2021-07-29;107837
2021-07-28;"Žilinský kraj";4;901;0;901;NA;336285;4;2021-07-28;107836
2021-07-27;"Žilinský kraj";11;1378;0;1378;NA;336285;11;2021-07-27;107832
2021-07-26;"Žilinský kraj";1;1301;1;1302;NA;336285;2;2021-07-26;107821
2021-07-25;"Žilinský kraj";2;828;2;830;NA;336285;4;2021-07-25;107819
2021-07-24;"Žilinský kraj";2;1338;2;1340;NA;336285;4;2021-07-24;107815
2021-07-23;"Žilinský kraj";4;1750;0;1750;NA;336285;4;2021-07-23;107811
2021-07-22;"Žilinský kraj";2;1207;0;1207;NA;336285;2;2021-07-22;107807
2021-07-21;"Žilinský kraj";2;1021;0;1021;NA;336285;2;2021-07-21;107805
2021-07-20;"Žilinský kraj";4;1439;0;1439;NA;336285;4;2021-07-20;107803
2021-07-19;"Žilinský kraj";4;1763;1;1764;NA;336285;5;2021-07-19;107799
2021-07-18;"Žilinský kraj";0;854;1;855;NA;336285;1;2021-07-18;107794
2021-07-17;"Žilinský kraj";0;1350;0;1350;NA;336285;0;2021-07-17;107793
2021-07-16;"Žilinský kraj";2;1767;0;1767;NA;336285;2;2021-07-16;107793
2021-07-15;"Žilinský kraj";2;1577;0;1577;NA;336285;2;2021-07-15;107791
2021-07-14;"Žilinský kraj";5;1042;1;1043;NA;336285;6;2021-07-14;107789
2021-07-13;"Žilinský kraj";3;1709;1;1710;NA;336285;4;2021-07-13;107783
2021-07-12;"Žilinský kraj";3;1325;1;1326;NA;336285;4;2021-07-12;107779
2021-07-11;"Žilinský kraj";2;989;0;989;NA;336285;2;2021-07-11;107775
2021-07-10;"Žilinský kraj";1;1511;4;1515;NA;336285;5;2021-07-10;107773
2021-07-09;"Žilinský kraj";1;2208;1;2209;NA;336285;2;2021-07-09;107768
2021-07-08;"Žilinský kraj";6;1776;3;1779;NA;336285;9;2021-07-08;107766
2021-07-07;"Žilinský kraj";1;1585;3;1588;NA;336285;4;2021-07-07;107757
2021-07-06;"Žilinský kraj";4;1956;0;1956;NA;336285;4;2021-07-06;107753
2021-07-05;"Žilinský kraj";2;1031;1;1032;NA;336285;3;2021-07-05;107749
2021-07-04;"Žilinský kraj";0;1003;0;1003;NA;336285;0;2021-07-04;107746
2021-07-03;"Žilinský kraj";1;1696;2;1698;NA;336285;3;2021-07-03;107746
2021-07-02;"Žilinský kraj";0;3356;2;3358;NA;336285;2;2021-07-02;107743
2021-07-01;"Žilinský kraj";1;1118;0;1118;NA;336285;1;2021-07-01;107741
2021-06-30;"Žilinský kraj";1;10464;6;10470;NA;336285;7;2021-06-30;107740
2021-06-29;"Žilinský kraj";10;5946;0;5946;NA;336285;10;2021-06-29;107733
2021-06-28;"Žilinský kraj";4;6245;2;6247;NA;336285;6;2021-06-28;107723
2021-06-27;"Žilinský kraj";3;4702;1;4703;NA;336285;4;2021-06-27;107717
2021-06-26;"Žilinský kraj";4;5919;0;5919;NA;336285;4;2021-06-26;107713
2021-06-25;"Žilinský kraj";8;9756;5;9761;NA;336285;13;2021-06-25;107709
2021-06-24;"Žilinský kraj";6;5657;3;5660;NA;336285;9;2021-06-24;107696
2021-06-23;"Žilinský kraj";7;5955;10;5965;NA;336285;17;2021-06-23;107687
2021-06-22;"Žilinský kraj";6;5214;8;5222;NA;336285;14;2021-06-22;107670
2021-06-21;"Žilinský kraj";6;6287;8;6295;NA;336285;14;2021-06-21;107656
2021-06-20;"Žilinský kraj";1;5531;8;5539;NA;336285;9;2021-06-20;107642
2021-06-19;"Žilinský kraj";9;8353;2;8355;NA;336285;11;2021-06-19;107633
2021-06-18;"Žilinský kraj";11;10624;12;10636;NA;336285;23;2021-06-18;107622
2021-06-17;"Žilinský kraj";10;6092;12;6104;NA;336285;22;2021-06-17;107599
2021-06-16;"Žilinský kraj";17;5786;11;5797;NA;336285;28;2021-06-16;107577
2021-06-15;"Žilinský kraj";13;5996;13;6009;NA;336285;26;2021-06-15;107549
2021-06-14;"Žilinský kraj";10;7596;21;7617;NA;336285;31;2021-06-14;107523
2021-06-13;"Žilinský kraj";2;6682;9;6691;NA;336285;11;2021-06-13;107492
2021-06-12;"Žilinský kraj";9;8634;11;8645;NA;336285;20;2021-06-12;107481
2021-06-11;"Žilinský kraj";11;11566;14;11580;NA;336285;25;2021-06-11;107461
2021-06-10;"Žilinský kraj";14;6788;14;6802;NA;336285;28;2021-06-10;107436
2021-06-09;"Žilinský kraj";23;5925;14;5939;NA;336285;37;2021-06-09;107408
2021-06-08;"Žilinský kraj";18;6615;16;6631;NA;336285;34;2021-06-08;107371
2021-06-07;"Žilinský kraj";25;8534;21;8555;NA;336285;46;2021-06-07;107337
2021-06-06;"Žilinský kraj";10;8056;27;8083;NA;336285;37;2021-06-06;107291
2021-06-05;"Žilinský kraj";8;9175;10;9185;NA;336285;18;2021-06-05;107254
2021-06-04;"Žilinský kraj";19;12260;34;12294;NA;336285;53;2021-06-04;107236
2021-06-03;"Žilinský kraj";12;7033;33;7066;NA;336285;45;2021-06-03;107183
2021-06-02;"Žilinský kraj";17;7090;28;7118;NA;336285;45;2021-06-02;107138
2021-06-01;"Žilinský kraj";38;8285;46;8331;NA;336285;84;2021-06-01;107093
2021-05-31;"Žilinský kraj";31;9616;59;9675;NA;336285;90;2021-05-31;107009
2021-05-30;"Žilinský kraj";21;9025;35;9060;NA;336285;56;2021-05-30;106919
2021-05-29;"Žilinský kraj";13;11195;23;11218;NA;336285;36;2021-05-29;106863
2021-05-28;"Žilinský kraj";28;13277;30;13307;NA;336285;58;2021-05-28;106827
2021-05-27;"Žilinský kraj";17;8267;39;8306;NA;336285;56;2021-05-27;106769
2021-05-26;"Žilinský kraj";20;8329;25;8354;NA;336285;45;2021-05-26;106713
2021-05-25;"Žilinský kraj";21;9624;38;9662;NA;336285;59;2021-05-25;106668
2021-05-24;"Žilinský kraj";36;11487;57;11544;NA;336285;93;2021-05-24;106609
2021-05-23;"Žilinský kraj";4;10923;56;10979;NA;336285;60;2021-05-23;106516
2021-05-22;"Žilinský kraj";21;11893;28;11921;NA;336285;49;2021-05-22;106456
2021-05-21;"Žilinský kraj";28;15654;50;15704;NA;336285;78;2021-05-21;106407
2021-05-20;"Žilinský kraj";30;9616;30;9646;NA;336285;60;2021-05-20;106329
2021-05-19;"Žilinský kraj";46;8693;41;8734;NA;336285;87;2021-05-19;106269
2021-05-18;"Žilinský kraj";52;10609;44;10653;NA;336285;96;2021-05-18;106182
2021-05-17;"Žilinský kraj";51;12676;84;12760;NA;336285;135;2021-05-17;106086
2021-05-16;"Žilinský kraj";13;14114;42;14156;NA;336285;55;2021-05-16;105951
2021-05-15;"Žilinský kraj";30;18404;35;18439;NA;336285;65;2021-05-15;105896
2021-05-14;"Žilinský kraj";34;21205;82;21287;NA;336285;116;2021-05-14;105831
2021-05-13;"Žilinský kraj";64;11865;51;11916;NA;336285;115;2021-05-13;105715
2021-05-12;"Žilinský kraj";57;10337;51;10388;NA;336285;108;2021-05-12;105600
2021-05-11;"Žilinský kraj";70;12174;51;12225;NA;336285;121;2021-05-11;105492
2021-05-10;"Žilinský kraj";69;16182;72;16254;NA;336285;141;2021-05-10;105371
2021-05-09;"Žilinský kraj";58;20385;77;20462;NA;336285;135;2021-05-09;105230
2021-05-08;"Žilinský kraj";0;24133;63;24196;NA;336285;63;2021-05-08;105095
2021-05-07;"Žilinský kraj";65;26522;87;26609;NA;336285;152;2021-05-07;105032
2021-05-06;"Žilinský kraj";67;16605;72;16677;NA;336285;139;2021-05-06;104880
2021-05-05;"Žilinský kraj";71;13096;73;13169;NA;336285;144;2021-05-05;104741
2021-05-04;"Žilinský kraj";81;16749;80;16829;NA;336285;161;2021-05-04;104597
2021-05-03;"Žilinský kraj";97;20391;111;20502;NA;336285;208;2021-05-03;104436
2021-05-02;"Žilinský kraj";8;28886;64;28950;NA;336285;72;2021-05-02;104228
2021-05-01;"Žilinský kraj";65;55053;105;55158;NA;336285;170;2021-05-01;104156
2021-04-30;"Žilinský kraj";84;44000;117;44117;NA;336285;201;2021-04-30;103986
2021-04-29;"Žilinský kraj";77;24566;101;24667;NA;336285;178;2021-04-29;103785
2021-04-28;"Žilinský kraj";76;19214;91;19305;NA;336285;167;2021-04-28;103607
2021-04-27;"Žilinský kraj";97;21805;110;21915;NA;336285;207;2021-04-27;103440
2021-04-26;"Žilinský kraj";114;27412;136;27548;NA;336285;250;2021-04-26;103233
2021-04-25;"Žilinský kraj";38;35750;82;35832;NA;336285;120;2021-04-25;102983
2021-04-24;"Žilinský kraj";93;78854;157;79011;NA;336285;250;2021-04-24;102863
2021-04-23;"Žilinský kraj";144;49440;153;49593;NA;336285;297;2021-04-23;102613
2021-04-22;"Žilinský kraj";110;25224;132;25356;NA;336285;242;2021-04-22;102316
2021-04-21;"Žilinský kraj";118;20616;145;20761;NA;336285;263;2021-04-21;102074
2021-04-20;"Žilinský kraj";128;23873;136;24009;NA;336285;264;2021-04-20;101811
2021-04-19;"Žilinský kraj";164;32773;210;32983;NA;336285;374;2021-04-19;101547
2021-04-18;"Žilinský kraj";18;36767;91;36858;NA;336285;109;2021-04-18;101173
2021-04-17;"Žilinský kraj";108;89377;156;89533;NA;336285;264;2021-04-17;101064
2021-04-16;"Žilinský kraj";185;47847;208;48055;NA;336285;393;2021-04-16;100800
2021-04-15;"Žilinský kraj";108;24830;130;24960;NA;336285;238;2021-04-15;100407
2021-04-14;"Žilinský kraj";135;23145;145;23290;NA;336285;280;2021-04-14;100169
2021-04-13;"Žilinský kraj";171;25050;135;25185;NA;336285;306;2021-04-13;99889
2021-04-12;"Žilinský kraj";266;30794;189;30983;NA;336285;455;2021-04-12;99583
2021-04-11;"Žilinský kraj";19;37126;107;37233;NA;336285;126;2021-04-11;99128
2021-04-10;"Žilinský kraj";111;86284;237;86521;NA;336285;348;2021-04-10;99002
2021-04-09;"Žilinský kraj";195;41973;206;42179;NA;336285;401;2021-04-09;98654
2021-04-08;"Žilinský kraj";179;24404;141;24545;NA;336285;320;2021-04-08;98253
2021-04-07;"Žilinský kraj";309;28651;174;28825;NA;336285;483;2021-04-07;97933
2021-04-06;"Žilinský kraj";308;40107;301;40408;NA;336285;609;2021-04-06;97450
2021-04-05;"Žilinský kraj";17;14747;140;14887;NA;336285;157;2021-04-05;96841
2021-04-04;"Žilinský kraj";17;16284;69;16353;NA;336285;86;2021-04-04;96684
2021-04-03;"Žilinský kraj";180;100699;403;101102;NA;336285;583;2021-04-03;96598
2021-04-02;"Žilinský kraj";73;22411;83;22494;NA;336285;156;2021-04-02;96015
2021-04-01;"Žilinský kraj";334;43264;240;43504;NA;336285;574;2021-04-01;95859
2021-03-31;"Žilinský kraj";170;31635;247;31882;NA;336285;417;2021-03-31;95285
2021-03-30;"Žilinský kraj";406;26323;243;26566;NA;336285;649;2021-03-30;94868
2021-03-29;"Žilinský kraj";297;28029;268;28297;NA;336285;565;2021-03-29;94219
2021-03-28;"Žilinský kraj";21;36206;239;36445;NA;336285;260;2021-03-28;93654
2021-03-27;"Žilinský kraj";151;89107;353;89460;NA;336285;504;2021-03-27;93394
2021-03-26;"Žilinský kraj";312;51757;330;52087;NA;336285;642;2021-03-26;92890
2021-03-25;"Žilinský kraj";281;27619;214;27833;NA;336285;495;2021-03-25;92248
2021-03-24;"Žilinský kraj";280;21268;260;21528;NA;336285;540;2021-03-24;91753
2021-03-23;"Žilinský kraj";418;23193;278;23471;NA;336285;696;2021-03-23;91213
2021-03-22;"Žilinský kraj";293;29289;314;29603;NA;336285;607;2021-03-22;90517
2021-03-21;"Žilinský kraj";32;33705;227;33932;NA;336285;259;2021-03-21;89910
2021-03-20;"Žilinský kraj";165;93015;497;93512;NA;336285;662;2021-03-20;89651
2021-03-19;"Žilinský kraj";357;51988;414;52402;NA;336285;771;2021-03-19;88989
2021-03-18;"Žilinský kraj";329;28459;294;28753;NA;336285;623;2021-03-18;88218
2021-03-17;"Žilinský kraj";395;21919;269;22188;NA;336285;664;2021-03-17;87595
2021-03-16;"Žilinský kraj";514;24341;317;24658;NA;336285;831;2021-03-16;86931
2021-03-15;"Žilinský kraj";341;29613;419;30032;NA;336285;760;2021-03-15;86100
2021-03-14;"Žilinský kraj";87;34121;267;34388;NA;336285;354;2021-03-14;85340
2021-03-13;"Žilinský kraj";113;93386;581;93967;NA;336285;694;2021-03-13;84986
2021-03-12;"Žilinský kraj";520;52329;411;52740;NA;336285;931;2021-03-12;84292
2021-03-11;"Žilinský kraj";399;28189;302;28491;NA;336285;701;2021-03-11;83361
2021-03-10;"Žilinský kraj";368;22414;378;22792;NA;336285;746;2021-03-10;82660
2021-03-09;"Žilinský kraj";537;24857;316;25173;NA;336285;853;2021-03-09;81914
2021-03-08;"Žilinský kraj";387;30873;458;31331;NA;336285;845;2021-03-08;81061
2021-03-07;"Žilinský kraj";48;33469;290;33759;NA;336285;338;2021-03-07;80216
2021-03-06;"Žilinský kraj";173;92410;589;92999;NA;336285;762;2021-03-06;79878
2021-03-05;"Žilinský kraj";369;51987;484;52471;NA;336285;853;2021-03-05;79116
2021-03-04;"Žilinský kraj";467;30037;377;30414;NA;336285;844;2021-03-04;78263
2021-03-03;"Žilinský kraj";448;26261;394;26655;NA;336285;842;2021-03-03;77419
2021-03-02;"Žilinský kraj";551;25913;378;26291;NA;336285;929;2021-03-02;76577
2021-03-01;"Žilinský kraj";375;30498;441;30939;NA;336285;816;2021-03-01;75648
2021-02-28;"Žilinský kraj";61;34802;327;35129;NA;336285;388;2021-02-28;74832
2021-02-27;"Žilinský kraj";159;83781;639;84420;NA;336285;798;2021-02-27;74444
2021-02-26;"Žilinský kraj";459;47500;508;48008;NA;336285;967;2021-02-26;73646
2021-02-25;"Žilinský kraj";347;30879;393;31272;NA;336285;740;2021-02-25;72679
2021-02-24;"Žilinský kraj";339;18760;395;19155;NA;336285;734;2021-02-24;71939
2021-02-23;"Žilinský kraj";437;22172;418;22590;NA;336285;855;2021-02-23;71205
2021-02-22;"Žilinský kraj";345;29270;438;29708;NA;336285;783;2021-02-22;70350
2021-02-21;"Žilinský kraj";36;28686;322;29008;NA;336285;358;2021-02-21;69567
2021-02-20;"Žilinský kraj";152;89944;671;90615;NA;336285;823;2021-02-20;69209
2021-02-19;"Žilinský kraj";337;45541;417;45958;NA;336285;754;2021-02-19;68386
2021-02-18;"Žilinský kraj";263;24662;337;24999;NA;336285;600;2021-02-18;67632
2021-02-17;"Žilinský kraj";269;17932;355;18287;NA;336285;624;2021-02-17;67032
2021-02-16;"Žilinský kraj";321;24298;325;24623;NA;336285;646;2021-02-16;66408
2021-02-15;"Žilinský kraj";230;30420;311;30731;NA;336285;541;2021-02-15;65762
2021-02-14;"Žilinský kraj";30;28574;231;28805;NA;336285;261;2021-02-14;65221
2021-02-13;"Žilinský kraj";91;69638;453;70091;NA;336285;544;2021-02-13;64960
2021-02-12;"Žilinský kraj";242;43338;336;43674;NA;336285;578;2021-02-12;64416
2021-02-11;"Žilinský kraj";228;23521;300;23821;NA;336285;528;2021-02-11;63838
2021-02-10;"Žilinský kraj";259;17894;267;18161;NA;336285;526;2021-02-10;63310
2021-02-09;"Žilinský kraj";377;24784;274;25058;NA;336285;651;2021-02-09;62784
2021-02-08;"Žilinský kraj";160;41375;390;41765;NA;336285;550;2021-02-08;62133
2021-02-07;"Žilinský kraj";24;46446;252;46698;NA;336285;276;2021-02-07;61583
2021-02-06;"Žilinský kraj";71;72880;367;73247;NA;336285;438;2021-02-06;61307
2021-02-05;"Žilinský kraj";248;31869;323;32192;NA;336285;571;2021-02-05;60869
2021-02-04;"Žilinský kraj";238;13240;258;13498;NA;336285;496;2021-02-04;60298
2021-02-03;"Žilinský kraj";194;9186;255;9441;NA;336285;449;2021-02-03;59802
2021-02-02;"Žilinský kraj";216;9280;272;9552;NA;336285;488;2021-02-02;59353
2021-02-01;"Žilinský kraj";220;19690;370;20060;NA;336285;590;2021-02-01;58865
2021-01-31;"Žilinský kraj";11;2652;27;2679;NA;336285;38;2021-01-31;58275
2021-01-30;"Žilinský kraj";85;18447;187;18634;NA;336285;272;2021-01-30;58237
2021-01-29;"Žilinský kraj";209;22891;304;23195;NA;336285;513;2021-01-29;57965
2021-01-28;"Žilinský kraj";240;5533;172;5705;NA;336285;412;2021-01-28;57452
2021-01-27;"Žilinský kraj";256;6725;119;6844;NA;336285;375;2021-01-27;57040
2021-01-26;"Žilinský kraj";245;49781;348;50129;NA;336285;593;2021-01-26;56665
2021-01-25;"Žilinský kraj";159;21245;150;21395;NA;336285;309;2021-01-25;56072
2021-01-24;"Žilinský kraj";22;55835;268;56103;NA;336285;290;2021-01-24;55763
2021-01-23;"Žilinský kraj";91;101730;444;102174;NA;336285;535;2021-01-23;55473
2021-01-22;"Žilinský kraj";163;32160;237;32397;NA;336285;400;2021-01-22;54938
2021-01-21;"Žilinský kraj";116;19828;181;20009;NA;336285;297;2021-01-21;54538
2021-01-20;"Žilinský kraj";236;17126;159;17285;NA;336285;395;2021-01-20;54241
2021-01-19;"Žilinský kraj";245;15730;285;16015;NA;336285;530;2021-01-19;53846
2021-01-18;"Žilinský kraj";236;12685;326;13011;NA;336285;562;2021-01-18;53316
2021-01-17;"Žilinský kraj";95;147;8;155;NA;336285;103;2021-01-17;52754
2021-01-16;"Žilinský kraj";14;516;31;547;NA;336285;45;2021-01-16;52651
2021-01-15;"Žilinský kraj";248;7486;209;7695;NA;336285;457;2021-01-15;52606
2021-01-14;"Žilinský kraj";166;5319;239;5558;NA;336285;405;2021-01-14;52149
2021-01-13;"Žilinský kraj";247;11263;557;11820;NA;336285;804;2021-01-13;51744
2021-01-12;"Žilinský kraj";376;8410;385;8795;NA;336285;761;2021-01-12;50940
2021-01-11;"Žilinský kraj";351;10058;465;10523;NA;336285;816;2021-01-11;50179
2021-01-10;"Žilinský kraj";38;229;6;235;NA;336285;44;2021-01-10;49363
2021-01-09;"Žilinský kraj";192;1282;60;1342;NA;336285;252;2021-01-09;49319
2021-01-08;"Žilinský kraj";413;8721;462;9183;NA;336285;875;2021-01-08;49067
2021-01-07;"Žilinský kraj";438;23407;1872;25279;NA;336285;2310;2021-01-07;48192
2021-01-06;"Žilinský kraj";145;1076;67;1143;NA;336285;212;2021-01-06;45882
2021-01-05;"Žilinský kraj";717;10227;796;11023;NA;336285;1513;2021-01-05;45670
2021-01-04;"Žilinský kraj";479;9313;893;10206;NA;336285;1372;2021-01-04;44157
2021-01-03;"Žilinský kraj";13;1006;107;1113;NA;336285;120;2021-01-03;42785
2021-01-02;"Žilinský kraj";98;789;91;880;NA;336285;189;2021-01-02;42665
2021-01-01;"Žilinský kraj";118;241;13;254;NA;336285;131;2021-01-01;42476
2020-12-31;"Žilinský kraj";395;9626;784;10410;NA;336285;1179;2020-12-31;42345
2020-12-30;"Žilinský kraj";1038;11781;823;12604;NA;336285;1861;2020-12-30;41166
2020-12-29;"Žilinský kraj";256;10159;979;11138;NA;336285;1235;2020-12-29;39305
2020-12-28;"Žilinský kraj";406;10704;976;11680;NA;336285;1382;2020-12-28;38070
2020-12-27;"Žilinský kraj";40;684;94;778;NA;336285;134;2020-12-27;36688
2020-12-26;"Žilinský kraj";135;593;48;641;NA;336285;183;2020-12-26;36554
2020-12-25;"Žilinský kraj";66;83;9;92;NA;336285;75;2020-12-25;36371
2020-12-24;"Žilinský kraj";643;667;55;722;NA;336285;698;2020-12-24;36296
2020-12-23;"Žilinský kraj";228;16229;975;17204;NA;336285;1203;2020-12-23;35598
2020-12-22;"Žilinský kraj";519;13483;988;14471;NA;336285;1507;2020-12-22;34395
2020-12-21;"Žilinský kraj";444;12429;1078;13507;NA;336285;1522;2020-12-21;32888
2020-12-20;"Žilinský kraj";36;598;80;678;NA;336285;116;2020-12-20;31366
2020-12-19;"Žilinský kraj";208;1678;127;1805;NA;336285;335;2020-12-19;31250
2020-12-18;"Žilinský kraj";333;6553;370;6923;NA;336285;703;2020-12-18;30915
2020-12-17;"Žilinský kraj";500;3922;262;4184;NA;336285;762;2020-12-17;30212
2020-12-16;"Žilinský kraj";333;3815;267;4082;NA;336285;600;2020-12-16;29450
2020-12-15;"Žilinský kraj";528;3729;340;4069;NA;336285;868;2020-12-15;28850
2020-12-14;"Žilinský kraj";321;3884;309;4193;NA;336285;630;2020-12-14;27982
2020-12-13;"Žilinský kraj";26;494;66;560;NA;336285;92;2020-12-13;27352
2020-12-12;"Žilinský kraj";95;767;46;813;NA;336285;141;2020-12-12;27260
2020-12-11;"Žilinský kraj";455;3938;227;4165;NA;336285;682;2020-12-11;27119
2020-12-10;"Žilinský kraj";166;9129;838;9967;NA;336285;1004;2020-12-10;26437
2020-12-09;"Žilinský kraj";392;2169;132;2301;NA;336285;524;2020-12-09;25433
2020-12-08;"Žilinský kraj";331;3127;101;3228;NA;336285;432;2020-12-08;24909
2020-12-07;"Žilinský kraj";348;2746;162;2908;NA;336285;510;2020-12-07;24477
2020-12-06;"Žilinský kraj";15;128;6;134;NA;336285;21;2020-12-06;23967
2020-12-05;"Žilinský kraj";98;781;41;822;NA;336285;139;2020-12-05;23946
2020-12-04;"Žilinský kraj";228;3091;107;3198;NA;336285;335;2020-12-04;23807
2020-12-03;"Žilinský kraj";237;1609;115;1724;NA;336285;352;2020-12-03;23472
2020-12-02;"Žilinský kraj";181;1710;94;1804;NA;336285;275;2020-12-02;23120
2020-12-01;"Žilinský kraj";209;6239;284;6523;NA;336285;493;2020-12-01;22845
2020-11-30;"Žilinský kraj";203;5326;305;5631;NA;336285;508;2020-11-30;22352
2020-11-29;"Žilinský kraj";18;81;7;88;NA;336285;25;2020-11-29;21844
2020-11-28;"Žilinský kraj";99;349;15;364;NA;336285;114;2020-11-28;21819
2020-11-27;"Žilinský kraj";218;904;46;950;NA;336285;264;2020-11-27;21705
2020-11-26;"Žilinský kraj";190;1041;54;1095;NA;336285;244;2020-11-26;21441
2020-11-25;"Žilinský kraj";225;1217;49;1266;NA;336285;274;2020-11-25;21197
2020-11-24;"Žilinský kraj";213;2139;67;2206;NA;336285;280;2020-11-24;20923
2020-11-23;"Žilinský kraj";170;759;44;803;NA;336285;214;2020-11-23;20643
2020-11-22;"Žilinský kraj";11;67;2;69;NA;336285;13;2020-11-22;20429
2020-11-21;"Žilinský kraj";61;505;20;525;NA;336285;81;2020-11-21;20416
2020-11-20;"Žilinský kraj";251;1074;45;1119;NA;336285;296;2020-11-20;20335
2020-11-19;"Žilinský kraj";252;752;61;813;NA;336285;313;2020-11-19;20039
2020-11-18;"Žilinský kraj";346;348;15;363;NA;336285;361;2020-11-18;19726
2020-11-17;"Žilinský kraj";123;490;15;505;NA;336285;138;2020-11-17;19365
2020-11-16;"Žilinský kraj";227;247;15;262;NA;336285;242;2020-11-16;19227
2020-11-15;"Žilinský kraj";63;13;0;13;NA;336285;63;2020-11-15;18985
2020-11-14;"Žilinský kraj";189;1038;11;1049;NA;336285;200;2020-11-14;18922
2020-11-13;"Žilinský kraj";181;125;9;134;NA;336285;190;2020-11-13;18722
2020-11-12;"Žilinský kraj";334;79;2;81;NA;336285;336;2020-11-12;18532
2020-11-11;"Žilinský kraj";489;147;10;157;NA;336285;499;2020-11-11;18196
2020-11-10;"Žilinský kraj";374;519;9;528;NA;336285;383;2020-11-10;17697
2020-11-09;"Žilinský kraj";143;2335;30;2365;NA;336285;173;2020-11-09;17314
2020-11-08;"Žilinský kraj";59;2538;37;2575;NA;336285;96;2020-11-08;17141
2020-11-07;"Žilinský kraj";312;8175;88;8263;NA;336285;400;2020-11-07;17045
2020-11-06;"Žilinský kraj";503;4090;38;4128;NA;336285;541;2020-11-06;16645
2020-11-05;"Žilinský kraj";473;64;4;68;NA;336285;477;2020-11-05;16104
2020-11-04;"Žilinský kraj";423;178;10;188;NA;336285;433;2020-11-04;15627
2020-11-03;"Žilinský kraj";688;889;16;905;NA;336285;704;2020-11-03;15194
2020-11-02;"Žilinský kraj";472;1043;39;1082;NA;336285;511;2020-11-02;14490
2020-11-01;"Žilinský kraj";349;5096;130;5226;NA;336285;479;2020-11-01;13979
2020-10-31;"Žilinský kraj";661;7963;203;8166;NA;336285;864;2020-10-31;13500
2020-10-30;"Žilinský kraj";529;2575;61;2636;NA;336285;590;2020-10-30;12636
2020-10-29;"Žilinský kraj";740;503;17;520;NA;336285;757;2020-10-29;12046
2020-10-28;"Žilinský kraj";635;105;11;116;NA;336285;646;2020-10-28;11289
2020-10-27;"Žilinský kraj";355;154;24;178;NA;336285;379;2020-10-27;10643
2020-10-26;"Žilinský kraj";148;117;28;145;NA;336285;176;2020-10-26;10264
2020-10-25;"Žilinský kraj";436;0;0;0;NA;336285;436;2020-10-25;10088
2020-10-24;"Žilinský kraj";803;0;0;0;NA;336285;803;2020-10-24;9652
2020-10-23;"Žilinský kraj";659;102;13;115;NA;336285;672;2020-10-23;8849
2020-10-22;"Žilinský kraj";525;33;3;36;NA;336285;528;2020-10-22;8177
2020-10-21;"Žilinský kraj";478;74;14;88;NA;336285;492;2020-10-21;7649
2020-10-20;"Žilinský kraj";524;127;8;135;NA;336285;532;2020-10-20;7157
2020-10-19;"Žilinský kraj";70;80;12;92;NA;336285;82;2020-10-19;6625
2020-10-18;"Žilinský kraj";159;0;0;0;NA;336285;159;2020-10-18;6543
2020-10-17;"Žilinský kraj";196;0;0;0;NA;336285;196;2020-10-17;6384
