"Datum";"Region";"PCR_Pos";"Ag_Neg";"Ag_Pos";"Total";"Pocet.potvrdenych";"Potvrdenych";"newcases";"date";"positive"
2021-08-29;"Banskobystrický kraj";0;255;2;257;38328;84173;2;2021-08-29;84173
2021-08-28;"Banskobystrický kraj";9;787;5;792;NA;84173;14;2021-08-28;84171
2021-08-27;"Banskobystrický kraj";7;1558;11;1569;NA;84173;18;2021-08-27;84157
2021-08-26;"Banskobystrický kraj";7;1166;2;1168;NA;84173;9;2021-08-26;84139
2021-08-25;"Banskobystrický kraj";6;1024;1;1025;NA;84173;7;2021-08-25;84130
2021-08-24;"Banskobystrický kraj";12;1117;1;1118;NA;84173;13;2021-08-24;84123
2021-08-23;"Banskobystrický kraj";7;1451;5;1456;NA;84173;12;2021-08-23;84110
2021-08-22;"Banskobystrický kraj";0;651;2;653;NA;84173;2;2021-08-22;84098
2021-08-21;"Banskobystrický kraj";3;793;1;794;NA;84173;4;2021-08-21;84096
2021-08-20;"Banskobystrický kraj";5;1616;4;1620;NA;84173;9;2021-08-20;84092
2021-08-19;"Banskobystrický kraj";4;1092;3;1095;NA;84173;7;2021-08-19;84083
2021-08-18;"Banskobystrický kraj";1;1044;1;1045;NA;84173;2;2021-08-18;84076
2021-08-17;"Banskobystrický kraj";12;890;0;890;NA;84173;12;2021-08-17;84074
2021-08-16;"Banskobystrický kraj";7;1255;3;1258;NA;84173;10;2021-08-16;84062
2021-08-15;"Banskobystrický kraj";0;364;3;367;NA;84173;3;2021-08-15;84052
2021-08-14;"Banskobystrický kraj";6;435;1;436;NA;84173;7;2021-08-14;84049
2021-08-13;"Banskobystrický kraj";11;895;0;895;NA;84173;11;2021-08-13;84042
2021-08-12;"Banskobystrický kraj";10;951;1;952;NA;84173;11;2021-08-12;84031
2021-08-11;"Banskobystrický kraj";7;575;3;578;NA;84173;10;2021-08-11;84020
2021-08-10;"Banskobystrický kraj";7;678;2;680;NA;84173;9;2021-08-10;84010
2021-08-09;"Banskobystrický kraj";9;1063;0;1063;NA;84173;9;2021-08-09;84001
2021-08-08;"Banskobystrický kraj";4;335;1;336;NA;84173;5;2021-08-08;83992
2021-08-07;"Banskobystrický kraj";0;308;4;312;NA;84173;4;2021-08-07;83987
2021-08-06;"Banskobystrický kraj";5;929;2;931;NA;84173;7;2021-08-06;83983
2021-08-05;"Banskobystrický kraj";2;837;1;838;NA;84173;3;2021-08-05;83976
2021-08-04;"Banskobystrický kraj";2;579;1;580;NA;84173;3;2021-08-04;83973
2021-08-03;"Banskobystrický kraj";4;743;0;743;NA;84173;4;2021-08-03;83970
2021-08-02;"Banskobystrický kraj";6;934;0;934;NA;84173;6;2021-08-02;83966
2021-08-01;"Banskobystrický kraj";0;271;0;271;NA;84173;0;2021-08-01;83960
2021-07-31;"Banskobystrický kraj";1;370;4;374;NA;84173;5;2021-07-31;83960
2021-07-30;"Banskobystrický kraj";27;826;2;828;NA;84173;29;2021-07-30;83955
2021-07-29;"Banskobystrický kraj";2;890;1;891;NA;84173;3;2021-07-29;83926
2021-07-28;"Banskobystrický kraj";4;520;1;521;NA;84173;5;2021-07-28;83923
2021-07-27;"Banskobystrický kraj";15;1092;0;1092;NA;84173;15;2021-07-27;83918
2021-07-26;"Banskobystrický kraj";2;911;1;912;NA;84173;3;2021-07-26;83903
2021-07-25;"Banskobystrický kraj";0;367;1;368;NA;84173;1;2021-07-25;83900
2021-07-24;"Banskobystrický kraj";2;298;0;298;NA;84173;2;2021-07-24;83899
2021-07-23;"Banskobystrický kraj";7;840;0;840;NA;84173;7;2021-07-23;83897
2021-07-22;"Banskobystrický kraj";5;727;3;730;NA;84173;8;2021-07-22;83890
2021-07-21;"Banskobystrický kraj";2;560;0;560;NA;84173;2;2021-07-21;83882
2021-07-20;"Banskobystrický kraj";6;675;2;677;NA;84173;8;2021-07-20;83880
2021-07-19;"Banskobystrický kraj";1;854;3;857;NA;84173;4;2021-07-19;83872
2021-07-18;"Banskobystrický kraj";0;377;1;378;NA;84173;1;2021-07-18;83868
2021-07-17;"Banskobystrický kraj";1;324;0;324;NA;84173;1;2021-07-17;83867
2021-07-16;"Banskobystrický kraj";3;974;1;975;NA;84173;4;2021-07-16;83866
2021-07-15;"Banskobystrický kraj";1;1038;0;1038;NA;84173;1;2021-07-15;83862
2021-07-14;"Banskobystrický kraj";3;765;0;765;NA;84173;3;2021-07-14;83861
2021-07-13;"Banskobystrický kraj";2;694;0;694;NA;84173;2;2021-07-13;83858
2021-07-12;"Banskobystrický kraj";1;1057;0;1057;NA;84173;1;2021-07-12;83856
2021-07-11;"Banskobystrický kraj";0;446;0;446;NA;84173;0;2021-07-11;83855
2021-07-10;"Banskobystrický kraj";2;368;0;368;NA;84173;2;2021-07-10;83855
2021-07-09;"Banskobystrický kraj";3;1209;0;1209;NA;84173;3;2021-07-09;83853
2021-07-08;"Banskobystrický kraj";0;1083;1;1084;NA;84173;1;2021-07-08;83850
2021-07-07;"Banskobystrický kraj";1;798;0;798;NA;84173;1;2021-07-07;83849
2021-07-06;"Banskobystrický kraj";6;1365;0;1365;NA;84173;6;2021-07-06;83848
2021-07-05;"Banskobystrický kraj";2;392;1;393;NA;84173;3;2021-07-05;83842
2021-07-04;"Banskobystrický kraj";0;318;0;318;NA;84173;0;2021-07-04;83839
2021-07-03;"Banskobystrický kraj";1;413;1;414;NA;84173;2;2021-07-03;83839
2021-07-02;"Banskobystrický kraj";3;1045;0;1045;NA;84173;3;2021-07-02;83837
2021-07-01;"Banskobystrický kraj";0;705;1;706;NA;84173;1;2021-07-01;83834
2021-06-30;"Banskobystrický kraj";3;7444;1;7445;NA;84173;4;2021-06-30;83833
2021-06-29;"Banskobystrický kraj";2;4642;1;4643;NA;84173;3;2021-06-29;83829
2021-06-28;"Banskobystrický kraj";3;5695;1;5696;NA;84173;4;2021-06-28;83826
2021-06-27;"Banskobystrický kraj";0;4369;5;4374;NA;84173;5;2021-06-27;83822
2021-06-26;"Banskobystrický kraj";0;4289;4;4293;NA;84173;4;2021-06-26;83817
2021-06-25;"Banskobystrický kraj";2;6717;2;6719;NA;84173;4;2021-06-25;83813
2021-06-24;"Banskobystrický kraj";6;4575;2;4577;NA;84173;8;2021-06-24;83809
2021-06-23;"Banskobystrický kraj";4;4947;0;4947;NA;84173;4;2021-06-23;83801
2021-06-22;"Banskobystrický kraj";7;4527;0;4527;NA;84173;7;2021-06-22;83797
2021-06-21;"Banskobystrický kraj";6;5835;8;5843;NA;84173;14;2021-06-21;83790
2021-06-20;"Banskobystrický kraj";0;5055;7;5062;NA;84173;7;2021-06-20;83776
2021-06-19;"Banskobystrický kraj";0;5639;4;5643;NA;84173;4;2021-06-19;83769
2021-06-18;"Banskobystrický kraj";4;7642;1;7643;NA;84173;5;2021-06-18;83765
2021-06-17;"Banskobystrický kraj";2;5245;3;5248;NA;84173;5;2021-06-17;83760
2021-06-16;"Banskobystrický kraj";10;5951;5;5956;NA;84173;15;2021-06-16;83755
2021-06-15;"Banskobystrický kraj";9;5576;6;5582;NA;84173;15;2021-06-15;83740
2021-06-14;"Banskobystrický kraj";8;6922;7;6929;NA;84173;15;2021-06-14;83725
2021-06-13;"Banskobystrický kraj";0;6405;7;6412;NA;84173;7;2021-06-13;83710
2021-06-12;"Banskobystrický kraj";3;6338;6;6344;NA;84173;9;2021-06-12;83703
2021-06-11;"Banskobystrický kraj";5;9693;15;9708;NA;84173;20;2021-06-11;83694
2021-06-10;"Banskobystrický kraj";10;5726;8;5734;NA;84173;18;2021-06-10;83674
2021-06-09;"Banskobystrický kraj";9;5720;4;5724;NA;84173;13;2021-06-09;83656
2021-06-08;"Banskobystrický kraj";15;5645;10;5655;NA;84173;25;2021-06-08;83643
2021-06-07;"Banskobystrický kraj";4;7582;21;7603;NA;84173;25;2021-06-07;83618
2021-06-06;"Banskobystrický kraj";1;7497;12;7509;NA;84173;13;2021-06-06;83593
2021-06-05;"Banskobystrický kraj";15;7531;9;7540;NA;84173;24;2021-06-05;83580
2021-06-04;"Banskobystrický kraj";2;9297;14;9311;NA;84173;16;2021-06-04;83556
2021-06-03;"Banskobystrický kraj";8;6497;24;6521;NA;84173;32;2021-06-03;83540
2021-06-02;"Banskobystrický kraj";7;6837;6;6843;NA;84173;13;2021-06-02;83508
2021-06-01;"Banskobystrický kraj";12;7145;14;7159;NA;84173;26;2021-06-01;83495
2021-05-31;"Banskobystrický kraj";4;9546;31;9577;NA;84173;35;2021-05-31;83469
2021-05-30;"Banskobystrický kraj";3;8959;19;8978;NA;84173;22;2021-05-30;83434
2021-05-29;"Banskobystrický kraj";11;9763;18;9781;NA;84173;29;2021-05-29;83412
2021-05-28;"Banskobystrický kraj";13;11905;27;11932;NA;84173;40;2021-05-28;83383
2021-05-27;"Banskobystrický kraj";7;8760;12;8772;NA;84173;19;2021-05-27;83343
2021-05-26;"Banskobystrický kraj";18;7905;17;7922;NA;84173;35;2021-05-26;83324
2021-05-25;"Banskobystrický kraj";27;8949;30;8979;NA;84173;57;2021-05-25;83289
2021-05-24;"Banskobystrický kraj";9;12469;44;12513;NA;84173;53;2021-05-24;83232
2021-05-23;"Banskobystrický kraj";0;9798;27;9825;NA;84173;27;2021-05-23;83179
2021-05-22;"Banskobystrický kraj";20;9608;26;9634;NA;84173;46;2021-05-22;83152
2021-05-21;"Banskobystrický kraj";22;12796;25;12821;NA;84173;47;2021-05-21;83106
2021-05-20;"Banskobystrický kraj";14;8994;25;9019;NA;84173;39;2021-05-20;83059
2021-05-19;"Banskobystrický kraj";42;8608;21;8629;NA;84173;63;2021-05-19;83020
2021-05-18;"Banskobystrický kraj";27;9437;25;9462;NA;84173;52;2021-05-18;82957
2021-05-17;"Banskobystrický kraj";11;13399;33;13432;NA;84173;44;2021-05-17;82905
2021-05-16;"Banskobystrický kraj";15;14072;26;14098;NA;84173;41;2021-05-16;82861
2021-05-15;"Banskobystrický kraj";11;15356;29;15385;NA;84173;40;2021-05-15;82820
2021-05-14;"Banskobystrický kraj";35;18939;45;18984;NA;84173;80;2021-05-14;82780
2021-05-13;"Banskobystrický kraj";37;10605;40;10645;NA;84173;77;2021-05-13;82700
2021-05-12;"Banskobystrický kraj";31;10841;45;10886;NA;84173;76;2021-05-12;82623
2021-05-11;"Banskobystrický kraj";42;11325;48;11373;NA;84173;90;2021-05-11;82547
2021-05-10;"Banskobystrický kraj";28;17621;68;17689;NA;84173;96;2021-05-10;82457
2021-05-09;"Banskobystrický kraj";25;21902;68;21970;NA;84173;93;2021-05-09;82361
2021-05-08;"Banskobystrický kraj";11;14285;26;14311;NA;84173;37;2021-05-08;82268
2021-05-07;"Banskobystrický kraj";41;21806;78;21884;NA;84173;119;2021-05-07;82231
2021-05-06;"Banskobystrický kraj";36;12251;70;12321;NA;84173;106;2021-05-06;82112
2021-05-05;"Banskobystrický kraj";34;12592;63;12655;NA;84173;97;2021-05-05;82006
2021-05-04;"Banskobystrický kraj";83;13888;47;13935;NA;84173;130;2021-05-04;81909
2021-05-03;"Banskobystrický kraj";30;20872;80;20952;NA;84173;110;2021-05-03;81779
2021-05-02;"Banskobystrický kraj";6;33040;60;33100;NA;84173;66;2021-05-02;81669
2021-05-01;"Banskobystrický kraj";54;36900;67;36967;NA;84173;121;2021-05-01;81603
2021-04-30;"Banskobystrický kraj";38;34957;86;35043;NA;84173;124;2021-04-30;81482
2021-04-29;"Banskobystrický kraj";55;16839;68;16907;NA;84173;123;2021-04-29;81358
2021-04-28;"Banskobystrický kraj";66;17959;67;18026;NA;84173;133;2021-04-28;81235
2021-04-27;"Banskobystrický kraj";70;19152;73;19225;NA;84173;143;2021-04-27;81102
2021-04-26;"Banskobystrický kraj";34;28517;101;28618;NA;84173;135;2021-04-26;80959
2021-04-25;"Banskobystrický kraj";14;40601;106;40707;NA;84173;120;2021-04-25;80824
2021-04-24;"Banskobystrický kraj";40;51944;98;52042;NA;84173;138;2021-04-24;80704
2021-04-23;"Banskobystrický kraj";78;37920;88;38008;NA;84173;166;2021-04-23;80566
2021-04-22;"Banskobystrický kraj";51;17412;57;17469;NA;84173;108;2021-04-22;80400
2021-04-21;"Banskobystrický kraj";76;19208;94;19302;NA;84173;170;2021-04-21;80292
2021-04-20;"Banskobystrický kraj";116;21233;98;21331;NA;84173;214;2021-04-20;80122
2021-04-19;"Banskobystrický kraj";48;31407;105;31512;NA;84173;153;2021-04-19;79908
2021-04-18;"Banskobystrický kraj";16;43375;90;43465;NA;84173;106;2021-04-18;79755
2021-04-17;"Banskobystrický kraj";42;64939;92;65031;NA;84173;134;2021-04-17;79649
2021-04-16;"Banskobystrický kraj";72;37307;100;37407;NA;84173;172;2021-04-16;79515
2021-04-15;"Banskobystrický kraj";67;20115;83;20198;NA;84173;150;2021-04-15;79343
2021-04-14;"Banskobystrický kraj";69;21260;86;21346;NA;84173;155;2021-04-14;79193
2021-04-13;"Banskobystrický kraj";130;23076;77;23153;NA;84173;207;2021-04-13;79038
2021-04-12;"Banskobystrický kraj";60;32272;130;32402;NA;84173;190;2021-04-12;78831
2021-04-11;"Banskobystrický kraj";0;41367;88;41455;NA;84173;88;2021-04-11;78641
2021-04-10;"Banskobystrický kraj";56;64728;141;64869;NA;84173;197;2021-04-10;78553
2021-04-09;"Banskobystrický kraj";106;31570;118;31688;NA;84173;224;2021-04-09;78356
2021-04-08;"Banskobystrický kraj";132;18989;148;19137;NA;84173;280;2021-04-08;78132
2021-04-07;"Banskobystrický kraj";226;25118;94;25212;NA;84173;320;2021-04-07;77852
2021-04-06;"Banskobystrický kraj";93;42486;187;42673;NA;84173;280;2021-04-06;77532
2021-04-05;"Banskobystrický kraj";15;11797;87;11884;NA;84173;102;2021-04-05;77252
2021-04-04;"Banskobystrický kraj";24;19683;79;19762;NA;84173;103;2021-04-04;77150
2021-04-03;"Banskobystrický kraj";5;72553;211;72764;NA;84173;216;2021-04-03;77047
2021-04-02;"Banskobystrický kraj";71;13455;66;13521;NA;84173;137;2021-04-02;76831
2021-04-01;"Banskobystrický kraj";171;39406;200;39606;NA;84173;371;2021-04-01;76694
2021-03-31;"Banskobystrický kraj";147;25543;161;25704;NA;84173;308;2021-03-31;76323
2021-03-30;"Banskobystrický kraj";167;21442;159;21601;NA;84173;326;2021-03-30;76015
2021-03-29;"Banskobystrický kraj";119;29491;218;29709;NA;84173;337;2021-03-29;75689
2021-03-28;"Banskobystrický kraj";25;40610;189;40799;NA;84173;214;2021-03-28;75352
2021-03-27;"Banskobystrický kraj";85;63414;260;63674;NA;84173;345;2021-03-27;75138
2021-03-26;"Banskobystrický kraj";122;43661;240;43901;NA;84173;362;2021-03-26;74793
2021-03-25;"Banskobystrický kraj";120;21589;240;21829;NA;84173;360;2021-03-25;74431
2021-03-24;"Banskobystrický kraj";200;19336;227;19563;NA;84173;427;2021-03-24;74071
2021-03-23;"Banskobystrický kraj";241;21540;257;21797;NA;84173;498;2021-03-23;73644
2021-03-22;"Banskobystrický kraj";65;30480;274;30754;NA;84173;339;2021-03-22;73146
2021-03-21;"Banskobystrický kraj";31;40039;280;40319;NA;84173;311;2021-03-21;72807
2021-03-20;"Banskobystrický kraj";119;67926;383;68309;NA;84173;502;2021-03-20;72496
2021-03-19;"Banskobystrický kraj";240;44036;306;44342;NA;84173;546;2021-03-19;71994
2021-03-18;"Banskobystrický kraj";160;22467;273;22740;NA;84173;433;2021-03-18;71448
2021-03-17;"Banskobystrický kraj";262;21573;245;21818;NA;84173;507;2021-03-17;71015
2021-03-16;"Banskobystrický kraj";340;23349;224;23573;NA;84173;564;2021-03-16;70508
2021-03-15;"Banskobystrický kraj";95;32306;366;32672;NA;84173;461;2021-03-15;69944
2021-03-14;"Banskobystrický kraj";39;39212;218;39430;NA;84173;257;2021-03-14;69483
2021-03-13;"Banskobystrický kraj";209;67463;395;67858;NA;84173;604;2021-03-13;69226
2021-03-12;"Banskobystrický kraj";206;41442;330;41772;NA;84173;536;2021-03-12;68622
2021-03-11;"Banskobystrický kraj";228;21337;274;21611;NA;84173;502;2021-03-11;68086
2021-03-10;"Banskobystrický kraj";260;20399;238;20637;NA;84173;498;2021-03-10;67584
2021-03-09;"Banskobystrický kraj";352;21790;284;22074;NA;84173;636;2021-03-09;67086
2021-03-08;"Banskobystrický kraj";191;31468;427;31895;NA;84173;618;2021-03-08;66450
2021-03-07;"Banskobystrický kraj";60;39191;295;39486;NA;84173;355;2021-03-07;65832
2021-03-06;"Banskobystrický kraj";164;70895;410;71305;NA;84173;574;2021-03-06;65477
2021-03-05;"Banskobystrický kraj";221;42336;389;42725;NA;84173;610;2021-03-05;64903
2021-03-04;"Banskobystrický kraj";226;22007;334;22341;NA;84173;560;2021-03-04;64293
2021-03-03;"Banskobystrický kraj";317;21949;331;22280;NA;84173;648;2021-03-03;63733
2021-03-02;"Banskobystrický kraj";291;23160;354;23514;NA;84173;645;2021-03-02;63085
2021-03-01;"Banskobystrický kraj";151;31773;434;32207;NA;84173;585;2021-03-01;62440
2021-02-28;"Banskobystrický kraj";45;38663;336;38999;NA;84173;381;2021-02-28;61855
2021-02-27;"Banskobystrický kraj";289;66667;529;67196;NA;84173;818;2021-02-27;61474
2021-02-26;"Banskobystrický kraj";326;39670;468;40138;NA;84173;794;2021-02-26;60656
2021-02-25;"Banskobystrický kraj";375;18081;366;18447;NA;84173;741;2021-02-25;59862
2021-02-24;"Banskobystrický kraj";332;16735;373;17108;NA;84173;705;2021-02-24;59121
2021-02-23;"Banskobystrický kraj";462;19932;439;20371;NA;84173;901;2021-02-23;58416
2021-02-22;"Banskobystrický kraj";67;28643;598;29241;NA;84173;665;2021-02-22;57515
2021-02-21;"Banskobystrický kraj";68;37619;444;38063;NA;84173;512;2021-02-21;56850
2021-02-20;"Banskobystrický kraj";280;68851;598;69449;NA;84173;878;2021-02-20;56338
2021-02-19;"Banskobystrický kraj";420;39888;511;40399;NA;84173;931;2021-02-19;55460
2021-02-18;"Banskobystrický kraj";241;18618;396;19014;NA;84173;637;2021-02-18;54529
2021-02-17;"Banskobystrický kraj";415;16740;389;17129;NA;84173;804;2021-02-17;53892
2021-02-16;"Banskobystrický kraj";338;19731;368;20099;NA;84173;706;2021-02-16;53088
2021-02-15;"Banskobystrický kraj";118;35835;591;36426;NA;84173;709;2021-02-15;52382
2021-02-14;"Banskobystrický kraj";60;31894;386;32280;NA;84173;446;2021-02-14;51673
2021-02-13;"Banskobystrický kraj";202;53889;492;54381;NA;84173;694;2021-02-13;51227
2021-02-12;"Banskobystrický kraj";312;37270;533;37803;NA;84173;845;2021-02-12;50533
2021-02-11;"Banskobystrický kraj";305;21200;386;21586;NA;84173;691;2021-02-11;49688
2021-02-10;"Banskobystrický kraj";333;14790;344;15134;NA;84173;677;2021-02-10;48997
2021-02-09;"Banskobystrický kraj";329;18504;362;18866;NA;84173;691;2021-02-09;48320
2021-02-08;"Banskobystrický kraj";103;49716;695;50411;NA;84173;798;2021-02-08;47629
2021-02-07;"Banskobystrický kraj";70;37659;335;37994;NA;84173;405;2021-02-07;46831
2021-02-06;"Banskobystrický kraj";178;69388;570;69958;NA;84173;748;2021-02-06;46426
2021-02-05;"Banskobystrický kraj";282;24577;363;24940;NA;84173;645;2021-02-05;45678
2021-02-04;"Banskobystrický kraj";240;14367;430;14797;NA;84173;670;2021-02-04;45033
2021-02-03;"Banskobystrický kraj";350;9459;255;9714;NA;84173;605;2021-02-03;44363
2021-02-02;"Banskobystrický kraj";277;15741;334;16075;NA;84173;611;2021-02-02;43758
2021-02-01;"Banskobystrický kraj";75;24346;489;24835;NA;84173;564;2021-02-01;43147
2021-01-31;"Banskobystrický kraj";34;19983;201;20184;NA;84173;235;2021-01-31;42583
2021-01-30;"Banskobystrický kraj";163;63896;525;64421;NA;84173;688;2021-01-30;42348
2021-01-29;"Banskobystrický kraj";196;17368;274;17642;NA;84173;470;2021-01-29;41660
2021-01-28;"Banskobystrický kraj";218;15613;382;15995;NA;84173;600;2021-01-28;41190
2021-01-27;"Banskobystrický kraj";191;8132;200;8332;NA;84173;391;2021-01-27;40590
2021-01-26;"Banskobystrický kraj";238;19795;283;20078;NA;84173;521;2021-01-26;40199
2021-01-25;"Banskobystrický kraj";82;33666;412;34078;NA;84173;494;2021-01-25;39678
2021-01-24;"Banskobystrický kraj";38;35587;278;35865;NA;84173;316;2021-01-24;39184
2021-01-23;"Banskobystrický kraj";142;89058;523;89581;NA;84173;665;2021-01-23;38868
2021-01-22;"Banskobystrický kraj";175;25887;355;26242;NA;84173;530;2021-01-22;38203
2021-01-21;"Banskobystrický kraj";194;17063;279;17342;NA;84173;473;2021-01-21;37673
2021-01-20;"Banskobystrický kraj";231;9142;186;9328;NA;84173;417;2021-01-20;37200
2021-01-19;"Banskobystrický kraj";213;10708;311;11019;NA;84173;524;2021-01-19;36783
2021-01-18;"Banskobystrický kraj";94;7402;401;7803;NA;84173;495;2021-01-18;36259
2021-01-17;"Banskobystrický kraj";110;8154;77;8231;NA;84173;187;2021-01-17;35764
2021-01-16;"Banskobystrický kraj";58;2274;57;2331;NA;84173;115;2021-01-16;35577
2021-01-15;"Banskobystrický kraj";164;7673;217;7890;NA;84173;381;2021-01-15;35462
2021-01-14;"Banskobystrický kraj";220;5760;325;6085;NA;84173;545;2021-01-14;35081
2021-01-13;"Banskobystrický kraj";235;5974;217;6191;NA;84173;452;2021-01-13;34536
2021-01-12;"Banskobystrický kraj";194;6600;290;6890;NA;84173;484;2021-01-12;34084
2021-01-11;"Banskobystrický kraj";76;8231;481;8712;NA;84173;557;2021-01-11;33600
2021-01-10;"Banskobystrický kraj";110;433;4;437;NA;84173;114;2021-01-10;33043
2021-01-09;"Banskobystrický kraj";297;2378;81;2459;NA;84173;378;2021-01-09;32929
2021-01-08;"Banskobystrický kraj";435;9807;443;10250;NA;84173;878;2021-01-08;32551
2021-01-07;"Banskobystrický kraj";127;6322;366;6688;NA;84173;493;2021-01-07;31673
2021-01-06;"Banskobystrický kraj";305;3374;185;3559;NA;84173;490;2021-01-06;31180
2021-01-05;"Banskobystrický kraj";372;7349;533;7882;NA;84173;905;2021-01-05;30690
2021-01-04;"Banskobystrický kraj";130;7083;700;7783;NA;84173;830;2021-01-04;29785
2021-01-03;"Banskobystrický kraj";199;320;19;339;NA;84173;218;2021-01-03;28955
2021-01-02;"Banskobystrický kraj";123;702;85;787;NA;84173;208;2021-01-02;28737
2021-01-01;"Banskobystrický kraj";220;1958;132;2090;NA;84173;352;2021-01-01;28529
2020-12-31;"Banskobystrický kraj";499;7679;633;8312;NA;84173;1132;2020-12-31;28177
2020-12-30;"Banskobystrický kraj";593;7407;541;7948;NA;84173;1134;2020-12-30;27045
2020-12-29;"Banskobystrický kraj";240;7876;660;8536;NA;84173;900;2020-12-29;25911
2020-12-28;"Banskobystrický kraj";131;6120;720;6840;NA;84173;851;2020-12-28;25011
2020-12-27;"Banskobystrický kraj";116;541;25;566;NA;84173;141;2020-12-27;24160
2020-12-26;"Banskobystrický kraj";61;295;35;330;NA;84173;96;2020-12-26;24019
2020-12-25;"Banskobystrický kraj";65;888;10;898;NA;84173;75;2020-12-25;23923
2020-12-24;"Banskobystrický kraj";452;3685;135;3820;NA;84173;587;2020-12-24;23848
2020-12-23;"Banskobystrický kraj";368;9892;473;10365;NA;84173;841;2020-12-23;23261
2020-12-22;"Banskobystrický kraj";307;8467;619;9086;NA;84173;926;2020-12-22;22420
2020-12-21;"Banskobystrický kraj";286;4922;455;5377;NA;84173;741;2020-12-21;21494
2020-12-20;"Banskobystrický kraj";155;249;14;263;NA;84173;169;2020-12-20;20753
2020-12-19;"Banskobystrický kraj";170;3084;138;3222;NA;84173;308;2020-12-19;20584
2020-12-18;"Banskobystrický kraj";432;5959;331;6290;NA;84173;763;2020-12-18;20276
2020-12-17;"Banskobystrický kraj";468;8753;653;9406;NA;84173;1121;2020-12-17;19513
2020-12-16;"Banskobystrický kraj";379;10184;567;10751;NA;84173;946;2020-12-16;18392
2020-12-15;"Banskobystrický kraj";336;5281;425;5706;NA;84173;761;2020-12-15;17446
2020-12-14;"Banskobystrický kraj";148;4012;259;4271;NA;84173;407;2020-12-14;16685
2020-12-13;"Banskobystrický kraj";122;142;1;143;NA;84173;123;2020-12-13;16278
2020-12-12;"Banskobystrický kraj";137;2714;138;2852;NA;84173;275;2020-12-12;16155
2020-12-11;"Banskobystrický kraj";468;6633;362;6995;NA;84173;830;2020-12-11;15880
2020-12-10;"Banskobystrický kraj";280;5501;369;5870;NA;84173;649;2020-12-10;15050
2020-12-09;"Banskobystrický kraj";323;3941;205;4146;NA;84173;528;2020-12-09;14401
2020-12-08;"Banskobystrický kraj";256;3782;272;4054;NA;84173;528;2020-12-08;13873
2020-12-07;"Banskobystrický kraj";175;2633;177;2810;NA;84173;352;2020-12-07;13345
2020-12-06;"Banskobystrický kraj";121;507;11;518;NA;84173;132;2020-12-06;12993
2020-12-05;"Banskobystrický kraj";109;1099;34;1133;NA;84173;143;2020-12-05;12861
2020-12-04;"Banskobystrický kraj";339;3828;174;4002;NA;84173;513;2020-12-04;12718
2020-12-03;"Banskobystrický kraj";240;3193;234;3427;NA;84173;474;2020-12-03;12205
2020-12-02;"Banskobystrický kraj";217;4442;186;4628;NA;84173;403;2020-12-02;11731
2020-12-01;"Banskobystrický kraj";215;2702;134;2836;NA;84173;349;2020-12-01;11328
2020-11-30;"Banskobystrický kraj";74;4314;241;4555;NA;84173;315;2020-11-30;10979
2020-11-29;"Banskobystrický kraj";19;208;7;215;NA;84173;26;2020-11-29;10664
2020-11-28;"Banskobystrický kraj";81;1408;55;1463;NA;84173;136;2020-11-28;10638
2020-11-27;"Banskobystrický kraj";219;2266;123;2389;NA;84173;342;2020-11-27;10502
2020-11-26;"Banskobystrický kraj";208;2124;93;2217;NA;84173;301;2020-11-26;10160
2020-11-25;"Banskobystrický kraj";170;1952;86;2038;NA;84173;256;2020-11-25;9859
2020-11-24;"Banskobystrický kraj";166;2566;69;2635;NA;84173;235;2020-11-24;9603
2020-11-23;"Banskobystrický kraj";66;10147;193;10340;NA;84173;259;2020-11-23;9368
2020-11-22;"Banskobystrický kraj";38;104;1;105;NA;84173;39;2020-11-22;9109
2020-11-21;"Banskobystrický kraj";52;904;14;918;NA;84173;66;2020-11-21;9070
2020-11-20;"Banskobystrický kraj";127;2005;107;2112;NA;84173;234;2020-11-20;9004
2020-11-19;"Banskobystrický kraj";170;1218;82;1300;NA;84173;252;2020-11-19;8770
2020-11-18;"Banskobystrický kraj";153;698;65;763;NA;84173;218;2020-11-18;8518
2020-11-17;"Banskobystrický kraj";52;578;35;613;NA;84173;87;2020-11-17;8300
2020-11-16;"Banskobystrický kraj";106;470;25;495;NA;84173;131;2020-11-16;8213
2020-11-15;"Banskobystrický kraj";52;301;4;305;NA;84173;56;2020-11-15;8082
2020-11-14;"Banskobystrický kraj";73;305;2;307;NA;84173;75;2020-11-14;8026
2020-11-13;"Banskobystrický kraj";157;552;11;563;NA;84173;168;2020-11-13;7951
2020-11-12;"Banskobystrický kraj";218;952;44;996;NA;84173;262;2020-11-12;7783
2020-11-11;"Banskobystrický kraj";224;437;9;446;NA;84173;233;2020-11-11;7521
2020-11-10;"Banskobystrický kraj";263;463;18;481;NA;84173;281;2020-11-10;7288
2020-11-09;"Banskobystrický kraj";80;2678;31;2709;NA;84173;111;2020-11-09;7007
2020-11-08;"Banskobystrický kraj";82;981;16;997;NA;84173;98;2020-11-08;6896
2020-11-07;"Banskobystrický kraj";164;8828;94;8922;NA;84173;258;2020-11-07;6798
2020-11-06;"Banskobystrický kraj";227;2496;16;2512;NA;84173;243;2020-11-06;6540
2020-11-05;"Banskobystrický kraj";240;290;33;323;NA;84173;273;2020-11-05;6297
2020-11-04;"Banskobystrický kraj";254;1366;13;1379;NA;84173;267;2020-11-04;6024
2020-11-03;"Banskobystrický kraj";246;1332;4;1336;NA;84173;250;2020-11-03;5757
2020-11-02;"Banskobystrický kraj";90;2909;65;2974;NA;84173;155;2020-11-02;5507
2020-11-01;"Banskobystrický kraj";101;2671;42;2713;NA;84173;143;2020-11-01;5352
2020-10-31;"Banskobystrický kraj";199;13516;116;13632;NA;84173;315;2020-10-31;5209
2020-10-30;"Banskobystrický kraj";254;2829;20;2849;NA;84173;274;2020-10-30;4894
2020-10-29;"Banskobystrický kraj";372;969;42;1011;NA;84173;414;2020-10-29;4620
2020-10-28;"Banskobystrický kraj";285;302;30;332;NA;84173;315;2020-10-28;4206
2020-10-27;"Banskobystrický kraj";266;654;40;694;NA;84173;306;2020-10-27;3891
2020-10-26;"Banskobystrický kraj";38;234;29;263;NA;84173;67;2020-10-26;3585
2020-10-25;"Banskobystrický kraj";50;140;11;151;NA;84173;61;2020-10-25;3518
2020-10-24;"Banskobystrický kraj";315;114;12;126;NA;84173;327;2020-10-24;3457
2020-10-23;"Banskobystrický kraj";231;230;29;259;NA;84173;260;2020-10-23;3130
2020-10-22;"Banskobystrický kraj";264;253;24;277;NA;84173;288;2020-10-22;2870
2020-10-21;"Banskobystrický kraj";209;266;3;269;NA;84173;212;2020-10-21;2582
2020-10-20;"Banskobystrický kraj";210;66;3;69;NA;84173;213;2020-10-20;2370
2020-10-19;"Banskobystrický kraj";27;73;12;85;NA;84173;39;2020-10-19;2157
2020-10-18;"Banskobystrický kraj";49;0;0;0;NA;84173;49;2020-10-18;2118
2020-10-17;"Banskobystrický kraj";91;0;0;0;NA;84173;91;2020-10-17;2069
2020-10-16;"Banskobystrický kraj";224;37;3;40;NA;84173;227;2020-10-16;1978
2020-10-15;"Banskobystrický kraj";133;29;1;30;NA;84173;134;2020-10-15;1751
2020-10-14;"Banskobystrický kraj";139;31;1;32;NA;84173;140;2020-10-14;1617
2020-10-13;"Banskobystrický kraj";151;169;11;180;NA;84173;162;2020-10-13;1477
2020-10-12;"Banskobystrický kraj";11;110;4;114;NA;84173;15;2020-10-12;1315
2020-10-11;"Banskobystrický kraj";14;0;0;0;NA;84173;14;2020-10-11;1300
2020-10-10;"Banskobystrický kraj";53;0;0;0;NA;84173;53;2020-10-10;1286
2020-10-09;"Banskobystrický kraj";128;0;0;0;NA;84173;128;2020-10-09;1233
2020-10-08;"Banskobystrický kraj";99;0;0;0;NA;84173;99;2020-10-08;1105
2020-10-07;"Banskobystrický kraj";124;0;0;0;NA;84173;124;2020-10-07;1006
2020-10-06;"Banskobystrický kraj";68;0;0;0;NA;84173;68;2020-10-06;882
2020-10-05;"Banskobystrický kraj";49;0;0;0;NA;84173;49;2020-10-05;814
2020-10-04;"Banskobystrický kraj";8;0;0;0;NA;84173;8;2020-10-04;765
2020-10-03;"Banskobystrický kraj";37;0;0;0;NA;84173;37;2020-10-03;757
2020-10-02;"Banskobystrický kraj";74;0;0;0;NA;84173;74;2020-10-02;720
2020-10-01;"Banskobystrický kraj";49;0;0;0;NA;84173;49;2020-10-01;646
2020-09-30;"Banskobystrický kraj";60;0;0;0;NA;84173;60;2020-09-30;597
2020-09-29;"Banskobystrický kraj";24;0;0;0;NA;84173;24;2020-09-29;537
2020-09-28;"Banskobystrický kraj";0;0;0;0;NA;84173;0;2020-09-28;513
2020-09-27;"Banskobystrický kraj";20;0;0;0;NA;84173;20;2020-09-27;513
2020-09-26;"Banskobystrický kraj";24;0;0;0;NA;84173;24;2020-09-26;493
2020-09-25;"Banskobystrický kraj";29;0;0;0;NA;84173;29;2020-09-25;469
2020-09-24;"Banskobystrický kraj";25;0;0;0;NA;84173;25;2020-09-24;440
2020-09-23;"Banskobystrický kraj";17;0;0;0;NA;84173;17;2020-09-23;415
2020-09-22;"Banskobystrický kraj";25;0;0;0;NA;84173;25;2020-09-22;398
2020-09-21;"Banskobystrický kraj";3;0;0;0;NA;84173;3;2020-09-21;373
2020-09-20;"Banskobystrický kraj";0;0;0;0;NA;84173;0;2020-09-20;370
2020-09-19;"Banskobystrický kraj";3;0;0;0;NA;84173;3;2020-09-19;370
2020-09-18;"Banskobystrický kraj";24;0;0;0;NA;84173;24;2020-09-18;367
2020-09-17;"Banskobystrický kraj";14;0;0;0;NA;84173;14;2020-09-17;343
2020-09-16;"Banskobystrický kraj";6;0;0;0;NA;84173;6;2020-09-16;329
2020-09-15;"Banskobystrický kraj";2;0;0;0;NA;84173;2;2020-09-15;323
2020-09-14;"Banskobystrický kraj";13;0;0;0;NA;84173;13;2020-09-14;321
2020-09-13;"Banskobystrický kraj";1;0;0;0;NA;84173;1;2020-09-13;308
2020-09-12;"Banskobystrický kraj";5;0;0;0;NA;84173;5;2020-09-12;307
2020-09-11;"Banskobystrický kraj";19;0;0;0;NA;84173;19;2020-09-11;302
2020-09-10;"Banskobystrický kraj";11;0;0;0;NA;84173;11;2020-09-10;283
2020-09-09;"Banskobystrický kraj";13;0;0;0;NA;84173;13;2020-09-09;272
2020-09-08;"Banskobystrický kraj";5;0;0;0;NA;84173;5;2020-09-08;259
2020-09-07;"Banskobystrický kraj";2;0;0;0;NA;84173;2;2020-09-07;254
2020-09-06;"Banskobystrický kraj";0;0;0;0;NA;84173;0;2020-09-06;252
2020-09-05;"Banskobystrický kraj";0;0;0;0;NA;84173;0;2020-09-05;252
2020-09-04;"Banskobystrický kraj";9;0;0;0;NA;84173;9;2020-09-04;252
2020-09-03;"Banskobystrický kraj";5;0;0;0;NA;84173;5;2020-09-03;243
2020-09-02;"Banskobystrický kraj";6;0;0;0;NA;84173;6;2020-09-02;238
2020-09-01;"Banskobystrický kraj";2;0;0;0;NA;84173;2;2020-09-01;232
2020-08-31;"Banskobystrický kraj";6;0;0;0;NA;84173;6;2020-08-31;230
2020-08-30;"Banskobystrický kraj";0;0;0;0;NA;84173;0;2020-08-30;224
2020-08-29;"Banskobystrický kraj";1;0;0;0;NA;84173;1;2020-08-29;224
2020-08-28;"Banskobystrický kraj";3;0;0;0;NA;84173;3;2020-08-28;223
2020-08-27;"Banskobystrický kraj";1;0;0;0;NA;84173;1;2020-08-27;220
2020-08-26;"Banskobystrický kraj";2;0;0;0;NA;84173;2;2020-08-26;219
2020-08-25;"Banskobystrický kraj";2;0;0;0;NA;84173;2;2020-08-25;217
2020-08-24;"Banskobystrický kraj";0;0;0;0;NA;84173;0;2020-08-24;215
2020-08-23;"Banskobystrický kraj";0;0;0;0;NA;84173;0;2020-08-23;215
2020-08-22;"Banskobystrický kraj";0;0;0;0;NA;84173;0;2020-08-22;215
2020-08-21;"Banskobystrický kraj";4;0;0;0;NA;84173;4;2020-08-21;215
2020-08-20;"Banskobystrický kraj";1;0;0;0;NA;84173;1;2020-08-20;211
2020-08-19;"Banskobystrický kraj";4;0;0;0;NA;84173;4;2020-08-19;210
2020-08-18;"Banskobystrický kraj";0;0;0;0;NA;84173;0;2020-08-18;206
2020-08-17;"Banskobystrický kraj";1;0;0;0;NA;84173;1;2020-08-17;206
2020-08-16;"Banskobystrický kraj";0;0;0;0;NA;84173;0;2020-08-16;205
2020-08-15;"Banskobystrický kraj";0;0;0;0;NA;84173;0;2020-08-15;205
2020-08-14;"Banskobystrický kraj";5;0;0;0;NA;84173;5;2020-08-14;205
2020-08-13;"Banskobystrický kraj";0;0;0;0;NA;84173;0;2020-08-13;200
2020-08-12;"Banskobystrický kraj";0;0;0;0;NA;84173;0;2020-08-12;200
2020-08-11;"Banskobystrický kraj";2;0;0;0;NA;84173;2;2020-08-11;200
2020-08-10;"Banskobystrický kraj";3;0;0;0;NA;84173;3;2020-08-10;198
2020-08-09;"Banskobystrický kraj";0;0;0;0;NA;84173;0;2020-08-09;195
2020-08-08;"Banskobystrický kraj";2;0;0;0;NA;84173;2;2020-08-08;195
2020-08-07;"Banskobystrický kraj";1;0;0;0;NA;84173;1;2020-08-07;193
2020-08-06;"Banskobystrický kraj";1;0;0;0;NA;84173;1;2020-08-06;192
2020-08-05;"Banskobystrický kraj";0;0;0;0;NA;84173;0;2020-08-05;191
2020-08-04;"Banskobystrický kraj";3;0;0;0;NA;84173;3;2020-08-04;191
2020-08-03;"Banskobystrický kraj";0;0;0;0;NA;84173;0;2020-08-03;188
2020-08-02;"Banskobystrický kraj";0;0;0;0;NA;84173;0;2020-08-02;188
2020-08-01;"Banskobystrický kraj";1;0;0;0;NA;84173;1;2020-08-01;188
2020-07-31;"Banskobystrický kraj";2;0;0;0;NA;84173;2;2020-07-31;187
2020-07-30;"Banskobystrický kraj";1;0;0;0;NA;84173;1;2020-07-30;185
2020-07-29;"Banskobystrický kraj";0;0;0;0;NA;84173;0;2020-07-29;184
2020-07-28;"Banskobystrický kraj";2;0;0;0;NA;84173;2;2020-07-28;184
2020-07-27;"Banskobystrický kraj";3;0;0;0;NA;84173;3;2020-07-27;182
2020-07-26;"Banskobystrický kraj";0;0;0;0;NA;84173;0;2020-07-26;179
2020-07-25;"Banskobystrický kraj";0;0;0;0;NA;84173;0;2020-07-25;179
2020-07-24;"Banskobystrický kraj";9;0;0;0;NA;84173;9;2020-07-24;179
2020-07-23;"Banskobystrický kraj";0;0;0;0;NA;84173;0;2020-07-23;170
2020-07-22;"Banskobystrický kraj";3;0;0;0;NA;84173;3;2020-07-22;170
2020-07-21;"Banskobystrický kraj";3;0;0;0;NA;84173;3;2020-07-21;167
2020-07-20;"Banskobystrický kraj";1;0;0;0;NA;84173;1;2020-07-20;164
2020-07-19;"Banskobystrický kraj";1;0;0;0;NA;84173;1;2020-07-19;163
2020-07-18;"Banskobystrický kraj";0;0;0;0;NA;84173;0;2020-07-18;162
2020-07-17;"Banskobystrický kraj";2;0;0;0;NA;84173;2;2020-07-17;162
2020-07-16;"Banskobystrický kraj";1;0;0;0;NA;84173;1;2020-07-16;160
2020-07-15;"Banskobystrický kraj";4;0;0;0;NA;84173;4;2020-07-15;159
2020-07-14;"Banskobystrický kraj";2;0;0;0;NA;84173;2;2020-07-14;155
2020-07-13;"Banskobystrický kraj";1;0;0;0;NA;84173;1;2020-07-13;153
2020-07-12;"Banskobystrický kraj";0;0;0;0;NA;84173;0;2020-07-12;152
2020-07-11;"Banskobystrický kraj";0;0;0;0;NA;84173;0;2020-07-11;152
2020-07-10;"Banskobystrický kraj";3;0;0;0;NA;84173;3;2020-07-10;152
2020-07-09;"Banskobystrický kraj";9;0;0;0;NA;84173;9;2020-07-09;149
2020-07-08;"Banskobystrický kraj";0;0;0;0;NA;84173;0;2020-07-08;140
2020-07-07;"Banskobystrický kraj";4;0;0;0;NA;84173;4;2020-07-07;140
2020-07-06;"Banskobystrický kraj";0;0;0;0;NA;84173;0;2020-07-06;136
2020-07-05;"Banskobystrický kraj";0;0;0;0;NA;84173;0;2020-07-05;136
2020-07-04;"Banskobystrický kraj";1;0;0;0;NA;84173;1;2020-07-04;136
2020-07-03;"Banskobystrický kraj";4;0;0;0;NA;84173;4;2020-07-03;135
2020-07-02;"Banskobystrický kraj";0;0;0;0;NA;84173;0;2020-07-02;131
2020-07-01;"Banskobystrický kraj";1;0;0;0;NA;84173;1;2020-07-01;131
2020-06-30;"Banskobystrický kraj";0;12;0;12;NA;84173;0;2020-06-30;130
2020-06-29;"Banskobystrický kraj";0;0;0;0;NA;84173;0;2020-06-29;130
2020-06-28;"Banskobystrický kraj";0;0;0;0;NA;84173;0;2020-06-28;130
2020-06-27;"Banskobystrický kraj";0;0;0;0;NA;84173;0;2020-06-27;130
2020-06-26;"Banskobystrický kraj";0;0;0;0;NA;84173;0;2020-06-26;130
2020-06-25;"Banskobystrický kraj";1;0;0;0;NA;84173;1;2020-06-25;130
2020-06-24;"Banskobystrický kraj";0;0;0;0;NA;84173;0;2020-06-24;129
2020-06-23;"Banskobystrický kraj";6;0;0;0;NA;84173;6;2020-06-23;129
2020-06-22;"Banskobystrický kraj";0;0;0;0;NA;84173;0;2020-06-22;123
2020-06-21;"Banskobystrický kraj";0;0;0;0;NA;84173;0;2020-06-21;123
2020-06-20;"Banskobystrický kraj";0;0;0;0;NA;84173;0;2020-06-20;123
2020-06-19;"Banskobystrický kraj";2;0;0;0;NA;84173;2;2020-06-19;123
2020-06-18;"Banskobystrický kraj";10;0;0;0;NA;84173;10;2020-06-18;121
2020-06-17;"Banskobystrický kraj";1;0;0;0;NA;84173;1;2020-06-17;111
2020-06-16;"Banskobystrický kraj";0;0;0;0;NA;84173;0;2020-06-16;110
2020-06-14;"Banskobystrický kraj";2;0;0;0;NA;84173;2;2020-06-14;110
2020-06-13;"Banskobystrický kraj";2;0;0;0;NA;84173;2;2020-06-13;108
2020-06-12;"Banskobystrický kraj";0;0;0;0;NA;84173;0;2020-06-12;106
2020-06-11;"Banskobystrický kraj";1;0;0;0;NA;84173;1;2020-06-11;106
2020-06-10;"Banskobystrický kraj";0;0;0;0;NA;84173;0;2020-06-10;105
2020-06-09;"Banskobystrický kraj";0;0;0;0;NA;84173;0;2020-06-09;105
2020-06-08;"Banskobystrický kraj";0;0;0;0;NA;84173;0;2020-06-08;105
2020-06-07;"Banskobystrický kraj";0;0;0;0;NA;84173;0;2020-06-07;105
2020-06-05;"Banskobystrický kraj";2;0;0;0;NA;84173;2;2020-06-05;105
2020-06-03;"Banskobystrický kraj";0;0;0;0;NA;84173;0;2020-06-03;103
2020-06-02;"Banskobystrický kraj";0;0;0;0;NA;84173;0;2020-06-02;103
2020-05-31;"Banskobystrický kraj";0;0;0;0;NA;84173;0;2020-05-31;103
2020-05-29;"Banskobystrický kraj";0;0;0;0;NA;84173;0;2020-05-29;103
2020-05-27;"Banskobystrický kraj";1;0;0;0;NA;84173;1;2020-05-27;103
2020-05-26;"Banskobystrický kraj";0;0;0;0;NA;84173;0;2020-05-26;102
2020-05-25;"Banskobystrický kraj";0;0;0;0;NA;84173;0;2020-05-25;102
2020-05-24;"Banskobystrický kraj";0;0;0;0;NA;84173;0;2020-05-24;102
2020-05-23;"Banskobystrický kraj";1;0;0;0;NA;84173;1;2020-05-23;102
2020-05-22;"Banskobystrický kraj";0;0;0;0;NA;84173;0;2020-05-22;101
2020-05-21;"Banskobystrický kraj";0;0;0;0;NA;84173;0;2020-05-21;101
2020-05-20;"Banskobystrický kraj";1;0;0;0;NA;84173;1;2020-05-20;101
2020-05-19;"Banskobystrický kraj";0;0;0;0;NA;84173;0;2020-05-19;100
2020-05-17;"Banskobystrický kraj";0;0;0;0;NA;84173;0;2020-05-17;100
2020-05-16;"Banskobystrický kraj";0;0;0;0;NA;84173;0;2020-05-16;100
2020-05-15;"Banskobystrický kraj";0;0;0;0;NA;84173;0;2020-05-15;100
2020-05-14;"Banskobystrický kraj";0;0;0;0;NA;84173;0;2020-05-14;100
2020-05-13;"Banskobystrický kraj";0;0;0;0;NA;84173;0;2020-05-13;100
2020-05-12;"Banskobystrický kraj";1;0;0;0;NA;84173;1;2020-05-12;100
2020-05-11;"Banskobystrický kraj";0;0;0;0;NA;84173;0;2020-05-11;99
2020-05-09;"Banskobystrický kraj";0;0;0;0;NA;84173;0;2020-05-09;99
2020-05-07;"Banskobystrický kraj";2;0;0;0;NA;84173;2;2020-05-07;99
2020-05-06;"Banskobystrický kraj";1;0;0;0;NA;84173;1;2020-05-06;97
2020-05-05;"Banskobystrický kraj";2;0;0;0;NA;84173;2;2020-05-05;96
2020-05-04;"Banskobystrický kraj";0;0;0;0;NA;84173;0;2020-05-04;94
2020-05-03;"Banskobystrický kraj";0;0;0;0;NA;84173;0;2020-05-03;94
2020-05-02;"Banskobystrický kraj";0;0;0;0;NA;84173;0;2020-05-02;94
2020-05-01;"Banskobystrický kraj";0;0;0;0;NA;84173;0;2020-05-01;94
2020-04-30;"Banskobystrický kraj";1;0;0;0;NA;84173;1;2020-04-30;94
2020-04-29;"Banskobystrický kraj";1;0;0;0;NA;84173;1;2020-04-29;93
2020-04-28;"Banskobystrický kraj";0;0;0;0;NA;84173;0;2020-04-28;92
2020-04-27;"Banskobystrický kraj";0;0;0;0;NA;84173;0;2020-04-27;92
2020-04-26;"Banskobystrický kraj";0;0;0;0;NA;84173;0;2020-04-26;92
2020-04-25;"Banskobystrický kraj";2;0;0;0;NA;84173;2;2020-04-25;92
2020-04-24;"Banskobystrický kraj";3;0;0;0;NA;84173;3;2020-04-24;90
2020-04-23;"Banskobystrický kraj";2;0;0;0;NA;84173;2;2020-04-23;87
2020-04-22;"Banskobystrický kraj";2;0;0;0;NA;84173;2;2020-04-22;85
2020-04-21;"Banskobystrický kraj";2;0;0;0;NA;84173;2;2020-04-21;83
2020-04-20;"Banskobystrický kraj";0;0;0;0;NA;84173;0;2020-04-20;81
2020-04-19;"Banskobystrický kraj";0;0;0;0;NA;84173;0;2020-04-19;81
2020-04-18;"Banskobystrický kraj";8;0;0;0;NA;84173;8;2020-04-18;81
2020-04-17;"Banskobystrický kraj";2;0;0;0;NA;84173;2;2020-04-17;73
2020-04-16;"Banskobystrický kraj";0;0;0;0;NA;84173;0;2020-04-16;71
2020-04-15;"Banskobystrický kraj";10;0;0;0;NA;84173;10;2020-04-15;71
2020-04-14;"Banskobystrický kraj";0;0;0;0;NA;84173;0;2020-04-14;61
2020-04-13;"Banskobystrický kraj";2;0;0;0;NA;84173;2;2020-04-13;61
2020-04-12;"Banskobystrický kraj";4;0;0;0;NA;84173;4;2020-04-12;59
2020-04-11;"Banskobystrický kraj";1;0;0;0;NA;84173;1;2020-04-11;55
2020-04-10;"Banskobystrický kraj";0;0;0;0;NA;84173;0;2020-04-10;54
2020-04-09;"Banskobystrický kraj";2;0;0;0;NA;84173;2;2020-04-09;54
2020-04-08;"Banskobystrický kraj";0;0;0;0;NA;84173;0;2020-04-08;52
2020-04-07;"Banskobystrický kraj";4;0;0;0;NA;84173;4;2020-04-07;52
2020-04-06;"Banskobystrický kraj";10;0;0;0;NA;84173;10;2020-04-06;48
2020-04-05;"Banskobystrický kraj";9;0;0;0;NA;84173;9;2020-04-05;38
2020-04-04;"Banskobystrický kraj";0;0;0;0;NA;84173;0;2020-04-04;29
2020-04-03;"Banskobystrický kraj";2;0;0;0;NA;84173;2;2020-04-03;29
2020-04-02;"Banskobystrický kraj";2;0;0;0;NA;84173;2;2020-04-02;27
2020-04-01;"Banskobystrický kraj";5;0;0;0;NA;84173;5;2020-04-01;25
2020-03-31;"Banskobystrický kraj";3;0;0;0;NA;84173;3;2020-03-31;20
2020-03-30;"Banskobystrický kraj";1;0;0;0;NA;84173;1;2020-03-30;17
2020-03-29;"Banskobystrický kraj";2;0;0;0;NA;84173;2;2020-03-29;16
2020-03-28;"Banskobystrický kraj";1;0;0;0;NA;84173;1;2020-03-28;14
2020-03-27;"Banskobystrický kraj";1;0;0;0;NA;84173;1;2020-03-27;13
2020-03-26;"Banskobystrický kraj";1;0;0;0;NA;84173;1;2020-03-26;12
2020-03-25;"Banskobystrický kraj";0;0;0;0;NA;84173;0;2020-03-25;11
2020-03-24;"Banskobystrický kraj";1;0;0;0;NA;84173;1;2020-03-24;11
2020-03-23;"Banskobystrický kraj";1;0;0;0;NA;84173;1;2020-03-23;10
2020-03-22;"Banskobystrický kraj";0;0;0;0;NA;84173;0;2020-03-22;9
2020-03-21;"Banskobystrický kraj";3;0;0;0;NA;84173;3;2020-03-21;9
2020-03-20;"Banskobystrický kraj";0;0;0;0;NA;84173;0;2020-03-20;6
2020-03-19;"Banskobystrický kraj";2;0;0;0;NA;84173;2;2020-03-19;6
2020-03-18;"Banskobystrický kraj";1;0;0;0;NA;84173;1;2020-03-18;4
2020-03-17;"Banskobystrický kraj";1;0;0;0;NA;84173;1;2020-03-17;3
2020-03-16;"Banskobystrický kraj";0;0;0;0;NA;84173;0;2020-03-16;2
2020-03-15;"Banskobystrický kraj";1;0;0;0;NA;84173;1;2020-03-15;2
2020-03-14;"Banskobystrický kraj";0;0;0;0;NA;84173;0;2020-03-14;1
2020-03-13;"Banskobystrický kraj";1;0;0;0;NA;84173;1;2020-03-13;1
2020-03-12;"Banskobystrický kraj";0;0;0;0;NA;84173;0;2020-03-12;0
2020-03-11;"Banskobystrický kraj";0;0;0;0;NA;84173;0;2020-03-11;0
2020-03-09;"Banskobystrický kraj";0;0;0;0;NA;84173;0;2020-03-09;0
2020-03-08;"Banskobystrický kraj";0;0;0;0;NA;84173;0;2020-03-08;0
2020-03-07;"Banskobystrický kraj";0;0;0;0;NA;84173;0;2020-03-07;0
2020-03-06;"Banskobystrický kraj";0;0;0;0;NA;84173;0;2020-03-06;0
2021-08-29;"Bratislavský kraj";11;801;5;806;45099;92093;16;2021-08-29;92093
2021-08-28;"Bratislavský kraj";24;1351;7;1358;NA;92093;31;2021-08-28;92077
2021-08-27;"Bratislavský kraj";19;2454;7;2461;NA;92093;26;2021-08-27;92046
2021-08-26;"Bratislavský kraj";15;2148;19;2167;NA;92093;34;2021-08-26;92020
2021-08-25;"Bratislavský kraj";29;1817;10;1827;NA;92093;39;2021-08-25;91986
2021-08-24;"Bratislavský kraj";22;1668;4;1672;NA;92093;26;2021-08-24;91947
2021-08-23;"Bratislavský kraj";21;2182;7;2189;NA;92093;28;2021-08-23;91921
2021-08-22;"Bratislavský kraj";5;1383;8;1391;NA;92093;13;2021-08-22;91893
2021-08-21;"Bratislavský kraj";18;1681;4;1685;NA;92093;22;2021-08-21;91880
2021-08-20;"Bratislavský kraj";27;2743;19;2762;NA;92093;46;2021-08-20;91858
2021-08-19;"Bratislavský kraj";15;2122;9;2131;NA;92093;24;2021-08-19;91812
2021-08-18;"Bratislavský kraj";16;1659;11;1670;NA;92093;27;2021-08-18;91788
2021-08-17;"Bratislavský kraj";18;1523;5;1528;NA;92093;23;2021-08-17;91761
2021-08-16;"Bratislavský kraj";18;2468;12;2480;NA;92093;30;2021-08-16;91738
2021-08-15;"Bratislavský kraj";3;1169;6;1175;NA;92093;9;2021-08-15;91708
2021-08-14;"Bratislavský kraj";11;1519;4;1523;NA;92093;15;2021-08-14;91699
2021-08-13;"Bratislavský kraj";32;2628;7;2635;NA;92093;39;2021-08-13;91684
2021-08-12;"Bratislavský kraj";16;1824;9;1833;NA;92093;25;2021-08-12;91645
2021-08-11;"Bratislavský kraj";22;1621;5;1626;NA;92093;27;2021-08-11;91620
2021-08-10;"Bratislavský kraj";15;1624;7;1631;NA;92093;22;2021-08-10;91593
2021-08-09;"Bratislavský kraj";35;1917;9;1926;NA;92093;44;2021-08-09;91571
2021-08-08;"Bratislavský kraj";3;1152;4;1156;NA;92093;7;2021-08-08;91527
2021-08-07;"Bratislavský kraj";6;1572;9;1581;NA;92093;15;2021-08-07;91520
2021-08-06;"Bratislavský kraj";9;2510;10;2520;NA;92093;19;2021-08-06;91505
2021-08-05;"Bratislavský kraj";10;1651;7;1658;NA;92093;17;2021-08-05;91486
2021-08-04;"Bratislavský kraj";9;1578;0;1578;NA;92093;9;2021-08-04;91469
2021-08-03;"Bratislavský kraj";11;1507;5;1512;NA;92093;16;2021-08-03;91460
2021-08-02;"Bratislavský kraj";15;1749;11;1760;NA;92093;26;2021-08-02;91444
2021-08-01;"Bratislavský kraj";4;1224;8;1232;NA;92093;12;2021-08-01;91418
2021-07-31;"Bratislavský kraj";7;1623;2;1625;NA;92093;9;2021-07-31;91406
2021-07-30;"Bratislavský kraj";15;2361;7;2368;NA;92093;22;2021-07-30;91397
2021-07-29;"Bratislavský kraj";19;1790;7;1797;NA;92093;26;2021-07-29;91375
2021-07-28;"Bratislavský kraj";8;1538;11;1549;NA;92093;19;2021-07-28;91349
2021-07-27;"Bratislavský kraj";9;1476;5;1481;NA;92093;14;2021-07-27;91330
2021-07-26;"Bratislavský kraj";17;1806;7;1813;NA;92093;24;2021-07-26;91316
2021-07-25;"Bratislavský kraj";4;1411;2;1413;NA;92093;6;2021-07-25;91292
2021-07-24;"Bratislavský kraj";9;1732;3;1735;NA;92093;12;2021-07-24;91286
2021-07-23;"Bratislavský kraj";6;2400;3;2403;NA;92093;9;2021-07-23;91274
2021-07-22;"Bratislavský kraj";12;1944;6;1950;NA;92093;18;2021-07-22;91265
2021-07-21;"Bratislavský kraj";5;1860;6;1866;NA;92093;11;2021-07-21;91247
2021-07-20;"Bratislavský kraj";19;1550;1;1551;NA;92093;20;2021-07-20;91236
2021-07-19;"Bratislavský kraj";15;2259;3;2262;NA;92093;18;2021-07-19;91216
2021-07-18;"Bratislavský kraj";2;1462;3;1465;NA;92093;5;2021-07-18;91198
2021-07-17;"Bratislavský kraj";3;1870;2;1872;NA;92093;5;2021-07-17;91193
2021-07-16;"Bratislavský kraj";8;2834;4;2838;NA;92093;12;2021-07-16;91188
2021-07-15;"Bratislavský kraj";5;1674;0;1674;NA;92093;5;2021-07-15;91176
2021-07-14;"Bratislavský kraj";5;1895;3;1898;NA;92093;8;2021-07-14;91171
2021-07-13;"Bratislavský kraj";4;1584;4;1588;NA;92093;8;2021-07-13;91163
2021-07-12;"Bratislavský kraj";6;1780;5;1785;NA;92093;11;2021-07-12;91155
2021-07-11;"Bratislavský kraj";3;1896;3;1899;NA;92093;6;2021-07-11;91144
2021-07-10;"Bratislavský kraj";5;2240;3;2243;NA;92093;8;2021-07-10;91138
2021-07-09;"Bratislavský kraj";13;3538;7;3545;NA;92093;20;2021-07-09;91130
2021-07-08;"Bratislavský kraj";9;2433;4;2437;NA;92093;13;2021-07-08;91110
2021-07-07;"Bratislavský kraj";5;2792;4;2796;NA;92093;9;2021-07-07;91097
2021-07-06;"Bratislavský kraj";19;2771;4;2775;NA;92093;23;2021-07-06;91088
2021-07-05;"Bratislavský kraj";5;2455;5;2460;NA;92093;10;2021-07-05;91065
2021-07-04;"Bratislavský kraj";3;1824;2;1826;NA;92093;5;2021-07-04;91055
2021-07-03;"Bratislavský kraj";8;2205;5;2210;NA;92093;13;2021-07-03;91050
2021-07-02;"Bratislavský kraj";4;2227;4;2231;NA;92093;8;2021-07-02;91037
2021-07-01;"Bratislavský kraj";6;1809;5;1814;NA;92093;11;2021-07-01;91029
2021-06-30;"Bratislavský kraj";2;11548;11;11559;NA;92093;13;2021-06-30;91018
2021-06-29;"Bratislavský kraj";5;6831;7;6838;NA;92093;12;2021-06-29;91005
2021-06-28;"Bratislavský kraj";16;6651;24;6675;NA;92093;40;2021-06-28;90993
2021-06-27;"Bratislavský kraj";4;6689;11;6700;NA;92093;15;2021-06-27;90953
2021-06-26;"Bratislavský kraj";3;8741;6;8747;NA;92093;9;2021-06-26;90938
2021-06-25;"Bratislavský kraj";7;10284;15;10299;NA;92093;22;2021-06-25;90929
2021-06-24;"Bratislavský kraj";3;7384;16;7400;NA;92093;19;2021-06-24;90907
2021-06-23;"Bratislavský kraj";4;7346;12;7358;NA;92093;16;2021-06-23;90888
2021-06-22;"Bratislavský kraj";6;7244;10;7254;NA;92093;16;2021-06-22;90872
2021-06-21;"Bratislavský kraj";5;7641;9;7650;NA;92093;14;2021-06-21;90856
2021-06-20;"Bratislavský kraj";0;7369;5;7374;NA;92093;5;2021-06-20;90842
2021-06-19;"Bratislavský kraj";3;9226;4;9230;NA;92093;7;2021-06-19;90837
2021-06-18;"Bratislavský kraj";5;12763;9;12772;NA;92093;14;2021-06-18;90830
2021-06-17;"Bratislavský kraj";3;8625;13;8638;NA;92093;16;2021-06-17;90816
2021-06-16;"Bratislavský kraj";3;7105;4;7109;NA;92093;7;2021-06-16;90800
2021-06-15;"Bratislavský kraj";7;7309;17;7326;NA;92093;24;2021-06-15;90793
2021-06-14;"Bratislavský kraj";4;8231;9;8240;NA;92093;13;2021-06-14;90769
2021-06-13;"Bratislavský kraj";2;8791;11;8802;NA;92093;13;2021-06-13;90756
2021-06-12;"Bratislavský kraj";4;11152;11;11163;NA;92093;15;2021-06-12;90743
2021-06-11;"Bratislavský kraj";9;13644;21;13665;NA;92093;30;2021-06-11;90728
2021-06-10;"Bratislavský kraj";12;8637;15;8652;NA;92093;27;2021-06-10;90698
2021-06-09;"Bratislavský kraj";12;7596;12;7608;NA;92093;24;2021-06-09;90671
2021-06-08;"Bratislavský kraj";13;7907;29;7936;NA;92093;42;2021-06-08;90647
2021-06-07;"Bratislavský kraj";13;9247;43;9290;NA;92093;56;2021-06-07;90605
2021-06-06;"Bratislavský kraj";3;10350;20;10370;NA;92093;23;2021-06-06;90549
2021-06-05;"Bratislavský kraj";2;12692;15;12707;NA;92093;17;2021-06-05;90526
2021-06-04;"Bratislavský kraj";10;13812;31;13843;NA;92093;41;2021-06-04;90509
2021-06-03;"Bratislavský kraj";12;9615;19;9634;NA;92093;31;2021-06-03;90468
2021-06-02;"Bratislavský kraj";10;8684;17;8701;NA;92093;27;2021-06-02;90437
2021-06-01;"Bratislavský kraj";3;8812;25;8837;NA;92093;28;2021-06-01;90410
2021-05-31;"Bratislavský kraj";18;11248;32;11280;NA;92093;50;2021-05-31;90382
2021-05-30;"Bratislavský kraj";1;11758;17;11775;NA;92093;18;2021-05-30;90332
2021-05-29;"Bratislavský kraj";4;12245;8;12253;NA;92093;12;2021-05-29;90314
2021-05-28;"Bratislavský kraj";14;15865;23;15888;NA;92093;37;2021-05-28;90302
2021-05-27;"Bratislavský kraj";5;11321;18;11339;NA;92093;23;2021-05-27;90265
2021-05-26;"Bratislavský kraj";20;10709;17;10726;NA;92093;37;2021-05-26;90242
2021-05-25;"Bratislavský kraj";19;11864;31;11895;NA;92093;50;2021-05-25;90205
2021-05-24;"Bratislavský kraj";12;12965;23;12988;NA;92093;35;2021-05-24;90155
2021-05-23;"Bratislavský kraj";7;13074;24;13098;NA;92093;31;2021-05-23;90120
2021-05-22;"Bratislavský kraj";6;14044;22;14066;NA;92093;28;2021-05-22;90089
2021-05-21;"Bratislavský kraj";15;18996;22;19018;NA;92093;37;2021-05-21;90061
2021-05-20;"Bratislavský kraj";15;14112;17;14129;NA;92093;32;2021-05-20;90024
2021-05-19;"Bratislavský kraj";21;11958;24;11982;NA;92093;45;2021-05-19;89992
2021-05-18;"Bratislavský kraj";14;13005;33;13038;NA;92093;47;2021-05-18;89947
2021-05-17;"Bratislavský kraj";15;13854;29;13883;NA;92093;44;2021-05-17;89900
2021-05-16;"Bratislavský kraj";12;19797;32;19829;NA;92093;44;2021-05-16;89856
2021-05-15;"Bratislavský kraj";1;18113;30;18143;NA;92093;31;2021-05-15;89812
2021-05-14;"Bratislavský kraj";15;22225;30;22255;NA;92093;45;2021-05-14;89781
2021-05-13;"Bratislavský kraj";9;16211;17;16228;NA;92093;26;2021-05-13;89736
2021-05-12;"Bratislavský kraj";11;14638;28;14666;NA;92093;39;2021-05-12;89710
2021-05-11;"Bratislavský kraj";29;16741;32;16773;NA;92093;61;2021-05-11;89671
2021-05-10;"Bratislavský kraj";27;19991;64;20055;NA;92093;91;2021-05-10;89610
2021-05-09;"Bratislavský kraj";9;29358;32;29390;NA;92093;41;2021-05-09;89519
2021-05-08;"Bratislavský kraj";5;19451;24;19475;NA;92093;29;2021-05-08;89478
2021-05-07;"Bratislavský kraj";32;28211;65;28276;NA;92093;97;2021-05-07;89449
2021-05-06;"Bratislavský kraj";19;20079;52;20131;NA;92093;71;2021-05-06;89352
2021-05-05;"Bratislavský kraj";29;15526;31;15557;NA;92093;60;2021-05-05;89281
2021-05-04;"Bratislavský kraj";46;19143;53;19196;NA;92093;99;2021-05-04;89221
2021-05-03;"Bratislavský kraj";37;22322;64;22386;NA;92093;101;2021-05-03;89122
2021-05-02;"Bratislavský kraj";38;43064;75;43139;NA;92093;113;2021-05-02;89021
2021-05-01;"Bratislavský kraj";11;39905;40;39945;NA;92093;51;2021-05-01;88908
2021-04-30;"Bratislavský kraj";43;47403;82;47485;NA;92093;125;2021-04-30;88857
2021-04-29;"Bratislavský kraj";48;30257;96;30353;NA;92093;144;2021-04-29;88732
2021-04-28;"Bratislavský kraj";40;28905;78;28983;NA;92093;118;2021-04-28;88588
2021-04-27;"Bratislavský kraj";41;30168;52;30220;NA;92093;93;2021-04-27;88470
2021-04-26;"Bratislavský kraj";59;34733;97;34830;NA;92093;156;2021-04-26;88377
2021-04-25;"Bratislavský kraj";8;57615;74;57689;NA;92093;82;2021-04-25;88221
2021-04-24;"Bratislavský kraj";28;74858;66;74924;NA;92093;94;2021-04-24;88139
2021-04-23;"Bratislavský kraj";70;48614;62;48676;NA;92093;132;2021-04-23;88045
2021-04-22;"Bratislavský kraj";39;31037;72;31109;NA;92093;111;2021-04-22;87913
2021-04-21;"Bratislavský kraj";48;30442;62;30504;NA;92093;110;2021-04-21;87802
2021-04-20;"Bratislavský kraj";58;35216;63;35279;NA;92093;121;2021-04-20;87692
2021-04-19;"Bratislavský kraj";48;39500;80;39580;NA;92093;128;2021-04-19;87571
2021-04-18;"Bratislavský kraj";35;62300;76;62376;NA;92093;111;2021-04-18;87443
2021-04-17;"Bratislavský kraj";13;80359;111;80470;NA;92093;124;2021-04-17;87332
2021-04-16;"Bratislavský kraj";62;47296;80;47376;NA;92093;142;2021-04-16;87208
2021-04-15;"Bratislavský kraj";34;32176;74;32250;NA;92093;108;2021-04-15;87066
2021-04-14;"Bratislavský kraj";65;33961;88;34049;NA;92093;153;2021-04-14;86958
2021-04-13;"Bratislavský kraj";82;35512;82;35594;NA;92093;164;2021-04-13;86805
2021-04-12;"Bratislavský kraj";77;42286;115;42401;NA;92093;192;2021-04-12;86641
2021-04-11;"Bratislavský kraj";42;61151;123;61274;NA;92093;165;2021-04-11;86449
2021-04-10;"Bratislavský kraj";14;77874;167;78041;NA;92093;181;2021-04-10;86284
2021-04-09;"Bratislavský kraj";72;41556;97;41653;NA;92093;169;2021-04-09;86103
2021-04-08;"Bratislavský kraj";71;28866;95;28961;NA;92093;166;2021-04-08;85934
2021-04-07;"Bratislavský kraj";96;38061;101;38162;NA;92093;197;2021-04-07;85768
2021-04-06;"Bratislavský kraj";94;56222;179;56401;NA;92093;273;2021-04-06;85571
2021-04-05;"Bratislavský kraj";85;18538;85;18623;NA;92093;170;2021-04-05;85298
2021-04-04;"Bratislavský kraj";37;29225;75;29300;NA;92093;112;2021-04-04;85128
2021-04-03;"Bratislavský kraj";52;79865;220;80085;NA;92093;272;2021-04-03;85016
2021-04-02;"Bratislavský kraj";33;23790;104;23894;NA;92093;137;2021-04-02;84744
2021-04-01;"Bratislavský kraj";119;57388;159;57547;NA;92093;278;2021-04-01;84607
2021-03-31;"Bratislavský kraj";105;46371;177;46548;NA;92093;282;2021-03-31;84329
2021-03-30;"Bratislavský kraj";100;39599;144;39743;NA;92093;244;2021-03-30;84047
2021-03-29;"Bratislavský kraj";153;40364;178;40542;NA;92093;331;2021-03-29;83803
2021-03-28;"Bratislavský kraj";59;53372;137;53509;NA;92093;196;2021-03-28;83472
2021-03-27;"Bratislavský kraj";53;79834;240;80074;NA;92093;293;2021-03-27;83276
2021-03-26;"Bratislavský kraj";114;56108;191;56299;NA;92093;305;2021-03-26;82983
2021-03-25;"Bratislavský kraj";76;36859;172;37031;NA;92093;248;2021-03-25;82678
2021-03-24;"Bratislavský kraj";120;30567;201;30768;NA;92093;321;2021-03-24;82430
2021-03-23;"Bratislavský kraj";138;36430;190;36620;NA;92093;328;2021-03-23;82109
2021-03-22;"Bratislavský kraj";110;42756;220;42976;NA;92093;330;2021-03-22;81781
2021-03-21;"Bratislavský kraj";54;61299;212;61511;NA;92093;266;2021-03-21;81451
2021-03-20;"Bratislavský kraj";59;73300;228;73528;NA;92093;287;2021-03-20;81185
2021-03-19;"Bratislavský kraj";139;54576;257;54833;NA;92093;396;2021-03-19;80898
2021-03-18;"Bratislavský kraj";142;34611;192;34803;NA;92093;334;2021-03-18;80502
2021-03-17;"Bratislavský kraj";177;30482;217;30699;NA;92093;394;2021-03-17;80168
2021-03-16;"Bratislavský kraj";258;36798;287;37085;NA;92093;545;2021-03-16;79774
2021-03-15;"Bratislavský kraj";180;38226;255;38481;NA;92093;435;2021-03-15;79229
2021-03-14;"Bratislavský kraj";75;52611;275;52886;NA;92093;350;2021-03-14;78794
2021-03-13;"Bratislavský kraj";110;81405;341;81746;NA;92093;451;2021-03-13;78444
2021-03-12;"Bratislavský kraj";152;55233;312;55545;NA;92093;464;2021-03-12;77993
2021-03-11;"Bratislavský kraj";178;34678;286;34964;NA;92093;464;2021-03-11;77529
2021-03-10;"Bratislavský kraj";164;31061;280;31341;NA;92093;444;2021-03-10;77065
2021-03-09;"Bratislavský kraj";242;37687;267;37954;NA;92093;509;2021-03-09;76621
2021-03-08;"Bratislavský kraj";255;41199;348;41547;NA;92093;603;2021-03-08;76112
2021-03-07;"Bratislavský kraj";142;52812;301;53113;NA;92093;443;2021-03-07;75509
2021-03-06;"Bratislavský kraj";79;71821;415;72236;NA;92093;494;2021-03-06;75066
2021-03-05;"Bratislavský kraj";238;50840;294;51134;NA;92093;532;2021-03-05;74572
2021-03-04;"Bratislavský kraj";204;34544;344;34888;NA;92093;548;2021-03-04;74040
2021-03-03;"Bratislavský kraj";250;30527;364;30891;NA;92093;614;2021-03-03;73492
2021-03-02;"Bratislavský kraj";267;39735;388;40123;NA;92093;655;2021-03-02;72878
2021-03-01;"Bratislavský kraj";320;38222;432;38654;NA;92093;752;2021-03-01;72223
2021-02-28;"Bratislavský kraj";184;50323;323;50646;NA;92093;507;2021-02-28;71471
2021-02-27;"Bratislavský kraj";151;76580;464;77044;NA;92093;615;2021-02-27;70964
2021-02-26;"Bratislavský kraj";277;47326;401;47727;NA;92093;678;2021-02-26;70349
2021-02-25;"Bratislavský kraj";277;28769;405;29174;NA;92093;682;2021-02-25;69671
2021-02-24;"Bratislavský kraj";217;27095;412;27507;NA;92093;629;2021-02-24;68989
2021-02-23;"Bratislavský kraj";257;31297;395;31692;NA;92093;652;2021-02-23;68360
2021-02-22;"Bratislavský kraj";353;36607;483;37090;NA;92093;836;2021-02-22;67708
2021-02-21;"Bratislavský kraj";185;54150;396;54546;NA;92093;581;2021-02-21;66872
2021-02-20;"Bratislavský kraj";167;74814;550;75364;NA;92093;717;2021-02-20;66291
2021-02-19;"Bratislavský kraj";280;44882;416;45298;NA;92093;696;2021-02-19;65574
2021-02-18;"Bratislavský kraj";263;26379;371;26750;NA;92093;634;2021-02-18;64878
2021-02-17;"Bratislavský kraj";264;22820;316;23136;NA;92093;580;2021-02-17;64244
2021-02-16;"Bratislavský kraj";289;28262;352;28614;NA;92093;641;2021-02-16;63664
2021-02-15;"Bratislavský kraj";248;36893;396;37289;NA;92093;644;2021-02-15;63023
2021-02-14;"Bratislavský kraj";153;47948;323;48271;NA;92093;476;2021-02-14;62379
2021-02-13;"Bratislavský kraj";173;68589;515;69104;NA;92093;688;2021-02-13;61903
2021-02-12;"Bratislavský kraj";282;35729;327;36056;NA;92093;609;2021-02-12;61215
2021-02-11;"Bratislavský kraj";337;24565;285;24850;NA;92093;622;2021-02-11;60606
2021-02-10;"Bratislavský kraj";314;22944;356;23300;NA;92093;670;2021-02-10;59984
2021-02-09;"Bratislavský kraj";288;36565;454;37019;NA;92093;742;2021-02-09;59314
2021-02-08;"Bratislavský kraj";484;31896;397;32293;NA;92093;881;2021-02-08;58572
2021-02-07;"Bratislavský kraj";243;51290;425;51715;NA;92093;668;2021-02-07;57691
2021-02-06;"Bratislavský kraj";116;61682;501;62183;NA;92093;617;2021-02-06;57023
2021-02-05;"Bratislavský kraj";327;27033;375;27408;NA;92093;702;2021-02-05;56406
2021-02-04;"Bratislavský kraj";555;17260;348;17608;NA;92093;903;2021-02-04;55704
2021-02-03;"Bratislavský kraj";161;13020;352;13372;NA;92093;513;2021-02-03;54801
2021-02-02;"Bratislavský kraj";397;25947;480;26427;NA;92093;877;2021-02-02;54288
2021-02-01;"Bratislavský kraj";221;35541;513;36054;NA;92093;734;2021-02-01;53411
2021-01-31;"Bratislavský kraj";180;35693;425;36118;NA;92093;605;2021-01-31;52677
2021-01-30;"Bratislavský kraj";310;49588;521;50109;NA;92093;831;2021-01-30;52072
2021-01-29;"Bratislavský kraj";344;16568;344;16912;NA;92093;688;2021-01-29;51241
2021-01-28;"Bratislavský kraj";307;10715;297;11012;NA;92093;604;2021-01-28;50553
2021-01-27;"Bratislavský kraj";336;22222;345;22567;NA;92093;681;2021-01-27;49949
2021-01-26;"Bratislavský kraj";297;21894;300;22194;NA;92093;597;2021-01-26;49268
2021-01-25;"Bratislavský kraj";356;23335;249;23584;NA;92093;605;2021-01-25;48671
2021-01-24;"Bratislavský kraj";175;37903;404;38307;NA;92093;579;2021-01-24;48066
2021-01-23;"Bratislavský kraj";396;79453;690;80143;NA;92093;1086;2021-01-23;47487
2021-01-22;"Bratislavský kraj";199;42055;365;42420;NA;92093;564;2021-01-22;46401
2021-01-21;"Bratislavský kraj";255;105746;1317;107063;NA;92093;1572;2021-01-21;45837
2021-01-20;"Bratislavský kraj";360;27289;452;27741;NA;92093;812;2021-01-20;44265
2021-01-19;"Bratislavský kraj";375;15318;346;15664;NA;92093;721;2021-01-19;43453
2021-01-18;"Bratislavský kraj";357;12533;707;13240;NA;92093;1064;2021-01-18;42732
2021-01-17;"Bratislavský kraj";244;482;26;508;NA;92093;270;2021-01-17;41668
2021-01-16;"Bratislavský kraj";70;3016;156;3172;NA;92093;226;2021-01-16;41398
2021-01-15;"Bratislavský kraj";251;7896;256;8152;NA;92093;507;2021-01-15;41172
2021-01-14;"Bratislavský kraj";363;8523;273;8796;NA;92093;636;2021-01-14;40665
2021-01-13;"Bratislavský kraj";336;8490;327;8817;NA;92093;663;2021-01-13;40029
2021-01-12;"Bratislavský kraj";450;10509;455;10964;NA;92093;905;2021-01-12;39366
2021-01-11;"Bratislavský kraj";397;19863;364;20227;NA;92093;761;2021-01-11;38461
2021-01-10;"Bratislavský kraj";252;1507;79;1586;NA;92093;331;2021-01-10;37700
2021-01-09;"Bratislavský kraj";351;4721;277;4998;NA;92093;628;2021-01-09;37369
2021-01-08;"Bratislavský kraj";556;10045;436;10481;NA;92093;992;2021-01-08;36741
2021-01-07;"Bratislavský kraj";537;6872;352;7224;NA;92093;889;2021-01-07;35749
2021-01-06;"Bratislavský kraj";271;3329;216;3545;NA;92093;487;2021-01-06;34860
2021-01-05;"Bratislavský kraj";619;10635;814;11449;NA;92093;1433;2021-01-05;34373
2021-01-04;"Bratislavský kraj";601;8226;538;8764;NA;92093;1139;2021-01-04;32940
2021-01-03;"Bratislavský kraj";77;433;41;474;NA;92093;118;2021-01-03;31801
2021-01-02;"Bratislavský kraj";185;462;57;519;NA;92093;242;2021-01-02;31683
2021-01-01;"Bratislavský kraj";235;3277;131;3408;NA;92093;366;2021-01-01;31441
2020-12-31;"Bratislavský kraj";925;14684;563;15247;NA;92093;1488;2020-12-31;31075
2020-12-30;"Bratislavský kraj";650;9823;554;10377;NA;92093;1204;2020-12-30;29587
2020-12-29;"Bratislavský kraj";303;10718;772;11490;NA;92093;1075;2020-12-29;28383
2020-12-28;"Bratislavský kraj";255;8365;555;8920;NA;92093;810;2020-12-28;27308
2020-12-27;"Bratislavský kraj";160;709;76;785;NA;92093;236;2020-12-27;26498
2020-12-26;"Bratislavský kraj";75;480;27;507;NA;92093;102;2020-12-26;26262
2020-12-25;"Bratislavský kraj";114;503;38;541;NA;92093;152;2020-12-25;26160
2020-12-24;"Bratislavský kraj";536;3367;104;3471;NA;92093;640;2020-12-24;26008
2020-12-23;"Bratislavský kraj";416;13255;496;13751;NA;92093;912;2020-12-23;25368
2020-12-22;"Bratislavský kraj";327;15545;759;16304;NA;92093;1086;2020-12-22;24456
2020-12-21;"Bratislavský kraj";392;15685;2007;17692;NA;92093;2399;2020-12-21;23370
2020-12-20;"Bratislavský kraj";180;797;57;854;NA;92093;237;2020-12-20;20971
2020-12-19;"Bratislavský kraj";396;3314;130;3444;NA;92093;526;2020-12-19;20734
2020-12-18;"Bratislavský kraj";306;10644;394;11038;NA;92093;700;2020-12-18;20208
2020-12-17;"Bratislavský kraj";502;10343;419;10762;NA;92093;921;2020-12-17;19508
2020-12-16;"Bratislavský kraj";282;10772;452;11224;NA;92093;734;2020-12-16;18587
2020-12-15;"Bratislavský kraj";423;10916;479;11395;NA;92093;902;2020-12-15;17853
2020-12-14;"Bratislavský kraj";279;7356;300;7656;NA;92093;579;2020-12-14;16951
2020-12-13;"Bratislavský kraj";125;139;10;149;NA;92093;135;2020-12-13;16372
2020-12-12;"Bratislavský kraj";361;3886;157;4043;NA;92093;518;2020-12-12;16237
2020-12-11;"Bratislavský kraj";326;7348;289;7637;NA;92093;615;2020-12-11;15719
2020-12-10;"Bratislavský kraj";286;5823;209;6032;NA;92093;495;2020-12-10;15104
2020-12-09;"Bratislavský kraj";382;4795;178;4973;NA;92093;560;2020-12-09;14609
2020-12-08;"Bratislavský kraj";234;6243;207;6450;NA;92093;441;2020-12-08;14049
2020-12-07;"Bratislavský kraj";272;4639;152;4791;NA;92093;424;2020-12-07;13608
2020-12-06;"Bratislavský kraj";61;1625;52;1677;NA;92093;113;2020-12-06;13184
2020-12-05;"Bratislavský kraj";266;2221;41;2262;NA;92093;307;2020-12-05;13071
2020-12-04;"Bratislavský kraj";200;4954;99;5053;NA;92093;299;2020-12-04;12764
2020-12-03;"Bratislavský kraj";213;5672;95;5767;NA;92093;308;2020-12-03;12465
2020-12-02;"Bratislavský kraj";205;3462;103;3565;NA;92093;308;2020-12-02;12157
2020-12-01;"Bratislavský kraj";255;3889;172;4061;NA;92093;427;2020-12-01;11849
2020-11-30;"Bratislavský kraj";152;2153;121;2274;NA;92093;273;2020-11-30;11422
2020-11-29;"Bratislavský kraj";52;201;24;225;NA;92093;76;2020-11-29;11149
2020-11-28;"Bratislavský kraj";232;2624;33;2657;NA;92093;265;2020-11-28;11073
2020-11-27;"Bratislavský kraj";54;2540;64;2604;NA;92093;118;2020-11-27;10808
2020-11-26;"Bratislavský kraj";129;1976;60;2036;NA;92093;189;2020-11-26;10690
2020-11-25;"Bratislavský kraj";140;1770;47;1817;NA;92093;187;2020-11-25;10501
2020-11-24;"Bratislavský kraj";81;2988;67;3055;NA;92093;148;2020-11-24;10314
2020-11-23;"Bratislavský kraj";67;7083;58;7141;NA;92093;125;2020-11-23;10166
2020-11-22;"Bratislavský kraj";36;81;7;88;NA;92093;43;2020-11-22;10041
2020-11-21;"Bratislavský kraj";109;2126;47;2173;NA;92093;156;2020-11-21;9998
2020-11-20;"Bratislavský kraj";118;2876;48;2924;NA;92093;166;2020-11-20;9842
2020-11-19;"Bratislavský kraj";173;987;29;1016;NA;92093;202;2020-11-19;9676
2020-11-18;"Bratislavský kraj";118;616;75;691;NA;92093;193;2020-11-18;9474
2020-11-17;"Bratislavský kraj";108;928;23;951;NA;92093;131;2020-11-17;9281
2020-11-16;"Bratislavský kraj";82;651;9;660;NA;92093;91;2020-11-16;9150
2020-11-15;"Bratislavský kraj";47;236;0;236;NA;92093;47;2020-11-15;9059
2020-11-14;"Bratislavský kraj";53;1834;15;1849;NA;92093;68;2020-11-14;9012
2020-11-13;"Bratislavský kraj";94;2096;21;2117;NA;92093;115;2020-11-13;8944
2020-11-12;"Bratislavský kraj";141;1727;6;1733;NA;92093;147;2020-11-12;8829
2020-11-11;"Bratislavský kraj";159;1429;12;1441;NA;92093;171;2020-11-11;8682
2020-11-10;"Bratislavský kraj";136;805;14;819;NA;92093;150;2020-11-10;8511
2020-11-09;"Bratislavský kraj";70;616;8;624;NA;92093;78;2020-11-09;8361
2020-11-08;"Bratislavský kraj";82;869;6;875;NA;92093;88;2020-11-08;8283
2020-11-07;"Bratislavský kraj";88;4039;17;4056;NA;92093;105;2020-11-07;8195
2020-11-06;"Bratislavský kraj";281;6441;25;6466;NA;92093;306;2020-11-06;8090
2020-11-05;"Bratislavský kraj";175;476;11;487;NA;92093;186;2020-11-05;7784
2020-11-04;"Bratislavský kraj";65;411;10;421;NA;92093;75;2020-11-04;7598
2020-11-03;"Bratislavský kraj";251;1085;12;1097;NA;92093;263;2020-11-03;7523
2020-11-02;"Bratislavský kraj";202;3365;22;3387;NA;92093;224;2020-11-02;7260
2020-11-01;"Bratislavský kraj";227;8694;39;8733;NA;92093;266;2020-11-01;7036
2020-10-31;"Bratislavský kraj";173;22407;123;22530;NA;92093;296;2020-10-31;6770
2020-10-30;"Bratislavský kraj";158;17350;138;17488;NA;92093;296;2020-10-30;6474
2020-10-29;"Bratislavský kraj";262;116;4;120;NA;92093;266;2020-10-29;6178
2020-10-28;"Bratislavský kraj";220;260;15;275;NA;92093;235;2020-10-28;5912
2020-10-27;"Bratislavský kraj";256;145;4;149;NA;92093;260;2020-10-27;5677
2020-10-26;"Bratislavský kraj";123;229;11;240;NA;92093;134;2020-10-26;5417
2020-10-25;"Bratislavský kraj";152;33;2;35;NA;92093;154;2020-10-25;5283
2020-10-24;"Bratislavský kraj";170;221;6;227;NA;92093;176;2020-10-24;5129
2020-10-23;"Bratislavský kraj";151;144;8;152;NA;92093;159;2020-10-23;4953
2020-10-22;"Bratislavský kraj";192;204;15;219;NA;92093;207;2020-10-22;4794
2020-10-21;"Bratislavský kraj";66;90;6;96;NA;92093;72;2020-10-21;4587
2020-10-20;"Bratislavský kraj";183;97;4;101;NA;92093;187;2020-10-20;4515
2020-10-19;"Bratislavský kraj";148;80;3;83;NA;92093;151;2020-10-19;4328
2020-10-18;"Bratislavský kraj";75;92;0;92;NA;92093;75;2020-10-18;4177
2020-10-17;"Bratislavský kraj";136;0;0;0;NA;92093;136;2020-10-17;4102
2020-10-16;"Bratislavský kraj";103;14;1;15;NA;92093;104;2020-10-16;3966
2020-10-15;"Bratislavský kraj";135;6;1;7;NA;92093;136;2020-10-15;3862
2020-10-14;"Bratislavský kraj";127;4;0;4;NA;92093;127;2020-10-14;3726
2020-10-13;"Bratislavský kraj";86;108;8;116;NA;92093;94;2020-10-13;3599
2020-10-12;"Bratislavský kraj";46;0;0;0;NA;92093;46;2020-10-12;3505
2020-10-11;"Bratislavský kraj";80;0;0;0;NA;92093;80;2020-10-11;3459
2020-10-10;"Bratislavský kraj";55;0;0;0;NA;92093;55;2020-10-10;3379
2020-10-09;"Bratislavský kraj";148;0;0;0;NA;92093;148;2020-10-09;3324
2020-10-08;"Bratislavský kraj";100;0;0;0;NA;92093;100;2020-10-08;3176
2020-10-07;"Bratislavský kraj";107;0;0;0;NA;92093;107;2020-10-07;3076
2020-10-06;"Bratislavský kraj";108;0;0;0;NA;92093;108;2020-10-06;2969
2020-10-05;"Bratislavský kraj";30;0;0;0;NA;92093;30;2020-10-05;2861
2020-10-04;"Bratislavský kraj";49;0;0;0;NA;92093;49;2020-10-04;2831
2020-10-03;"Bratislavský kraj";82;0;0;0;NA;92093;82;2020-10-03;2782
2020-10-02;"Bratislavský kraj";101;0;0;0;NA;92093;101;2020-10-02;2700
2020-10-01;"Bratislavský kraj";72;0;0;0;NA;92093;72;2020-10-01;2599
2020-09-30;"Bratislavský kraj";91;0;0;0;NA;92093;91;2020-09-30;2527
2020-09-29;"Bratislavský kraj";74;0;0;0;NA;92093;74;2020-09-29;2436
2020-09-28;"Bratislavský kraj";29;0;0;0;NA;92093;29;2020-09-28;2362
2020-09-27;"Bratislavský kraj";48;0;0;0;NA;92093;48;2020-09-27;2333
2020-09-26;"Bratislavský kraj";86;0;0;0;NA;92093;86;2020-09-26;2285
2020-09-25;"Bratislavský kraj";97;0;0;0;NA;92093;97;2020-09-25;2199
2020-09-24;"Bratislavský kraj";73;0;0;0;NA;92093;73;2020-09-24;2102
2020-09-23;"Bratislavský kraj";55;0;0;0;NA;92093;55;2020-09-23;2029
2020-09-22;"Bratislavský kraj";81;0;0;0;NA;92093;81;2020-09-22;1974
2020-09-21;"Bratislavský kraj";32;0;0;0;NA;92093;32;2020-09-21;1893
2020-09-20;"Bratislavský kraj";25;0;0;0;NA;92093;25;2020-09-20;1861
2020-09-19;"Bratislavský kraj";59;0;0;0;NA;92093;59;2020-09-19;1836
2020-09-18;"Bratislavský kraj";42;0;0;0;NA;92093;42;2020-09-18;1777
2020-09-17;"Bratislavský kraj";52;0;0;0;NA;92093;52;2020-09-17;1735
2020-09-16;"Bratislavský kraj";32;0;0;0;NA;92093;32;2020-09-16;1683
2020-09-15;"Bratislavský kraj";26;0;0;0;NA;92093;26;2020-09-15;1651
2020-09-14;"Bratislavský kraj";24;0;0;0;NA;92093;24;2020-09-14;1625
2020-09-13;"Bratislavský kraj";11;0;0;0;NA;92093;11;2020-09-13;1601
2020-09-12;"Bratislavský kraj";24;0;0;0;NA;92093;24;2020-09-12;1590
2020-09-11;"Bratislavský kraj";50;0;0;0;NA;92093;50;2020-09-11;1566
2020-09-10;"Bratislavský kraj";47;0;0;0;NA;92093;47;2020-09-10;1516
2020-09-09;"Bratislavský kraj";40;0;0;0;NA;92093;40;2020-09-09;1469
2020-09-08;"Bratislavský kraj";58;0;0;0;NA;92093;58;2020-09-08;1429
2020-09-07;"Bratislavský kraj";39;0;0;0;NA;92093;39;2020-09-07;1371
2020-09-06;"Bratislavský kraj";11;0;0;0;NA;92093;11;2020-09-06;1332
2020-09-05;"Bratislavský kraj";37;0;0;0;NA;92093;37;2020-09-05;1321
2020-09-04;"Bratislavský kraj";87;0;0;0;NA;92093;87;2020-09-04;1284
2020-09-03;"Bratislavský kraj";51;0;0;0;NA;92093;51;2020-09-03;1197
2020-09-02;"Bratislavský kraj";50;0;0;0;NA;92093;50;2020-09-02;1146
2020-09-01;"Bratislavský kraj";16;0;0;0;NA;92093;16;2020-09-01;1096
2020-08-31;"Bratislavský kraj";19;0;0;0;NA;92093;19;2020-08-31;1080
2020-08-30;"Bratislavský kraj";9;0;0;0;NA;92093;9;2020-08-30;1061
2020-08-29;"Bratislavský kraj";12;0;0;0;NA;92093;12;2020-08-29;1052
2020-08-28;"Bratislavský kraj";35;0;0;0;NA;92093;35;2020-08-28;1040
2020-08-27;"Bratislavský kraj";33;0;0;0;NA;92093;33;2020-08-27;1005
2020-08-26;"Bratislavský kraj";27;0;0;0;NA;92093;27;2020-08-26;972
2020-08-25;"Bratislavský kraj";29;0;0;0;NA;92093;29;2020-08-25;945
2020-08-24;"Bratislavský kraj";6;0;0;0;NA;92093;6;2020-08-24;916
2020-08-23;"Bratislavský kraj";45;0;0;0;NA;92093;45;2020-08-23;910
2020-08-22;"Bratislavský kraj";13;0;0;0;NA;92093;13;2020-08-22;865
2020-08-21;"Bratislavský kraj";46;0;0;0;NA;92093;46;2020-08-21;852
2020-08-20;"Bratislavský kraj";41;0;0;0;NA;92093;41;2020-08-20;806
2020-08-19;"Bratislavský kraj";27;0;0;0;NA;92093;27;2020-08-19;765
2020-08-18;"Bratislavský kraj";47;0;0;0;NA;92093;47;2020-08-18;738
2020-08-17;"Bratislavský kraj";2;0;0;0;NA;92093;2;2020-08-17;691
2020-08-16;"Bratislavský kraj";3;0;0;0;NA;92093;3;2020-08-16;689
2020-08-15;"Bratislavský kraj";18;0;0;0;NA;92093;18;2020-08-15;686
2020-08-14;"Bratislavský kraj";16;0;0;0;NA;92093;16;2020-08-14;668
2020-08-13;"Bratislavský kraj";12;0;0;0;NA;92093;12;2020-08-13;652
2020-08-12;"Bratislavský kraj";10;0;0;0;NA;92093;10;2020-08-12;640
2020-08-11;"Bratislavský kraj";23;0;0;0;NA;92093;23;2020-08-11;630
2020-08-10;"Bratislavský kraj";2;0;0;0;NA;92093;2;2020-08-10;607
2020-08-09;"Bratislavský kraj";2;0;0;0;NA;92093;2;2020-08-09;605
2020-08-08;"Bratislavský kraj";1;0;0;0;NA;92093;1;2020-08-08;603
2020-08-07;"Bratislavský kraj";9;0;0;0;NA;92093;9;2020-08-07;602
2020-08-06;"Bratislavský kraj";15;0;0;0;NA;92093;15;2020-08-06;593
2020-08-05;"Bratislavský kraj";11;0;0;0;NA;92093;11;2020-08-05;578
2020-08-04;"Bratislavský kraj";21;0;0;0;NA;92093;21;2020-08-04;567
2020-08-03;"Bratislavský kraj";7;0;0;0;NA;92093;7;2020-08-03;546
2020-08-02;"Bratislavský kraj";0;0;0;0;NA;92093;0;2020-08-02;539
2020-08-01;"Bratislavský kraj";0;0;0;0;NA;92093;0;2020-08-01;539
2020-07-31;"Bratislavský kraj";14;0;0;0;NA;92093;14;2020-07-31;539
2020-07-30;"Bratislavský kraj";6;0;0;0;NA;92093;6;2020-07-30;525
2020-07-29;"Bratislavský kraj";7;0;0;0;NA;92093;7;2020-07-29;519
2020-07-28;"Bratislavský kraj";14;0;0;0;NA;92093;14;2020-07-28;512
2020-07-27;"Bratislavský kraj";3;0;0;0;NA;92093;3;2020-07-27;498
2020-07-26;"Bratislavský kraj";0;0;0;0;NA;92093;0;2020-07-26;495
2020-07-25;"Bratislavský kraj";8;0;0;0;NA;92093;8;2020-07-25;495
2020-07-24;"Bratislavský kraj";2;0;0;0;NA;92093;2;2020-07-24;487
2020-07-23;"Bratislavský kraj";8;0;0;0;NA;92093;8;2020-07-23;485
2020-07-22;"Bratislavský kraj";11;0;0;0;NA;92093;11;2020-07-22;477
2020-07-21;"Bratislavský kraj";8;0;0;0;NA;92093;8;2020-07-21;466
2020-07-20;"Bratislavský kraj";12;0;0;0;NA;92093;12;2020-07-20;458
2020-07-19;"Bratislavský kraj";0;0;0;0;NA;92093;0;2020-07-19;446
2020-07-18;"Bratislavský kraj";2;0;0;0;NA;92093;2;2020-07-18;446
2020-07-17;"Bratislavský kraj";2;0;0;0;NA;92093;2;2020-07-17;444
2020-07-16;"Bratislavský kraj";6;0;0;0;NA;92093;6;2020-07-16;442
2020-07-15;"Bratislavský kraj";3;0;0;0;NA;92093;3;2020-07-15;436
2020-07-14;"Bratislavský kraj";2;0;0;0;NA;92093;2;2020-07-14;433
2020-07-13;"Bratislavský kraj";2;0;0;0;NA;92093;2;2020-07-13;431
2020-07-12;"Bratislavský kraj";0;0;0;0;NA;92093;0;2020-07-12;429
2020-07-11;"Bratislavský kraj";0;0;0;0;NA;92093;0;2020-07-11;429
2020-07-10;"Bratislavský kraj";8;0;0;0;NA;92093;8;2020-07-10;429
2020-07-09;"Bratislavský kraj";2;0;0;0;NA;92093;2;2020-07-09;421
2020-07-08;"Bratislavský kraj";11;0;0;0;NA;92093;11;2020-07-08;419
2020-07-07;"Bratislavský kraj";5;0;0;0;NA;92093;5;2020-07-07;408
2020-07-06;"Bratislavský kraj";1;0;0;0;NA;92093;1;2020-07-06;403
2020-07-05;"Bratislavský kraj";0;0;0;0;NA;92093;0;2020-07-05;402
2020-07-04;"Bratislavský kraj";3;0;0;0;NA;92093;3;2020-07-04;402
2020-07-03;"Bratislavský kraj";1;0;0;0;NA;92093;1;2020-07-03;399
2020-07-02;"Bratislavský kraj";0;0;0;0;NA;92093;0;2020-07-02;398
2020-07-01;"Bratislavský kraj";7;0;0;0;NA;92093;7;2020-07-01;398
2020-06-30;"Bratislavský kraj";3;0;0;0;NA;92093;3;2020-06-30;391
2020-06-29;"Bratislavský kraj";1;0;0;0;NA;92093;1;2020-06-29;388
2020-06-28;"Bratislavský kraj";0;0;0;0;NA;92093;0;2020-06-28;387
2020-06-27;"Bratislavský kraj";1;0;0;0;NA;92093;1;2020-06-27;387
2020-06-26;"Bratislavský kraj";6;0;0;0;NA;92093;6;2020-06-26;386
2020-06-25;"Bratislavský kraj";0;0;0;0;NA;92093;0;2020-06-25;380
2020-06-24;"Bratislavský kraj";3;0;0;0;NA;92093;3;2020-06-24;380
2020-06-23;"Bratislavský kraj";0;0;0;0;NA;92093;0;2020-06-23;377
2020-06-22;"Bratislavský kraj";1;0;0;0;NA;92093;1;2020-06-22;377
2020-06-21;"Bratislavský kraj";0;0;0;0;NA;92093;0;2020-06-21;376
2020-06-20;"Bratislavský kraj";0;0;0;0;NA;92093;0;2020-06-20;376
2020-06-19;"Bratislavský kraj";3;0;0;0;NA;92093;3;2020-06-19;376
2020-06-18;"Bratislavský kraj";0;0;0;0;NA;92093;0;2020-06-18;373
2020-06-17;"Bratislavský kraj";0;0;0;0;NA;92093;0;2020-06-17;373
2020-06-16;"Bratislavský kraj";0;0;0;0;NA;92093;0;2020-06-16;373
2020-06-14;"Bratislavský kraj";2;0;0;0;NA;92093;2;2020-06-14;373
2020-06-13;"Bratislavský kraj";1;0;0;0;NA;92093;1;2020-06-13;371
2020-06-12;"Bratislavský kraj";2;0;0;0;NA;92093;2;2020-06-12;370
2020-06-11;"Bratislavský kraj";0;0;0;0;NA;92093;0;2020-06-11;368
2020-06-10;"Bratislavský kraj";0;0;0;0;NA;92093;0;2020-06-10;368
2020-06-09;"Bratislavský kraj";0;0;0;0;NA;92093;0;2020-06-09;368
2020-06-08;"Bratislavský kraj";1;0;0;0;NA;92093;1;2020-06-08;368
2020-06-07;"Bratislavský kraj";0;0;0;0;NA;92093;0;2020-06-07;367
2020-06-05;"Bratislavský kraj";0;0;0;0;NA;92093;0;2020-06-05;367
2020-06-03;"Bratislavský kraj";1;0;0;0;NA;92093;1;2020-06-03;367
2020-06-02;"Bratislavský kraj";0;0;0;0;NA;92093;0;2020-06-02;366
2020-05-31;"Bratislavský kraj";0;0;0;0;NA;92093;0;2020-05-31;366
2020-05-29;"Bratislavský kraj";0;0;0;0;NA;92093;0;2020-05-29;366
2020-05-27;"Bratislavský kraj";1;0;0;0;NA;92093;1;2020-05-27;366
2020-05-26;"Bratislavský kraj";0;0;0;0;NA;92093;0;2020-05-26;365
2020-05-25;"Bratislavský kraj";0;0;0;0;NA;92093;0;2020-05-25;365
2020-05-24;"Bratislavský kraj";0;0;0;0;NA;92093;0;2020-05-24;365
2020-05-23;"Bratislavský kraj";2;0;0;0;NA;92093;2;2020-05-23;365
2020-05-22;"Bratislavský kraj";0;0;0;0;NA;92093;0;2020-05-22;363
2020-05-21;"Bratislavský kraj";0;0;0;0;NA;92093;0;2020-05-21;363
2020-05-20;"Bratislavský kraj";0;0;0;0;NA;92093;0;2020-05-20;363
2020-05-19;"Bratislavský kraj";0;0;0;0;NA;92093;0;2020-05-19;363
2020-05-17;"Bratislavský kraj";0;0;0;0;NA;92093;0;2020-05-17;363
2020-05-16;"Bratislavský kraj";0;0;0;0;NA;92093;0;2020-05-16;363
2020-05-15;"Bratislavský kraj";0;0;0;0;NA;92093;0;2020-05-15;363
2020-05-14;"Bratislavský kraj";0;0;0;0;NA;92093;0;2020-05-14;363
2020-05-13;"Bratislavský kraj";0;0;0;0;NA;92093;0;2020-05-13;363
2020-05-12;"Bratislavský kraj";2;0;0;0;NA;92093;2;2020-05-12;363
2020-05-11;"Bratislavský kraj";0;0;0;0;NA;92093;0;2020-05-11;361
2020-05-09;"Bratislavský kraj";0;0;0;0;NA;92093;0;2020-05-09;361
2020-05-07;"Bratislavský kraj";1;0;0;0;NA;92093;1;2020-05-07;361
2020-05-06;"Bratislavský kraj";3;0;0;0;NA;92093;3;2020-05-06;360
2020-05-05;"Bratislavský kraj";0;0;0;0;NA;92093;0;2020-05-05;357
2020-05-04;"Bratislavský kraj";0;0;0;0;NA;92093;0;2020-05-04;357
2020-05-03;"Bratislavský kraj";2;0;0;0;NA;92093;2;2020-05-03;357
2020-05-02;"Bratislavský kraj";0;0;0;0;NA;92093;0;2020-05-02;355
2020-05-01;"Bratislavský kraj";0;0;0;0;NA;92093;0;2020-05-01;355
2020-04-30;"Bratislavský kraj";5;0;0;0;NA;92093;5;2020-04-30;355
2020-04-29;"Bratislavský kraj";0;0;0;0;NA;92093;0;2020-04-29;350
2020-04-28;"Bratislavský kraj";2;0;0;0;NA;92093;2;2020-04-28;350
2020-04-27;"Bratislavský kraj";0;0;0;0;NA;92093;0;2020-04-27;348
2020-04-26;"Bratislavský kraj";1;0;0;0;NA;92093;1;2020-04-26;348
2020-04-25;"Bratislavský kraj";0;0;0;0;NA;92093;0;2020-04-25;347
2020-04-24;"Bratislavský kraj";2;0;0;0;NA;92093;2;2020-04-24;347
2020-04-23;"Bratislavský kraj";6;0;0;0;NA;92093;6;2020-04-23;345
2020-04-22;"Bratislavský kraj";11;0;0;0;NA;92093;11;2020-04-22;339
2020-04-21;"Bratislavský kraj";4;0;0;0;NA;92093;4;2020-04-21;328
2020-04-20;"Bratislavský kraj";0;0;0;0;NA;92093;0;2020-04-20;324
2020-04-19;"Bratislavský kraj";4;0;0;0;NA;92093;4;2020-04-19;324
2020-04-18;"Bratislavský kraj";5;0;0;0;NA;92093;5;2020-04-18;320
2020-04-17;"Bratislavský kraj";6;0;0;0;NA;92093;6;2020-04-17;315
2020-04-16;"Bratislavský kraj";15;0;0;0;NA;92093;15;2020-04-16;309
2020-04-15;"Bratislavský kraj";11;0;0;0;NA;92093;11;2020-04-15;294
2020-04-14;"Bratislavský kraj";19;0;0;0;NA;92093;19;2020-04-14;283
2020-04-13;"Bratislavský kraj";53;0;0;0;NA;92093;53;2020-04-13;264
2020-04-12;"Bratislavský kraj";3;0;0;0;NA;92093;3;2020-04-12;211
2020-04-11;"Bratislavský kraj";1;0;0;0;NA;92093;1;2020-04-11;208
2020-04-10;"Bratislavský kraj";8;0;0;0;NA;92093;8;2020-04-10;207
2020-04-09;"Bratislavský kraj";3;0;0;0;NA;92093;3;2020-04-09;199
2020-04-08;"Bratislavský kraj";3;0;0;0;NA;92093;3;2020-04-08;196
2020-04-07;"Bratislavský kraj";24;0;0;0;NA;92093;24;2020-04-07;193
2020-04-06;"Bratislavský kraj";5;0;0;0;NA;92093;5;2020-04-06;169
2020-04-05;"Bratislavský kraj";6;0;0;0;NA;92093;6;2020-04-05;164
2020-04-04;"Bratislavský kraj";2;0;0;0;NA;92093;2;2020-04-04;158
2020-04-03;"Bratislavský kraj";1;0;0;0;NA;92093;1;2020-04-03;156
2020-04-02;"Bratislavský kraj";2;0;0;0;NA;92093;2;2020-04-02;155
2020-04-01;"Bratislavský kraj";5;0;0;0;NA;92093;5;2020-04-01;153
2020-03-31;"Bratislavský kraj";19;0;0;0;NA;92093;19;2020-03-31;148
2020-03-30;"Bratislavský kraj";6;0;0;0;NA;92093;6;2020-03-30;129
2020-03-29;"Bratislavský kraj";8;0;0;0;NA;92093;8;2020-03-29;123
2020-03-28;"Bratislavský kraj";4;0;0;0;NA;92093;4;2020-03-28;115
2020-03-27;"Bratislavský kraj";3;0;0;0;NA;92093;3;2020-03-27;111
2020-03-26;"Bratislavský kraj";15;0;0;0;NA;92093;15;2020-03-26;108
2020-03-25;"Bratislavský kraj";1;0;0;0;NA;92093;1;2020-03-25;93
2020-03-24;"Bratislavský kraj";4;0;0;0;NA;92093;4;2020-03-24;92
2020-03-23;"Bratislavský kraj";9;0;0;0;NA;92093;9;2020-03-23;88
2020-03-22;"Bratislavský kraj";2;0;0;0;NA;92093;2;2020-03-22;79
2020-03-21;"Bratislavský kraj";22;0;0;0;NA;92093;22;2020-03-21;77
2020-03-20;"Bratislavský kraj";3;0;0;0;NA;92093;3;2020-03-20;55
2020-03-19;"Bratislavský kraj";4;0;0;0;NA;92093;4;2020-03-19;52
2020-03-18;"Bratislavský kraj";3;0;0;0;NA;92093;3;2020-03-18;48
2020-03-17;"Bratislavský kraj";13;0;0;0;NA;92093;13;2020-03-17;45
2020-03-16;"Bratislavský kraj";1;0;0;0;NA;92093;1;2020-03-16;32
2020-03-15;"Bratislavský kraj";4;0;0;0;NA;92093;4;2020-03-15;31
2020-03-14;"Bratislavský kraj";9;0;0;0;NA;92093;9;2020-03-14;27
2020-03-13;"Bratislavský kraj";2;0;0;0;NA;92093;2;2020-03-13;18
2020-03-12;"Bratislavský kraj";8;0;0;0;NA;92093;8;2020-03-12;16
2020-03-11;"Bratislavský kraj";3;0;0;0;NA;92093;3;2020-03-11;8
2020-03-09;"Bratislavský kraj";0;0;0;0;NA;92093;0;2020-03-09;5
2020-03-08;"Bratislavský kraj";2;0;0;0;NA;92093;2;2020-03-08;5
2020-03-07;"Bratislavský kraj";2;0;0;0;NA;92093;2;2020-03-07;3
2020-03-06;"Bratislavský kraj";1;0;0;0;NA;92093;1;2020-03-06;1
2021-08-29;"Košický kraj";16;485;1;486;53513;98342;17;2021-08-29;98342
2021-08-28;"Košický kraj";14;1720;11;1731;NA;98342;25;2021-08-28;98325
2021-08-27;"Košický kraj";22;2423;13;2436;NA;98342;35;2021-08-27;98300
2021-08-26;"Košický kraj";19;2191;13;2204;NA;98342;32;2021-08-26;98265
2021-08-25;"Košický kraj";33;1939;6;1945;NA;98342;39;2021-08-25;98233
2021-08-24;"Košický kraj";14;2264;2;2266;NA;98342;16;2021-08-24;98194
2021-08-23;"Košický kraj";33;2386;5;2391;NA;98342;38;2021-08-23;98178
2021-08-22;"Košický kraj";4;1457;8;1465;NA;98342;12;2021-08-22;98140
2021-08-21;"Košický kraj";35;2042;3;2045;NA;98342;38;2021-08-21;98128
2021-08-20;"Košický kraj";13;3098;5;3103;NA;98342;18;2021-08-20;98090
2021-08-19;"Košický kraj";14;2117;6;2123;NA;98342;20;2021-08-19;98072
2021-08-18;"Košický kraj";30;1770;8;1778;NA;98342;38;2021-08-18;98052
2021-08-17;"Košický kraj";24;1619;3;1622;NA;98342;27;2021-08-17;98014
2021-08-16;"Košický kraj";3;2094;8;2102;NA;98342;11;2021-08-16;97987
2021-08-15;"Košický kraj";1;771;5;776;NA;98342;6;2021-08-15;97976
2021-08-14;"Košický kraj";15;1144;1;1145;NA;98342;16;2021-08-14;97970
2021-08-13;"Košický kraj";14;1862;8;1870;NA;98342;22;2021-08-13;97954
2021-08-12;"Košický kraj";10;1156;3;1159;NA;98342;13;2021-08-12;97932
2021-08-11;"Košický kraj";6;1298;4;1302;NA;98342;10;2021-08-11;97919
2021-08-10;"Košický kraj";10;1352;8;1360;NA;98342;18;2021-08-10;97909
2021-08-09;"Košický kraj";12;1578;2;1580;NA;98342;14;2021-08-09;97891
2021-08-08;"Košický kraj";8;688;1;689;NA;98342;9;2021-08-08;97877
2021-08-07;"Košický kraj";3;1061;3;1064;NA;98342;6;2021-08-07;97868
2021-08-06;"Košický kraj";9;1536;6;1542;NA;98342;15;2021-08-06;97862
2021-08-05;"Košický kraj";26;1220;6;1226;NA;98342;32;2021-08-05;97847
2021-08-04;"Košický kraj";8;1321;4;1325;NA;98342;12;2021-08-04;97815
2021-08-03;"Košický kraj";33;1078;3;1081;NA;98342;36;2021-08-03;97803
2021-08-02;"Košický kraj";6;1613;8;1621;NA;98342;14;2021-08-02;97767
2021-08-01;"Košický kraj";1;662;1;663;NA;98342;2;2021-08-01;97753
2021-07-31;"Košický kraj";17;1072;2;1074;NA;98342;19;2021-07-31;97751
2021-07-30;"Košický kraj";12;1500;7;1507;NA;98342;19;2021-07-30;97732
2021-07-29;"Košický kraj";7;1183;5;1188;NA;98342;12;2021-07-29;97713
2021-07-28;"Košický kraj";15;910;4;914;NA;98342;19;2021-07-28;97701
2021-07-27;"Košický kraj";17;1132;7;1139;NA;98342;24;2021-07-27;97682
2021-07-26;"Košický kraj";3;1585;8;1593;NA;98342;11;2021-07-26;97658
2021-07-25;"Košický kraj";0;719;3;722;NA;98342;3;2021-07-25;97647
2021-07-24;"Košický kraj";18;928;4;932;NA;98342;22;2021-07-24;97644
2021-07-23;"Košický kraj";9;1446;5;1451;NA;98342;14;2021-07-23;97622
2021-07-22;"Košický kraj";1;1177;4;1181;NA;98342;5;2021-07-22;97608
2021-07-21;"Košický kraj";4;1117;3;1120;NA;98342;7;2021-07-21;97603
2021-07-20;"Košický kraj";6;1291;1;1292;NA;98342;7;2021-07-20;97596
2021-07-19;"Košický kraj";2;1449;2;1451;NA;98342;4;2021-07-19;97589
2021-07-18;"Košický kraj";0;643;0;643;NA;98342;0;2021-07-18;97585
2021-07-17;"Košický kraj";3;986;5;991;NA;98342;8;2021-07-17;97585
2021-07-16;"Košický kraj";3;1486;4;1490;NA;98342;7;2021-07-16;97577
2021-07-15;"Košický kraj";4;1301;4;1305;NA;98342;8;2021-07-15;97570
2021-07-14;"Košický kraj";2;1090;3;1093;NA;98342;5;2021-07-14;97562
2021-07-13;"Košický kraj";4;1329;1;1330;NA;98342;5;2021-07-13;97557
2021-07-12;"Košický kraj";3;1773;3;1776;NA;98342;6;2021-07-12;97552
2021-07-11;"Košický kraj";1;537;2;539;NA;98342;3;2021-07-11;97546
2021-07-10;"Košický kraj";9;1051;0;1051;NA;98342;9;2021-07-10;97543
2021-07-09;"Košický kraj";5;1855;5;1860;NA;98342;10;2021-07-09;97534
2021-07-08;"Košický kraj";13;1211;2;1213;NA;98342;15;2021-07-08;97524
2021-07-07;"Košický kraj";6;1436;1;1437;NA;98342;7;2021-07-07;97509
2021-07-06;"Košický kraj";4;1766;2;1768;NA;98342;6;2021-07-06;97502
2021-07-05;"Košický kraj";1;491;0;491;NA;98342;1;2021-07-05;97496
2021-07-04;"Košický kraj";0;480;2;482;NA;98342;2;2021-07-04;97495
2021-07-03;"Košický kraj";2;1112;0;1112;NA;98342;2;2021-07-03;97493
2021-07-02;"Košický kraj";2;1724;3;1727;NA;98342;5;2021-07-02;97491
2021-07-01;"Košický kraj";0;1139;2;1141;NA;98342;2;2021-07-01;97486
2021-06-30;"Košický kraj";5;9248;7;9255;NA;98342;12;2021-06-30;97484
2021-06-29;"Košický kraj";6;5692;7;5699;NA;98342;13;2021-06-29;97472
2021-06-28;"Košický kraj";5;6129;2;6131;NA;98342;7;2021-06-28;97459
2021-06-27;"Košický kraj";8;4612;3;4615;NA;98342;11;2021-06-27;97452
2021-06-26;"Košický kraj";4;5699;14;5713;NA;98342;18;2021-06-26;97441
2021-06-25;"Košický kraj";5;6981;2;6983;NA;98342;7;2021-06-25;97423
2021-06-24;"Košický kraj";1;5072;3;5075;NA;98342;4;2021-06-24;97416
2021-06-23;"Košický kraj";8;5373;3;5376;NA;98342;11;2021-06-23;97412
2021-06-22;"Košický kraj";1;5269;3;5272;NA;98342;4;2021-06-22;97401
2021-06-21;"Košický kraj";5;6830;11;6841;NA;98342;16;2021-06-21;97397
2021-06-20;"Košický kraj";0;4882;6;4888;NA;98342;6;2021-06-20;97381
2021-06-19;"Košický kraj";7;6473;1;6474;NA;98342;8;2021-06-19;97375
2021-06-18;"Košický kraj";4;7969;8;7977;NA;98342;12;2021-06-18;97367
2021-06-17;"Košický kraj";6;6128;3;6131;NA;98342;9;2021-06-17;97355
2021-06-16;"Košický kraj";11;6059;7;6066;NA;98342;18;2021-06-16;97346
2021-06-15;"Košický kraj";12;6301;2;6303;NA;98342;14;2021-06-15;97328
2021-06-14;"Košický kraj";10;7010;9;7019;NA;98342;19;2021-06-14;97314
2021-06-13;"Košický kraj";7;6948;8;6956;NA;98342;15;2021-06-13;97295
2021-06-12;"Košický kraj";7;7485;9;7494;NA;98342;16;2021-06-12;97280
2021-06-11;"Košický kraj";15;8973;6;8979;NA;98342;21;2021-06-11;97264
2021-06-10;"Košický kraj";11;6588;16;6604;NA;98342;27;2021-06-10;97243
2021-06-09;"Košický kraj";37;6056;7;6063;NA;98342;44;2021-06-09;97216
2021-06-08;"Košický kraj";33;7019;13;7032;NA;98342;46;2021-06-08;97172
2021-06-07;"Košický kraj";11;8106;22;8128;NA;98342;33;2021-06-07;97126
2021-06-06;"Košický kraj";1;7843;7;7850;NA;98342;8;2021-06-06;97093
2021-06-05;"Košický kraj";21;9286;3;9289;NA;98342;24;2021-06-05;97085
2021-06-04;"Košický kraj";26;11377;20;11397;NA;98342;46;2021-06-04;97061
2021-06-03;"Košický kraj";23;6467;14;6481;NA;98342;37;2021-06-03;97015
2021-06-02;"Košický kraj";15;7180;24;7204;NA;98342;39;2021-06-02;96978
2021-06-01;"Košický kraj";13;7562;10;7572;NA;98342;23;2021-06-01;96939
2021-05-31;"Košický kraj";13;9256;18;9274;NA;98342;31;2021-05-31;96916
2021-05-30;"Košický kraj";3;11215;10;11225;NA;98342;13;2021-05-30;96885
2021-05-29;"Košický kraj";25;10942;22;10964;NA;98342;47;2021-05-29;96872
2021-05-28;"Košický kraj";17;13055;29;13084;NA;98342;46;2021-05-28;96825
2021-05-27;"Košický kraj";19;7924;26;7950;NA;98342;45;2021-05-27;96779
2021-05-26;"Košický kraj";35;8118;27;8145;NA;98342;62;2021-05-26;96734
2021-05-25;"Košický kraj";33;9296;29;9325;NA;98342;62;2021-05-25;96672
2021-05-24;"Košický kraj";10;10855;27;10882;NA;98342;37;2021-05-24;96610
2021-05-23;"Košický kraj";4;12151;15;12166;NA;98342;19;2021-05-23;96573
2021-05-22;"Košický kraj";27;12601;19;12620;NA;98342;46;2021-05-22;96554
2021-05-21;"Košický kraj";24;14910;27;14937;NA;98342;51;2021-05-21;96508
2021-05-20;"Košický kraj";20;9422;28;9450;NA;98342;48;2021-05-20;96457
2021-05-19;"Košický kraj";30;10421;21;10442;NA;98342;51;2021-05-19;96409
2021-05-18;"Košický kraj";34;10254;36;10290;NA;98342;70;2021-05-18;96358
2021-05-17;"Košický kraj";20;12686;38;12724;NA;98342;58;2021-05-17;96288
2021-05-16;"Košický kraj";37;17865;20;17885;NA;98342;57;2021-05-16;96230
2021-05-15;"Košický kraj";22;25602;28;25630;NA;98342;50;2021-05-15;96173
2021-05-14;"Košický kraj";32;21824;42;21866;NA;98342;74;2021-05-14;96123
2021-05-13;"Košický kraj";39;10172;32;10204;NA;98342;71;2021-05-13;96049
2021-05-12;"Košický kraj";85;10868;33;10901;NA;98342;118;2021-05-12;95978
2021-05-11;"Košický kraj";68;11166;32;11198;NA;98342;100;2021-05-11;95860
2021-05-10;"Košický kraj";25;17044;42;17086;NA;98342;67;2021-05-10;95760
2021-05-09;"Košický kraj";84;25594;55;25649;NA;98342;139;2021-05-09;95693
2021-05-08;"Košický kraj";18;23399;23;23422;NA;98342;41;2021-05-08;95554
2021-05-07;"Košický kraj";51;24497;57;24554;NA;98342;108;2021-05-07;95513
2021-05-06;"Košický kraj";55;11847;43;11890;NA;98342;98;2021-05-06;95405
2021-05-05;"Košický kraj";23;12124;35;12159;NA;98342;58;2021-05-05;95307
2021-05-04;"Košický kraj";143;13562;38;13600;NA;98342;181;2021-05-04;95249
2021-05-03;"Košický kraj";37;16944;68;17012;NA;98342;105;2021-05-03;95068
2021-05-02;"Košický kraj";45;36096;56;36152;NA;98342;101;2021-05-02;94963
2021-05-01;"Košický kraj";54;52075;76;52151;NA;98342;130;2021-05-01;94862
2021-04-30;"Košický kraj";59;44602;94;44696;NA;98342;153;2021-04-30;94732
2021-04-29;"Košický kraj";76;17014;53;17067;NA;98342;129;2021-04-29;94579
2021-04-28;"Košický kraj";99;17970;52;18022;NA;98342;151;2021-04-28;94450
2021-04-27;"Košický kraj";108;20670;43;20713;NA;98342;151;2021-04-27;94299
2021-04-26;"Košický kraj";39;25915;96;26011;NA;98342;135;2021-04-26;94148
2021-04-25;"Košický kraj";23;48355;57;48412;NA;98342;80;2021-04-25;94013
2021-04-24;"Košický kraj";68;90124;114;90238;NA;98342;182;2021-04-24;93933
2021-04-23;"Košický kraj";110;41232;72;41304;NA;98342;182;2021-04-23;93751
2021-04-22;"Košický kraj";56;16772;44;16816;NA;98342;100;2021-04-22;93569
2021-04-21;"Košický kraj";114;19519;61;19580;NA;98342;175;2021-04-21;93469
2021-04-20;"Košický kraj";81;25432;63;25495;NA;98342;144;2021-04-20;93294
2021-04-19;"Košický kraj";93;29950;108;30058;NA;98342;201;2021-04-19;93150
2021-04-18;"Košický kraj";10;48913;82;48995;NA;98342;92;2021-04-18;92949
2021-04-17;"Košický kraj";187;83856;103;83959;NA;98342;290;2021-04-17;92857
2021-04-16;"Košický kraj";83;41568;127;41695;NA;98342;210;2021-04-16;92567
2021-04-15;"Košický kraj";104;18522;93;18615;NA;98342;197;2021-04-15;92357
2021-04-14;"Košický kraj";119;20089;64;20153;NA;98342;183;2021-04-14;92160
2021-04-13;"Košický kraj";81;23175;120;23295;NA;98342;201;2021-04-13;91977
2021-04-12;"Košický kraj";129;26573;124;26697;NA;98342;253;2021-04-12;91776
2021-04-11;"Košický kraj";29;46949;80;47029;NA;98342;109;2021-04-11;91523
2021-04-10;"Košický kraj";138;100114;183;100297;NA;98342;321;2021-04-10;91414
2021-04-09;"Košický kraj";168;35206;133;35339;NA;98342;301;2021-04-09;91093
2021-04-08;"Košický kraj";81;18530;90;18620;NA;98342;171;2021-04-08;90792
2021-04-07;"Košický kraj";232;28027;194;28221;NA;98342;426;2021-04-07;90621
2021-04-06;"Košický kraj";121;36495;164;36659;NA;98342;285;2021-04-06;90195
2021-04-05;"Košický kraj";19;14361;66;14427;NA;98342;85;2021-04-05;89910
2021-04-04;"Košický kraj";33;15089;66;15155;NA;98342;99;2021-04-04;89825
2021-04-03;"Košický kraj";138;97664;241;97905;NA;98342;379;2021-04-03;89726
2021-04-02;"Košický kraj";128;24515;76;24591;NA;98342;204;2021-04-02;89347
2021-04-01;"Košický kraj";165;46151;156;46307;NA;98342;321;2021-04-01;89143
2021-03-31;"Košický kraj";160;29659;124;29783;NA;98342;284;2021-03-31;88822
2021-03-30;"Košický kraj";229;24038;163;24201;NA;98342;392;2021-03-30;88538
2021-03-29;"Košický kraj";78;28843;194;29037;NA;98342;272;2021-03-29;88146
2021-03-28;"Košický kraj";39;44263;128;44391;NA;98342;167;2021-03-28;87874
2021-03-27;"Košický kraj";222;96602;265;96867;NA;98342;487;2021-03-27;87707
2021-03-26;"Košický kraj";233;45252;202;45454;NA;98342;435;2021-03-26;87220
2021-03-25;"Košický kraj";133;23804;175;23979;NA;98342;308;2021-03-25;86785
2021-03-24;"Košický kraj";165;20696;155;20851;NA;98342;320;2021-03-24;86477
2021-03-23;"Košický kraj";202;22434;192;22626;NA;98342;394;2021-03-23;86157
2021-03-22;"Košický kraj";169;26890;228;27118;NA;98342;397;2021-03-22;85763
2021-03-21;"Košický kraj";109;46746;167;46913;NA;98342;276;2021-03-21;85366
2021-03-20;"Košický kraj";126;101334;311;101645;NA;98342;437;2021-03-20;85090
2021-03-19;"Košický kraj";205;45632;260;45892;NA;98342;465;2021-03-19;84653
2021-03-18;"Košický kraj";274;23827;212;24039;NA;98342;486;2021-03-18;84188
2021-03-17;"Košický kraj";177;21548;195;21743;NA;98342;372;2021-03-17;83702
2021-03-16;"Košický kraj";386;23454;226;23680;NA;98342;612;2021-03-16;83330
2021-03-15;"Košický kraj";173;27900;297;28197;NA;98342;470;2021-03-15;82718
2021-03-14;"Košický kraj";145;44354;220;44574;NA;98342;365;2021-03-14;82248
2021-03-13;"Košický kraj";146;103790;483;104273;NA;98342;629;2021-03-13;81883
2021-03-12;"Košický kraj";366;47871;321;48192;NA;98342;687;2021-03-12;81254
2021-03-11;"Košický kraj";396;23229;263;23492;NA;98342;659;2021-03-11;80567
2021-03-10;"Košický kraj";121;22205;269;22474;NA;98342;390;2021-03-10;79908
2021-03-09;"Košický kraj";676;24509;300;24809;NA;98342;976;2021-03-09;79518
2021-03-08;"Košický kraj";559;29852;344;30196;NA;98342;903;2021-03-08;78542
2021-03-07;"Košický kraj";45;44230;299;44529;NA;98342;344;2021-03-07;77639
2021-03-06;"Košický kraj";177;105598;532;106130;NA;98342;709;2021-03-06;77295
2021-03-05;"Košický kraj";439;45567;424;45991;NA;98342;863;2021-03-05;76586
2021-03-04;"Košický kraj";417;23862;320;24182;NA;98342;737;2021-03-04;75723
2021-03-03;"Košický kraj";390;23169;298;23467;NA;98342;688;2021-03-03;74986
2021-03-02;"Košický kraj";464;24158;368;24526;NA;98342;832;2021-03-02;74298
2021-03-01;"Košický kraj";389;30013;514;30527;NA;98342;903;2021-03-01;73466
2021-02-28;"Košický kraj";265;43053;334;43387;NA;98342;599;2021-02-28;72563
2021-02-27;"Košický kraj";301;100559;784;101343;NA;98342;1085;2021-02-27;71964
2021-02-26;"Košický kraj";440;45466;492;45958;NA;98342;932;2021-02-26;70879
2021-02-25;"Košický kraj";331;19872;342;20214;NA;98342;673;2021-02-25;69947
2021-02-24;"Košický kraj";263;18751;505;19256;NA;98342;768;2021-02-24;69274
2021-02-23;"Košický kraj";642;21605;341;21946;NA;98342;983;2021-02-23;68506
2021-02-22;"Košický kraj";362;30858;434;31292;NA;98342;796;2021-02-22;67523
2021-02-21;"Košický kraj";170;40464;385;40849;NA;98342;555;2021-02-21;66727
2021-02-20;"Košický kraj";283;92550;770;93320;NA;98342;1053;2021-02-20;66172
2021-02-19;"Košický kraj";507;41579;583;42162;NA;98342;1090;2021-02-19;65119
2021-02-18;"Košický kraj";397;18442;345;18787;NA;98342;742;2021-02-18;64029
2021-02-17;"Košický kraj";322;18080;387;18467;NA;98342;709;2021-02-17;63287
2021-02-16;"Košický kraj";600;22111;463;22574;NA;98342;1063;2021-02-16;62578
2021-02-15;"Košický kraj";216;27633;419;28052;NA;98342;635;2021-02-15;61515
2021-02-14;"Košický kraj";241;56743;524;57267;NA;98342;765;2021-02-14;60880
2021-02-13;"Košický kraj";206;93745;765;94510;NA;98342;971;2021-02-13;60115
2021-02-12;"Košický kraj";448;49924;611;50535;NA;98342;1059;2021-02-12;59144
2021-02-11;"Košický kraj";435;14524;323;14847;NA;98342;758;2021-02-11;58085
2021-02-10;"Košický kraj";360;18475;431;18906;NA;98342;791;2021-02-10;57327
2021-02-09;"Košický kraj";544;24841;463;25304;NA;98342;1007;2021-02-09;56536
2021-02-08;"Košický kraj";237;24836;392;25228;NA;98342;629;2021-02-08;55529
2021-02-07;"Košický kraj";208;56897;612;57509;NA;98342;820;2021-02-07;54900
2021-02-06;"Košický kraj";318;104357;884;105241;NA;98342;1202;2021-02-06;54080
2021-02-05;"Košický kraj";384;43186;494;43680;NA;98342;878;2021-02-05;52878
2021-02-04;"Košický kraj";391;14512;371;14883;NA;98342;762;2021-02-04;52000
2021-02-03;"Košický kraj";296;12599;339;12938;NA;98342;635;2021-02-03;51238
2021-02-02;"Košický kraj";473;43883;1212;45095;NA;98342;1685;2021-02-02;50603
2021-02-01;"Košický kraj";415;21984;362;22346;NA;98342;777;2021-02-01;48918
2021-01-31;"Košický kraj";142;54690;617;55307;NA;98342;759;2021-01-31;48141
2021-01-30;"Košický kraj";320;76722;661;77383;NA;98342;981;2021-01-30;47382
2021-01-29;"Košický kraj";311;37164;466;37630;NA;98342;777;2021-01-29;46401
2021-01-28;"Košický kraj";540;9006;244;9250;NA;98342;784;2021-01-28;45624
2021-01-27;"Košický kraj";265;7575;211;7786;NA;98342;476;2021-01-27;44840
2021-01-26;"Košický kraj";530;14210;245;14455;NA;98342;775;2021-01-26;44364
2021-01-25;"Košický kraj";226;26431;413;26844;NA;98342;639;2021-01-25;43589
2021-01-24;"Košický kraj";150;44419;581;45000;NA;98342;731;2021-01-24;42950
2021-01-23;"Košický kraj";232;82705;857;83562;NA;98342;1089;2021-01-23;42219
2021-01-22;"Košický kraj";316;19997;265;20262;NA;98342;581;2021-01-22;41130
2021-01-21;"Košický kraj";274;14053;159;14212;NA;98342;433;2021-01-21;40549
2021-01-20;"Košický kraj";374;10844;201;11045;NA;98342;575;2021-01-20;40116
2021-01-19;"Košický kraj";248;9717;181;9898;NA;98342;429;2021-01-19;39541
2021-01-18;"Košický kraj";333;7659;262;7921;NA;98342;595;2021-01-18;39112
2021-01-17;"Košický kraj";155;535;14;549;NA;98342;169;2021-01-17;38517
2021-01-16;"Košický kraj";153;1403;47;1450;NA;98342;200;2021-01-16;38348
2021-01-15;"Košický kraj";308;6443;213;6656;NA;98342;521;2021-01-15;38148
2021-01-14;"Košický kraj";358;5471;221;5692;NA;98342;579;2021-01-14;37627
2021-01-13;"Košický kraj";421;4897;226;5123;NA;98342;647;2021-01-13;37048
2021-01-12;"Košický kraj";482;6473;237;6710;NA;98342;719;2021-01-12;36401
2021-01-11;"Košický kraj";309;7553;286;7839;NA;98342;595;2021-01-11;35682
2021-01-10;"Košický kraj";193;136;6;142;NA;98342;199;2021-01-10;35087
2021-01-09;"Košický kraj";469;1134;45;1179;NA;98342;514;2021-01-09;34888
2021-01-08;"Košický kraj";551;7106;348;7454;NA;98342;899;2021-01-08;34374
2021-01-07;"Košický kraj";251;5853;398;6251;NA;98342;649;2021-01-07;33475
2021-01-06;"Košický kraj";442;429;33;462;NA;98342;475;2021-01-06;32826
2021-01-05;"Košický kraj";584;7633;527;8160;NA;98342;1111;2021-01-05;32351
2021-01-04;"Košický kraj";407;6479;660;7139;NA;98342;1067;2021-01-04;31240
2021-01-03;"Košický kraj";118;661;22;683;NA;98342;140;2021-01-03;30173
2021-01-02;"Košický kraj";88;440;52;492;NA;98342;140;2021-01-02;30033
2021-01-01;"Košický kraj";398;725;49;774;NA;98342;447;2021-01-01;29893
2020-12-31;"Košický kraj";625;7877;461;8338;NA;98342;1086;2020-12-31;29446
2020-12-30;"Košický kraj";590;6477;412;6889;NA;98342;1002;2020-12-30;28360
2020-12-29;"Košický kraj";419;7573;605;8178;NA;98342;1024;2020-12-29;27358
2020-12-28;"Košický kraj";356;8296;804;9100;NA;98342;1160;2020-12-28;26334
2020-12-27;"Košický kraj";159;147;16;163;NA;98342;175;2020-12-27;25174
2020-12-26;"Košický kraj";163;274;23;297;NA;98342;186;2020-12-26;24999
2020-12-25;"Košický kraj";237;140;10;150;NA;98342;247;2020-12-25;24813
2020-12-24;"Košický kraj";564;1470;90;1560;NA;98342;654;2020-12-24;24566
2020-12-23;"Košický kraj";304;7942;354;8296;NA;98342;658;2020-12-23;23912
2020-12-22;"Košický kraj";438;7915;459;8374;NA;98342;897;2020-12-22;23254
2020-12-21;"Košický kraj";405;6981;509;7490;NA;98342;914;2020-12-21;22357
2020-12-20;"Košický kraj";215;73;11;84;NA;98342;226;2020-12-20;21443
2020-12-19;"Košický kraj";207;1309;63;1372;NA;98342;270;2020-12-19;21217
2020-12-18;"Košický kraj";310;8484;326;8810;NA;98342;636;2020-12-18;20947
2020-12-17;"Košický kraj";463;5292;255;5547;NA;98342;718;2020-12-17;20311
2020-12-16;"Košický kraj";455;5898;316;6214;NA;98342;771;2020-12-16;19593
2020-12-15;"Košický kraj";319;5086;338;5424;NA;98342;657;2020-12-15;18822
2020-12-14;"Košický kraj";256;3401;264;3665;NA;98342;520;2020-12-14;18165
2020-12-13;"Košický kraj";47;181;2;183;NA;98342;49;2020-12-13;17645
2020-12-12;"Košický kraj";369;1587;118;1705;NA;98342;487;2020-12-12;17596
2020-12-11;"Košický kraj";354;5461;258;5719;NA;98342;612;2020-12-11;17109
2020-12-10;"Košický kraj";283;4064;176;4240;NA;98342;459;2020-12-10;16497
2020-12-09;"Košický kraj";279;3786;166;3952;NA;98342;445;2020-12-09;16038
2020-12-08;"Košický kraj";226;4105;355;4460;NA;98342;581;2020-12-08;15593
2020-12-07;"Košický kraj";270;2383;106;2489;NA;98342;376;2020-12-07;15012
2020-12-06;"Košický kraj";121;97;20;117;NA;98342;141;2020-12-06;14636
2020-12-05;"Košický kraj";90;1096;48;1144;NA;98342;138;2020-12-05;14495
2020-12-04;"Košický kraj";224;2680;82;2762;NA;98342;306;2020-12-04;14357
2020-12-03;"Košický kraj";211;7717;173;7890;NA;98342;384;2020-12-03;14051
2020-12-02;"Košický kraj";193;8132;496;8628;NA;98342;689;2020-12-02;13667
2020-12-01;"Košický kraj";178;2237;124;2361;NA;98342;302;2020-12-01;12978
2020-11-30;"Košický kraj";171;3598;59;3657;NA;98342;230;2020-11-30;12676
2020-11-29;"Košický kraj";31;325;17;342;NA;98342;48;2020-11-29;12446
2020-11-28;"Košický kraj";69;721;52;773;NA;98342;121;2020-11-28;12398
2020-11-27;"Košický kraj";149;2921;78;2999;NA;98342;227;2020-11-27;12277
2020-11-26;"Košický kraj";239;1234;60;1294;NA;98342;299;2020-11-26;12050
2020-11-25;"Košický kraj";237;1785;123;1908;NA;98342;360;2020-11-25;11751
2020-11-24;"Košický kraj";196;1976;67;2043;NA;98342;263;2020-11-24;11391
2020-11-23;"Košický kraj";51;4115;63;4178;NA;98342;114;2020-11-23;11128
2020-11-22;"Košický kraj";57;57;5;62;NA;98342;62;2020-11-22;11014
2020-11-21;"Košický kraj";87;858;36;894;NA;98342;123;2020-11-21;10952
2020-11-20;"Košický kraj";176;3084;49;3133;NA;98342;225;2020-11-20;10829
2020-11-19;"Košický kraj";206;1736;48;1784;NA;98342;254;2020-11-19;10604
2020-11-18;"Košický kraj";122;532;17;549;NA;98342;139;2020-11-18;10350
2020-11-17;"Košický kraj";152;82;9;91;NA;98342;161;2020-11-17;10211
2020-11-16;"Košický kraj";114;596;27;623;NA;98342;141;2020-11-16;10050
2020-11-15;"Košický kraj";15;338;7;345;NA;98342;22;2020-11-15;9909
2020-11-14;"Košický kraj";234;520;12;532;NA;98342;246;2020-11-14;9887
2020-11-13;"Košický kraj";207;664;29;693;NA;98342;236;2020-11-13;9641
2020-11-12;"Košický kraj";192;736;13;749;NA;98342;205;2020-11-12;9405
2020-11-11;"Košický kraj";301;593;7;600;NA;98342;308;2020-11-11;9200
2020-11-10;"Košický kraj";190;541;11;552;NA;98342;201;2020-11-10;8892
2020-11-09;"Košický kraj";129;380;17;397;NA;98342;146;2020-11-09;8691
2020-11-08;"Košický kraj";78;1306;8;1314;NA;98342;86;2020-11-08;8545
2020-11-07;"Košický kraj";192;3909;22;3931;NA;98342;214;2020-11-07;8459
2020-11-06;"Košický kraj";195;5310;34;5344;NA;98342;229;2020-11-06;8245
2020-11-05;"Košický kraj";342;330;31;361;NA;98342;373;2020-11-05;8016
2020-11-04;"Košický kraj";101;154;6;160;NA;98342;107;2020-11-04;7643
2020-11-03;"Košický kraj";358;1122;13;1135;NA;98342;371;2020-11-03;7536
2020-11-02;"Košický kraj";111;6125;56;6181;NA;98342;167;2020-11-02;7165
2020-11-01;"Košický kraj";346;6522;34;6556;NA;98342;380;2020-11-01;6998
2020-10-31;"Košický kraj";82;14035;106;14141;NA;98342;188;2020-10-31;6618
2020-10-30;"Košický kraj";379;2835;27;2862;NA;98342;406;2020-10-30;6430
2020-10-29;"Košický kraj";333;983;13;996;NA;98342;346;2020-10-29;6024
2020-10-28;"Košický kraj";224;305;13;318;NA;98342;237;2020-10-28;5678
2020-10-27;"Košický kraj";386;439;21;460;NA;98342;407;2020-10-27;5441
2020-10-26;"Košický kraj";56;212;12;224;NA;98342;68;2020-10-26;5034
2020-10-25;"Košický kraj";154;79;2;81;NA;98342;156;2020-10-25;4966
2020-10-24;"Košický kraj";313;118;16;134;NA;98342;329;2020-10-24;4810
2020-10-23;"Košický kraj";315;331;8;339;NA;98342;323;2020-10-23;4481
2020-10-22;"Košický kraj";349;530;16;546;NA;98342;365;2020-10-22;4158
2020-10-21;"Košický kraj";129;84;2;86;NA;98342;131;2020-10-21;3793
2020-10-20;"Košický kraj";181;14;1;15;NA;98342;182;2020-10-20;3662
2020-10-19;"Košický kraj";64;38;1;39;NA;98342;65;2020-10-19;3480
2020-10-18;"Košický kraj";158;0;0;0;NA;98342;158;2020-10-18;3415
2020-10-17;"Košický kraj";142;0;0;0;NA;98342;142;2020-10-17;3257
2020-10-16;"Košický kraj";206;19;0;19;NA;98342;206;2020-10-16;3115
2020-10-15;"Košický kraj";177;19;5;24;NA;98342;182;2020-10-15;2909
2020-10-14;"Košický kraj";211;8;0;8;NA;98342;211;2020-10-14;2727
2020-10-13;"Košický kraj";179;80;3;83;NA;98342;182;2020-10-13;2516
2020-10-12;"Košický kraj";74;0;0;0;NA;98342;74;2020-10-12;2334
2020-10-11;"Košický kraj";121;0;0;0;NA;98342;121;2020-10-11;2260
2020-10-10;"Košický kraj";70;0;0;0;NA;98342;70;2020-10-10;2139
2020-10-09;"Košický kraj";188;0;0;0;NA;98342;188;2020-10-09;2069
2020-10-08;"Košický kraj";102;0;0;0;NA;98342;102;2020-10-08;1881
2020-10-07;"Košický kraj";158;0;0;0;NA;98342;158;2020-10-07;1779
2020-10-06;"Košický kraj";70;0;0;0;NA;98342;70;2020-10-06;1621
2020-10-05;"Košický kraj";39;0;0;0;NA;98342;39;2020-10-05;1551
2020-10-04;"Košický kraj";45;0;0;0;NA;98342;45;2020-10-04;1512
2020-10-03;"Košický kraj";105;0;0;0;NA;98342;105;2020-10-03;1467
2020-10-02;"Košický kraj";57;0;0;0;NA;98342;57;2020-10-02;1362
2020-10-01;"Košický kraj";69;0;0;0;NA;98342;69;2020-10-01;1305
2020-09-30;"Košický kraj";95;0;0;0;NA;98342;95;2020-09-30;1236
2020-09-29;"Košický kraj";75;0;0;0;NA;98342;75;2020-09-29;1141
2020-09-28;"Košický kraj";19;0;0;0;NA;98342;19;2020-09-28;1066
2020-09-27;"Košický kraj";21;0;0;0;NA;98342;21;2020-09-27;1047
2020-09-26;"Košický kraj";53;0;0;0;NA;98342;53;2020-09-26;1026
2020-09-25;"Košický kraj";72;0;0;0;NA;98342;72;2020-09-25;973
2020-09-24;"Košický kraj";35;0;0;0;NA;98342;35;2020-09-24;901
2020-09-23;"Košický kraj";23;0;0;0;NA;98342;23;2020-09-23;866
2020-09-22;"Košický kraj";39;0;0;0;NA;98342;39;2020-09-22;843
2020-09-21;"Košický kraj";5;0;0;0;NA;98342;5;2020-09-21;804
2020-09-20;"Košický kraj";3;0;0;0;NA;98342;3;2020-09-20;799
2020-09-19;"Košický kraj";13;0;0;0;NA;98342;13;2020-09-19;796
2020-09-18;"Košický kraj";20;0;0;0;NA;98342;20;2020-09-18;783
2020-09-17;"Košický kraj";22;0;0;0;NA;98342;22;2020-09-17;763
2020-09-16;"Košický kraj";12;0;0;0;NA;98342;12;2020-09-16;741
2020-09-15;"Košický kraj";10;0;0;0;NA;98342;10;2020-09-15;729
2020-09-14;"Košický kraj";6;0;0;0;NA;98342;6;2020-09-14;719
2020-09-13;"Košický kraj";3;0;0;0;NA;98342;3;2020-09-13;713
2020-09-12;"Košický kraj";16;0;0;0;NA;98342;16;2020-09-12;710
2020-09-11;"Košický kraj";20;0;0;0;NA;98342;20;2020-09-11;694
2020-09-10;"Košický kraj";11;0;0;0;NA;98342;11;2020-09-10;674
2020-09-09;"Košický kraj";37;0;0;0;NA;98342;37;2020-09-09;663
2020-09-08;"Košický kraj";10;0;0;0;NA;98342;10;2020-09-08;626
2020-09-07;"Košický kraj";4;0;0;0;NA;98342;4;2020-09-07;616
2020-09-06;"Košický kraj";2;0;0;0;NA;98342;2;2020-09-06;612
2020-09-05;"Košický kraj";10;0;0;0;NA;98342;10;2020-09-05;610
2020-09-04;"Košický kraj";14;0;0;0;NA;98342;14;2020-09-04;600
2020-09-03;"Košický kraj";22;0;0;0;NA;98342;22;2020-09-03;586
2020-09-02;"Košický kraj";13;0;0;0;NA;98342;13;2020-09-02;564
2020-09-01;"Košický kraj";21;0;0;0;NA;98342;21;2020-09-01;551
2020-08-31;"Košický kraj";9;0;0;0;NA;98342;9;2020-08-31;530
2020-08-30;"Košický kraj";21;0;0;0;NA;98342;21;2020-08-30;521
2020-08-29;"Košický kraj";1;0;0;0;NA;98342;1;2020-08-29;500
2020-08-28;"Košický kraj";19;0;0;0;NA;98342;19;2020-08-28;499
2020-08-27;"Košický kraj";15;0;0;0;NA;98342;15;2020-08-27;480
2020-08-26;"Košický kraj";8;0;0;0;NA;98342;8;2020-08-26;465
2020-08-25;"Košický kraj";23;0;0;0;NA;98342;23;2020-08-25;457
2020-08-24;"Košický kraj";6;0;0;0;NA;98342;6;2020-08-24;434
2020-08-23;"Košický kraj";8;0;0;0;NA;98342;8;2020-08-23;428
2020-08-22;"Košický kraj";13;0;0;0;NA;98342;13;2020-08-22;420
2020-08-21;"Košický kraj";10;0;0;0;NA;98342;10;2020-08-21;407
2020-08-20;"Košický kraj";10;0;0;0;NA;98342;10;2020-08-20;397
2020-08-19;"Košický kraj";3;0;0;0;NA;98342;3;2020-08-19;387
2020-08-18;"Košický kraj";7;0;0;0;NA;98342;7;2020-08-18;384
2020-08-17;"Košický kraj";2;0;0;0;NA;98342;2;2020-08-17;377
2020-08-16;"Košický kraj";2;0;0;0;NA;98342;2;2020-08-16;375
2020-08-15;"Košický kraj";3;0;0;0;NA;98342;3;2020-08-15;373
2020-08-14;"Košický kraj";1;0;0;0;NA;98342;1;2020-08-14;370
2020-08-13;"Košický kraj";3;0;0;0;NA;98342;3;2020-08-13;369
2020-08-12;"Košický kraj";12;0;0;0;NA;98342;12;2020-08-12;366
2020-08-11;"Košický kraj";5;0;0;0;NA;98342;5;2020-08-11;354
2020-08-10;"Košický kraj";1;0;0;0;NA;98342;1;2020-08-10;349
2020-08-09;"Košický kraj";0;0;0;0;NA;98342;0;2020-08-09;348
2020-08-08;"Košický kraj";5;0;0;0;NA;98342;5;2020-08-08;348
2020-08-07;"Košický kraj";7;0;0;0;NA;98342;7;2020-08-07;343
2020-08-06;"Košický kraj";3;0;0;0;NA;98342;3;2020-08-06;336
2020-08-05;"Košický kraj";4;0;0;0;NA;98342;4;2020-08-05;333
2020-08-04;"Košický kraj";1;0;0;0;NA;98342;1;2020-08-04;329
2020-08-03;"Košický kraj";1;0;0;0;NA;98342;1;2020-08-03;328
2020-08-02;"Košický kraj";0;0;0;0;NA;98342;0;2020-08-02;327
2020-08-01;"Košický kraj";0;0;0;0;NA;98342;0;2020-08-01;327
2020-07-31;"Košický kraj";0;0;0;0;NA;98342;0;2020-07-31;327
2020-07-30;"Košický kraj";2;0;0;0;NA;98342;2;2020-07-30;327
2020-07-29;"Košický kraj";1;0;0;0;NA;98342;1;2020-07-29;325
2020-07-28;"Košický kraj";9;0;0;0;NA;98342;9;2020-07-28;324
2020-07-27;"Košický kraj";4;0;0;0;NA;98342;4;2020-07-27;315
2020-07-26;"Košický kraj";0;0;0;0;NA;98342;0;2020-07-26;311
2020-07-25;"Košický kraj";2;0;0;0;NA;98342;2;2020-07-25;311
2020-07-24;"Košický kraj";2;0;0;0;NA;98342;2;2020-07-24;309
2020-07-23;"Košický kraj";1;0;0;0;NA;98342;1;2020-07-23;307
2020-07-22;"Košický kraj";1;0;0;0;NA;98342;1;2020-07-22;306
2020-07-21;"Košický kraj";0;0;0;0;NA;98342;0;2020-07-21;305
2020-07-20;"Košický kraj";0;0;0;0;NA;98342;0;2020-07-20;305
2020-07-19;"Košický kraj";0;0;0;0;NA;98342;0;2020-07-19;305
2020-07-18;"Košický kraj";1;0;0;0;NA;98342;1;2020-07-18;305
2020-07-17;"Košický kraj";1;0;0;0;NA;98342;1;2020-07-17;304
2020-07-16;"Košický kraj";0;0;0;0;NA;98342;0;2020-07-16;303
2020-07-15;"Košický kraj";2;0;0;0;NA;98342;2;2020-07-15;303
2020-07-14;"Košický kraj";1;0;0;0;NA;98342;1;2020-07-14;301
2020-07-13;"Košický kraj";1;0;0;0;NA;98342;1;2020-07-13;300
2020-07-12;"Košický kraj";0;0;0;0;NA;98342;0;2020-07-12;299
2020-07-11;"Košický kraj";0;0;0;0;NA;98342;0;2020-07-11;299
2020-07-10;"Košický kraj";1;0;0;0;NA;98342;1;2020-07-10;299
2020-07-09;"Košický kraj";1;0;0;0;NA;98342;1;2020-07-09;298
2020-07-08;"Košický kraj";12;0;0;0;NA;98342;12;2020-07-08;297
2020-07-07;"Košický kraj";0;0;0;0;NA;98342;0;2020-07-07;285
2020-07-06;"Košický kraj";0;0;0;0;NA;98342;0;2020-07-06;285
2020-07-05;"Košický kraj";0;0;0;0;NA;98342;0;2020-07-05;285
2020-07-04;"Košický kraj";0;0;0;0;NA;98342;0;2020-07-04;285
2020-07-03;"Košický kraj";1;0;0;0;NA;98342;1;2020-07-03;285
2020-07-02;"Košický kraj";0;0;0;0;NA;98342;0;2020-07-02;284
2020-07-01;"Košický kraj";1;0;0;0;NA;98342;1;2020-07-01;284
2020-06-30;"Košický kraj";0;0;0;0;NA;98342;0;2020-06-30;283
2020-06-29;"Košický kraj";0;0;0;0;NA;98342;0;2020-06-29;283
2020-06-28;"Košický kraj";0;0;0;0;NA;98342;0;2020-06-28;283
2020-06-27;"Košický kraj";0;0;0;0;NA;98342;0;2020-06-27;283
2020-06-26;"Košický kraj";0;0;0;0;NA;98342;0;2020-06-26;283
2020-06-25;"Košický kraj";3;0;0;0;NA;98342;3;2020-06-25;283
2020-06-24;"Košický kraj";3;0;0;0;NA;98342;3;2020-06-24;280
2020-06-23;"Košický kraj";3;0;0;0;NA;98342;3;2020-06-23;277
2020-06-22;"Košický kraj";0;0;0;0;NA;98342;0;2020-06-22;274
2020-06-21;"Košický kraj";0;0;0;0;NA;98342;0;2020-06-21;274
2020-06-20;"Košický kraj";0;0;0;0;NA;98342;0;2020-06-20;274
2020-06-19;"Košický kraj";0;0;0;0;NA;98342;0;2020-06-19;274
2020-06-18;"Košický kraj";1;0;0;0;NA;98342;1;2020-06-18;274
2020-06-17;"Košický kraj";0;0;0;0;NA;98342;0;2020-06-17;273
2020-06-16;"Košický kraj";2;0;0;0;NA;98342;2;2020-06-16;273
2020-06-14;"Košický kraj";0;0;0;0;NA;98342;0;2020-06-14;271
2020-06-13;"Košický kraj";0;0;0;0;NA;98342;0;2020-06-13;271
2020-06-12;"Košický kraj";0;0;0;0;NA;98342;0;2020-06-12;271
2020-06-11;"Košický kraj";0;0;0;0;NA;98342;0;2020-06-11;271
2020-06-10;"Košický kraj";6;0;0;0;NA;98342;6;2020-06-10;271
2020-06-09;"Košický kraj";0;0;0;0;NA;98342;0;2020-06-09;265
2020-06-08;"Košický kraj";0;0;0;0;NA;98342;0;2020-06-08;265
2020-06-07;"Košický kraj";2;0;0;0;NA;98342;2;2020-06-07;265
2020-06-05;"Košický kraj";0;0;0;0;NA;98342;0;2020-06-05;263
2020-06-03;"Košický kraj";0;0;0;0;NA;98342;0;2020-06-03;263
2020-06-02;"Košický kraj";1;0;0;0;NA;98342;1;2020-06-02;263
2020-05-31;"Košický kraj";0;0;0;0;NA;98342;0;2020-05-31;262
2020-05-29;"Košický kraj";1;0;0;0;NA;98342;1;2020-05-29;262
2020-05-27;"Košický kraj";0;0;0;0;NA;98342;0;2020-05-27;261
2020-05-26;"Košický kraj";1;0;0;0;NA;98342;1;2020-05-26;261
2020-05-25;"Košický kraj";1;0;0;0;NA;98342;1;2020-05-25;260
2020-05-24;"Košický kraj";0;0;0;0;NA;98342;0;2020-05-24;259
2020-05-23;"Košický kraj";0;0;0;0;NA;98342;0;2020-05-23;259
2020-05-22;"Košický kraj";0;0;0;0;NA;98342;0;2020-05-22;259
2020-05-21;"Košický kraj";0;0;0;0;NA;98342;0;2020-05-21;259
2020-05-20;"Košický kraj";3;0;0;0;NA;98342;3;2020-05-20;259
2020-05-19;"Košický kraj";0;0;0;0;NA;98342;0;2020-05-19;256
2020-05-17;"Košický kraj";1;0;0;0;NA;98342;1;2020-05-17;256
2020-05-16;"Košický kraj";1;0;0;0;NA;98342;1;2020-05-16;255
2020-05-15;"Košický kraj";10;0;0;0;NA;98342;10;2020-05-15;254
2020-05-14;"Košický kraj";1;0;0;0;NA;98342;1;2020-05-14;244
2020-05-13;"Košický kraj";6;0;0;0;NA;98342;6;2020-05-13;243
2020-05-12;"Košický kraj";0;0;0;0;NA;98342;0;2020-05-12;237
2020-05-11;"Košický kraj";0;0;0;0;NA;98342;0;2020-05-11;237
2020-05-09;"Košický kraj";0;0;0;0;NA;98342;0;2020-05-09;237
2020-05-07;"Košický kraj";0;0;0;0;NA;98342;0;2020-05-07;237
2020-05-06;"Košický kraj";1;0;0;0;NA;98342;1;2020-05-06;237
2020-05-05;"Košický kraj";0;0;0;0;NA;98342;0;2020-05-05;236
2020-05-04;"Košický kraj";0;0;0;0;NA;98342;0;2020-05-04;236
2020-05-03;"Košický kraj";0;0;0;0;NA;98342;0;2020-05-03;236
2020-05-02;"Košický kraj";1;0;0;0;NA;98342;1;2020-05-02;236
2020-05-01;"Košický kraj";0;0;0;0;NA;98342;0;2020-05-01;235
2020-04-30;"Košický kraj";1;0;0;0;NA;98342;1;2020-04-30;235
2020-04-29;"Košický kraj";1;0;0;0;NA;98342;1;2020-04-29;234
2020-04-28;"Košický kraj";1;0;0;0;NA;98342;1;2020-04-28;233
2020-04-27;"Košický kraj";1;0;0;0;NA;98342;1;2020-04-27;232
2020-04-26;"Košický kraj";0;0;0;0;NA;98342;0;2020-04-26;231
2020-04-25;"Košický kraj";0;0;0;0;NA;98342;0;2020-04-25;231
2020-04-24;"Košický kraj";3;0;0;0;NA;98342;3;2020-04-24;231
2020-04-23;"Košický kraj";4;0;0;0;NA;98342;4;2020-04-23;228
2020-04-22;"Košický kraj";21;0;0;0;NA;98342;21;2020-04-22;224
2020-04-21;"Košický kraj";4;0;0;0;NA;98342;4;2020-04-21;203
2020-04-20;"Košický kraj";0;0;0;0;NA;98342;0;2020-04-20;199
2020-04-19;"Košický kraj";1;0;0;0;NA;98342;1;2020-04-19;199
2020-04-18;"Košický kraj";2;0;0;0;NA;98342;2;2020-04-18;198
2020-04-17;"Košický kraj";7;0;0;0;NA;98342;7;2020-04-17;196
2020-04-16;"Košický kraj";29;0;0;0;NA;98342;29;2020-04-16;189
2020-04-15;"Košický kraj";50;0;0;0;NA;98342;50;2020-04-15;160
2020-04-14;"Košický kraj";4;0;0;0;NA;98342;4;2020-04-14;110
2020-04-13;"Košický kraj";5;0;0;0;NA;98342;5;2020-04-13;106
2020-04-12;"Košický kraj";4;0;0;0;NA;98342;4;2020-04-12;101
2020-04-11;"Košický kraj";2;0;0;0;NA;98342;2;2020-04-11;97
2020-04-10;"Košický kraj";1;0;0;0;NA;98342;1;2020-04-10;95
2020-04-09;"Košický kraj";4;0;0;0;NA;98342;4;2020-04-09;94
2020-04-08;"Košický kraj";5;0;0;0;NA;98342;5;2020-04-08;90
2020-04-07;"Košický kraj";34;0;0;0;NA;98342;34;2020-04-07;85
2020-04-06;"Košický kraj";6;0;0;0;NA;98342;6;2020-04-06;51
2020-04-05;"Košický kraj";4;0;0;0;NA;98342;4;2020-04-05;45
2020-04-04;"Košický kraj";5;0;0;0;NA;98342;5;2020-04-04;41
2020-04-03;"Košický kraj";4;0;0;0;NA;98342;4;2020-04-03;36
2020-04-02;"Košický kraj";3;0;0;0;NA;98342;3;2020-04-02;32
2020-04-01;"Košický kraj";3;0;0;0;NA;98342;3;2020-04-01;29
2020-03-31;"Košický kraj";1;0;0;0;NA;98342;1;2020-03-31;26
2020-03-30;"Košický kraj";5;0;0;0;NA;98342;5;2020-03-30;25
2020-03-29;"Košický kraj";0;0;0;0;NA;98342;0;2020-03-29;20
2020-03-28;"Košický kraj";1;0;0;0;NA;98342;1;2020-03-28;20
2020-03-27;"Košický kraj";1;0;0;0;NA;98342;1;2020-03-27;19
2020-03-26;"Košický kraj";3;0;0;0;NA;98342;3;2020-03-26;18
2020-03-25;"Košický kraj";2;0;0;0;NA;98342;2;2020-03-25;15
2020-03-24;"Košický kraj";0;0;0;0;NA;98342;0;2020-03-24;13
2020-03-23;"Košický kraj";2;0;0;0;NA;98342;2;2020-03-23;13
2020-03-22;"Košický kraj";0;0;0;0;NA;98342;0;2020-03-22;11
2020-03-21;"Košický kraj";3;0;0;0;NA;98342;3;2020-03-21;11
2020-03-20;"Košický kraj";1;0;0;0;NA;98342;1;2020-03-20;8
2020-03-19;"Košický kraj";0;0;0;0;NA;98342;0;2020-03-19;7
2020-03-18;"Košický kraj";0;0;0;0;NA;98342;0;2020-03-18;7
2020-03-17;"Košický kraj";0;0;0;0;NA;98342;0;2020-03-17;7
2020-03-16;"Košický kraj";3;0;0;0;NA;98342;3;2020-03-16;7
2020-03-15;"Košický kraj";1;0;0;0;NA;98342;1;2020-03-15;4
2020-03-14;"Košický kraj";0;0;0;0;NA;98342;0;2020-03-14;3
2020-03-13;"Košický kraj";2;0;0;0;NA;98342;2;2020-03-13;3
2020-03-12;"Košický kraj";0;0;0;0;NA;98342;0;2020-03-12;1
2020-03-11;"Košický kraj";0;0;0;0;NA;98342;0;2020-03-11;1
2020-03-09;"Košický kraj";1;0;0;0;NA;98342;1;2020-03-09;1
2020-03-08;"Košický kraj";0;0;0;0;NA;98342;0;2020-03-08;0
2020-03-07;"Košický kraj";0;0;0;0;NA;98342;0;2020-03-07;0
2020-03-06;"Košický kraj";0;0;0;0;NA;98342;0;2020-03-06;0
2021-08-29;"Nitriansky kraj";2;283;1;284;39464;92802;3;2021-08-29;92802
2021-08-28;"Nitriansky kraj";5;859;3;862;NA;92802;8;2021-08-28;92799
2021-08-27;"Nitriansky kraj";7;1493;4;1497;NA;92802;11;2021-08-27;92791
2021-08-26;"Nitriansky kraj";2;1015;4;1019;NA;92802;6;2021-08-26;92780
2021-08-25;"Nitriansky kraj";15;847;1;848;NA;92802;16;2021-08-25;92774
2021-08-24;"Nitriansky kraj";6;796;2;798;NA;92802;8;2021-08-24;92758
2021-08-23;"Nitriansky kraj";13;1162;4;1166;NA;92802;17;2021-08-23;92750
2021-08-22;"Nitriansky kraj";0;1093;3;1096;NA;92802;3;2021-08-22;92733
2021-08-21;"Nitriansky kraj";1;777;1;778;NA;92802;2;2021-08-21;92730
2021-08-20;"Nitriansky kraj";8;1457;5;1462;NA;92802;13;2021-08-20;92728
2021-08-19;"Nitriansky kraj";11;1095;4;1099;NA;92802;15;2021-08-19;92715
2021-08-18;"Nitriansky kraj";8;1111;7;1118;NA;92802;15;2021-08-18;92700
2021-08-17;"Nitriansky kraj";4;948;3;951;NA;92802;7;2021-08-17;92685
2021-08-16;"Nitriansky kraj";7;1004;4;1008;NA;92802;11;2021-08-16;92678
2021-08-15;"Nitriansky kraj";2;580;1;581;NA;92802;3;2021-08-15;92667
2021-08-14;"Nitriansky kraj";1;787;5;792;NA;92802;6;2021-08-14;92664
2021-08-13;"Nitriansky kraj";0;862;1;863;NA;92802;1;2021-08-13;92658
2021-08-12;"Nitriansky kraj";5;683;0;683;NA;92802;5;2021-08-12;92657
2021-08-11;"Nitriansky kraj";3;455;1;456;NA;92802;4;2021-08-11;92652
2021-08-10;"Nitriansky kraj";3;529;1;530;NA;92802;4;2021-08-10;92648
2021-08-09;"Nitriansky kraj";3;916;1;917;NA;92802;4;2021-08-09;92644
2021-08-08;"Nitriansky kraj";0;615;1;616;NA;92802;1;2021-08-08;92640
2021-08-07;"Nitriansky kraj";0;473;1;474;NA;92802;1;2021-08-07;92639
2021-08-06;"Nitriansky kraj";5;693;0;693;NA;92802;5;2021-08-06;92638
2021-08-05;"Nitriansky kraj";6;549;0;549;NA;92802;6;2021-08-05;92633
2021-08-04;"Nitriansky kraj";1;453;0;453;NA;92802;1;2021-08-04;92627
2021-08-03;"Nitriansky kraj";5;445;0;445;NA;92802;5;2021-08-03;92626
2021-08-02;"Nitriansky kraj";1;620;4;624;NA;92802;5;2021-08-02;92621
2021-08-01;"Nitriansky kraj";1;551;0;551;NA;92802;1;2021-08-01;92616
2021-07-31;"Nitriansky kraj";1;468;1;469;NA;92802;2;2021-07-31;92615
2021-07-30;"Nitriansky kraj";2;689;0;689;NA;92802;2;2021-07-30;92613
2021-07-29;"Nitriansky kraj";3;661;2;663;NA;92802;5;2021-07-29;92611
2021-07-28;"Nitriansky kraj";4;598;0;598;NA;92802;4;2021-07-28;92606
2021-07-27;"Nitriansky kraj";12;555;1;556;NA;92802;13;2021-07-27;92602
2021-07-26;"Nitriansky kraj";7;912;0;912;NA;92802;7;2021-07-26;92589
2021-07-25;"Nitriansky kraj";1;591;1;592;NA;92802;2;2021-07-25;92582
2021-07-24;"Nitriansky kraj";0;544;0;544;NA;92802;0;2021-07-24;92580
2021-07-23;"Nitriansky kraj";3;777;1;778;NA;92802;4;2021-07-23;92580
2021-07-22;"Nitriansky kraj";5;622;0;622;NA;92802;5;2021-07-22;92576
2021-07-21;"Nitriansky kraj";6;607;2;609;NA;92802;8;2021-07-21;92571
2021-07-20;"Nitriansky kraj";1;469;1;470;NA;92802;2;2021-07-20;92563
2021-07-19;"Nitriansky kraj";2;924;0;924;NA;92802;2;2021-07-19;92561
2021-07-18;"Nitriansky kraj";1;685;0;685;NA;92802;1;2021-07-18;92559
2021-07-17;"Nitriansky kraj";5;546;0;546;NA;92802;5;2021-07-17;92558
2021-07-16;"Nitriansky kraj";2;784;0;784;NA;92802;2;2021-07-16;92553
2021-07-15;"Nitriansky kraj";11;662;0;662;NA;92802;11;2021-07-15;92551
2021-07-14;"Nitriansky kraj";4;588;0;588;NA;92802;4;2021-07-14;92540
2021-07-13;"Nitriansky kraj";2;637;2;639;NA;92802;4;2021-07-13;92536
2021-07-12;"Nitriansky kraj";1;754;0;754;NA;92802;1;2021-07-12;92532
2021-07-11;"Nitriansky kraj";1;892;0;892;NA;92802;1;2021-07-11;92531
2021-07-10;"Nitriansky kraj";1;573;0;573;NA;92802;1;2021-07-10;92530
2021-07-09;"Nitriansky kraj";3;870;0;870;NA;92802;3;2021-07-09;92529
2021-07-08;"Nitriansky kraj";0;616;0;616;NA;92802;0;2021-07-08;92526
2021-07-07;"Nitriansky kraj";2;874;2;876;NA;92802;4;2021-07-07;92526
2021-07-06;"Nitriansky kraj";1;1198;1;1199;NA;92802;2;2021-07-06;92522
2021-07-05;"Nitriansky kraj";1;452;0;452;NA;92802;1;2021-07-05;92520
2021-07-04;"Nitriansky kraj";0;745;1;746;NA;92802;1;2021-07-04;92519
2021-07-03;"Nitriansky kraj";0;611;0;611;NA;92802;0;2021-07-03;92518
2021-07-02;"Nitriansky kraj";0;1061;0;1061;NA;92802;0;2021-07-02;92518
2021-07-01;"Nitriansky kraj";0;316;1;317;NA;92802;1;2021-07-01;92518
2021-06-30;"Nitriansky kraj";1;6702;2;6704;NA;92802;3;2021-06-30;92517
2021-06-29;"Nitriansky kraj";1;3536;0;3536;NA;92802;1;2021-06-29;92514
2021-06-28;"Nitriansky kraj";3;4393;0;4393;NA;92802;3;2021-06-28;92513
2021-06-27;"Nitriansky kraj";0;3263;0;3263;NA;92802;0;2021-06-27;92510
2021-06-26;"Nitriansky kraj";1;4845;2;4847;NA;92802;3;2021-06-26;92510
2021-06-25;"Nitriansky kraj";8;5174;1;5175;NA;92802;9;2021-06-25;92507
2021-06-24;"Nitriansky kraj";1;3354;0;3354;NA;92802;1;2021-06-24;92498
2021-06-23;"Nitriansky kraj";1;3033;0;3033;NA;92802;1;2021-06-23;92497
2021-06-22;"Nitriansky kraj";1;3240;3;3243;NA;92802;4;2021-06-22;92496
2021-06-21;"Nitriansky kraj";8;5362;8;5370;NA;92802;16;2021-06-21;92492
2021-06-20;"Nitriansky kraj";0;4437;6;4443;NA;92802;6;2021-06-20;92476
2021-06-19;"Nitriansky kraj";0;5750;4;5754;NA;92802;4;2021-06-19;92470
2021-06-18;"Nitriansky kraj";4;6453;3;6456;NA;92802;7;2021-06-18;92466
2021-06-17;"Nitriansky kraj";5;4152;1;4153;NA;92802;6;2021-06-17;92459
2021-06-16;"Nitriansky kraj";4;3694;3;3697;NA;92802;7;2021-06-16;92453
2021-06-15;"Nitriansky kraj";1;3995;0;3995;NA;92802;1;2021-06-15;92446
2021-06-14;"Nitriansky kraj";0;5875;3;5878;NA;92802;3;2021-06-14;92445
2021-06-13;"Nitriansky kraj";0;6184;3;6187;NA;92802;3;2021-06-13;92442
2021-06-12;"Nitriansky kraj";1;7913;1;7914;NA;92802;2;2021-06-12;92439
2021-06-11;"Nitriansky kraj";3;6891;4;6895;NA;92802;7;2021-06-11;92437
2021-06-10;"Nitriansky kraj";7;4539;1;4540;NA;92802;8;2021-06-10;92430
2021-06-09;"Nitriansky kraj";2;4706;2;4708;NA;92802;4;2021-06-09;92422
2021-06-08;"Nitriansky kraj";8;4239;3;4242;NA;92802;11;2021-06-08;92418
2021-06-07;"Nitriansky kraj";6;5841;8;5849;NA;92802;14;2021-06-07;92407
2021-06-06;"Nitriansky kraj";0;6981;4;6985;NA;92802;4;2021-06-06;92393
2021-06-05;"Nitriansky kraj";6;8529;9;8538;NA;92802;15;2021-06-05;92389
2021-06-04;"Nitriansky kraj";9;7608;5;7613;NA;92802;14;2021-06-04;92374
2021-06-03;"Nitriansky kraj";2;5064;6;5070;NA;92802;8;2021-06-03;92360
2021-06-02;"Nitriansky kraj";11;5119;11;5130;NA;92802;22;2021-06-02;92352
2021-06-01;"Nitriansky kraj";3;4847;2;4849;NA;92802;5;2021-06-01;92330
2021-05-31;"Nitriansky kraj";8;8933;8;8941;NA;92802;16;2021-05-31;92325
2021-05-30;"Nitriansky kraj";1;9067;8;9075;NA;92802;9;2021-05-30;92309
2021-05-29;"Nitriansky kraj";2;12799;7;12806;NA;92802;9;2021-05-29;92300
2021-05-28;"Nitriansky kraj";10;8872;6;8878;NA;92802;16;2021-05-28;92291
2021-05-27;"Nitriansky kraj";4;6164;5;6169;NA;92802;9;2021-05-27;92275
2021-05-26;"Nitriansky kraj";11;8509;10;8519;NA;92802;21;2021-05-26;92266
2021-05-25;"Nitriansky kraj";15;7342;8;7350;NA;92802;23;2021-05-25;92245
2021-05-24;"Nitriansky kraj";14;9816;17;9833;NA;92802;31;2021-05-24;92222
2021-05-23;"Nitriansky kraj";1;9456;13;9469;NA;92802;14;2021-05-23;92191
2021-05-22;"Nitriansky kraj";7;16939;11;16950;NA;92802;18;2021-05-22;92177
2021-05-21;"Nitriansky kraj";18;10632;15;10647;NA;92802;33;2021-05-21;92159
2021-05-20;"Nitriansky kraj";8;7185;7;7192;NA;92802;15;2021-05-20;92126
2021-05-19;"Nitriansky kraj";20;6787;14;6801;NA;92802;34;2021-05-19;92111
2021-05-18;"Nitriansky kraj";23;7791;18;7809;NA;92802;41;2021-05-18;92077
2021-05-17;"Nitriansky kraj";22;9774;20;9794;NA;92802;42;2021-05-17;92036
2021-05-16;"Nitriansky kraj";4;13830;15;13845;NA;92802;19;2021-05-16;91994
2021-05-15;"Nitriansky kraj";5;25389;23;25412;NA;92802;28;2021-05-15;91975
2021-05-14;"Nitriansky kraj";18;13385;23;13408;NA;92802;41;2021-05-14;91947
2021-05-13;"Nitriansky kraj";24;8289;19;8308;NA;92802;43;2021-05-13;91906
2021-05-12;"Nitriansky kraj";10;7682;26;7708;NA;92802;36;2021-05-12;91863
2021-05-11;"Nitriansky kraj";36;8163;13;8176;NA;92802;49;2021-05-11;91827
2021-05-10;"Nitriansky kraj";16;13800;42;13842;NA;92802;58;2021-05-10;91778
2021-05-09;"Nitriansky kraj";8;21879;35;21914;NA;92802;43;2021-05-09;91720
2021-05-08;"Nitriansky kraj";0;24318;29;24347;NA;92802;29;2021-05-08;91677
2021-05-07;"Nitriansky kraj";32;14915;20;14935;NA;92802;52;2021-05-07;91648
2021-05-06;"Nitriansky kraj";30;9463;20;9483;NA;92802;50;2021-05-06;91596
2021-05-05;"Nitriansky kraj";19;8527;23;8550;NA;92802;42;2021-05-05;91546
2021-05-04;"Nitriansky kraj";46;9380;27;9407;NA;92802;73;2021-05-04;91504
2021-05-03;"Nitriansky kraj";32;14490;44;14534;NA;92802;76;2021-05-03;91431
2021-05-02;"Nitriansky kraj";4;31751;46;31797;NA;92802;50;2021-05-02;91355
2021-05-01;"Nitriansky kraj";23;60451;43;60494;NA;92802;66;2021-05-01;91305
2021-04-30;"Nitriansky kraj";28;31803;53;31856;NA;92802;81;2021-04-30;91239
2021-04-29;"Nitriansky kraj";27;14265;34;14299;NA;92802;61;2021-04-29;91158
2021-04-28;"Nitriansky kraj";36;14716;45;14761;NA;92802;81;2021-04-28;91097
2021-04-27;"Nitriansky kraj";51;13154;35;13189;NA;92802;86;2021-04-27;91016
2021-04-26;"Nitriansky kraj";38;21029;44;21073;NA;92802;82;2021-04-26;90930
2021-04-25;"Nitriansky kraj";7;44312;46;44358;NA;92802;53;2021-04-25;90848
2021-04-24;"Nitriansky kraj";23;93455;72;93527;NA;92802;95;2021-04-24;90795
2021-04-23;"Nitriansky kraj";54;35145;51;35196;NA;92802;105;2021-04-23;90700
2021-04-22;"Nitriansky kraj";32;15435;44;15479;NA;92802;76;2021-04-22;90595
2021-04-21;"Nitriansky kraj";38;14228;45;14273;NA;92802;83;2021-04-21;90519
2021-04-20;"Nitriansky kraj";67;16058;51;16109;NA;92802;118;2021-04-20;90436
2021-04-19;"Nitriansky kraj";35;24819;59;24878;NA;92802;94;2021-04-19;90318
2021-04-18;"Nitriansky kraj";0;39569;27;39596;NA;92802;27;2021-04-18;90224
2021-04-17;"Nitriansky kraj";34;92102;82;92184;NA;92802;116;2021-04-17;90197
2021-04-16;"Nitriansky kraj";46;32348;37;32385;NA;92802;83;2021-04-16;90081
2021-04-15;"Nitriansky kraj";75;16215;52;16267;NA;92802;127;2021-04-15;89998
2021-04-14;"Nitriansky kraj";43;15303;42;15345;NA;92802;85;2021-04-14;89871
2021-04-13;"Nitriansky kraj";110;15104;44;15148;NA;92802;154;2021-04-13;89786
2021-04-12;"Nitriansky kraj";29;22817;50;22867;NA;92802;79;2021-04-12;89632
2021-04-11;"Nitriansky kraj";1;37537;31;37568;NA;92802;32;2021-04-11;89553
2021-04-10;"Nitriansky kraj";35;95851;115;95966;NA;92802;150;2021-04-10;89521
2021-04-09;"Nitriansky kraj";69;30669;58;30727;NA;92802;127;2021-04-09;89371
2021-04-08;"Nitriansky kraj";71;15369;36;15405;NA;92802;107;2021-04-08;89244
2021-04-07;"Nitriansky kraj";64;18541;47;18588;NA;92802;111;2021-04-07;89137
2021-04-06;"Nitriansky kraj";65;33218;112;33330;NA;92802;177;2021-04-06;89026
2021-04-05;"Nitriansky kraj";37;12673;48;12721;NA;92802;85;2021-04-05;88849
2021-04-04;"Nitriansky kraj";5;17887;35;17922;NA;92802;40;2021-04-04;88764
2021-04-03;"Nitriansky kraj";26;85465;153;85618;NA;92802;179;2021-04-03;88724
2021-04-02;"Nitriansky kraj";32;18743;46;18789;NA;92802;78;2021-04-02;88545
2021-04-01;"Nitriansky kraj";63;24610;83;24693;NA;92802;146;2021-04-01;88467
2021-03-31;"Nitriansky kraj";73;21752;94;21846;NA;92802;167;2021-03-31;88321
2021-03-30;"Nitriansky kraj";125;17122;83;17205;NA;92802;208;2021-03-30;88154
2021-03-29;"Nitriansky kraj";81;25139;100;25239;NA;92802;181;2021-03-29;87946
2021-03-28;"Nitriansky kraj";6;45581;106;45687;NA;92802;112;2021-03-28;87765
2021-03-27;"Nitriansky kraj";39;104104;174;104278;NA;92802;213;2021-03-27;87653
2021-03-26;"Nitriansky kraj";90;40444;115;40559;NA;92802;205;2021-03-26;87440
2021-03-25;"Nitriansky kraj";95;19219;94;19313;NA;92802;189;2021-03-25;87235
2021-03-24;"Nitriansky kraj";90;14787;91;14878;NA;92802;181;2021-03-24;87046
2021-03-23;"Nitriansky kraj";167;16753;66;16819;NA;92802;233;2021-03-23;86865
2021-03-22;"Nitriansky kraj";101;24886;125;25011;NA;92802;226;2021-03-22;86632
2021-03-21;"Nitriansky kraj";27;42773;99;42872;NA;92802;126;2021-03-21;86406
2021-03-20;"Nitriansky kraj";36;100640;207;100847;NA;92802;243;2021-03-20;86280
2021-03-19;"Nitriansky kraj";76;37312;102;37414;NA;92802;178;2021-03-19;86037
2021-03-18;"Nitriansky kraj";103;20051;113;20164;NA;92802;216;2021-03-18;85859
2021-03-17;"Nitriansky kraj";87;15839;127;15966;NA;92802;214;2021-03-17;85643
2021-03-16;"Nitriansky kraj";172;18085;121;18206;NA;92802;293;2021-03-16;85429
2021-03-15;"Nitriansky kraj";130;24491;165;24656;NA;92802;295;2021-03-15;85136
2021-03-14;"Nitriansky kraj";3;45770;107;45877;NA;92802;110;2021-03-14;84841
2021-03-13;"Nitriansky kraj";65;112573;242;112815;NA;92802;307;2021-03-13;84731
2021-03-12;"Nitriansky kraj";127;40777;159;40936;NA;92802;286;2021-03-12;84424
2021-03-11;"Nitriansky kraj";131;18686;130;18816;NA;92802;261;2021-03-11;84138
2021-03-10;"Nitriansky kraj";96;17422;143;17565;NA;92802;239;2021-03-10;83877
2021-03-09;"Nitriansky kraj";260;17635;149;17784;NA;92802;409;2021-03-09;83638
2021-03-08;"Nitriansky kraj";145;27214;172;27386;NA;92802;317;2021-03-08;83229
2021-03-07;"Nitriansky kraj";48;46867;185;47052;NA;92802;233;2021-03-07;82912
2021-03-06;"Nitriansky kraj";86;112027;327;112354;NA;92802;413;2021-03-06;82679
2021-03-05;"Nitriansky kraj";133;39068;200;39268;NA;92802;333;2021-03-05;82266
2021-03-04;"Nitriansky kraj";176;18340;173;18513;NA;92802;349;2021-03-04;81933
2021-03-03;"Nitriansky kraj";172;17210;177;17387;NA;92802;349;2021-03-03;81584
2021-03-02;"Nitriansky kraj";274;21003;366;21369;NA;92802;640;2021-03-02;81235
2021-03-01;"Nitriansky kraj";133;27881;279;28160;NA;92802;412;2021-03-01;80595
2021-02-28;"Nitriansky kraj";80;40866;218;41084;NA;92802;298;2021-02-28;80183
2021-02-27;"Nitriansky kraj";101;106352;496;106848;NA;92802;597;2021-02-27;79885
2021-02-26;"Nitriansky kraj";109;36788;308;37096;NA;92802;417;2021-02-26;79288
2021-02-25;"Nitriansky kraj";188;15243;212;15455;NA;92802;400;2021-02-25;78871
2021-02-24;"Nitriansky kraj";125;13833;260;14093;NA;92802;385;2021-02-24;78471
2021-02-23;"Nitriansky kraj";273;15402;273;15675;NA;92802;546;2021-02-23;78086
2021-02-22;"Nitriansky kraj";154;26478;330;26808;NA;92802;484;2021-02-22;77540
2021-02-21;"Nitriansky kraj";22;43664;320;43984;NA;92802;342;2021-02-21;77056
2021-02-20;"Nitriansky kraj";128;109038;586;109624;NA;92802;714;2021-02-20;76714
2021-02-19;"Nitriansky kraj";173;36849;328;37177;NA;92802;501;2021-02-19;76000
2021-02-18;"Nitriansky kraj";202;17046;275;17321;NA;92802;477;2021-02-18;75499
2021-02-17;"Nitriansky kraj";198;12080;310;12390;NA;92802;508;2021-02-17;75022
2021-02-16;"Nitriansky kraj";284;16066;288;16354;NA;92802;572;2021-02-16;74514
2021-02-15;"Nitriansky kraj";122;28636;474;29110;NA;92802;596;2021-02-15;73942
2021-02-14;"Nitriansky kraj";8;49392;315;49707;NA;92802;323;2021-02-14;73346
2021-02-13;"Nitriansky kraj";127;110294;690;110984;NA;92802;817;2021-02-13;73023
2021-02-12;"Nitriansky kraj";162;33405;407;33812;NA;92802;569;2021-02-12;72206
2021-02-11;"Nitriansky kraj";195;12406;270;12676;NA;92802;465;2021-02-11;71637
2021-02-10;"Nitriansky kraj";186;17770;644;18414;NA;92802;830;2021-02-10;71172
2021-02-09;"Nitriansky kraj";260;18530;385;18915;NA;92802;645;2021-02-09;70342
2021-02-08;"Nitriansky kraj";177;37530;569;38099;NA;92802;746;2021-02-08;69697
2021-02-07;"Nitriansky kraj";20;52307;513;52820;NA;92802;533;2021-02-07;68951
2021-02-06;"Nitriansky kraj";129;101439;764;102203;NA;92802;893;2021-02-06;68418
2021-02-05;"Nitriansky kraj";244;26137;491;26628;NA;92802;735;2021-02-05;67525
2021-02-04;"Nitriansky kraj";308;15681;512;16193;NA;92802;820;2021-02-04;66790
2021-02-03;"Nitriansky kraj";191;13459;382;13841;NA;92802;573;2021-02-03;65970
2021-02-02;"Nitriansky kraj";327;17880;382;18262;NA;92802;709;2021-02-02;65397
2021-02-01;"Nitriansky kraj";221;24002;460;24462;NA;92802;681;2021-02-01;64688
2021-01-31;"Nitriansky kraj";9;46215;507;46722;NA;92802;516;2021-01-31;64007
2021-01-30;"Nitriansky kraj";152;99241;1090;100331;NA;92802;1242;2021-01-30;63491
2021-01-29;"Nitriansky kraj";302;22461;477;22938;NA;92802;779;2021-01-29;62249
2021-01-28;"Nitriansky kraj";269;11370;398;11768;NA;92802;667;2021-01-28;61470
2021-01-27;"Nitriansky kraj";235;6758;299;7057;NA;92802;534;2021-01-27;60803
2021-01-26;"Nitriansky kraj";345;16015;454;16469;NA;92802;799;2021-01-26;60269
2021-01-25;"Nitriansky kraj";201;21909;434;22343;NA;92802;635;2021-01-25;59470
2021-01-24;"Nitriansky kraj";12;79041;897;79938;NA;92802;909;2021-01-24;58835
2021-01-23;"Nitriansky kraj";277;97845;1446;99291;NA;92802;1723;2021-01-23;57926
2021-01-22;"Nitriansky kraj";139;35924;619;36543;NA;92802;758;2021-01-22;56203
2021-01-21;"Nitriansky kraj";305;14649;412;15061;NA;92802;717;2021-01-21;55445
2021-01-20;"Nitriansky kraj";326;11991;625;12616;NA;92802;951;2021-01-20;54728
2021-01-19;"Nitriansky kraj";344;11015;633;11648;NA;92802;977;2021-01-19;53777
2021-01-18;"Nitriansky kraj";367;8901;519;9420;NA;92802;886;2021-01-18;52800
2021-01-17;"Nitriansky kraj";97;15061;275;15336;NA;92802;372;2021-01-17;51914
2021-01-16;"Nitriansky kraj";64;36838;679;37517;NA;92802;743;2021-01-16;51542
2021-01-15;"Nitriansky kraj";373;15940;474;16414;NA;92802;847;2021-01-15;50799
2021-01-14;"Nitriansky kraj";627;10577;452;11029;NA;92802;1079;2021-01-14;49952
2021-01-13;"Nitriansky kraj";663;9234;484;9718;NA;92802;1147;2021-01-13;48873
2021-01-12;"Nitriansky kraj";642;8805;545;9350;NA;92802;1187;2021-01-12;47726
2021-01-11;"Nitriansky kraj";422;8347;513;8860;NA;92802;935;2021-01-11;46539
2021-01-10;"Nitriansky kraj";44;19841;730;20571;NA;92802;774;2021-01-10;45604
2021-01-09;"Nitriansky kraj";532;36823;1071;37894;NA;92802;1603;2021-01-09;44830
2021-01-08;"Nitriansky kraj";817;14001;691;14692;NA;92802;1508;2021-01-08;43227
2021-01-07;"Nitriansky kraj";438;10121;795;10916;NA;92802;1233;2021-01-07;41719
2021-01-06;"Nitriansky kraj";259;3192;197;3389;NA;92802;456;2021-01-06;40486
2021-01-05;"Nitriansky kraj";732;8918;1208;10126;NA;92802;1940;2021-01-05;40030
2021-01-04;"Nitriansky kraj";362;8375;1287;9662;NA;92802;1649;2021-01-04;38090
2021-01-03;"Nitriansky kraj";42;84;20;104;NA;92802;62;2021-01-03;36441
2021-01-02;"Nitriansky kraj";249;1090;26;1116;NA;92802;275;2021-01-02;36379
2021-01-01;"Nitriansky kraj";119;781;95;876;NA;92802;214;2021-01-01;36104
2020-12-31;"Nitriansky kraj";786;7646;962;8608;NA;92802;1748;2020-12-31;35890
2020-12-30;"Nitriansky kraj";1094;9619;1165;10784;NA;92802;2259;2020-12-30;34142
2020-12-29;"Nitriansky kraj";607;8277;1286;9563;NA;92802;1893;2020-12-29;31883
2020-12-28;"Nitriansky kraj";83;6804;1220;8024;NA;92802;1303;2020-12-28;29990
2020-12-27;"Nitriansky kraj";22;60;8;68;NA;92802;30;2020-12-27;28687
2020-12-26;"Nitriansky kraj";54;297;56;353;NA;92802;110;2020-12-26;28657
2020-12-25;"Nitriansky kraj";35;60;11;71;NA;92802;46;2020-12-25;28547
2020-12-24;"Nitriansky kraj";514;1861;176;2037;NA;92802;690;2020-12-24;28501
2020-12-23;"Nitriansky kraj";349;15295;843;16138;NA;92802;1192;2020-12-23;27811
2020-12-22;"Nitriansky kraj";673;10989;994;11983;NA;92802;1667;2020-12-22;26619
2020-12-21;"Nitriansky kraj";128;7953;976;8929;NA;92802;1104;2020-12-21;24952
2020-12-20;"Nitriansky kraj";77;50;10;60;NA;92802;87;2020-12-20;23848
2020-12-19;"Nitriansky kraj";262;2259;159;2418;NA;92802;421;2020-12-19;23761
2020-12-18;"Nitriansky kraj";512;8437;551;8988;NA;92802;1063;2020-12-18;23340
2020-12-17;"Nitriansky kraj";586;6894;514;7408;NA;92802;1100;2020-12-17;22277
2020-12-16;"Nitriansky kraj";357;8380;513;8893;NA;92802;870;2020-12-16;21177
2020-12-15;"Nitriansky kraj";461;9365;769;10134;NA;92802;1230;2020-12-15;20307
2020-12-14;"Nitriansky kraj";217;8089;827;8916;NA;92802;1044;2020-12-14;19077
2020-12-13;"Nitriansky kraj";12;69;6;75;NA;92802;18;2020-12-13;18033
2020-12-12;"Nitriansky kraj";341;1832;125;1957;NA;92802;466;2020-12-12;18015
2020-12-11;"Nitriansky kraj";409;5430;416;5846;NA;92802;825;2020-12-11;17549
2020-12-10;"Nitriansky kraj";360;5473;351;5824;NA;92802;711;2020-12-10;16724
2020-12-09;"Nitriansky kraj";362;5506;529;6035;NA;92802;891;2020-12-09;16013
2020-12-08;"Nitriansky kraj";340;8168;548;8716;NA;92802;888;2020-12-08;15122
2020-12-07;"Nitriansky kraj";139;6243;573;6816;NA;92802;712;2020-12-07;14234
2020-12-06;"Nitriansky kraj";15;89;4;93;NA;92802;19;2020-12-06;13522
2020-12-05;"Nitriansky kraj";136;1388;19;1407;NA;92802;155;2020-12-05;13503
2020-12-04;"Nitriansky kraj";232;2884;74;2958;NA;92802;306;2020-12-04;13348
2020-12-03;"Nitriansky kraj";248;2471;110;2581;NA;92802;358;2020-12-03;13042
2020-12-02;"Nitriansky kraj";252;3733;163;3896;NA;92802;415;2020-12-02;12684
2020-12-01;"Nitriansky kraj";331;2891;131;3022;NA;92802;462;2020-12-01;12269
2020-11-30;"Nitriansky kraj";91;4228;188;4416;NA;92802;279;2020-11-30;11807
2020-11-29;"Nitriansky kraj";3;634;42;676;NA;92802;45;2020-11-29;11528
2020-11-28;"Nitriansky kraj";135;892;31;923;NA;92802;166;2020-11-28;11483
2020-11-27;"Nitriansky kraj";177;2069;73;2142;NA;92802;250;2020-11-27;11317
2020-11-26;"Nitriansky kraj";191;2813;80;2893;NA;92802;271;2020-11-26;11067
2020-11-25;"Nitriansky kraj";325;2478;91;2569;NA;92802;416;2020-11-25;10796
2020-11-24;"Nitriansky kraj";147;1641;64;1705;NA;92802;211;2020-11-24;10380
2020-11-23;"Nitriansky kraj";102;9891;212;10103;NA;92802;314;2020-11-23;10169
2020-11-22;"Nitriansky kraj";7;1176;25;1201;NA;92802;32;2020-11-22;9855
2020-11-21;"Nitriansky kraj";86;1083;38;1121;NA;92802;124;2020-11-21;9823
2020-11-20;"Nitriansky kraj";264;4180;103;4283;NA;92802;367;2020-11-20;9699
2020-11-19;"Nitriansky kraj";185;3065;134;3199;NA;92802;319;2020-11-19;9332
2020-11-18;"Nitriansky kraj";188;2214;79;2293;NA;92802;267;2020-11-18;9013
2020-11-17;"Nitriansky kraj";178;596;29;625;NA;92802;207;2020-11-17;8746
2020-11-16;"Nitriansky kraj";139;1877;75;1952;NA;92802;214;2020-11-16;8539
2020-11-15;"Nitriansky kraj";14;180;5;185;NA;92802;19;2020-11-15;8325
2020-11-14;"Nitriansky kraj";114;1131;32;1163;NA;92802;146;2020-11-14;8306
2020-11-13;"Nitriansky kraj";210;936;46;982;NA;92802;256;2020-11-13;8160
2020-11-12;"Nitriansky kraj";256;1195;35;1230;NA;92802;291;2020-11-12;7904
2020-11-11;"Nitriansky kraj";279;1247;22;1269;NA;92802;301;2020-11-11;7613
2020-11-10;"Nitriansky kraj";192;2623;39;2662;NA;92802;231;2020-11-10;7312
2020-11-09;"Nitriansky kraj";128;3136;43;3179;NA;92802;171;2020-11-09;7081
2020-11-08;"Nitriansky kraj";43;1462;32;1494;NA;92802;75;2020-11-08;6910
2020-11-07;"Nitriansky kraj";130;1046;4;1050;NA;92802;134;2020-11-07;6835
2020-11-06;"Nitriansky kraj";210;2264;32;2296;NA;92802;242;2020-11-06;6701
2020-11-05;"Nitriansky kraj";178;313;14;327;NA;92802;192;2020-11-05;6459
2020-11-04;"Nitriansky kraj";211;297;16;313;NA;92802;227;2020-11-04;6267
2020-11-03;"Nitriansky kraj";216;435;25;460;NA;92802;241;2020-11-03;6040
2020-11-02;"Nitriansky kraj";171;4208;46;4254;NA;92802;217;2020-11-02;5799
2020-11-01;"Nitriansky kraj";130;2546;27;2573;NA;92802;157;2020-11-01;5582
2020-10-31;"Nitriansky kraj";261;10466;134;10600;NA;92802;395;2020-10-31;5425
2020-10-30;"Nitriansky kraj";204;2593;42;2635;NA;92802;246;2020-10-30;5030
2020-10-29;"Nitriansky kraj";293;841;39;880;NA;92802;332;2020-10-29;4784
2020-10-28;"Nitriansky kraj";216;608;59;667;NA;92802;275;2020-10-28;4452
2020-10-27;"Nitriansky kraj";296;550;47;597;NA;92802;343;2020-10-27;4177
2020-10-26;"Nitriansky kraj";69;633;56;689;NA;92802;125;2020-10-26;3834
2020-10-25;"Nitriansky kraj";50;62;8;70;NA;92802;58;2020-10-25;3709
2020-10-24;"Nitriansky kraj";169;237;11;248;NA;92802;180;2020-10-24;3651
2020-10-23;"Nitriansky kraj";282;762;41;803;NA;92802;323;2020-10-23;3471
2020-10-22;"Nitriansky kraj";137;444;39;483;NA;92802;176;2020-10-22;3148
2020-10-21;"Nitriansky kraj";146;208;3;211;NA;92802;149;2020-10-21;2972
2020-10-20;"Nitriansky kraj";197;78;6;84;NA;92802;203;2020-10-20;2823
2020-10-19;"Nitriansky kraj";148;79;1;80;NA;92802;149;2020-10-19;2620
2020-10-18;"Nitriansky kraj";22;0;0;0;NA;92802;22;2020-10-18;2471
2020-10-17;"Nitriansky kraj";67;0;0;0;NA;92802;67;2020-10-17;2449
2020-10-16;"Nitriansky kraj";133;28;3;31;NA;92802;136;2020-10-16;2382
2020-10-15;"Nitriansky kraj";106;31;2;33;NA;92802;108;2020-10-15;2246
2020-10-14;"Nitriansky kraj";80;22;4;26;NA;92802;84;2020-10-14;2138
2020-10-13;"Nitriansky kraj";101;82;2;84;NA;92802;103;2020-10-13;2054
2020-10-12;"Nitriansky kraj";36;0;0;0;NA;92802;36;2020-10-12;1951
2020-10-11;"Nitriansky kraj";8;0;0;0;NA;92802;8;2020-10-11;1915
2020-10-10;"Nitriansky kraj";107;0;0;0;NA;92802;107;2020-10-10;1907
2020-10-09;"Nitriansky kraj";120;0;0;0;NA;92802;120;2020-10-09;1800
2020-10-08;"Nitriansky kraj";132;0;0;0;NA;92802;132;2020-10-08;1680
2020-10-07;"Nitriansky kraj";81;0;0;0;NA;92802;81;2020-10-07;1548
2020-10-06;"Nitriansky kraj";48;0;0;0;NA;92802;48;2020-10-06;1467
2020-10-05;"Nitriansky kraj";20;0;0;0;NA;92802;20;2020-10-05;1419
2020-10-04;"Nitriansky kraj";17;0;0;0;NA;92802;17;2020-10-04;1399
2020-10-03;"Nitriansky kraj";96;0;0;0;NA;92802;96;2020-10-03;1382
2020-10-02;"Nitriansky kraj";108;0;0;0;NA;92802;108;2020-10-02;1286
2020-10-01;"Nitriansky kraj";95;0;0;0;NA;92802;95;2020-10-01;1178
2020-09-30;"Nitriansky kraj";100;0;0;0;NA;92802;100;2020-09-30;1083
2020-09-29;"Nitriansky kraj";50;0;0;0;NA;92802;50;2020-09-29;983
2020-09-28;"Nitriansky kraj";22;0;0;0;NA;92802;22;2020-09-28;933
2020-09-27;"Nitriansky kraj";16;0;0;0;NA;92802;16;2020-09-27;911
2020-09-26;"Nitriansky kraj";64;0;0;0;NA;92802;64;2020-09-26;895
2020-09-25;"Nitriansky kraj";90;0;0;0;NA;92802;90;2020-09-25;831
2020-09-24;"Nitriansky kraj";51;0;0;0;NA;92802;51;2020-09-24;741
2020-09-23;"Nitriansky kraj";70;0;0;0;NA;92802;70;2020-09-23;690
2020-09-22;"Nitriansky kraj";18;0;0;0;NA;92802;18;2020-09-22;620
2020-09-21;"Nitriansky kraj";10;0;0;0;NA;92802;10;2020-09-21;602
2020-09-20;"Nitriansky kraj";4;0;0;0;NA;92802;4;2020-09-20;592
2020-09-19;"Nitriansky kraj";14;0;0;0;NA;92802;14;2020-09-19;588
2020-09-18;"Nitriansky kraj";19;0;0;0;NA;92802;19;2020-09-18;574
2020-09-17;"Nitriansky kraj";30;0;0;0;NA;92802;30;2020-09-17;555
2020-09-16;"Nitriansky kraj";6;0;0;0;NA;92802;6;2020-09-16;525
2020-09-15;"Nitriansky kraj";19;0;0;0;NA;92802;19;2020-09-15;519
2020-09-14;"Nitriansky kraj";28;0;0;0;NA;92802;28;2020-09-14;500
2020-09-13;"Nitriansky kraj";3;0;0;0;NA;92802;3;2020-09-13;472
2020-09-12;"Nitriansky kraj";12;0;0;0;NA;92802;12;2020-09-12;469
2020-09-11;"Nitriansky kraj";23;0;0;0;NA;92802;23;2020-09-11;457
2020-09-10;"Nitriansky kraj";29;0;0;0;NA;92802;29;2020-09-10;434
2020-09-09;"Nitriansky kraj";19;0;0;0;NA;92802;19;2020-09-09;405
2020-09-08;"Nitriansky kraj";17;0;0;0;NA;92802;17;2020-09-08;386
2020-09-07;"Nitriansky kraj";17;0;0;0;NA;92802;17;2020-09-07;369
2020-09-06;"Nitriansky kraj";0;0;0;0;NA;92802;0;2020-09-06;352
2020-09-05;"Nitriansky kraj";22;0;0;0;NA;92802;22;2020-09-05;352
2020-09-04;"Nitriansky kraj";34;0;0;0;NA;92802;34;2020-09-04;330
2020-09-03;"Nitriansky kraj";15;0;0;0;NA;92802;15;2020-09-03;296
2020-09-02;"Nitriansky kraj";15;0;0;0;NA;92802;15;2020-09-02;281
2020-09-01;"Nitriansky kraj";2;0;0;0;NA;92802;2;2020-09-01;266
2020-08-31;"Nitriansky kraj";12;0;0;0;NA;92802;12;2020-08-31;264
2020-08-30;"Nitriansky kraj";1;0;0;0;NA;92802;1;2020-08-30;252
2020-08-29;"Nitriansky kraj";7;0;0;0;NA;92802;7;2020-08-29;251
2020-08-28;"Nitriansky kraj";12;0;0;0;NA;92802;12;2020-08-28;244
2020-08-27;"Nitriansky kraj";12;0;0;0;NA;92802;12;2020-08-27;232
2020-08-26;"Nitriansky kraj";4;0;0;0;NA;92802;4;2020-08-26;220
2020-08-25;"Nitriansky kraj";8;0;0;0;NA;92802;8;2020-08-25;216
2020-08-24;"Nitriansky kraj";1;0;0;0;NA;92802;1;2020-08-24;208
2020-08-23;"Nitriansky kraj";1;0;0;0;NA;92802;1;2020-08-23;207
2020-08-22;"Nitriansky kraj";2;0;0;0;NA;92802;2;2020-08-22;206
2020-08-21;"Nitriansky kraj";0;0;0;0;NA;92802;0;2020-08-21;204
2020-08-20;"Nitriansky kraj";7;0;0;0;NA;92802;7;2020-08-20;204
2020-08-19;"Nitriansky kraj";1;0;0;0;NA;92802;1;2020-08-19;197
2020-08-18;"Nitriansky kraj";2;0;0;0;NA;92802;2;2020-08-18;196
2020-08-17;"Nitriansky kraj";1;0;0;0;NA;92802;1;2020-08-17;194
2020-08-16;"Nitriansky kraj";0;0;0;0;NA;92802;0;2020-08-16;193
2020-08-15;"Nitriansky kraj";2;0;0;0;NA;92802;2;2020-08-15;193
2020-08-14;"Nitriansky kraj";1;0;0;0;NA;92802;1;2020-08-14;191
2020-08-13;"Nitriansky kraj";4;0;0;0;NA;92802;4;2020-08-13;190
2020-08-12;"Nitriansky kraj";0;0;0;0;NA;92802;0;2020-08-12;186
2020-08-11;"Nitriansky kraj";1;0;0;0;NA;92802;1;2020-08-11;186
2020-08-10;"Nitriansky kraj";0;0;0;0;NA;92802;0;2020-08-10;185
2020-08-09;"Nitriansky kraj";0;0;0;0;NA;92802;0;2020-08-09;185
2020-08-08;"Nitriansky kraj";0;0;0;0;NA;92802;0;2020-08-08;185
2020-08-07;"Nitriansky kraj";4;0;0;0;NA;92802;4;2020-08-07;185
2020-08-06;"Nitriansky kraj";4;0;0;0;NA;92802;4;2020-08-06;181
2020-08-05;"Nitriansky kraj";0;0;0;0;NA;92802;0;2020-08-05;177
2020-08-04;"Nitriansky kraj";7;0;0;0;NA;92802;7;2020-08-04;177
2020-08-03;"Nitriansky kraj";0;0;0;0;NA;92802;0;2020-08-03;170
2020-08-02;"Nitriansky kraj";0;0;0;0;NA;92802;0;2020-08-02;170
2020-08-01;"Nitriansky kraj";0;0;0;0;NA;92802;0;2020-08-01;170
2020-07-31;"Nitriansky kraj";0;0;0;0;NA;92802;0;2020-07-31;170
2020-07-30;"Nitriansky kraj";0;0;0;0;NA;92802;0;2020-07-30;170
2020-07-29;"Nitriansky kraj";0;0;0;0;NA;92802;0;2020-07-29;170
2020-07-28;"Nitriansky kraj";0;0;0;0;NA;92802;0;2020-07-28;170
2020-07-27;"Nitriansky kraj";0;0;0;0;NA;92802;0;2020-07-27;170
2020-07-26;"Nitriansky kraj";0;0;0;0;NA;92802;0;2020-07-26;170
2020-07-25;"Nitriansky kraj";0;0;0;0;NA;92802;0;2020-07-25;170
2020-07-24;"Nitriansky kraj";1;0;0;0;NA;92802;1;2020-07-24;170
2020-07-23;"Nitriansky kraj";3;0;0;0;NA;92802;3;2020-07-23;169
2020-07-22;"Nitriansky kraj";2;0;0;0;NA;92802;2;2020-07-22;166
2020-07-21;"Nitriansky kraj";14;0;0;0;NA;92802;14;2020-07-21;164
2020-07-20;"Nitriansky kraj";11;0;0;0;NA;92802;11;2020-07-20;150
2020-07-19;"Nitriansky kraj";0;0;0;0;NA;92802;0;2020-07-19;139
2020-07-18;"Nitriansky kraj";0;0;0;0;NA;92802;0;2020-07-18;139
2020-07-17;"Nitriansky kraj";0;0;0;0;NA;92802;0;2020-07-17;139
2020-07-16;"Nitriansky kraj";4;0;0;0;NA;92802;4;2020-07-16;139
2020-07-15;"Nitriansky kraj";5;0;0;0;NA;92802;5;2020-07-15;135
2020-07-14;"Nitriansky kraj";0;0;0;0;NA;92802;0;2020-07-14;130
2020-07-13;"Nitriansky kraj";0;0;0;0;NA;92802;0;2020-07-13;130
2020-07-12;"Nitriansky kraj";0;0;0;0;NA;92802;0;2020-07-12;130
2020-07-11;"Nitriansky kraj";0;0;0;0;NA;92802;0;2020-07-11;130
2020-07-10;"Nitriansky kraj";0;0;0;0;NA;92802;0;2020-07-10;130
2020-07-09;"Nitriansky kraj";1;0;0;0;NA;92802;1;2020-07-09;130
2020-07-08;"Nitriansky kraj";2;0;0;0;NA;92802;2;2020-07-08;129
2020-07-07;"Nitriansky kraj";0;0;0;0;NA;92802;0;2020-07-07;127
2020-07-06;"Nitriansky kraj";0;0;0;0;NA;92802;0;2020-07-06;127
2020-07-05;"Nitriansky kraj";0;0;0;0;NA;92802;0;2020-07-05;127
2020-07-04;"Nitriansky kraj";0;0;0;0;NA;92802;0;2020-07-04;127
2020-07-03;"Nitriansky kraj";0;0;0;0;NA;92802;0;2020-07-03;127
2020-07-02;"Nitriansky kraj";0;0;0;0;NA;92802;0;2020-07-02;127
2020-07-01;"Nitriansky kraj";3;0;0;0;NA;92802;3;2020-07-01;127
2020-06-30;"Nitriansky kraj";0;0;0;0;NA;92802;0;2020-06-30;124
2020-06-29;"Nitriansky kraj";0;0;0;0;NA;92802;0;2020-06-29;124
2020-06-28;"Nitriansky kraj";0;0;0;0;NA;92802;0;2020-06-28;124
2020-06-27;"Nitriansky kraj";0;0;0;0;NA;92802;0;2020-06-27;124
2020-06-26;"Nitriansky kraj";0;0;0;0;NA;92802;0;2020-06-26;124
2020-06-25;"Nitriansky kraj";0;0;0;0;NA;92802;0;2020-06-25;124
2020-06-24;"Nitriansky kraj";1;0;0;0;NA;92802;1;2020-06-24;124
2020-06-23;"Nitriansky kraj";0;0;0;0;NA;92802;0;2020-06-23;123
2020-06-22;"Nitriansky kraj";0;0;0;0;NA;92802;0;2020-06-22;123
2020-06-21;"Nitriansky kraj";0;0;0;0;NA;92802;0;2020-06-21;123
2020-06-20;"Nitriansky kraj";0;0;0;0;NA;92802;0;2020-06-20;123
2020-06-19;"Nitriansky kraj";0;0;0;0;NA;92802;0;2020-06-19;123
2020-06-18;"Nitriansky kraj";0;0;0;0;NA;92802;0;2020-06-18;123
2020-06-17;"Nitriansky kraj";0;0;0;0;NA;92802;0;2020-06-17;123
2020-06-16;"Nitriansky kraj";0;0;0;0;NA;92802;0;2020-06-16;123
2020-06-14;"Nitriansky kraj";0;0;0;0;NA;92802;0;2020-06-14;123
2020-06-13;"Nitriansky kraj";0;0;0;0;NA;92802;0;2020-06-13;123
2020-06-12;"Nitriansky kraj";0;0;0;0;NA;92802;0;2020-06-12;123
2020-06-11;"Nitriansky kraj";0;0;0;0;NA;92802;0;2020-06-11;123
2020-06-10;"Nitriansky kraj";1;0;0;0;NA;92802;1;2020-06-10;123
2020-06-09;"Nitriansky kraj";1;0;0;0;NA;92802;1;2020-06-09;122
2020-06-08;"Nitriansky kraj";0;0;0;0;NA;92802;0;2020-06-08;121
2020-06-07;"Nitriansky kraj";0;0;0;0;NA;92802;0;2020-06-07;121
2020-06-05;"Nitriansky kraj";0;0;0;0;NA;92802;0;2020-06-05;121
2020-06-03;"Nitriansky kraj";0;0;0;0;NA;92802;0;2020-06-03;121
2020-06-02;"Nitriansky kraj";1;0;0;0;NA;92802;1;2020-06-02;121
2020-05-31;"Nitriansky kraj";0;0;0;0;NA;92802;0;2020-05-31;120
2020-05-29;"Nitriansky kraj";0;0;0;0;NA;92802;0;2020-05-29;120
2020-05-27;"Nitriansky kraj";0;0;0;0;NA;92802;0;2020-05-27;120
2020-05-26;"Nitriansky kraj";0;0;0;0;NA;92802;0;2020-05-26;120
2020-05-25;"Nitriansky kraj";0;0;0;0;NA;92802;0;2020-05-25;120
2020-05-24;"Nitriansky kraj";2;0;0;0;NA;92802;2;2020-05-24;120
2020-05-23;"Nitriansky kraj";0;0;0;0;NA;92802;0;2020-05-23;118
2020-05-22;"Nitriansky kraj";1;0;0;0;NA;92802;1;2020-05-22;118
2020-05-21;"Nitriansky kraj";0;0;0;0;NA;92802;0;2020-05-21;117
2020-05-20;"Nitriansky kraj";0;0;0;0;NA;92802;0;2020-05-20;117
2020-05-19;"Nitriansky kraj";0;0;0;0;NA;92802;0;2020-05-19;117
2020-05-17;"Nitriansky kraj";0;0;0;0;NA;92802;0;2020-05-17;117
2020-05-16;"Nitriansky kraj";0;0;0;0;NA;92802;0;2020-05-16;117
2020-05-15;"Nitriansky kraj";1;0;0;0;NA;92802;1;2020-05-15;117
2020-05-14;"Nitriansky kraj";0;0;0;0;NA;92802;0;2020-05-14;116
2020-05-13;"Nitriansky kraj";0;0;0;0;NA;92802;0;2020-05-13;116
2020-05-12;"Nitriansky kraj";0;0;0;0;NA;92802;0;2020-05-12;116
2020-05-11;"Nitriansky kraj";2;0;0;0;NA;92802;2;2020-05-11;116
2020-05-09;"Nitriansky kraj";0;0;0;0;NA;92802;0;2020-05-09;114
2020-05-07;"Nitriansky kraj";1;0;0;0;NA;92802;1;2020-05-07;114
2020-05-06;"Nitriansky kraj";9;0;0;0;NA;92802;9;2020-05-06;113
2020-05-05;"Nitriansky kraj";0;0;0;0;NA;92802;0;2020-05-05;104
2020-05-04;"Nitriansky kraj";5;0;0;0;NA;92802;5;2020-05-04;104
2020-05-03;"Nitriansky kraj";2;0;0;0;NA;92802;2;2020-05-03;99
2020-05-02;"Nitriansky kraj";0;0;0;0;NA;92802;0;2020-05-02;97
2020-05-01;"Nitriansky kraj";1;0;0;0;NA;92802;1;2020-05-01;97
2020-04-30;"Nitriansky kraj";0;0;0;0;NA;92802;0;2020-04-30;96
2020-04-29;"Nitriansky kraj";0;0;0;0;NA;92802;0;2020-04-29;96
2020-04-28;"Nitriansky kraj";1;0;0;0;NA;92802;1;2020-04-28;96
2020-04-27;"Nitriansky kraj";0;0;0;0;NA;92802;0;2020-04-27;95
2020-04-26;"Nitriansky kraj";0;0;0;0;NA;92802;0;2020-04-26;95
2020-04-25;"Nitriansky kraj";0;0;0;0;NA;92802;0;2020-04-25;95
2020-04-24;"Nitriansky kraj";0;0;0;0;NA;92802;0;2020-04-24;95
2020-04-23;"Nitriansky kraj";3;0;0;0;NA;92802;3;2020-04-23;95
2020-04-22;"Nitriansky kraj";16;0;0;0;NA;92802;16;2020-04-22;92
2020-04-21;"Nitriansky kraj";6;0;0;0;NA;92802;6;2020-04-21;76
2020-04-20;"Nitriansky kraj";5;0;0;0;NA;92802;5;2020-04-20;70
2020-04-19;"Nitriansky kraj";0;0;0;0;NA;92802;0;2020-04-19;65
2020-04-18;"Nitriansky kraj";0;0;0;0;NA;92802;0;2020-04-18;65
2020-04-17;"Nitriansky kraj";7;0;0;0;NA;92802;7;2020-04-17;65
2020-04-16;"Nitriansky kraj";0;0;0;0;NA;92802;0;2020-04-16;58
2020-04-15;"Nitriansky kraj";6;0;0;0;NA;92802;6;2020-04-15;58
2020-04-14;"Nitriansky kraj";2;0;0;0;NA;92802;2;2020-04-14;52
2020-04-13;"Nitriansky kraj";1;0;0;0;NA;92802;1;2020-04-13;50
2020-04-12;"Nitriansky kraj";3;0;0;0;NA;92802;3;2020-04-12;49
2020-04-11;"Nitriansky kraj";1;0;0;0;NA;92802;1;2020-04-11;46
2020-04-10;"Nitriansky kraj";1;0;0;0;NA;92802;1;2020-04-10;45
2020-04-09;"Nitriansky kraj";0;0;0;0;NA;92802;0;2020-04-09;44
2020-04-08;"Nitriansky kraj";2;0;0;0;NA;92802;2;2020-04-08;44
2020-04-07;"Nitriansky kraj";3;0;0;0;NA;92802;3;2020-04-07;42
2020-04-06;"Nitriansky kraj";4;0;0;0;NA;92802;4;2020-04-06;39
2020-04-05;"Nitriansky kraj";5;0;0;0;NA;92802;5;2020-04-05;35
2020-04-04;"Nitriansky kraj";0;0;0;0;NA;92802;0;2020-04-04;30
2020-04-03;"Nitriansky kraj";0;0;0;0;NA;92802;0;2020-04-03;30
2020-04-02;"Nitriansky kraj";1;0;0;0;NA;92802;1;2020-04-02;30
2020-04-01;"Nitriansky kraj";0;0;0;0;NA;92802;0;2020-04-01;29
2020-03-31;"Nitriansky kraj";3;0;0;0;NA;92802;3;2020-03-31;29
2020-03-30;"Nitriansky kraj";3;0;0;0;NA;92802;3;2020-03-30;26
2020-03-29;"Nitriansky kraj";3;0;0;0;NA;92802;3;2020-03-29;23
2020-03-28;"Nitriansky kraj";1;0;0;0;NA;92802;1;2020-03-28;20
2020-03-27;"Nitriansky kraj";1;0;0;0;NA;92802;1;2020-03-27;19
2020-03-26;"Nitriansky kraj";1;0;0;0;NA;92802;1;2020-03-26;18
2020-03-25;"Nitriansky kraj";1;0;0;0;NA;92802;1;2020-03-25;17
2020-03-24;"Nitriansky kraj";0;0;0;0;NA;92802;0;2020-03-24;16
2020-03-23;"Nitriansky kraj";2;0;0;0;NA;92802;2;2020-03-23;16
2020-03-22;"Nitriansky kraj";2;0;0;0;NA;92802;2;2020-03-22;14
2020-03-21;"Nitriansky kraj";2;0;0;0;NA;92802;2;2020-03-21;12
2020-03-20;"Nitriansky kraj";1;0;0;0;NA;92802;1;2020-03-20;10
2020-03-19;"Nitriansky kraj";1;0;0;0;NA;92802;1;2020-03-19;9
2020-03-18;"Nitriansky kraj";2;0;0;0;NA;92802;2;2020-03-18;8
2020-03-17;"Nitriansky kraj";1;0;0;0;NA;92802;1;2020-03-17;6
2020-03-16;"Nitriansky kraj";0;0;0;0;NA;92802;0;2020-03-16;5
2020-03-15;"Nitriansky kraj";4;0;0;0;NA;92802;4;2020-03-15;5
2020-03-14;"Nitriansky kraj";1;0;0;0;NA;92802;1;2020-03-14;1
2020-03-13;"Nitriansky kraj";0;0;0;0;NA;92802;0;2020-03-13;0
2020-03-12;"Nitriansky kraj";0;0;0;0;NA;92802;0;2020-03-12;0
2020-03-11;"Nitriansky kraj";0;0;0;0;NA;92802;0;2020-03-11;0
2020-03-09;"Nitriansky kraj";0;0;0;0;NA;92802;0;2020-03-09;0
2020-03-08;"Nitriansky kraj";0;0;0;0;NA;92802;0;2020-03-08;0
2020-03-07;"Nitriansky kraj";0;0;0;0;NA;92802;0;2020-03-07;0
2020-03-06;"Nitriansky kraj";0;0;0;0;NA;92802;0;2020-03-06;0
2021-08-29;"Prešovský kraj";3;551;1;552;60522;114381;4;2021-08-29;114381
2021-08-28;"Prešovský kraj";5;1571;7;1578;NA;114381;12;2021-08-28;114377
2021-08-27;"Prešovský kraj";32;2359;7;2366;NA;114381;39;2021-08-27;114365
2021-08-26;"Prešovský kraj";13;1992;8;2000;NA;114381;21;2021-08-26;114326
2021-08-25;"Prešovský kraj";18;1847;4;1851;NA;114381;22;2021-08-25;114305
2021-08-24;"Prešovský kraj";10;2042;5;2047;NA;114381;15;2021-08-24;114283
2021-08-23;"Prešovský kraj";16;2487;5;2492;NA;114381;21;2021-08-23;114268
2021-08-22;"Prešovský kraj";0;1359;6;1365;NA;114381;6;2021-08-22;114247
2021-08-21;"Prešovský kraj";29;1943;4;1947;NA;114381;33;2021-08-21;114241
2021-08-20;"Prešovský kraj";15;2821;7;2828;NA;114381;22;2021-08-20;114208
2021-08-19;"Prešovský kraj";22;2198;8;2206;NA;114381;30;2021-08-19;114186
2021-08-18;"Prešovský kraj";6;1734;11;1745;NA;114381;17;2021-08-18;114156
2021-08-17;"Prešovský kraj";29;1781;6;1787;NA;114381;35;2021-08-17;114139
2021-08-16;"Prešovský kraj";11;2427;7;2434;NA;114381;18;2021-08-16;114104
2021-08-15;"Prešovský kraj";0;837;2;839;NA;114381;2;2021-08-15;114086
2021-08-14;"Prešovský kraj";14;1603;1;1604;NA;114381;15;2021-08-14;114084
2021-08-13;"Prešovský kraj";24;1619;12;1631;NA;114381;36;2021-08-13;114069
2021-08-12;"Prešovský kraj";9;1718;3;1721;NA;114381;12;2021-08-12;114033
2021-08-11;"Prešovský kraj";15;1180;4;1184;NA;114381;19;2021-08-11;114021
2021-08-10;"Prešovský kraj";10;1088;4;1092;NA;114381;14;2021-08-10;114002
2021-08-09;"Prešovský kraj";13;2131;4;2135;NA;114381;17;2021-08-09;113988
2021-08-08;"Prešovský kraj";2;629;2;631;NA;114381;4;2021-08-08;113971
2021-08-07;"Prešovský kraj";5;1064;3;1067;NA;114381;8;2021-08-07;113967
2021-08-06;"Prešovský kraj";9;1409;4;1413;NA;114381;13;2021-08-06;113959
2021-08-05;"Prešovský kraj";9;1356;2;1358;NA;114381;11;2021-08-05;113946
2021-08-04;"Prešovský kraj";6;981;1;982;NA;114381;7;2021-08-04;113935
2021-08-03;"Prešovský kraj";8;967;1;968;NA;114381;9;2021-08-03;113928
2021-08-02;"Prešovský kraj";5;1467;6;1473;NA;114381;11;2021-08-02;113919
2021-08-01;"Prešovský kraj";0;712;2;714;NA;114381;2;2021-08-01;113908
2021-07-31;"Prešovský kraj";20;1027;0;1027;NA;114381;20;2021-07-31;113906
2021-07-30;"Prešovský kraj";2;1382;1;1383;NA;114381;3;2021-07-30;113886
2021-07-29;"Prešovský kraj";6;1291;1;1292;NA;114381;7;2021-07-29;113883
2021-07-28;"Prešovský kraj";6;1099;1;1100;NA;114381;7;2021-07-28;113876
2021-07-27;"Prešovský kraj";5;1123;2;1125;NA;114381;7;2021-07-27;113869
2021-07-26;"Prešovský kraj";12;1573;1;1574;NA;114381;13;2021-07-26;113862
2021-07-25;"Prešovský kraj";0;675;1;676;NA;114381;1;2021-07-25;113849
2021-07-24;"Prešovský kraj";8;1015;0;1015;NA;114381;8;2021-07-24;113848
2021-07-23;"Prešovský kraj";8;1608;1;1609;NA;114381;9;2021-07-23;113840
2021-07-22;"Prešovský kraj";13;1431;10;1441;NA;114381;23;2021-07-22;113831
2021-07-21;"Prešovský kraj";5;1076;1;1077;NA;114381;6;2021-07-21;113808
2021-07-20;"Prešovský kraj";4;1046;0;1046;NA;114381;4;2021-07-20;113802
2021-07-19;"Prešovský kraj";2;1644;4;1648;NA;114381;6;2021-07-19;113798
2021-07-18;"Prešovský kraj";1;629;0;629;NA;114381;1;2021-07-18;113792
2021-07-17;"Prešovský kraj";6;1232;1;1233;NA;114381;7;2021-07-17;113791
2021-07-16;"Prešovský kraj";4;1558;2;1560;NA;114381;6;2021-07-16;113784
2021-07-15;"Prešovský kraj";5;1282;4;1286;NA;114381;9;2021-07-15;113778
2021-07-14;"Prešovský kraj";1;1051;2;1053;NA;114381;3;2021-07-14;113769
2021-07-13;"Prešovský kraj";1;1071;2;1073;NA;114381;3;2021-07-13;113766
2021-07-12;"Prešovský kraj";1;1949;2;1951;NA;114381;3;2021-07-12;113763
2021-07-11;"Prešovský kraj";0;645;1;646;NA;114381;1;2021-07-11;113760
2021-07-10;"Prešovský kraj";4;1206;2;1208;NA;114381;6;2021-07-10;113759
2021-07-09;"Prešovský kraj";6;1957;1;1958;NA;114381;7;2021-07-09;113753
2021-07-08;"Prešovský kraj";5;1192;0;1192;NA;114381;5;2021-07-08;113746
2021-07-07;"Prešovský kraj";7;1468;3;1471;NA;114381;10;2021-07-07;113741
2021-07-06;"Prešovský kraj";5;1423;2;1425;NA;114381;7;2021-07-06;113731
2021-07-05;"Prešovský kraj";2;619;0;619;NA;114381;2;2021-07-05;113724
2021-07-04;"Prešovský kraj";0;773;0;773;NA;114381;0;2021-07-04;113722
2021-07-03;"Prešovský kraj";2;1363;0;1363;NA;114381;2;2021-07-03;113722
2021-07-02;"Prešovský kraj";4;1796;0;1796;NA;114381;4;2021-07-02;113720
2021-07-01;"Prešovský kraj";2;1590;1;1591;NA;114381;3;2021-07-01;113716
2021-06-30;"Prešovský kraj";3;8670;4;8674;NA;114381;7;2021-06-30;113713
2021-06-29;"Prešovský kraj";1;4935;3;4938;NA;114381;4;2021-06-29;113706
2021-06-28;"Prešovský kraj";5;6109;2;6111;NA;114381;7;2021-06-28;113702
2021-06-27;"Prešovský kraj";0;3835;1;3836;NA;114381;1;2021-06-27;113695
2021-06-26;"Prešovský kraj";4;5791;1;5792;NA;114381;5;2021-06-26;113694
2021-06-25;"Prešovský kraj";7;7321;4;7325;NA;114381;11;2021-06-25;113689
2021-06-24;"Prešovský kraj";10;5406;5;5411;NA;114381;15;2021-06-24;113678
2021-06-23;"Prešovský kraj";4;5124;2;5126;NA;114381;6;2021-06-23;113663
2021-06-22;"Prešovský kraj";5;5143;1;5144;NA;114381;6;2021-06-22;113657
2021-06-21;"Prešovský kraj";13;7033;6;7039;NA;114381;19;2021-06-21;113651
2021-06-20;"Prešovský kraj";0;5173;3;5176;NA;114381;3;2021-06-20;113632
2021-06-19;"Prešovský kraj";1;7349;5;7354;NA;114381;6;2021-06-19;113629
2021-06-18;"Prešovský kraj";9;8682;10;8692;NA;114381;19;2021-06-18;113623
2021-06-17;"Prešovský kraj";9;6548;5;6553;NA;114381;14;2021-06-17;113604
2021-06-16;"Prešovský kraj";6;6422;3;6425;NA;114381;9;2021-06-16;113590
2021-06-15;"Prešovský kraj";2;5709;4;5713;NA;114381;6;2021-06-15;113581
2021-06-14;"Prešovský kraj";5;8229;13;8242;NA;114381;18;2021-06-14;113575
2021-06-13;"Prešovský kraj";1;6437;7;6444;NA;114381;8;2021-06-13;113557
2021-06-12;"Prešovský kraj";3;8881;9;8890;NA;114381;12;2021-06-12;113549
2021-06-11;"Prešovský kraj";21;9877;9;9886;NA;114381;30;2021-06-11;113537
2021-06-10;"Prešovský kraj";11;6512;10;6522;NA;114381;21;2021-06-10;113507
2021-06-09;"Prešovský kraj";16;6375;3;6378;NA;114381;19;2021-06-09;113486
2021-06-08;"Prešovský kraj";31;6495;12;6507;NA;114381;43;2021-06-08;113467
2021-06-07;"Prešovský kraj";11;9111;15;9126;NA;114381;26;2021-06-07;113424
2021-06-06;"Prešovský kraj";0;7999;5;8004;NA;114381;5;2021-06-06;113398
2021-06-05;"Prešovský kraj";17;10248;15;10263;NA;114381;32;2021-06-05;113393
2021-06-04;"Prešovský kraj";26;10321;18;10339;NA;114381;44;2021-06-04;113361
2021-06-03;"Prešovský kraj";14;6820;16;6836;NA;114381;30;2021-06-03;113317
2021-06-02;"Prešovský kraj";47;7372;14;7386;NA;114381;61;2021-06-02;113287
2021-06-01;"Prešovský kraj";15;6926;14;6940;NA;114381;29;2021-06-01;113226
2021-05-31;"Prešovský kraj";27;9951;22;9973;NA;114381;49;2021-05-31;113197
2021-05-30;"Prešovský kraj";2;9694;14;9708;NA;114381;16;2021-05-30;113148
2021-05-29;"Prešovský kraj";23;12709;24;12733;NA;114381;47;2021-05-29;113132
2021-05-28;"Prešovský kraj";30;12468;19;12487;NA;114381;49;2021-05-28;113085
2021-05-27;"Prešovský kraj";16;7610;37;7647;NA;114381;53;2021-05-27;113036
2021-05-26;"Prešovský kraj";32;8140;23;8163;NA;114381;55;2021-05-26;112983
2021-05-25;"Prešovský kraj";38;8690;20;8710;NA;114381;58;2021-05-25;112928
2021-05-24;"Prešovský kraj";17;13298;37;13335;NA;114381;54;2021-05-24;112870
2021-05-23;"Prešovský kraj";3;11933;20;11953;NA;114381;23;2021-05-23;112816
2021-05-22;"Prešovský kraj";11;14422;44;14466;NA;114381;55;2021-05-22;112793
2021-05-21;"Prešovský kraj";44;13803;24;13827;NA;114381;68;2021-05-21;112738
2021-05-20;"Prešovský kraj";13;9437;29;9466;NA;114381;42;2021-05-20;112670
2021-05-19;"Prešovský kraj";60;10756;36;10792;NA;114381;96;2021-05-19;112628
2021-05-18;"Prešovský kraj";44;9062;27;9089;NA;114381;71;2021-05-18;112532
2021-05-17;"Prešovský kraj";60;12856;47;12903;NA;114381;107;2021-05-17;112461
2021-05-16;"Prešovský kraj";20;16302;66;16368;NA;114381;86;2021-05-16;112354
2021-05-15;"Prešovský kraj";20;24585;81;24666;NA;114381;101;2021-05-15;112268
2021-05-14;"Prešovský kraj";49;18671;68;18739;NA;114381;117;2021-05-14;112167
2021-05-13;"Prešovský kraj";54;11166;71;11237;NA;114381;125;2021-05-13;112050
2021-05-12;"Prešovský kraj";59;10822;39;10861;NA;114381;98;2021-05-12;111925
2021-05-11;"Prešovský kraj";61;10728;48;10776;NA;114381;109;2021-05-11;111827
2021-05-10;"Prešovský kraj";79;15726;67;15793;NA;114381;146;2021-05-10;111718
2021-05-09;"Prešovský kraj";54;21614;82;21696;NA;114381;136;2021-05-09;111572
2021-05-08;"Prešovský kraj";39;23050;52;23102;NA;114381;91;2021-05-08;111436
2021-05-07;"Prešovský kraj";81;23543;66;23609;NA;114381;147;2021-05-07;111345
2021-05-06;"Prešovský kraj";107;12924;66;12990;NA;114381;173;2021-05-06;111198
2021-05-05;"Prešovský kraj";60;12808;84;12892;NA;114381;144;2021-05-05;111025
2021-05-04;"Prešovský kraj";203;13470;67;13537;NA;114381;270;2021-05-04;110881
2021-05-03;"Prešovský kraj";68;18458;109;18567;NA;114381;177;2021-05-03;110611
2021-05-02;"Prešovský kraj";29;36664;102;36766;NA;114381;131;2021-05-02;110434
2021-05-01;"Prešovský kraj";70;57153;183;57336;NA;114381;253;2021-05-01;110303
2021-04-30;"Prešovský kraj";135;39333;118;39451;NA;114381;253;2021-04-30;110050
2021-04-29;"Prešovský kraj";110;16635;97;16732;NA;114381;207;2021-04-29;109797
2021-04-28;"Prešovský kraj";122;18671;89;18760;NA;114381;211;2021-04-28;109590
2021-04-27;"Prešovský kraj";154;19994;120;20114;NA;114381;274;2021-04-27;109379
2021-04-26;"Prešovský kraj";99;27241;123;27364;NA;114381;222;2021-04-26;109105
2021-04-25;"Prešovský kraj";9;52776;156;52932;NA;114381;165;2021-04-25;108883
2021-04-24;"Prešovský kraj";61;85698;243;85941;NA;114381;304;2021-04-24;108718
2021-04-23;"Prešovský kraj";171;40365;137;40502;NA;114381;308;2021-04-23;108414
2021-04-22;"Prešovský kraj";86;18104;125;18229;NA;114381;211;2021-04-22;108106
2021-04-21;"Prešovský kraj";144;21550;139;21689;NA;114381;283;2021-04-21;107895
2021-04-20;"Prešovský kraj";115;23346;128;23474;NA;114381;243;2021-04-20;107612
2021-04-19;"Prešovský kraj";106;29133;145;29278;NA;114381;251;2021-04-19;107369
2021-04-18;"Prešovský kraj";4;51824;129;51953;NA;114381;133;2021-04-18;107118
2021-04-17;"Prešovský kraj";119;97970;238;98208;NA;114381;357;2021-04-17;106985
2021-04-16;"Prešovský kraj";135;40989;146;41135;NA;114381;281;2021-04-16;106628
2021-04-15;"Prešovský kraj";112;20179;137;20316;NA;114381;249;2021-04-15;106347
2021-04-14;"Prešovský kraj";199;23332;130;23462;NA;114381;329;2021-04-14;106098
2021-04-13;"Prešovský kraj";180;23907;116;24023;NA;114381;296;2021-04-13;105769
2021-04-12;"Prešovský kraj";172;30152;175;30327;NA;114381;347;2021-04-12;105473
2021-04-11;"Prešovský kraj";11;49955;187;50142;NA;114381;198;2021-04-11;105126
2021-04-10;"Prešovský kraj";94;90181;297;90478;NA;114381;391;2021-04-10;104928
2021-04-09;"Prešovský kraj";255;37163;200;37363;NA;114381;455;2021-04-09;104537
2021-04-08;"Prešovský kraj";192;18893;157;19050;NA;114381;349;2021-04-08;104082
2021-04-07;"Prešovský kraj";314;27797;154;27951;NA;114381;468;2021-04-07;103733
2021-04-06;"Prešovský kraj";231;41711;268;41979;NA;114381;499;2021-04-06;103265
2021-04-05;"Prešovský kraj";54;18454;132;18586;NA;114381;186;2021-04-05;102766
2021-04-04;"Prešovský kraj";31;18569;91;18660;NA;114381;122;2021-04-04;102580
2021-04-03;"Prešovský kraj";104;90664;321;90985;NA;114381;425;2021-04-03;102458
2021-04-02;"Prešovský kraj";194;23381;134;23515;NA;114381;328;2021-04-02;102033
2021-04-01;"Prešovský kraj";256;42879;195;43074;NA;114381;451;2021-04-01;101705
2021-03-31;"Prešovský kraj";311;30176;227;30403;NA;114381;538;2021-03-31;101254
2021-03-30;"Prešovský kraj";374;20751;203;20954;NA;114381;577;2021-03-30;100716
2021-03-29;"Prešovský kraj";219;28188;229;28417;NA;114381;448;2021-03-29;100139
2021-03-28;"Prešovský kraj";26;46811;256;47067;NA;114381;282;2021-03-28;99691
2021-03-27;"Prešovský kraj";181;88673;372;89045;NA;114381;553;2021-03-27;99409
2021-03-26;"Prešovský kraj";310;47751;299;48050;NA;114381;609;2021-03-26;98856
2021-03-25;"Prešovský kraj";248;22281;213;22494;NA;114381;461;2021-03-25;98247
2021-03-24;"Prešovský kraj";381;19590;213;19803;NA;114381;594;2021-03-24;97786
2021-03-23;"Prešovský kraj";241;20351;255;20606;NA;114381;496;2021-03-23;97192
2021-03-22;"Prešovský kraj";299;28634;287;28921;NA;114381;586;2021-03-22;96696
2021-03-21;"Prešovský kraj";32;49439;266;49705;NA;114381;298;2021-03-21;96110
2021-03-20;"Prešovský kraj";180;92529;426;92955;NA;114381;606;2021-03-20;95812
2021-03-19;"Prešovský kraj";373;46582;326;46908;NA;114381;699;2021-03-19;95206
2021-03-18;"Prešovský kraj";251;21721;217;21938;NA;114381;468;2021-03-18;94507
2021-03-17;"Prešovský kraj";331;20887;231;21118;NA;114381;562;2021-03-17;94039
2021-03-16;"Prešovský kraj";461;21094;278;21372;NA;114381;739;2021-03-16;93477
2021-03-15;"Prešovský kraj";370;28813;324;29137;NA;114381;694;2021-03-15;92738
2021-03-14;"Prešovský kraj";52;50410;356;50766;NA;114381;408;2021-03-14;92044
2021-03-13;"Prešovský kraj";200;94768;531;95299;NA;114381;731;2021-03-13;91636
2021-03-12;"Prešovský kraj";425;47691;368;48059;NA;114381;793;2021-03-12;90905
2021-03-11;"Prešovský kraj";463;22059;253;22312;NA;114381;716;2021-03-11;90112
2021-03-10;"Prešovský kraj";325;20821;293;21114;NA;114381;618;2021-03-10;89396
2021-03-09;"Prešovský kraj";505;21496;288;21784;NA;114381;793;2021-03-09;88778
2021-03-08;"Prešovský kraj";314;28903;333;29236;NA;114381;647;2021-03-08;87985
2021-03-07;"Prešovský kraj";19;48328;388;48716;NA;114381;407;2021-03-07;87338
2021-03-06;"Prešovský kraj";193;97527;591;98118;NA;114381;784;2021-03-06;86931
2021-03-05;"Prešovský kraj";497;46054;397;46451;NA;114381;894;2021-03-05;86147
2021-03-04;"Prešovský kraj";372;22670;359;23029;NA;114381;731;2021-03-04;85253
2021-03-03;"Prešovský kraj";397;21623;333;21956;NA;114381;730;2021-03-03;84522
2021-03-02;"Prešovský kraj";421;22682;357;23039;NA;114381;778;2021-03-02;83792
2021-03-01;"Prešovský kraj";303;27716;406;28122;NA;114381;709;2021-03-01;83014
2021-02-28;"Prešovský kraj";75;45000;387;45387;NA;114381;462;2021-02-28;82305
2021-02-27;"Prešovský kraj";273;90231;734;90965;NA;114381;1007;2021-02-27;81843
2021-02-26;"Prešovský kraj";455;41340;438;41778;NA;114381;893;2021-02-26;80836
2021-02-25;"Prešovský kraj";270;19496;337;19833;NA;114381;607;2021-02-25;79943
2021-02-24;"Prešovský kraj";328;19026;377;19403;NA;114381;705;2021-02-24;79336
2021-02-23;"Prešovský kraj";430;21277;345;21622;NA;114381;775;2021-02-23;78631
2021-02-22;"Prešovský kraj";351;27180;356;27536;NA;114381;707;2021-02-22;77856
2021-02-21;"Prešovský kraj";66;31841;302;32143;NA;114381;368;2021-02-21;77149
2021-02-20;"Prešovský kraj";129;71413;517;71930;NA;114381;646;2021-02-20;76781
2021-02-19;"Prešovský kraj";381;38995;430;39425;NA;114381;811;2021-02-19;76135
2021-02-18;"Prešovský kraj";268;16960;322;17282;NA;114381;590;2021-02-18;75324
2021-02-17;"Prešovský kraj";293;17392;246;17638;NA;114381;539;2021-02-17;74734
2021-02-16;"Prešovský kraj";422;18862;265;19127;NA;114381;687;2021-02-16;74195
2021-02-15;"Prešovský kraj";211;31366;303;31669;NA;114381;514;2021-02-15;73508
2021-02-14;"Prešovský kraj";27;39387;321;39708;NA;114381;348;2021-02-14;72994
2021-02-13;"Prešovský kraj";157;74747;402;75149;NA;114381;559;2021-02-13;72646
2021-02-12;"Prešovský kraj";308;38758;365;39123;NA;114381;673;2021-02-12;72087
2021-02-11;"Prešovský kraj";218;16207;238;16445;NA;114381;456;2021-02-11;71414
2021-02-10;"Prešovský kraj";220;18542;282;18824;NA;114381;502;2021-02-10;70958
2021-02-09;"Prešovský kraj";323;21497;370;21867;NA;114381;693;2021-02-09;70456
2021-02-08;"Prešovský kraj";161;36924;261;37185;NA;114381;422;2021-02-08;69763
2021-02-07;"Prešovský kraj";21;34227;209;34436;NA;114381;230;2021-02-07;69341
2021-02-06;"Prešovský kraj";176;69164;360;69524;NA;114381;536;2021-02-06;69111
2021-02-05;"Prešovský kraj";177;31271;262;31533;NA;114381;439;2021-02-05;68575
2021-02-04;"Prešovský kraj";176;13080;237;13317;NA;114381;413;2021-02-04;68136
2021-02-03;"Prešovský kraj";251;8421;236;8657;NA;114381;487;2021-02-03;67723
2021-02-02;"Prešovský kraj";249;11769;264;12033;NA;114381;513;2021-02-02;67236
2021-02-01;"Prešovský kraj";220;16059;316;16375;NA;114381;536;2021-02-01;66723
2021-01-31;"Prešovský kraj";42;10587;107;10694;NA;114381;149;2021-01-31;66187
2021-01-30;"Prešovský kraj";142;23939;215;24154;NA;114381;357;2021-01-30;66038
2021-01-29;"Prešovský kraj";185;17924;326;18250;NA;114381;511;2021-01-29;65681
2021-01-28;"Prešovský kraj";311;7348;150;7498;NA;114381;461;2021-01-28;65170
2021-01-27;"Prešovský kraj";153;9730;147;9877;NA;114381;300;2021-01-27;64709
2021-01-26;"Prešovský kraj";252;16653;151;16804;NA;114381;403;2021-01-26;64409
2021-01-25;"Prešovský kraj";196;30092;253;30345;NA;114381;449;2021-01-25;64006
2021-01-24;"Prešovský kraj";12;45706;304;46010;NA;114381;316;2021-01-24;63557
2021-01-23;"Prešovský kraj";189;96883;487;97370;NA;114381;676;2021-01-23;63241
2021-01-22;"Prešovský kraj";187;35383;261;35644;NA;114381;448;2021-01-22;62565
2021-01-21;"Prešovský kraj";187;20434;212;20646;NA;114381;399;2021-01-21;62117
2021-01-20;"Prešovský kraj";253;14782;195;14977;NA;114381;448;2021-01-20;61718
2021-01-19;"Prešovský kraj";281;12329;305;12634;NA;114381;586;2021-01-19;61270
2021-01-18;"Prešovský kraj";203;10422;336;10758;NA;114381;539;2021-01-18;60684
2021-01-17;"Prešovský kraj";107;14391;1008;15399;NA;114381;1115;2021-01-17;60145
2021-01-16;"Prešovský kraj";72;1838;81;1919;NA;114381;153;2021-01-16;59030
2021-01-15;"Prešovský kraj";159;7033;257;7290;NA;114381;416;2021-01-15;58877
2021-01-14;"Prešovský kraj";268;5534;256;5790;NA;114381;524;2021-01-14;58461
2021-01-13;"Prešovský kraj";342;5649;226;5875;NA;114381;568;2021-01-13;57937
2021-01-12;"Prešovský kraj";455;8251;386;8637;NA;114381;841;2021-01-12;57369
2021-01-11;"Prešovský kraj";343;8149;471;8620;NA;114381;814;2021-01-11;56528
2021-01-10;"Prešovský kraj";63;476;23;499;NA;114381;86;2021-01-10;55714
2021-01-09;"Prešovský kraj";439;2248;125;2373;NA;114381;564;2021-01-09;55628
2021-01-08;"Prešovský kraj";430;10416;561;10977;NA;114381;991;2021-01-08;55064
2021-01-07;"Prešovský kraj";268;7432;622;8054;NA;114381;890;2021-01-07;54073
2021-01-06;"Prešovský kraj";315;1484;134;1618;NA;114381;449;2021-01-06;53183
2021-01-05;"Prešovský kraj";655;11275;976;12251;NA;114381;1631;2021-01-05;52734
2021-01-04;"Prešovský kraj";371;16845;1789;18634;NA;114381;2160;2021-01-04;51103
2021-01-03;"Prešovský kraj";89;459;41;500;NA;114381;130;2021-01-03;48943
2021-01-02;"Prešovský kraj";65;1556;160;1716;NA;114381;225;2021-01-02;48813
2021-01-01;"Prešovský kraj";174;956;71;1027;NA;114381;245;2021-01-01;48588
2020-12-31;"Prešovský kraj";640;11959;783;12742;NA;114381;1423;2020-12-31;48343
2020-12-30;"Prešovský kraj";729;9062;802;9864;NA;114381;1531;2020-12-30;46920
2020-12-29;"Prešovský kraj";435;9273;949;10222;NA;114381;1384;2020-12-29;45389
2020-12-28;"Prešovský kraj";393;9046;1079;10125;NA;114381;1472;2020-12-28;44005
2020-12-27;"Prešovský kraj";40;613;45;658;NA;114381;85;2020-12-27;42533
2020-12-26;"Prešovský kraj";64;176;12;188;NA;114381;76;2020-12-26;42448
2020-12-25;"Prešovský kraj";208;274;11;285;NA;114381;219;2020-12-25;42372
2020-12-24;"Prešovský kraj";452;1214;85;1299;NA;114381;537;2020-12-24;42153
2020-12-23;"Prešovský kraj";361;11372;636;12008;NA;114381;997;2020-12-23;41616
2020-12-22;"Prešovský kraj";439;9371;710;10081;NA;114381;1149;2020-12-22;40619
2020-12-21;"Prešovský kraj";432;9884;880;10764;NA;114381;1312;2020-12-21;39470
2020-12-20;"Prešovský kraj";184;396;20;416;NA;114381;204;2020-12-20;38158
2020-12-19;"Prešovský kraj";276;1658;151;1809;NA;114381;427;2020-12-19;37954
2020-12-18;"Prešovský kraj";396;8845;595;9440;NA;114381;991;2020-12-18;37527
2020-12-17;"Prešovský kraj";427;10826;891;11717;NA;114381;1318;2020-12-17;36536
2020-12-16;"Prešovský kraj";466;6003;505;6508;NA;114381;971;2020-12-16;35218
2020-12-15;"Prešovský kraj";411;5685;584;6269;NA;114381;995;2020-12-15;34247
2020-12-14;"Prešovský kraj";334;5767;508;6275;NA;114381;842;2020-12-14;33252
2020-12-13;"Prešovský kraj";89;29;8;37;NA;114381;97;2020-12-13;32410
2020-12-12;"Prešovský kraj";319;2474;166;2640;NA;114381;485;2020-12-12;32313
2020-12-11;"Prešovský kraj";560;5602;402;6004;NA;114381;962;2020-12-11;31828
2020-12-10;"Prešovský kraj";337;5202;443;5645;NA;114381;780;2020-12-10;30866
2020-12-09;"Prešovský kraj";358;4357;314;4671;NA;114381;672;2020-12-09;30086
2020-12-08;"Prešovský kraj";350;6629;651;7280;NA;114381;1001;2020-12-08;29414
2020-12-07;"Prešovský kraj";309;4345;327;4672;NA;114381;636;2020-12-07;28413
2020-12-06;"Prešovský kraj";59;655;26;681;NA;114381;85;2020-12-06;27777
2020-12-05;"Prešovský kraj";218;984;87;1071;NA;114381;305;2020-12-05;27692
2020-12-04;"Prešovský kraj";352;5070;293;5363;NA;114381;645;2020-12-04;27387
2020-12-03;"Prešovský kraj";284;2456;179;2635;NA;114381;463;2020-12-03;26742
2020-12-02;"Prešovský kraj";232;2830;225;3055;NA;114381;457;2020-12-02;26279
2020-12-01;"Prešovský kraj";281;1884;196;2080;NA;114381;477;2020-12-01;25822
2020-11-30;"Prešovský kraj";196;5333;97;5430;NA;114381;293;2020-11-30;25345
2020-11-29;"Prešovský kraj";27;379;42;421;NA;114381;69;2020-11-29;25052
2020-11-28;"Prešovský kraj";199;772;77;849;NA;114381;276;2020-11-28;24983
2020-11-27;"Prešovský kraj";232;2350;130;2480;NA;114381;362;2020-11-27;24707
2020-11-26;"Prešovský kraj";263;3014;329;3343;NA;114381;592;2020-11-26;24345
2020-11-25;"Prešovský kraj";302;2174;103;2277;NA;114381;405;2020-11-25;23753
2020-11-24;"Prešovský kraj";365;1777;156;1933;NA;114381;521;2020-11-24;23348
2020-11-23;"Prešovský kraj";164;1099;60;1159;NA;114381;224;2020-11-23;22827
2020-11-22;"Prešovský kraj";46;44;1;45;NA;114381;47;2020-11-22;22603
2020-11-21;"Prešovský kraj";205;754;62;816;NA;114381;267;2020-11-21;22556
2020-11-20;"Prešovský kraj";363;2258;102;2360;NA;114381;465;2020-11-20;22289
2020-11-19;"Prešovský kraj";359;2096;238;2334;NA;114381;597;2020-11-19;21824
2020-11-18;"Prešovský kraj";270;488;43;531;NA;114381;313;2020-11-18;21227
2020-11-17;"Prešovský kraj";347;205;23;228;NA;114381;370;2020-11-17;20914
2020-11-16;"Prešovský kraj";226;540;58;598;NA;114381;284;2020-11-16;20544
2020-11-15;"Prešovský kraj";186;39;4;43;NA;114381;190;2020-11-15;20260
2020-11-14;"Prešovský kraj";261;54;4;58;NA;114381;265;2020-11-14;20070
2020-11-13;"Prešovský kraj";395;166;8;174;NA;114381;403;2020-11-13;19805
2020-11-12;"Prešovský kraj";397;229;50;279;NA;114381;447;2020-11-12;19402
2020-11-11;"Prešovský kraj";516;161;15;176;NA;114381;531;2020-11-11;18955
2020-11-10;"Prešovský kraj";437;197;9;206;NA;114381;446;2020-11-10;18424
2020-11-09;"Prešovský kraj";190;4110;945;5055;NA;114381;1135;2020-11-09;17978
2020-11-08;"Prešovský kraj";97;2817;32;2849;NA;114381;129;2020-11-08;16843
2020-11-07;"Prešovský kraj";416;8578;81;8659;NA;114381;497;2020-11-07;16714
2020-11-06;"Prešovský kraj";520;4791;76;4867;NA;114381;596;2020-11-06;16217
2020-11-05;"Prešovský kraj";397;180;5;185;NA;114381;402;2020-11-05;15621
2020-11-04;"Prešovský kraj";350;807;8;815;NA;114381;358;2020-11-04;15219
2020-11-03;"Prešovský kraj";565;98;12;110;NA;114381;577;2020-11-03;14861
2020-11-02;"Prešovský kraj";203;4158;1004;5162;NA;114381;1207;2020-11-02;14284
2020-11-01;"Prešovský kraj";386;2906;53;2959;NA;114381;439;2020-11-01;13077
2020-10-31;"Prešovský kraj";315;10497;170;10667;NA;114381;485;2020-10-31;12638
2020-10-30;"Prešovský kraj";552;2949;65;3014;NA;114381;617;2020-10-30;12153
2020-10-29;"Prešovský kraj";594;301;38;339;NA;114381;632;2020-10-29;11536
2020-10-28;"Prešovský kraj";617;291;46;337;NA;114381;663;2020-10-28;10904
2020-10-27;"Prešovský kraj";656;268;34;302;NA;114381;690;2020-10-27;10241
2020-10-26;"Prešovský kraj";137;363;57;420;NA;114381;194;2020-10-26;9551
2020-10-25;"Prešovský kraj";237;346;11;357;NA;114381;248;2020-10-25;9357
2020-10-24;"Prešovský kraj";719;200;12;212;NA;114381;731;2020-10-24;9109
2020-10-23;"Prešovský kraj";750;218;8;226;NA;114381;758;2020-10-23;8378
2020-10-22;"Prešovský kraj";646;396;30;426;NA;114381;676;2020-10-22;7620
2020-10-21;"Prešovský kraj";383;58;8;66;NA;114381;391;2020-10-21;6944
2020-10-20;"Prešovský kraj";493;65;7;72;NA;114381;500;2020-10-20;6553
2020-10-19;"Prešovský kraj";140;235;15;250;NA;114381;155;2020-10-19;6053
2020-10-18;"Prešovský kraj";209;0;0;0;NA;114381;209;2020-10-18;5898
2020-10-17;"Prešovský kraj";342;0;0;0;NA;114381;342;2020-10-17;5689
2020-10-16;"Prešovský kraj";388;57;3;60;NA;114381;391;2020-10-16;5347
2020-10-15;"Prešovský kraj";435;85;18;103;NA;114381;453;2020-10-15;4956
2020-10-14;"Prešovský kraj";451;54;10;64;NA;114381;461;2020-10-14;4503
2020-10-13;"Prešovský kraj";264;50;6;56;NA;114381;270;2020-10-13;4042
2020-10-12;"Prešovský kraj";214;334;35;369;NA;114381;249;2020-10-12;3772
2020-10-11;"Prešovský kraj";127;0;0;0;NA;114381;127;2020-10-11;3523
2020-10-10;"Prešovský kraj";248;0;0;0;NA;114381;248;2020-10-10;3396
2020-10-09;"Prešovský kraj";406;0;0;0;NA;114381;406;2020-10-09;3148
2020-10-08;"Prešovský kraj";245;0;0;0;NA;114381;245;2020-10-08;2742
2020-10-07;"Prešovský kraj";244;0;0;0;NA;114381;244;2020-10-07;2497
2020-10-06;"Prešovský kraj";166;0;0;0;NA;114381;166;2020-10-06;2253
2020-10-05;"Prešovský kraj";84;0;0;0;NA;114381;84;2020-10-05;2087
2020-10-04;"Prešovský kraj";118;0;0;0;NA;114381;118;2020-10-04;2003
2020-10-03;"Prešovský kraj";204;0;0;0;NA;114381;204;2020-10-03;1885
2020-10-02;"Prešovský kraj";149;0;0;0;NA;114381;149;2020-10-02;1681
2020-10-01;"Prešovský kraj";136;0;0;0;NA;114381;136;2020-10-01;1532
2020-09-30;"Prešovský kraj";121;0;0;0;NA;114381;121;2020-09-30;1396
2020-09-29;"Prešovský kraj";156;0;0;0;NA;114381;156;2020-09-29;1275
2020-09-28;"Prešovský kraj";51;0;0;0;NA;114381;51;2020-09-28;1119
2020-09-27;"Prešovský kraj";10;0;0;0;NA;114381;10;2020-09-27;1068
2020-09-26;"Prešovský kraj";72;0;0;0;NA;114381;72;2020-09-26;1058
2020-09-25;"Prešovský kraj";91;0;0;0;NA;114381;91;2020-09-25;986
2020-09-24;"Prešovský kraj";52;0;0;0;NA;114381;52;2020-09-24;895
2020-09-23;"Prešovský kraj";55;0;0;0;NA;114381;55;2020-09-23;843
2020-09-22;"Prešovský kraj";29;0;0;0;NA;114381;29;2020-09-22;788
2020-09-21;"Prešovský kraj";14;0;0;0;NA;114381;14;2020-09-21;759
2020-09-20;"Prešovský kraj";5;0;0;0;NA;114381;5;2020-09-20;745
2020-09-19;"Prešovský kraj";12;0;0;0;NA;114381;12;2020-09-19;740
2020-09-18;"Prešovský kraj";29;0;0;0;NA;114381;29;2020-09-18;728
2020-09-17;"Prešovský kraj";25;0;0;0;NA;114381;25;2020-09-17;699
2020-09-16;"Prešovský kraj";8;0;0;0;NA;114381;8;2020-09-16;674
2020-09-15;"Prešovský kraj";10;0;0;0;NA;114381;10;2020-09-15;666
2020-09-14;"Prešovský kraj";47;0;0;0;NA;114381;47;2020-09-14;656
2020-09-13;"Prešovský kraj";3;0;0;0;NA;114381;3;2020-09-13;609
2020-09-12;"Prešovský kraj";4;0;0;0;NA;114381;4;2020-09-12;606
2020-09-11;"Prešovský kraj";15;0;0;0;NA;114381;15;2020-09-11;602
2020-09-10;"Prešovský kraj";10;0;0;0;NA;114381;10;2020-09-10;587
2020-09-09;"Prešovský kraj";21;0;0;0;NA;114381;21;2020-09-09;577
2020-09-08;"Prešovský kraj";23;0;0;0;NA;114381;23;2020-09-08;556
2020-09-07;"Prešovský kraj";5;0;0;0;NA;114381;5;2020-09-07;533
2020-09-06;"Prešovský kraj";3;0;0;0;NA;114381;3;2020-09-06;528
2020-09-05;"Prešovský kraj";7;0;0;0;NA;114381;7;2020-09-05;525
2020-09-04;"Prešovský kraj";24;0;0;0;NA;114381;24;2020-09-04;518
2020-09-03;"Prešovský kraj";8;0;0;0;NA;114381;8;2020-09-03;494
2020-09-02;"Prešovský kraj";9;0;0;0;NA;114381;9;2020-09-02;486
2020-09-01;"Prešovský kraj";6;0;0;0;NA;114381;6;2020-09-01;477
2020-08-31;"Prešovský kraj";3;0;0;0;NA;114381;3;2020-08-31;471
2020-08-30;"Prešovský kraj";6;0;0;0;NA;114381;6;2020-08-30;468
2020-08-29;"Prešovský kraj";4;0;0;0;NA;114381;4;2020-08-29;462
2020-08-28;"Prešovský kraj";6;0;0;0;NA;114381;6;2020-08-28;458
2020-08-27;"Prešovský kraj";7;0;0;0;NA;114381;7;2020-08-27;452
2020-08-26;"Prešovský kraj";22;0;0;0;NA;114381;22;2020-08-26;445
2020-08-25;"Prešovský kraj";1;0;0;0;NA;114381;1;2020-08-25;423
2020-08-24;"Prešovský kraj";5;0;0;0;NA;114381;5;2020-08-24;422
2020-08-23;"Prešovský kraj";3;0;0;0;NA;114381;3;2020-08-23;417
2020-08-22;"Prešovský kraj";3;0;0;0;NA;114381;3;2020-08-22;414
2020-08-21;"Prešovský kraj";11;0;0;0;NA;114381;11;2020-08-21;411
2020-08-20;"Prešovský kraj";8;0;0;0;NA;114381;8;2020-08-20;400
2020-08-19;"Prešovský kraj";8;0;0;0;NA;114381;8;2020-08-19;392
2020-08-18;"Prešovský kraj";6;0;0;0;NA;114381;6;2020-08-18;384
2020-08-17;"Prešovský kraj";1;0;0;0;NA;114381;1;2020-08-17;378
2020-08-16;"Prešovský kraj";0;0;0;0;NA;114381;0;2020-08-16;377
2020-08-15;"Prešovský kraj";8;0;0;0;NA;114381;8;2020-08-15;377
2020-08-14;"Prešovský kraj";6;0;0;0;NA;114381;6;2020-08-14;369
2020-08-13;"Prešovský kraj";8;0;0;0;NA;114381;8;2020-08-13;363
2020-08-12;"Prešovský kraj";19;0;0;0;NA;114381;19;2020-08-12;355
2020-08-11;"Prešovský kraj";3;0;0;0;NA;114381;3;2020-08-11;336
2020-08-10;"Prešovský kraj";0;0;0;0;NA;114381;0;2020-08-10;333
2020-08-09;"Prešovský kraj";0;0;0;0;NA;114381;0;2020-08-09;333
2020-08-08;"Prešovský kraj";2;0;0;0;NA;114381;2;2020-08-08;333
2020-08-07;"Prešovský kraj";6;0;0;0;NA;114381;6;2020-08-07;331
2020-08-06;"Prešovský kraj";2;0;0;0;NA;114381;2;2020-08-06;325
2020-08-05;"Prešovský kraj";8;0;0;0;NA;114381;8;2020-08-05;323
2020-08-04;"Prešovský kraj";5;0;0;0;NA;114381;5;2020-08-04;315
2020-08-03;"Prešovský kraj";4;0;0;0;NA;114381;4;2020-08-03;310
2020-08-02;"Prešovský kraj";6;0;0;0;NA;114381;6;2020-08-02;306
2020-08-01;"Prešovský kraj";0;0;0;0;NA;114381;0;2020-08-01;300
2020-07-31;"Prešovský kraj";2;0;0;0;NA;114381;2;2020-07-31;300
2020-07-30;"Prešovský kraj";6;0;0;0;NA;114381;6;2020-07-30;298
2020-07-29;"Prešovský kraj";5;0;0;0;NA;114381;5;2020-07-29;292
2020-07-28;"Prešovský kraj";0;0;0;0;NA;114381;0;2020-07-28;287
2020-07-27;"Prešovský kraj";1;0;0;0;NA;114381;1;2020-07-27;287
2020-07-26;"Prešovský kraj";1;0;0;0;NA;114381;1;2020-07-26;286
2020-07-25;"Prešovský kraj";21;0;0;0;NA;114381;21;2020-07-25;285
2020-07-24;"Prešovský kraj";1;0;0;0;NA;114381;1;2020-07-24;264
2020-07-23;"Prešovský kraj";5;0;0;0;NA;114381;5;2020-07-23;263
2020-07-22;"Prešovský kraj";1;0;0;0;NA;114381;1;2020-07-22;258
2020-07-21;"Prešovský kraj";2;0;0;0;NA;114381;2;2020-07-21;257
2020-07-20;"Prešovský kraj";1;0;0;0;NA;114381;1;2020-07-20;255
2020-07-19;"Prešovský kraj";0;0;0;0;NA;114381;0;2020-07-19;254
2020-07-18;"Prešovský kraj";0;0;0;0;NA;114381;0;2020-07-18;254
2020-07-17;"Prešovský kraj";3;0;0;0;NA;114381;3;2020-07-17;254
2020-07-16;"Prešovský kraj";1;0;0;0;NA;114381;1;2020-07-16;251
2020-07-15;"Prešovský kraj";5;0;0;0;NA;114381;5;2020-07-15;250
2020-07-14;"Prešovský kraj";5;0;0;0;NA;114381;5;2020-07-14;245
2020-07-13;"Prešovský kraj";1;0;0;0;NA;114381;1;2020-07-13;240
2020-07-12;"Prešovský kraj";1;0;0;0;NA;114381;1;2020-07-12;239
2020-07-11;"Prešovský kraj";6;0;0;0;NA;114381;6;2020-07-11;238
2020-07-10;"Prešovský kraj";5;0;0;0;NA;114381;5;2020-07-10;232
2020-07-09;"Prešovský kraj";2;0;0;0;NA;114381;2;2020-07-09;227
2020-07-08;"Prešovský kraj";14;0;0;0;NA;114381;14;2020-07-08;225
2020-07-07;"Prešovský kraj";2;0;0;0;NA;114381;2;2020-07-07;211
2020-07-06;"Prešovský kraj";0;0;0;0;NA;114381;0;2020-07-06;209
2020-07-05;"Prešovský kraj";0;0;0;0;NA;114381;0;2020-07-05;209
2020-07-04;"Prešovský kraj";1;0;0;0;NA;114381;1;2020-07-04;209
2020-07-03;"Prešovský kraj";3;0;0;0;NA;114381;3;2020-07-03;208
2020-07-02;"Prešovský kraj";0;0;0;0;NA;114381;0;2020-07-02;205
2020-07-01;"Prešovský kraj";0;0;0;0;NA;114381;0;2020-07-01;205
2020-06-30;"Prešovský kraj";7;0;0;0;NA;114381;7;2020-06-30;205
2020-06-29;"Prešovský kraj";0;0;0;0;NA;114381;0;2020-06-29;198
2020-06-28;"Prešovský kraj";0;0;0;0;NA;114381;0;2020-06-28;198
2020-06-27;"Prešovský kraj";3;0;0;0;NA;114381;3;2020-06-27;198
2020-06-26;"Prešovský kraj";3;0;0;0;NA;114381;3;2020-06-26;195
2020-06-25;"Prešovský kraj";0;0;0;0;NA;114381;0;2020-06-25;192
2020-06-24;"Prešovský kraj";4;0;0;0;NA;114381;4;2020-06-24;192
2020-06-23;"Prešovský kraj";0;0;0;0;NA;114381;0;2020-06-23;188
2020-06-22;"Prešovský kraj";0;0;0;0;NA;114381;0;2020-06-22;188
2020-06-21;"Prešovský kraj";0;0;0;0;NA;114381;0;2020-06-21;188
2020-06-20;"Prešovský kraj";0;0;0;0;NA;114381;0;2020-06-20;188
2020-06-19;"Prešovský kraj";1;0;0;0;NA;114381;1;2020-06-19;188
2020-06-18;"Prešovský kraj";0;0;0;0;NA;114381;0;2020-06-18;187
2020-06-17;"Prešovský kraj";0;0;0;0;NA;114381;0;2020-06-17;187
2020-06-16;"Prešovský kraj";6;0;0;0;NA;114381;6;2020-06-16;187
2020-06-14;"Prešovský kraj";0;0;0;0;NA;114381;0;2020-06-14;181
2020-06-13;"Prešovský kraj";0;0;0;0;NA;114381;0;2020-06-13;181
2020-06-12;"Prešovský kraj";1;0;0;0;NA;114381;1;2020-06-12;181
2020-06-11;"Prešovský kraj";0;0;0;0;NA;114381;0;2020-06-11;180
2020-06-10;"Prešovský kraj";0;0;0;0;NA;114381;0;2020-06-10;180
2020-06-09;"Prešovský kraj";0;0;0;0;NA;114381;0;2020-06-09;180
2020-06-08;"Prešovský kraj";0;0;0;0;NA;114381;0;2020-06-08;180
2020-06-07;"Prešovský kraj";0;0;0;0;NA;114381;0;2020-06-07;180
2020-06-05;"Prešovský kraj";0;0;0;0;NA;114381;0;2020-06-05;180
2020-06-03;"Prešovský kraj";0;0;0;0;NA;114381;0;2020-06-03;180
2020-06-02;"Prešovský kraj";1;0;0;0;NA;114381;1;2020-06-02;180
2020-05-31;"Prešovský kraj";1;0;0;0;NA;114381;1;2020-05-31;179
2020-05-29;"Prešovský kraj";0;0;0;0;NA;114381;0;2020-05-29;178
2020-05-27;"Prešovský kraj";0;0;0;0;NA;114381;0;2020-05-27;178
2020-05-26;"Prešovský kraj";0;0;0;0;NA;114381;0;2020-05-26;178
2020-05-25;"Prešovský kraj";0;0;0;0;NA;114381;0;2020-05-25;178
2020-05-24;"Prešovský kraj";0;0;0;0;NA;114381;0;2020-05-24;178
2020-05-23;"Prešovský kraj";0;0;0;0;NA;114381;0;2020-05-23;178
2020-05-22;"Prešovský kraj";0;0;0;0;NA;114381;0;2020-05-22;178
2020-05-21;"Prešovský kraj";1;0;0;0;NA;114381;1;2020-05-21;178
2020-05-20;"Prešovský kraj";0;0;0;0;NA;114381;0;2020-05-20;177
2020-05-19;"Prešovský kraj";0;0;0;0;NA;114381;0;2020-05-19;177
2020-05-17;"Prešovský kraj";0;0;0;0;NA;114381;0;2020-05-17;177
2020-05-16;"Prešovský kraj";0;0;0;0;NA;114381;0;2020-05-16;177
2020-05-15;"Prešovský kraj";0;0;0;0;NA;114381;0;2020-05-15;177
2020-05-14;"Prešovský kraj";0;0;0;0;NA;114381;0;2020-05-14;177
2020-05-13;"Prešovský kraj";1;0;0;0;NA;114381;1;2020-05-13;177
2020-05-12;"Prešovský kraj";0;0;0;0;NA;114381;0;2020-05-12;176
2020-05-11;"Prešovský kraj";1;0;0;0;NA;114381;1;2020-05-11;176
2020-05-09;"Prešovský kraj";0;0;0;0;NA;114381;0;2020-05-09;175
2020-05-07;"Prešovský kraj";0;0;0;0;NA;114381;0;2020-05-07;175
2020-05-06;"Prešovský kraj";0;0;0;0;NA;114381;0;2020-05-06;175
2020-05-05;"Prešovský kraj";1;0;0;0;NA;114381;1;2020-05-05;175
2020-05-04;"Prešovský kraj";0;0;0;0;NA;114381;0;2020-05-04;174
2020-05-03;"Prešovský kraj";0;0;0;0;NA;114381;0;2020-05-03;174
2020-05-02;"Prešovský kraj";0;0;0;0;NA;114381;0;2020-05-02;174
2020-05-01;"Prešovský kraj";2;0;0;0;NA;114381;2;2020-05-01;174
2020-04-30;"Prešovský kraj";0;0;0;0;NA;114381;0;2020-04-30;172
2020-04-29;"Prešovský kraj";1;0;0;0;NA;114381;1;2020-04-29;172
2020-04-28;"Prešovský kraj";1;0;0;0;NA;114381;1;2020-04-28;171
2020-04-27;"Prešovský kraj";2;0;0;0;NA;114381;2;2020-04-27;170
2020-04-26;"Prešovský kraj";0;0;0;0;NA;114381;0;2020-04-26;168
2020-04-25;"Prešovský kraj";0;0;0;0;NA;114381;0;2020-04-25;168
2020-04-24;"Prešovský kraj";0;0;0;0;NA;114381;0;2020-04-24;168
2020-04-23;"Prešovský kraj";2;0;0;0;NA;114381;2;2020-04-23;168
2020-04-22;"Prešovský kraj";11;0;0;0;NA;114381;11;2020-04-22;166
2020-04-21;"Prešovský kraj";12;0;0;0;NA;114381;12;2020-04-21;155
2020-04-20;"Prešovský kraj";2;0;0;0;NA;114381;2;2020-04-20;143
2020-04-19;"Prešovský kraj";4;0;0;0;NA;114381;4;2020-04-19;141
2020-04-18;"Prešovský kraj";1;0;0;0;NA;114381;1;2020-04-18;137
2020-04-17;"Prešovský kraj";4;0;0;0;NA;114381;4;2020-04-17;136
2020-04-16;"Prešovský kraj";9;0;0;0;NA;114381;9;2020-04-16;132
2020-04-15;"Prešovský kraj";21;0;0;0;NA;114381;21;2020-04-15;123
2020-04-14;"Prešovský kraj";1;0;0;0;NA;114381;1;2020-04-14;102
2020-04-13;"Prešovský kraj";2;0;0;0;NA;114381;2;2020-04-13;101
2020-04-12;"Prešovský kraj";6;0;0;0;NA;114381;6;2020-04-12;99
2020-04-11;"Prešovský kraj";4;0;0;0;NA;114381;4;2020-04-11;93
2020-04-10;"Prešovský kraj";0;0;0;0;NA;114381;0;2020-04-10;89
2020-04-09;"Prešovský kraj";1;0;0;0;NA;114381;1;2020-04-09;89
2020-04-08;"Prešovský kraj";0;0;0;0;NA;114381;0;2020-04-08;88
2020-04-07;"Prešovský kraj";7;0;0;0;NA;114381;7;2020-04-07;88
2020-04-06;"Prešovský kraj";10;0;0;0;NA;114381;10;2020-04-06;81
2020-04-05;"Prešovský kraj";13;0;0;0;NA;114381;13;2020-04-05;71
2020-04-04;"Prešovský kraj";1;0;0;0;NA;114381;1;2020-04-04;58
2020-04-03;"Prešovský kraj";4;0;0;0;NA;114381;4;2020-04-03;57
2020-04-02;"Prešovský kraj";6;0;0;0;NA;114381;6;2020-04-02;53
2020-04-01;"Prešovský kraj";6;0;0;0;NA;114381;6;2020-04-01;47
2020-03-31;"Prešovský kraj";6;0;0;0;NA;114381;6;2020-03-31;41
2020-03-30;"Prešovský kraj";2;0;0;0;NA;114381;2;2020-03-30;35
2020-03-29;"Prešovský kraj";2;0;0;0;NA;114381;2;2020-03-29;33
2020-03-28;"Prešovský kraj";2;0;0;0;NA;114381;2;2020-03-28;31
2020-03-27;"Prešovský kraj";1;0;0;0;NA;114381;1;2020-03-27;29
2020-03-26;"Prešovský kraj";8;0;0;0;NA;114381;8;2020-03-26;28
2020-03-25;"Prešovský kraj";1;0;0;0;NA;114381;1;2020-03-25;20
2020-03-24;"Prešovský kraj";4;0;0;0;NA;114381;4;2020-03-24;19
2020-03-23;"Prešovský kraj";0;0;0;0;NA;114381;0;2020-03-23;15
2020-03-22;"Prešovský kraj";1;0;0;0;NA;114381;1;2020-03-22;15
2020-03-21;"Prešovský kraj";2;0;0;0;NA;114381;2;2020-03-21;14
2020-03-20;"Prešovský kraj";3;0;0;0;NA;114381;3;2020-03-20;12
2020-03-19;"Prešovský kraj";2;0;0;0;NA;114381;2;2020-03-19;9
2020-03-18;"Prešovský kraj";1;0;0;0;NA;114381;1;2020-03-18;7
2020-03-17;"Prešovský kraj";1;0;0;0;NA;114381;1;2020-03-17;6
2020-03-16;"Prešovský kraj";4;0;0;0;NA;114381;4;2020-03-16;5
2020-03-15;"Prešovský kraj";0;0;0;0;NA;114381;0;2020-03-15;1
2020-03-14;"Prešovský kraj";1;0;0;0;NA;114381;1;2020-03-14;1
2020-03-13;"Prešovský kraj";0;0;0;0;NA;114381;0;2020-03-13;0
2020-03-12;"Prešovský kraj";0;0;0;0;NA;114381;0;2020-03-12;0
2020-03-11;"Prešovský kraj";0;0;0;0;NA;114381;0;2020-03-11;0
2020-03-09;"Prešovský kraj";0;0;0;0;NA;114381;0;2020-03-09;0
2020-03-08;"Prešovský kraj";0;0;0;0;NA;114381;0;2020-03-08;0
2020-03-07;"Prešovský kraj";0;0;0;0;NA;114381;0;2020-03-07;0
2020-03-06;"Prešovský kraj";0;0;0;0;NA;114381;0;2020-03-06;0
2021-08-29;"Trenčiansky kraj";1;376;10;386;53554;101089;11;2021-08-29;101089
2021-08-28;"Trenčiansky kraj";9;921;10;931;NA;101089;19;2021-08-28;101078
2021-08-27;"Trenčiansky kraj";21;1488;1;1489;NA;101089;22;2021-08-27;101059
2021-08-26;"Trenčiansky kraj";8;936;6;942;NA;101089;14;2021-08-26;101037
2021-08-25;"Trenčiansky kraj";40;845;6;851;NA;101089;46;2021-08-25;101023
2021-08-24;"Trenčiansky kraj";4;796;4;800;NA;101089;8;2021-08-24;100977
2021-08-23;"Trenčiansky kraj";6;1022;16;1038;NA;101089;22;2021-08-23;100969
2021-08-22;"Trenčiansky kraj";0;736;9;745;NA;101089;9;2021-08-22;100947
2021-08-21;"Trenčiansky kraj";5;910;7;917;NA;101089;12;2021-08-21;100938
2021-08-20;"Trenčiansky kraj";15;1478;2;1480;NA;101089;17;2021-08-20;100926
2021-08-19;"Trenčiansky kraj";2;936;2;938;NA;101089;4;2021-08-19;100909
2021-08-18;"Trenčiansky kraj";6;784;7;791;NA;101089;13;2021-08-18;100905
2021-08-17;"Trenčiansky kraj";9;615;1;616;NA;101089;10;2021-08-17;100892
2021-08-16;"Trenčiansky kraj";5;893;3;896;NA;101089;8;2021-08-16;100882
2021-08-15;"Trenčiansky kraj";0;506;1;507;NA;101089;1;2021-08-15;100874
2021-08-14;"Trenčiansky kraj";12;535;6;541;NA;101089;18;2021-08-14;100873
2021-08-13;"Trenčiansky kraj";2;869;0;869;NA;101089;2;2021-08-13;100855
2021-08-12;"Trenčiansky kraj";2;532;3;535;NA;101089;5;2021-08-12;100853
2021-08-11;"Trenčiansky kraj";1;668;0;668;NA;101089;1;2021-08-11;100848
2021-08-10;"Trenčiansky kraj";8;523;1;524;NA;101089;9;2021-08-10;100847
2021-08-09;"Trenčiansky kraj";8;681;1;682;NA;101089;9;2021-08-09;100838
2021-08-08;"Trenčiansky kraj";0;403;0;403;NA;101089;0;2021-08-08;100829
2021-08-07;"Trenčiansky kraj";3;448;0;448;NA;101089;3;2021-08-07;100829
2021-08-06;"Trenčiansky kraj";3;942;1;943;NA;101089;4;2021-08-06;100826
2021-08-05;"Trenčiansky kraj";3;570;1;571;NA;101089;4;2021-08-05;100822
2021-08-04;"Trenčiansky kraj";14;537;3;540;NA;101089;17;2021-08-04;100818
2021-08-03;"Trenčiansky kraj";9;508;5;513;NA;101089;14;2021-08-03;100801
2021-08-02;"Trenčiansky kraj";1;807;2;809;NA;101089;3;2021-08-02;100787
2021-08-01;"Trenčiansky kraj";0;458;1;459;NA;101089;1;2021-08-01;100784
2021-07-31;"Trenčiansky kraj";4;525;2;527;NA;101089;6;2021-07-31;100783
2021-07-30;"Trenčiansky kraj";2;1041;0;1041;NA;101089;2;2021-07-30;100777
2021-07-29;"Trenčiansky kraj";5;684;0;684;NA;101089;5;2021-07-29;100775
2021-07-28;"Trenčiansky kraj";3;517;2;519;NA;101089;5;2021-07-28;100770
2021-07-27;"Trenčiansky kraj";6;551;1;552;NA;101089;7;2021-07-27;100765
2021-07-26;"Trenčiansky kraj";7;772;1;773;NA;101089;8;2021-07-26;100758
2021-07-25;"Trenčiansky kraj";0;487;2;489;NA;101089;2;2021-07-25;100750
2021-07-24;"Trenčiansky kraj";3;643;1;644;NA;101089;4;2021-07-24;100748
2021-07-23;"Trenčiansky kraj";3;1151;0;1151;NA;101089;3;2021-07-23;100744
2021-07-22;"Trenčiansky kraj";2;844;2;846;NA;101089;4;2021-07-22;100741
2021-07-21;"Trenčiansky kraj";8;661;2;663;NA;101089;10;2021-07-21;100737
2021-07-20;"Trenčiansky kraj";4;525;1;526;NA;101089;5;2021-07-20;100727
2021-07-19;"Trenčiansky kraj";0;866;4;870;NA;101089;4;2021-07-19;100722
2021-07-18;"Trenčiansky kraj";0;526;0;526;NA;101089;0;2021-07-18;100718
2021-07-17;"Trenčiansky kraj";3;673;0;673;NA;101089;3;2021-07-17;100718
2021-07-16;"Trenčiansky kraj";4;1122;0;1122;NA;101089;4;2021-07-16;100715
2021-07-15;"Trenčiansky kraj";2;824;0;824;NA;101089;2;2021-07-15;100711
2021-07-14;"Trenčiansky kraj";8;645;0;645;NA;101089;8;2021-07-14;100709
2021-07-13;"Trenčiansky kraj";1;520;3;523;NA;101089;4;2021-07-13;100701
2021-07-12;"Trenčiansky kraj";9;820;2;822;NA;101089;11;2021-07-12;100697
2021-07-11;"Trenčiansky kraj";0;609;0;609;NA;101089;0;2021-07-11;100686
2021-07-10;"Trenčiansky kraj";2;535;0;535;NA;101089;2;2021-07-10;100686
2021-07-09;"Trenčiansky kraj";7;1379;0;1379;NA;101089;7;2021-07-09;100684
2021-07-08;"Trenčiansky kraj";2;815;1;816;NA;101089;3;2021-07-08;100677
2021-07-07;"Trenčiansky kraj";2;928;0;928;NA;101089;2;2021-07-07;100674
2021-07-06;"Trenčiansky kraj";4;1041;1;1042;NA;101089;5;2021-07-06;100672
2021-07-05;"Trenčiansky kraj";1;508;0;508;NA;101089;1;2021-07-05;100667
2021-07-04;"Trenčiansky kraj";0;612;1;613;NA;101089;1;2021-07-04;100666
2021-07-03;"Trenčiansky kraj";3;815;1;816;NA;101089;4;2021-07-03;100665
2021-07-02;"Trenčiansky kraj";5;1583;2;1585;NA;101089;7;2021-07-02;100661
2021-07-01;"Trenčiansky kraj";4;1152;1;1153;NA;101089;5;2021-07-01;100654
2021-06-30;"Trenčiansky kraj";2;6993;6;6999;NA;101089;8;2021-06-30;100649
2021-06-29;"Trenčiansky kraj";4;2773;5;2778;NA;101089;9;2021-06-29;100641
2021-06-28;"Trenčiansky kraj";5;3644;4;3648;NA;101089;9;2021-06-28;100632
2021-06-27;"Trenčiansky kraj";0;2861;1;2862;NA;101089;1;2021-06-27;100623
2021-06-26;"Trenčiansky kraj";1;3547;4;3551;NA;101089;5;2021-06-26;100622
2021-06-25;"Trenčiansky kraj";2;4497;1;4498;NA;101089;3;2021-06-25;100617
2021-06-24;"Trenčiansky kraj";3;3205;4;3209;NA;101089;7;2021-06-24;100614
2021-06-23;"Trenčiansky kraj";4;2725;2;2727;NA;101089;6;2021-06-23;100607
2021-06-22;"Trenčiansky kraj";7;3058;3;3061;NA;101089;10;2021-06-22;100601
2021-06-21;"Trenčiansky kraj";10;3891;4;3895;NA;101089;14;2021-06-21;100591
2021-06-20;"Trenčiansky kraj";0;3579;5;3584;NA;101089;5;2021-06-20;100577
2021-06-19;"Trenčiansky kraj";5;4413;1;4414;NA;101089;6;2021-06-19;100572
2021-06-18;"Trenčiansky kraj";7;6725;7;6732;NA;101089;14;2021-06-18;100566
2021-06-17;"Trenčiansky kraj";0;3469;6;3475;NA;101089;6;2021-06-17;100552
2021-06-16;"Trenčiansky kraj";4;3183;3;3186;NA;101089;7;2021-06-16;100546
2021-06-15;"Trenčiansky kraj";10;3697;2;3699;NA;101089;12;2021-06-15;100539
2021-06-14;"Trenčiansky kraj";10;4805;15;4820;NA;101089;25;2021-06-14;100527
2021-06-13;"Trenčiansky kraj";0;4643;4;4647;NA;101089;4;2021-06-13;100502
2021-06-12;"Trenčiansky kraj";4;5456;8;5464;NA;101089;12;2021-06-12;100498
2021-06-11;"Trenčiansky kraj";10;7169;11;7180;NA;101089;21;2021-06-11;100486
2021-06-10;"Trenčiansky kraj";5;4345;7;4352;NA;101089;12;2021-06-10;100465
2021-06-09;"Trenčiansky kraj";7;3693;7;3700;NA;101089;14;2021-06-09;100453
2021-06-08;"Trenčiansky kraj";21;3965;7;3972;NA;101089;28;2021-06-08;100439
2021-06-07;"Trenčiansky kraj";13;5560;10;5570;NA;101089;23;2021-06-07;100411
2021-06-06;"Trenčiansky kraj";0;5500;10;5510;NA;101089;10;2021-06-06;100388
2021-06-05;"Trenčiansky kraj";7;6511;5;6516;NA;101089;12;2021-06-05;100378
2021-06-04;"Trenčiansky kraj";16;7653;3;7656;NA;101089;19;2021-06-04;100366
2021-06-03;"Trenčiansky kraj";9;4485;10;4495;NA;101089;19;2021-06-03;100347
2021-06-02;"Trenčiansky kraj";28;4329;8;4337;NA;101089;36;2021-06-02;100328
2021-06-01;"Trenčiansky kraj";22;5396;18;5414;NA;101089;40;2021-06-01;100292
2021-05-31;"Trenčiansky kraj";30;6117;24;6141;NA;101089;54;2021-05-31;100252
2021-05-30;"Trenčiansky kraj";0;8258;16;8274;NA;101089;16;2021-05-30;100198
2021-05-29;"Trenčiansky kraj";13;7915;14;7929;NA;101089;27;2021-05-29;100182
2021-05-28;"Trenčiansky kraj";22;8995;25;9020;NA;101089;47;2021-05-28;100155
2021-05-27;"Trenčiansky kraj";6;5205;12;5217;NA;101089;18;2021-05-27;100108
2021-05-26;"Trenčiansky kraj";26;5069;15;5084;NA;101089;41;2021-05-26;100090
2021-05-25;"Trenčiansky kraj";18;6168;24;6192;NA;101089;42;2021-05-25;100049
2021-05-24;"Trenčiansky kraj";19;9292;37;9329;NA;101089;56;2021-05-24;100007
2021-05-23;"Trenčiansky kraj";0;9083;26;9109;NA;101089;26;2021-05-23;99951
2021-05-22;"Trenčiansky kraj";11;11314;21;11335;NA;101089;32;2021-05-22;99925
2021-05-21;"Trenčiansky kraj";23;11572;26;11598;NA;101089;49;2021-05-21;99893
2021-05-20;"Trenčiansky kraj";23;6320;25;6345;NA;101089;48;2021-05-20;99844
2021-05-19;"Trenčiansky kraj";16;5694;32;5726;NA;101089;48;2021-05-19;99796
2021-05-18;"Trenčiansky kraj";26;7779;28;7807;NA;101089;54;2021-05-18;99748
2021-05-17;"Trenčiansky kraj";37;7671;43;7714;NA;101089;80;2021-05-17;99694
2021-05-16;"Trenčiansky kraj";25;15615;41;15656;NA;101089;66;2021-05-16;99614
2021-05-15;"Trenčiansky kraj";3;21237;32;21269;NA;101089;35;2021-05-15;99548
2021-05-14;"Trenčiansky kraj";41;18676;42;18718;NA;101089;83;2021-05-14;99513
2021-05-13;"Trenčiansky kraj";41;8195;24;8219;NA;101089;65;2021-05-13;99430
2021-05-12;"Trenčiansky kraj";41;7409;31;7440;NA;101089;72;2021-05-12;99365
2021-05-11;"Trenčiansky kraj";66;10507;32;10539;NA;101089;98;2021-05-11;99293
2021-05-10;"Trenčiansky kraj";48;12989;55;13044;NA;101089;103;2021-05-10;99195
2021-05-09;"Trenčiansky kraj";52;17737;39;17776;NA;101089;91;2021-05-09;99092
2021-05-08;"Trenčiansky kraj";3;23822;33;23855;NA;101089;36;2021-05-08;99001
2021-05-07;"Trenčiansky kraj";45;23549;56;23605;NA;101089;101;2021-05-07;98965
2021-05-06;"Trenčiansky kraj";26;10771;44;10815;NA;101089;70;2021-05-06;98864
2021-05-05;"Trenčiansky kraj";73;9377;41;9418;NA;101089;114;2021-05-05;98794
2021-05-04;"Trenčiansky kraj";55;12733;53;12786;NA;101089;108;2021-05-04;98680
2021-05-03;"Trenčiansky kraj";60;15331;51;15382;NA;101089;111;2021-05-03;98572
2021-05-02;"Trenčiansky kraj";0;31163;65;31228;NA;101089;65;2021-05-02;98461
2021-05-01;"Trenčiansky kraj";71;56982;60;57042;NA;101089;131;2021-05-01;98396
2021-04-30;"Trenčiansky kraj";77;29427;61;29488;NA;101089;138;2021-04-30;98265
2021-04-29;"Trenčiansky kraj";49;13198;59;13257;NA;101089;108;2021-04-29;98127
2021-04-28;"Trenčiansky kraj";79;12537;52;12589;NA;101089;131;2021-04-28;98019
2021-04-27;"Trenčiansky kraj";107;15527;40;15567;NA;101089;147;2021-04-27;97888
2021-04-26;"Trenčiansky kraj";52;21070;63;21133;NA;101089;115;2021-04-26;97741
2021-04-25;"Trenčiansky kraj";0;34560;48;34608;NA;101089;48;2021-04-25;97626
2021-04-24;"Trenčiansky kraj";76;72398;100;72498;NA;101089;176;2021-04-24;97578
2021-04-23;"Trenčiansky kraj";143;29959;79;30038;NA;101089;222;2021-04-23;97402
2021-04-22;"Trenčiansky kraj";71;13847;64;13911;NA;101089;135;2021-04-22;97180
2021-04-21;"Trenčiansky kraj";79;13000;67;13067;NA;101089;146;2021-04-21;97045
2021-04-20;"Trenčiansky kraj";142;17740;80;17820;NA;101089;222;2021-04-20;96899
2021-04-19;"Trenčiansky kraj";102;22631;103;22734;NA;101089;205;2021-04-19;96677
2021-04-18;"Trenčiansky kraj";3;40879;97;40976;NA;101089;100;2021-04-18;96472
2021-04-17;"Trenčiansky kraj";77;81498;136;81634;NA;101089;213;2021-04-17;96372
2021-04-16;"Trenčiansky kraj";100;31961;90;32051;NA;101089;190;2021-04-16;96159
2021-04-15;"Trenčiansky kraj";71;14479;69;14548;NA;101089;140;2021-04-15;95969
2021-04-14;"Trenčiansky kraj";135;15574;72;15646;NA;101089;207;2021-04-14;95829
2021-04-13;"Trenčiansky kraj";189;18721;75;18796;NA;101089;264;2021-04-13;95622
2021-04-12;"Trenčiansky kraj";97;23743;91;23834;NA;101089;188;2021-04-12;95358
2021-04-11;"Trenčiansky kraj";1;34735;75;34810;NA;101089;76;2021-04-11;95170
2021-04-10;"Trenčiansky kraj";81;83093;145;83238;NA;101089;226;2021-04-10;95094
2021-04-09;"Trenčiansky kraj";120;28014;91;28105;NA;101089;211;2021-04-09;94868
2021-04-08;"Trenčiansky kraj";112;13283;85;13368;NA;101089;197;2021-04-08;94657
2021-04-07;"Trenčiansky kraj";204;17688;123;17811;NA;101089;327;2021-04-07;94460
2021-04-06;"Trenčiansky kraj";157;28567;178;28745;NA;101089;335;2021-04-06;94133
2021-04-05;"Trenčiansky kraj";15;9227;64;9291;NA;101089;79;2021-04-05;93798
2021-04-04;"Trenčiansky kraj";2;20291;85;20376;NA;101089;87;2021-04-04;93719
2021-04-03;"Trenčiansky kraj";86;80473;221;80694;NA;101089;307;2021-04-03;93632
2021-04-02;"Trenčiansky kraj";126;21620;81;21701;NA;101089;207;2021-04-02;93325
2021-04-01;"Trenčiansky kraj";159;32376;139;32515;NA;101089;298;2021-04-01;93118
2021-03-31;"Trenčiansky kraj";198;20100;130;20230;NA;101089;328;2021-03-31;92820
2021-03-30;"Trenčiansky kraj";272;17305;136;17441;NA;101089;408;2021-03-30;92492
2021-03-29;"Trenčiansky kraj";142;19479;170;19649;NA;101089;312;2021-03-29;92084
2021-03-28;"Trenčiansky kraj";3;34759;116;34875;NA;101089;119;2021-03-28;91772
2021-03-27;"Trenčiansky kraj";130;77314;293;77607;NA;101089;423;2021-03-27;91653
2021-03-26;"Trenčiansky kraj";211;35095;157;35252;NA;101089;368;2021-03-26;91230
2021-03-25;"Trenčiansky kraj";184;16580;176;16756;NA;101089;360;2021-03-25;90862
2021-03-24;"Trenčiansky kraj";259;13102;171;13273;NA;101089;430;2021-03-24;90502
2021-03-23;"Trenčiansky kraj";349;17589;174;17763;NA;101089;523;2021-03-23;90072
2021-03-22;"Trenčiansky kraj";141;21116;213;21329;NA;101089;354;2021-03-22;89549
2021-03-21;"Trenčiansky kraj";85;32711;164;32875;NA;101089;249;2021-03-21;89195
2021-03-20;"Trenčiansky kraj";128;80035;322;80357;NA;101089;450;2021-03-20;88946
2021-03-19;"Trenčiansky kraj";231;34783;232;35015;NA;101089;463;2021-03-19;88496
2021-03-18;"Trenčiansky kraj";262;16105;178;16283;NA;101089;440;2021-03-18;88033
2021-03-17;"Trenčiansky kraj";366;13435;164;13599;NA;101089;530;2021-03-17;87593
2021-03-16;"Trenčiansky kraj";450;15282;241;15523;NA;101089;691;2021-03-16;87063
2021-03-15;"Trenčiansky kraj";162;21235;261;21496;NA;101089;423;2021-03-15;86372
2021-03-14;"Trenčiansky kraj";42;34416;238;34654;NA;101089;280;2021-03-14;85949
2021-03-13;"Trenčiansky kraj";270;79186;453;79639;NA;101089;723;2021-03-13;85669
2021-03-12;"Trenčiansky kraj";366;34795;307;35102;NA;101089;673;2021-03-12;84946
2021-03-11;"Trenčiansky kraj";302;15558;213;15771;NA;101089;515;2021-03-11;84273
2021-03-10;"Trenčiansky kraj";402;13585;237;13822;NA;101089;639;2021-03-10;83758
2021-03-09;"Trenčiansky kraj";586;17982;285;18267;NA;101089;871;2021-03-09;83119
2021-03-08;"Trenčiansky kraj";174;21704;363;22067;NA;101089;537;2021-03-08;82248
2021-03-07;"Trenčiansky kraj";4;33660;313;33973;NA;101089;317;2021-03-07;81711
2021-03-06;"Trenčiansky kraj";260;79661;529;80190;NA;101089;789;2021-03-06;81394
2021-03-05;"Trenčiansky kraj";326;32960;416;33376;NA;101089;742;2021-03-05;80605
2021-03-04;"Trenčiansky kraj";323;16821;317;17138;NA;101089;640;2021-03-04;79863
2021-03-03;"Trenčiansky kraj";413;13960;347;14307;NA;101089;760;2021-03-03;79223
2021-03-02;"Trenčiansky kraj";612;17794;344;18138;NA;101089;956;2021-03-02;78463
2021-03-01;"Trenčiansky kraj";217;21104;445;21549;NA;101089;662;2021-03-01;77507
2021-02-28;"Trenčiansky kraj";45;30238;376;30614;NA;101089;421;2021-02-28;76845
2021-02-27;"Trenčiansky kraj";277;78735;686;79421;NA;101089;963;2021-02-27;76424
2021-02-26;"Trenčiansky kraj";420;32944;435;33379;NA;101089;855;2021-02-26;75461
2021-02-25;"Trenčiansky kraj";424;14029;328;14357;NA;101089;752;2021-02-25;74606
2021-02-24;"Trenčiansky kraj";427;11997;398;12395;NA;101089;825;2021-02-24;73854
2021-02-23;"Trenčiansky kraj";577;14904;390;15294;NA;101089;967;2021-02-23;73029
2021-02-22;"Trenčiansky kraj";160;19969;468;20437;NA;101089;628;2021-02-22;72062
2021-02-21;"Trenčiansky kraj";64;29478;392;29870;NA;101089;456;2021-02-21;71434
2021-02-20;"Trenčiansky kraj";274;77840;745;78585;NA;101089;1019;2021-02-20;70978
2021-02-19;"Trenčiansky kraj";272;30266;523;30789;NA;101089;795;2021-02-19;69959
2021-02-18;"Trenčiansky kraj";355;14094;403;14497;NA;101089;758;2021-02-18;69164
2021-02-17;"Trenčiansky kraj";363;11413;377;11790;NA;101089;740;2021-02-17;68406
2021-02-16;"Trenčiansky kraj";488;17761;406;18167;NA;101089;894;2021-02-16;67666
2021-02-15;"Trenčiansky kraj";151;21846;463;22309;NA;101089;614;2021-02-15;66772
2021-02-14;"Trenčiansky kraj";2;31255;324;31579;NA;101089;326;2021-02-14;66158
2021-02-13;"Trenčiansky kraj";274;63006;522;63528;NA;101089;796;2021-02-13;65832
2021-02-12;"Trenčiansky kraj";276;27979;412;28391;NA;101089;688;2021-02-12;65036
2021-02-11;"Trenčiansky kraj";291;11567;323;11890;NA;101089;614;2021-02-11;64348
2021-02-10;"Trenčiansky kraj";304;11408;317;11725;NA;101089;621;2021-02-10;63734
2021-02-09;"Trenčiansky kraj";514;18412;360;18772;NA;101089;874;2021-02-09;63113
2021-02-08;"Trenčiansky kraj";182;26832;430;27262;NA;101089;612;2021-02-08;62239
2021-02-07;"Trenčiansky kraj";31;36781;341;37122;NA;101089;372;2021-02-07;61627
2021-02-06;"Trenčiansky kraj";216;63931;560;64491;NA;101089;776;2021-02-06;61255
2021-02-05;"Trenčiansky kraj";202;18164;367;18531;NA;101089;569;2021-02-05;60479
2021-02-04;"Trenčiansky kraj";266;7253;311;7564;NA;101089;577;2021-02-04;59910
2021-02-03;"Trenčiansky kraj";162;6723;320;7043;NA;101089;482;2021-02-03;59333
2021-02-02;"Trenčiansky kraj";347;8074;381;8455;NA;101089;728;2021-02-02;58851
2021-02-01;"Trenčiansky kraj";167;8921;311;9232;NA;101089;478;2021-02-01;58123
2021-01-31;"Trenčiansky kraj";7;19103;159;19262;NA;101089;166;2021-01-31;57645
2021-01-30;"Trenčiansky kraj";228;38167;332;38499;NA;101089;560;2021-01-30;57479
2021-01-29;"Trenčiansky kraj";214;7590;235;7825;NA;101089;449;2021-01-29;56919
2021-01-28;"Trenčiansky kraj";307;5442;158;5600;NA;101089;465;2021-01-28;56470
2021-01-27;"Trenčiansky kraj";166;4842;181;5023;NA;101089;347;2021-01-27;56005
2021-01-26;"Trenčiansky kraj";303;14589;250;14839;NA;101089;553;2021-01-26;55658
2021-01-25;"Trenčiansky kraj";160;24310;207;24517;NA;101089;367;2021-01-25;55105
2021-01-24;"Trenčiansky kraj";51;38369;282;38651;NA;101089;333;2021-01-24;54738
2021-01-23;"Trenčiansky kraj";206;114125;749;114874;NA;101089;955;2021-01-23;54405
2021-01-22;"Trenčiansky kraj";148;21831;241;22072;NA;101089;389;2021-01-22;53450
2021-01-21;"Trenčiansky kraj";143;8586;166;8752;NA;101089;309;2021-01-21;53061
2021-01-20;"Trenčiansky kraj";181;8189;227;8416;NA;101089;408;2021-01-20;52752
2021-01-19;"Trenčiansky kraj";363;6600;262;6862;NA;101089;625;2021-01-19;52344
2021-01-18;"Trenčiansky kraj";72;4970;321;5291;NA;101089;393;2021-01-18;51719
2021-01-17;"Trenčiansky kraj";124;156;11;167;NA;101089;135;2021-01-17;51326
2021-01-16;"Trenčiansky kraj";39;1288;53;1341;NA;101089;92;2021-01-16;51191
2021-01-15;"Trenčiansky kraj";264;4031;214;4245;NA;101089;478;2021-01-15;51099
2021-01-14;"Trenčiansky kraj";275;3193;189;3382;NA;101089;464;2021-01-14;50621
2021-01-13;"Trenčiansky kraj";222;3893;215;4108;NA;101089;437;2021-01-13;50157
2021-01-12;"Trenčiansky kraj";508;4604;261;4865;NA;101089;769;2021-01-12;49720
2021-01-11;"Trenčiansky kraj";142;4367;354;4721;NA;101089;496;2021-01-11;48951
2021-01-10;"Trenčiansky kraj";89;4969;77;5046;NA;101089;166;2021-01-10;48455
2021-01-09;"Trenčiansky kraj";276;8280;128;8408;NA;101089;404;2021-01-09;48289
2021-01-08;"Trenčiansky kraj";489;6435;484;6919;NA;101089;973;2021-01-08;47885
2021-01-07;"Trenčiansky kraj";420;6138;577;6715;NA;101089;997;2021-01-07;46912
2021-01-06;"Trenčiansky kraj";221;1021;64;1085;NA;101089;285;2021-01-06;45915
2021-01-05;"Trenčiansky kraj";669;5753;706;6459;NA;101089;1375;2021-01-05;45630
2021-01-04;"Trenčiansky kraj";337;5248;782;6030;NA;101089;1119;2021-01-04;44255
2021-01-03;"Trenčiansky kraj";38;114;15;129;NA;101089;53;2021-01-03;43136
2021-01-02;"Trenčiansky kraj";129;196;23;219;NA;101089;152;2021-01-02;43083
2021-01-01;"Trenčiansky kraj";329;347;23;370;NA;101089;352;2021-01-01;42931
2020-12-31;"Trenčiansky kraj";597;4943;557;5500;NA;101089;1154;2020-12-31;42579
2020-12-30;"Trenčiansky kraj";836;7012;762;7774;NA;101089;1598;2020-12-30;41425
2020-12-29;"Trenčiansky kraj";459;6121;1009;7130;NA;101089;1468;2020-12-29;39827
2020-12-28;"Trenčiansky kraj";258;4195;777;4972;NA;101089;1035;2020-12-28;38359
2020-12-27;"Trenčiansky kraj";5;208;36;244;NA;101089;41;2020-12-27;37324
2020-12-26;"Trenčiansky kraj";174;74;10;84;NA;101089;184;2020-12-26;37283
2020-12-25;"Trenčiansky kraj";251;325;47;372;NA;101089;298;2020-12-25;37099
2020-12-24;"Trenčiansky kraj";552;2194;256;2450;NA;101089;808;2020-12-24;36801
2020-12-23;"Trenčiansky kraj";421;6552;661;7213;NA;101089;1082;2020-12-23;35993
2020-12-22;"Trenčiansky kraj";673;5760;694;6454;NA;101089;1367;2020-12-22;34911
2020-12-21;"Trenčiansky kraj";248;13395;979;14374;NA;101089;1227;2020-12-21;33544
2020-12-20;"Trenčiansky kraj";238;12504;292;12796;NA;101089;530;2020-12-20;32317
2020-12-19;"Trenčiansky kraj";341;1611;150;1761;NA;101089;491;2020-12-19;31787
2020-12-18;"Trenčiansky kraj";521;5199;615;5814;NA;101089;1136;2020-12-18;31296
2020-12-17;"Trenčiansky kraj";670;3843;524;4367;NA;101089;1194;2020-12-17;30160
2020-12-16;"Trenčiansky kraj";461;4474;648;5122;NA;101089;1109;2020-12-16;28966
2020-12-15;"Trenčiansky kraj";595;3805;670;4475;NA;101089;1265;2020-12-15;27857
2020-12-14;"Trenčiansky kraj";318;3194;613;3807;NA;101089;931;2020-12-14;26592
2020-12-13;"Trenčiansky kraj";77;49;6;55;NA;101089;83;2020-12-13;25661
2020-12-12;"Trenčiansky kraj";314;1191;136;1327;NA;101089;450;2020-12-12;25578
2020-12-11;"Trenčiansky kraj";751;4049;478;4527;NA;101089;1229;2020-12-11;25128
2020-12-10;"Trenčiansky kraj";271;3354;473;3827;NA;101089;744;2020-12-10;23899
2020-12-09;"Trenčiansky kraj";508;3788;466;4254;NA;101089;974;2020-12-09;23155
2020-12-08;"Trenčiansky kraj";546;3440;522;3962;NA;101089;1068;2020-12-08;22181
2020-12-07;"Trenčiansky kraj";258;3832;468;4300;NA;101089;726;2020-12-07;21113
2020-12-06;"Trenčiansky kraj";114;179;10;189;NA;101089;124;2020-12-06;20387
2020-12-05;"Trenčiansky kraj";223;610;56;666;NA;101089;279;2020-12-05;20263
2020-12-04;"Trenčiansky kraj";253;2943;273;3216;NA;101089;526;2020-12-04;19984
2020-12-03;"Trenčiansky kraj";503;1714;178;1892;NA;101089;681;2020-12-03;19458
2020-12-02;"Trenčiansky kraj";418;1844;232;2076;NA;101089;650;2020-12-02;18777
2020-12-01;"Trenčiansky kraj";321;5642;351;5993;NA;101089;672;2020-12-01;18127
2020-11-30;"Trenčiansky kraj";167;11514;520;12034;NA;101089;687;2020-11-30;17455
2020-11-29;"Trenčiansky kraj";29;30;5;35;NA;101089;34;2020-11-29;16768
2020-11-28;"Trenčiansky kraj";202;1051;93;1144;NA;101089;295;2020-11-28;16734
2020-11-27;"Trenčiansky kraj";330;1888;186;2074;NA;101089;516;2020-11-27;16439
2020-11-26;"Trenčiansky kraj";395;1252;122;1374;NA;101089;517;2020-11-26;15923
2020-11-25;"Trenčiansky kraj";322;1444;160;1604;NA;101089;482;2020-11-25;15406
2020-11-24;"Trenčiansky kraj";348;2553;308;2861;NA;101089;656;2020-11-24;14924
2020-11-23;"Trenčiansky kraj";159;1186;122;1308;NA;101089;281;2020-11-23;14268
2020-11-22;"Trenčiansky kraj";26;30;7;37;NA;101089;33;2020-11-22;13987
2020-11-21;"Trenčiansky kraj";255;1376;69;1445;NA;101089;324;2020-11-21;13954
2020-11-20;"Trenčiansky kraj";316;861;93;954;NA;101089;409;2020-11-20;13630
2020-11-19;"Trenčiansky kraj";316;740;113;853;NA;101089;429;2020-11-19;13221
2020-11-18;"Trenčiansky kraj";233;379;66;445;NA;101089;299;2020-11-18;12792
2020-11-17;"Trenčiansky kraj";222;106;15;121;NA;101089;237;2020-11-17;12493
2020-11-16;"Trenčiansky kraj";245;236;45;281;NA;101089;290;2020-11-16;12256
2020-11-15;"Trenčiansky kraj";109;29;6;35;NA;101089;115;2020-11-15;11966
2020-11-14;"Trenčiansky kraj";190;74;11;85;NA;101089;201;2020-11-14;11851
2020-11-13;"Trenčiansky kraj";308;131;13;144;NA;101089;321;2020-11-13;11650
2020-11-12;"Trenčiansky kraj";324;124;5;129;NA;101089;329;2020-11-12;11329
2020-11-11;"Trenčiansky kraj";366;113;10;123;NA;101089;376;2020-11-11;11000
2020-11-10;"Trenčiansky kraj";277;106;6;112;NA;101089;283;2020-11-10;10624
2020-11-09;"Trenčiansky kraj";115;1407;48;1455;NA;101089;163;2020-11-09;10341
2020-11-08;"Trenčiansky kraj";81;1271;8;1279;NA;101089;89;2020-11-08;10178
2020-11-07;"Trenčiansky kraj";319;3662;59;3721;NA;101089;378;2020-11-07;10089
2020-11-06;"Trenčiansky kraj";383;6893;84;6977;NA;101089;467;2020-11-06;9711
2020-11-05;"Trenčiansky kraj";399;98;15;113;NA;101089;414;2020-11-05;9244
2020-11-04;"Trenčiansky kraj";370;91;9;100;NA;101089;379;2020-11-04;8830
2020-11-03;"Trenčiansky kraj";575;97;8;105;NA;101089;583;2020-11-03;8451
2020-11-02;"Trenčiansky kraj";197;1833;68;1901;NA;101089;265;2020-11-02;7868
2020-11-01;"Trenčiansky kraj";257;808;24;832;NA;101089;281;2020-11-01;7603
2020-10-31;"Trenčiansky kraj";332;4719;82;4801;NA;101089;414;2020-10-31;7322
2020-10-30;"Trenčiansky kraj";299;5283;102;5385;NA;101089;401;2020-10-30;6908
2020-10-29;"Trenčiansky kraj";496;764;68;832;NA;101089;564;2020-10-29;6507
2020-10-28;"Trenčiansky kraj";269;192;33;225;NA;101089;302;2020-10-28;5943
2020-10-27;"Trenčiansky kraj";473;127;27;154;NA;101089;500;2020-10-27;5641
2020-10-26;"Trenčiansky kraj";177;107;36;143;NA;101089;213;2020-10-26;5141
2020-10-25;"Trenčiansky kraj";138;9;5;14;NA;101089;143;2020-10-25;4928
2020-10-24;"Trenčiansky kraj";395;128;6;134;NA;101089;401;2020-10-24;4785
2020-10-23;"Trenčiansky kraj";301;154;8;162;NA;101089;309;2020-10-23;4384
2020-10-22;"Trenčiansky kraj";273;82;12;94;NA;101089;285;2020-10-22;4075
2020-10-21;"Trenčiansky kraj";183;53;9;62;NA;101089;192;2020-10-21;3790
2020-10-20;"Trenčiansky kraj";212;47;6;53;NA;101089;218;2020-10-20;3598
2020-10-19;"Trenčiansky kraj";41;83;25;108;NA;101089;66;2020-10-19;3380
2020-10-18;"Trenčiansky kraj";104;0;0;0;NA;101089;104;2020-10-18;3314
2020-10-17;"Trenčiansky kraj";157;0;0;0;NA;101089;157;2020-10-17;3210
2020-10-16;"Trenčiansky kraj";225;42;6;48;NA;101089;231;2020-10-16;3053
2020-10-15;"Trenčiansky kraj";255;39;4;43;NA;101089;259;2020-10-15;2822
2020-10-14;"Trenčiansky kraj";162;42;7;49;NA;101089;169;2020-10-14;2563
2020-10-13;"Trenčiansky kraj";124;105;12;117;NA;101089;136;2020-10-13;2394
2020-10-12;"Trenčiansky kraj";55;0;0;0;NA;101089;55;2020-10-12;2258
2020-10-11;"Trenčiansky kraj";73;0;0;0;NA;101089;73;2020-10-11;2203
2020-10-10;"Trenčiansky kraj";180;0;0;0;NA;101089;180;2020-10-10;2130
2020-10-09;"Trenčiansky kraj";198;0;0;0;NA;101089;198;2020-10-09;1950
2020-10-08;"Trenčiansky kraj";115;0;0;0;NA;101089;115;2020-10-08;1752
2020-10-07;"Trenčiansky kraj";75;0;0;0;NA;101089;75;2020-10-07;1637
2020-10-06;"Trenčiansky kraj";72;0;0;0;NA;101089;72;2020-10-06;1562
2020-10-05;"Trenčiansky kraj";32;0;0;0;NA;101089;32;2020-10-05;1490
2020-10-04;"Trenčiansky kraj";37;0;0;0;NA;101089;37;2020-10-04;1458
2020-10-03;"Trenčiansky kraj";79;0;0;0;NA;101089;79;2020-10-03;1421
2020-10-02;"Trenčiansky kraj";69;0;0;0;NA;101089;69;2020-10-02;1342
2020-10-01;"Trenčiansky kraj";58;0;0;0;NA;101089;58;2020-10-01;1273
2020-09-30;"Trenčiansky kraj";76;0;0;0;NA;101089;76;2020-09-30;1215
2020-09-29;"Trenčiansky kraj";43;0;0;0;NA;101089;43;2020-09-29;1139
2020-09-28;"Trenčiansky kraj";7;0;0;0;NA;101089;7;2020-09-28;1096
2020-09-27;"Trenčiansky kraj";12;0;0;0;NA;101089;12;2020-09-27;1089
2020-09-26;"Trenčiansky kraj";37;0;0;0;NA;101089;37;2020-09-26;1077
2020-09-25;"Trenčiansky kraj";72;0;0;0;NA;101089;72;2020-09-25;1040
2020-09-24;"Trenčiansky kraj";41;0;0;0;NA;101089;41;2020-09-24;968
2020-09-23;"Trenčiansky kraj";32;0;0;0;NA;101089;32;2020-09-23;927
2020-09-22;"Trenčiansky kraj";26;0;0;0;NA;101089;26;2020-09-22;895
2020-09-21;"Trenčiansky kraj";23;0;0;0;NA;101089;23;2020-09-21;869
2020-09-20;"Trenčiansky kraj";21;0;0;0;NA;101089;21;2020-09-20;846
2020-09-19;"Trenčiansky kraj";20;0;0;0;NA;101089;20;2020-09-19;825
2020-09-18;"Trenčiansky kraj";41;0;0;0;NA;101089;41;2020-09-18;805
2020-09-17;"Trenčiansky kraj";20;0;0;0;NA;101089;20;2020-09-17;764
2020-09-16;"Trenčiansky kraj";14;0;0;0;NA;101089;14;2020-09-16;744
2020-09-15;"Trenčiansky kraj";8;0;0;0;NA;101089;8;2020-09-15;730
2020-09-14;"Trenčiansky kraj";5;0;0;0;NA;101089;5;2020-09-14;722
2020-09-13;"Trenčiansky kraj";12;0;0;0;NA;101089;12;2020-09-13;717
2020-09-12;"Trenčiansky kraj";2;0;0;0;NA;101089;2;2020-09-12;705
2020-09-11;"Trenčiansky kraj";27;0;0;0;NA;101089;27;2020-09-11;703
2020-09-10;"Trenčiansky kraj";15;0;0;0;NA;101089;15;2020-09-10;676
2020-09-09;"Trenčiansky kraj";11;0;0;0;NA;101089;11;2020-09-09;661
2020-09-08;"Trenčiansky kraj";12;0;0;0;NA;101089;12;2020-09-08;650
2020-09-07;"Trenčiansky kraj";6;0;0;0;NA;101089;6;2020-09-07;638
2020-09-06;"Trenčiansky kraj";1;0;0;0;NA;101089;1;2020-09-06;632
2020-09-05;"Trenčiansky kraj";3;0;0;0;NA;101089;3;2020-09-05;631
2020-09-04;"Trenčiansky kraj";9;0;0;0;NA;101089;9;2020-09-04;628
2020-09-03;"Trenčiansky kraj";10;0;0;0;NA;101089;10;2020-09-03;619
2020-09-02;"Trenčiansky kraj";5;0;0;0;NA;101089;5;2020-09-02;609
2020-09-01;"Trenčiansky kraj";1;0;0;0;NA;101089;1;2020-09-01;604
2020-08-31;"Trenčiansky kraj";12;0;0;0;NA;101089;12;2020-08-31;603
2020-08-30;"Trenčiansky kraj";0;0;0;0;NA;101089;0;2020-08-30;591
2020-08-29;"Trenčiansky kraj";1;0;0;0;NA;101089;1;2020-08-29;591
2020-08-28;"Trenčiansky kraj";12;0;0;0;NA;101089;12;2020-08-28;590
2020-08-27;"Trenčiansky kraj";10;0;0;0;NA;101089;10;2020-08-27;578
2020-08-26;"Trenčiansky kraj";15;0;0;0;NA;101089;15;2020-08-26;568
2020-08-25;"Trenčiansky kraj";12;0;0;0;NA;101089;12;2020-08-25;553
2020-08-24;"Trenčiansky kraj";4;0;0;0;NA;101089;4;2020-08-24;541
2020-08-23;"Trenčiansky kraj";5;0;0;0;NA;101089;5;2020-08-23;537
2020-08-22;"Trenčiansky kraj";6;0;0;0;NA;101089;6;2020-08-22;532
2020-08-21;"Trenčiansky kraj";6;0;0;0;NA;101089;6;2020-08-21;526
2020-08-20;"Trenčiansky kraj";20;0;0;0;NA;101089;20;2020-08-20;520
2020-08-19;"Trenčiansky kraj";17;0;0;0;NA;101089;17;2020-08-19;500
2020-08-18;"Trenčiansky kraj";9;0;0;0;NA;101089;9;2020-08-18;483
2020-08-17;"Trenčiansky kraj";4;0;0;0;NA;101089;4;2020-08-17;474
2020-08-16;"Trenčiansky kraj";0;0;0;0;NA;101089;0;2020-08-16;470
2020-08-15;"Trenčiansky kraj";9;0;0;0;NA;101089;9;2020-08-15;470
2020-08-14;"Trenčiansky kraj";15;0;0;0;NA;101089;15;2020-08-14;461
2020-08-13;"Trenčiansky kraj";23;0;0;0;NA;101089;23;2020-08-13;446
2020-08-12;"Trenčiansky kraj";6;0;0;0;NA;101089;6;2020-08-12;423
2020-08-11;"Trenčiansky kraj";7;0;0;0;NA;101089;7;2020-08-11;417
2020-08-10;"Trenčiansky kraj";9;0;0;0;NA;101089;9;2020-08-10;410
2020-08-09;"Trenčiansky kraj";1;0;0;0;NA;101089;1;2020-08-09;401
2020-08-08;"Trenčiansky kraj";4;0;0;0;NA;101089;4;2020-08-08;400
2020-08-07;"Trenčiansky kraj";4;0;0;0;NA;101089;4;2020-08-07;396
2020-08-06;"Trenčiansky kraj";13;0;0;0;NA;101089;13;2020-08-06;392
2020-08-05;"Trenčiansky kraj";39;0;0;0;NA;101089;39;2020-08-05;379
2020-08-04;"Trenčiansky kraj";9;0;0;0;NA;101089;9;2020-08-04;340
2020-08-03;"Trenčiansky kraj";0;0;0;0;NA;101089;0;2020-08-03;331
2020-08-02;"Trenčiansky kraj";2;0;0;0;NA;101089;2;2020-08-02;331
2020-08-01;"Trenčiansky kraj";6;0;0;0;NA;101089;6;2020-08-01;329
2020-07-31;"Trenčiansky kraj";16;0;0;0;NA;101089;16;2020-07-31;323
2020-07-30;"Trenčiansky kraj";4;0;0;0;NA;101089;4;2020-07-30;307
2020-07-29;"Trenčiansky kraj";5;0;0;0;NA;101089;5;2020-07-29;303
2020-07-28;"Trenčiansky kraj";11;0;0;0;NA;101089;11;2020-07-28;298
2020-07-27;"Trenčiansky kraj";4;0;0;0;NA;101089;4;2020-07-27;287
2020-07-26;"Trenčiansky kraj";1;0;0;0;NA;101089;1;2020-07-26;283
2020-07-25;"Trenčiansky kraj";7;0;0;0;NA;101089;7;2020-07-25;282
2020-07-24;"Trenčiansky kraj";5;0;0;0;NA;101089;5;2020-07-24;275
2020-07-23;"Trenčiansky kraj";10;0;0;0;NA;101089;10;2020-07-23;270
2020-07-22;"Trenčiansky kraj";11;0;0;0;NA;101089;11;2020-07-22;260
2020-07-21;"Trenčiansky kraj";6;0;0;0;NA;101089;6;2020-07-21;249
2020-07-20;"Trenčiansky kraj";13;0;0;0;NA;101089;13;2020-07-20;243
2020-07-19;"Trenčiansky kraj";0;0;0;0;NA;101089;0;2020-07-19;230
2020-07-18;"Trenčiansky kraj";0;0;0;0;NA;101089;0;2020-07-18;230
2020-07-17;"Trenčiansky kraj";1;0;0;0;NA;101089;1;2020-07-17;230
2020-07-16;"Trenčiansky kraj";0;0;0;0;NA;101089;0;2020-07-16;229
2020-07-15;"Trenčiansky kraj";2;0;0;0;NA;101089;2;2020-07-15;229
2020-07-14;"Trenčiansky kraj";8;0;0;0;NA;101089;8;2020-07-14;227
2020-07-13;"Trenčiansky kraj";1;0;0;0;NA;101089;1;2020-07-13;219
2020-07-12;"Trenčiansky kraj";0;0;0;0;NA;101089;0;2020-07-12;218
2020-07-11;"Trenčiansky kraj";0;0;0;0;NA;101089;0;2020-07-11;218
2020-07-10;"Trenčiansky kraj";3;0;0;0;NA;101089;3;2020-07-10;218
2020-07-09;"Trenčiansky kraj";2;0;0;0;NA;101089;2;2020-07-09;215
2020-07-08;"Trenčiansky kraj";1;0;0;0;NA;101089;1;2020-07-08;213
2020-07-07;"Trenčiansky kraj";9;0;0;0;NA;101089;9;2020-07-07;212
2020-07-06;"Trenčiansky kraj";1;0;0;0;NA;101089;1;2020-07-06;203
2020-07-05;"Trenčiansky kraj";1;0;0;0;NA;101089;1;2020-07-05;202
2020-07-04;"Trenčiansky kraj";0;0;0;0;NA;101089;0;2020-07-04;201
2020-07-03;"Trenčiansky kraj";2;0;0;0;NA;101089;2;2020-07-03;201
2020-07-02;"Trenčiansky kraj";10;0;0;0;NA;101089;10;2020-07-02;199
2020-07-01;"Trenčiansky kraj";1;0;0;0;NA;101089;1;2020-07-01;189
2020-06-30;"Trenčiansky kraj";6;0;0;0;NA;101089;6;2020-06-30;188
2020-06-29;"Trenčiansky kraj";1;0;0;0;NA;101089;1;2020-06-29;182
2020-06-28;"Trenčiansky kraj";0;0;0;0;NA;101089;0;2020-06-28;181
2020-06-27;"Trenčiansky kraj";0;0;0;0;NA;101089;0;2020-06-27;181
2020-06-26;"Trenčiansky kraj";0;0;0;0;NA;101089;0;2020-06-26;181
2020-06-25;"Trenčiansky kraj";2;0;0;0;NA;101089;2;2020-06-25;181
2020-06-24;"Trenčiansky kraj";1;0;0;0;NA;101089;1;2020-06-24;179
2020-06-23;"Trenčiansky kraj";0;0;0;0;NA;101089;0;2020-06-23;178
2020-06-22;"Trenčiansky kraj";0;0;0;0;NA;101089;0;2020-06-22;178
2020-06-21;"Trenčiansky kraj";0;0;0;0;NA;101089;0;2020-06-21;178
2020-06-20;"Trenčiansky kraj";0;0;0;0;NA;101089;0;2020-06-20;178
2020-06-19;"Trenčiansky kraj";0;0;0;0;NA;101089;0;2020-06-19;178
2020-06-18;"Trenčiansky kraj";0;0;0;0;NA;101089;0;2020-06-18;178
2020-06-17;"Trenčiansky kraj";0;0;0;0;NA;101089;0;2020-06-17;178
2020-06-16;"Trenčiansky kraj";0;0;0;0;NA;101089;0;2020-06-16;178
2020-06-14;"Trenčiansky kraj";0;0;0;0;NA;101089;0;2020-06-14;178
2020-06-13;"Trenčiansky kraj";0;0;0;0;NA;101089;0;2020-06-13;178
2020-06-12;"Trenčiansky kraj";0;0;0;0;NA;101089;0;2020-06-12;178
2020-06-11;"Trenčiansky kraj";0;0;0;0;NA;101089;0;2020-06-11;178
2020-06-10;"Trenčiansky kraj";1;0;0;0;NA;101089;1;2020-06-10;178
2020-06-09;"Trenčiansky kraj";0;0;0;0;NA;101089;0;2020-06-09;177
2020-06-08;"Trenčiansky kraj";0;0;0;0;NA;101089;0;2020-06-08;177
2020-06-07;"Trenčiansky kraj";0;0;0;0;NA;101089;0;2020-06-07;177
2020-06-05;"Trenčiansky kraj";0;0;0;0;NA;101089;0;2020-06-05;177
2020-06-03;"Trenčiansky kraj";0;0;0;0;NA;101089;0;2020-06-03;177
2020-06-02;"Trenčiansky kraj";0;0;0;0;NA;101089;0;2020-06-02;177
2020-05-31;"Trenčiansky kraj";0;0;0;0;NA;101089;0;2020-05-31;177
2020-05-29;"Trenčiansky kraj";0;0;0;0;NA;101089;0;2020-05-29;177
2020-05-27;"Trenčiansky kraj";2;0;0;0;NA;101089;2;2020-05-27;177
2020-05-26;"Trenčiansky kraj";0;0;0;0;NA;101089;0;2020-05-26;175
2020-05-25;"Trenčiansky kraj";0;0;0;0;NA;101089;0;2020-05-25;175
2020-05-24;"Trenčiansky kraj";0;0;0;0;NA;101089;0;2020-05-24;175
2020-05-23;"Trenčiansky kraj";0;0;0;0;NA;101089;0;2020-05-23;175
2020-05-22;"Trenčiansky kraj";0;0;0;0;NA;101089;0;2020-05-22;175
2020-05-21;"Trenčiansky kraj";0;0;0;0;NA;101089;0;2020-05-21;175
2020-05-20;"Trenčiansky kraj";0;0;0;0;NA;101089;0;2020-05-20;175
2020-05-19;"Trenčiansky kraj";0;0;0;0;NA;101089;0;2020-05-19;175
2020-05-17;"Trenčiansky kraj";0;0;0;0;NA;101089;0;2020-05-17;175
2020-05-16;"Trenčiansky kraj";0;0;0;0;NA;101089;0;2020-05-16;175
2020-05-15;"Trenčiansky kraj";1;0;0;0;NA;101089;1;2020-05-15;175
2020-05-14;"Trenčiansky kraj";2;0;0;0;NA;101089;2;2020-05-14;174
2020-05-13;"Trenčiansky kraj";1;0;0;0;NA;101089;1;2020-05-13;172
2020-05-12;"Trenčiansky kraj";1;0;0;0;NA;101089;1;2020-05-12;171
2020-05-11;"Trenčiansky kraj";3;0;0;0;NA;101089;3;2020-05-11;170
2020-05-09;"Trenčiansky kraj";2;0;0;0;NA;101089;2;2020-05-09;167
2020-05-07;"Trenčiansky kraj";6;0;0;0;NA;101089;6;2020-05-07;165
2020-05-06;"Trenčiansky kraj";0;0;0;0;NA;101089;0;2020-05-06;159
2020-05-05;"Trenčiansky kraj";2;0;0;0;NA;101089;2;2020-05-05;159
2020-05-04;"Trenčiansky kraj";0;0;0;0;NA;101089;0;2020-05-04;157
2020-05-03;"Trenčiansky kraj";0;0;0;0;NA;101089;0;2020-05-03;157
2020-05-02;"Trenčiansky kraj";0;0;0;0;NA;101089;0;2020-05-02;157
2020-05-01;"Trenčiansky kraj";0;0;0;0;NA;101089;0;2020-05-01;157
2020-04-30;"Trenčiansky kraj";0;0;0;0;NA;101089;0;2020-04-30;157
2020-04-29;"Trenčiansky kraj";2;0;0;0;NA;101089;2;2020-04-29;157
2020-04-28;"Trenčiansky kraj";1;0;0;0;NA;101089;1;2020-04-28;155
2020-04-27;"Trenčiansky kraj";0;0;0;0;NA;101089;0;2020-04-27;154
2020-04-26;"Trenčiansky kraj";1;0;0;0;NA;101089;1;2020-04-26;154
2020-04-25;"Trenčiansky kraj";0;0;0;0;NA;101089;0;2020-04-25;153
2020-04-24;"Trenčiansky kraj";0;0;0;0;NA;101089;0;2020-04-24;153
2020-04-23;"Trenčiansky kraj";11;0;0;0;NA;101089;11;2020-04-23;153
2020-04-22;"Trenčiansky kraj";1;0;0;0;NA;101089;1;2020-04-22;142
2020-04-21;"Trenčiansky kraj";11;0;0;0;NA;101089;11;2020-04-21;141
2020-04-20;"Trenčiansky kraj";15;0;0;0;NA;101089;15;2020-04-20;130
2020-04-19;"Trenčiansky kraj";2;0;0;0;NA;101089;2;2020-04-19;115
2020-04-18;"Trenčiansky kraj";3;0;0;0;NA;101089;3;2020-04-18;113
2020-04-17;"Trenčiansky kraj";4;0;0;0;NA;101089;4;2020-04-17;110
2020-04-16;"Trenčiansky kraj";10;0;0;0;NA;101089;10;2020-04-16;106
2020-04-15;"Trenčiansky kraj";4;0;0;0;NA;101089;4;2020-04-15;96
2020-04-14;"Trenčiansky kraj";0;0;0;0;NA;101089;0;2020-04-14;92
2020-04-13;"Trenčiansky kraj";1;0;0;0;NA;101089;1;2020-04-13;92
2020-04-12;"Trenčiansky kraj";2;0;0;0;NA;101089;2;2020-04-12;91
2020-04-11;"Trenčiansky kraj";3;0;0;0;NA;101089;3;2020-04-11;89
2020-04-10;"Trenčiansky kraj";0;0;0;0;NA;101089;0;2020-04-10;86
2020-04-09;"Trenčiansky kraj";0;0;0;0;NA;101089;0;2020-04-09;86
2020-04-08;"Trenčiansky kraj";2;0;0;0;NA;101089;2;2020-04-08;86
2020-04-07;"Trenčiansky kraj";18;0;0;0;NA;101089;18;2020-04-07;84
2020-04-06;"Trenčiansky kraj";0;0;0;0;NA;101089;0;2020-04-06;66
2020-04-05;"Trenčiansky kraj";3;0;0;0;NA;101089;3;2020-04-05;66
2020-04-04;"Trenčiansky kraj";5;0;0;0;NA;101089;5;2020-04-04;63
2020-04-03;"Trenčiansky kraj";4;0;0;0;NA;101089;4;2020-04-03;58
2020-04-02;"Trenčiansky kraj";1;0;0;0;NA;101089;1;2020-04-02;54
2020-04-01;"Trenčiansky kraj";3;0;0;0;NA;101089;3;2020-04-01;53
2020-03-31;"Trenčiansky kraj";1;0;0;0;NA;101089;1;2020-03-31;50
2020-03-30;"Trenčiansky kraj";3;0;0;0;NA;101089;3;2020-03-30;49
2020-03-29;"Trenčiansky kraj";6;0;0;0;NA;101089;6;2020-03-29;46
2020-03-28;"Trenčiansky kraj";9;0;0;0;NA;101089;9;2020-03-28;40
2020-03-27;"Trenčiansky kraj";2;0;0;0;NA;101089;2;2020-03-27;31
2020-03-26;"Trenčiansky kraj";6;0;0;0;NA;101089;6;2020-03-26;29
2020-03-25;"Trenčiansky kraj";3;0;0;0;NA;101089;3;2020-03-25;23
2020-03-24;"Trenčiansky kraj";1;0;0;0;NA;101089;1;2020-03-24;20
2020-03-23;"Trenčiansky kraj";0;0;0;0;NA;101089;0;2020-03-23;19
2020-03-22;"Trenčiansky kraj";0;0;0;0;NA;101089;0;2020-03-22;19
2020-03-21;"Trenčiansky kraj";2;0;0;0;NA;101089;2;2020-03-21;19
2020-03-20;"Trenčiansky kraj";2;0;0;0;NA;101089;2;2020-03-20;17
2020-03-19;"Trenčiansky kraj";8;0;0;0;NA;101089;8;2020-03-19;15
2020-03-18;"Trenčiansky kraj";0;0;0;0;NA;101089;0;2020-03-18;7
2020-03-17;"Trenčiansky kraj";0;0;0;0;NA;101089;0;2020-03-17;7
2020-03-16;"Trenčiansky kraj";1;0;0;0;NA;101089;1;2020-03-16;7
2020-03-15;"Trenčiansky kraj";5;0;0;0;NA;101089;5;2020-03-15;6
2020-03-14;"Trenčiansky kraj";0;0;0;0;NA;101089;0;2020-03-14;1
2020-03-13;"Trenčiansky kraj";0;0;0;0;NA;101089;0;2020-03-13;1
2020-03-12;"Trenčiansky kraj";1;0;0;0;NA;101089;1;2020-03-12;1
2020-03-11;"Trenčiansky kraj";0;0;0;0;NA;101089;0;2020-03-11;0
2020-03-09;"Trenčiansky kraj";0;0;0;0;NA;101089;0;2020-03-09;0
2020-03-08;"Trenčiansky kraj";0;0;0;0;NA;101089;0;2020-03-08;0
2020-03-07;"Trenčiansky kraj";0;0;0;0;NA;101089;0;2020-03-07;0
2020-03-06;"Trenčiansky kraj";0;0;0;0;NA;101089;0;2020-03-06;0
2021-08-29;"Trnavský kraj";8;359;1;360;46055;90440;9;2021-08-29;90440
2021-08-28;"Trnavský kraj";17;478;0;478;NA;90440;17;2021-08-28;90431
2021-08-27;"Trnavský kraj";1;986;3;989;NA;90440;4;2021-08-27;90414
2021-08-26;"Trnavský kraj";8;591;2;593;NA;90440;10;2021-08-26;90410
2021-08-25;"Trnavský kraj";11;529;5;534;NA;90440;16;2021-08-25;90400
2021-08-24;"Trnavský kraj";7;657;1;658;NA;90440;8;2021-08-24;90384
2021-08-23;"Trnavský kraj";4;824;1;825;NA;90440;5;2021-08-23;90376
2021-08-22;"Trnavský kraj";0;449;0;449;NA;90440;0;2021-08-22;90371
2021-08-21;"Trnavský kraj";8;674;0;674;NA;90440;8;2021-08-21;90371
2021-08-20;"Trnavský kraj";4;1051;4;1055;NA;90440;8;2021-08-20;90363
2021-08-19;"Trnavský kraj";10;852;3;855;NA;90440;13;2021-08-19;90355
2021-08-18;"Trnavský kraj";6;715;0;715;NA;90440;6;2021-08-18;90342
2021-08-17;"Trnavský kraj";7;494;4;498;NA;90440;11;2021-08-17;90336
2021-08-16;"Trnavský kraj";9;879;0;879;NA;90440;9;2021-08-16;90325
2021-08-15;"Trnavský kraj";0;509;1;510;NA;90440;1;2021-08-15;90316
2021-08-14;"Trnavský kraj";10;772;3;775;NA;90440;13;2021-08-14;90315
2021-08-13;"Trnavský kraj";5;1005;5;1010;NA;90440;10;2021-08-13;90302
2021-08-12;"Trnavský kraj";3;638;3;641;NA;90440;6;2021-08-12;90292
2021-08-11;"Trnavský kraj";7;560;2;562;NA;90440;9;2021-08-11;90286
2021-08-10;"Trnavský kraj";3;731;3;734;NA;90440;6;2021-08-10;90277
2021-08-09;"Trnavský kraj";12;784;0;784;NA;90440;12;2021-08-09;90271
2021-08-08;"Trnavský kraj";1;521;0;521;NA;90440;1;2021-08-08;90259
2021-08-07;"Trnavský kraj";9;694;0;694;NA;90440;9;2021-08-07;90258
2021-08-06;"Trnavský kraj";3;967;0;967;NA;90440;3;2021-08-06;90249
2021-08-05;"Trnavský kraj";2;651;1;652;NA;90440;3;2021-08-05;90246
2021-08-04;"Trnavský kraj";1;868;1;869;NA;90440;2;2021-08-04;90243
2021-08-03;"Trnavský kraj";13;645;0;645;NA;90440;13;2021-08-03;90241
2021-08-02;"Trnavský kraj";2;725;1;726;NA;90440;3;2021-08-02;90228
2021-08-01;"Trnavský kraj";0;565;2;567;NA;90440;2;2021-08-01;90225
2021-07-31;"Trnavský kraj";3;886;0;886;NA;90440;3;2021-07-31;90223
2021-07-30;"Trnavský kraj";3;1071;3;1074;NA;90440;6;2021-07-30;90220
2021-07-29;"Trnavský kraj";1;775;0;775;NA;90440;1;2021-07-29;90214
2021-07-28;"Trnavský kraj";5;794;1;795;NA;90440;6;2021-07-28;90213
2021-07-27;"Trnavský kraj";7;623;2;625;NA;90440;9;2021-07-27;90207
2021-07-26;"Trnavský kraj";2;857;2;859;NA;90440;4;2021-07-26;90198
2021-07-25;"Trnavský kraj";0;707;0;707;NA;90440;0;2021-07-25;90194
2021-07-24;"Trnavský kraj";4;828;2;830;NA;90440;6;2021-07-24;90194
2021-07-23;"Trnavský kraj";3;1057;0;1057;NA;90440;3;2021-07-23;90188
2021-07-22;"Trnavský kraj";0;671;2;673;NA;90440;2;2021-07-22;90185
2021-07-21;"Trnavský kraj";2;660;2;662;NA;90440;4;2021-07-21;90183
2021-07-20;"Trnavský kraj";2;593;0;593;NA;90440;2;2021-07-20;90179
2021-07-19;"Trnavský kraj";9;886;0;886;NA;90440;9;2021-07-19;90177
2021-07-18;"Trnavský kraj";0;600;2;602;NA;90440;2;2021-07-18;90168
2021-07-17;"Trnavský kraj";8;796;0;796;NA;90440;8;2021-07-17;90166
2021-07-16;"Trnavský kraj";11;963;0;963;NA;90440;11;2021-07-16;90158
2021-07-15;"Trnavský kraj";4;832;1;833;NA;90440;5;2021-07-15;90147
2021-07-14;"Trnavský kraj";1;699;1;700;NA;90440;2;2021-07-14;90142
2021-07-13;"Trnavský kraj";1;693;1;694;NA;90440;2;2021-07-13;90140
2021-07-12;"Trnavský kraj";4;959;0;959;NA;90440;4;2021-07-12;90138
2021-07-11;"Trnavský kraj";0;692;0;692;NA;90440;0;2021-07-11;90134
2021-07-10;"Trnavský kraj";1;803;0;803;NA;90440;1;2021-07-10;90134
2021-07-09;"Trnavský kraj";3;1262;3;1265;NA;90440;6;2021-07-09;90133
2021-07-08;"Trnavský kraj";4;755;0;755;NA;90440;4;2021-07-08;90127
2021-07-07;"Trnavský kraj";9;924;2;926;NA;90440;11;2021-07-07;90123
2021-07-06;"Trnavský kraj";2;1401;1;1402;NA;90440;3;2021-07-06;90112
2021-07-05;"Trnavský kraj";1;503;2;505;NA;90440;3;2021-07-05;90109
2021-07-04;"Trnavský kraj";0;1129;3;1132;NA;90440;3;2021-07-04;90106
2021-07-03;"Trnavský kraj";4;815;0;815;NA;90440;4;2021-07-03;90103
2021-07-02;"Trnavský kraj";2;1137;2;1139;NA;90440;4;2021-07-02;90099
2021-07-01;"Trnavský kraj";4;437;0;437;NA;90440;4;2021-07-01;90095
2021-06-30;"Trnavský kraj";0;5109;1;5110;NA;90440;1;2021-06-30;90091
2021-06-29;"Trnavský kraj";4;2563;1;2564;NA;90440;5;2021-06-29;90090
2021-06-28;"Trnavský kraj";2;2600;1;2601;NA;90440;3;2021-06-28;90085
2021-06-27;"Trnavský kraj";0;3213;0;3213;NA;90440;0;2021-06-27;90082
2021-06-26;"Trnavský kraj";3;3871;1;3872;NA;90440;4;2021-06-26;90082
2021-06-25;"Trnavský kraj";2;4374;3;4377;NA;90440;5;2021-06-25;90078
2021-06-24;"Trnavský kraj";4;2520;3;2523;NA;90440;7;2021-06-24;90073
2021-06-23;"Trnavský kraj";4;2842;2;2844;NA;90440;6;2021-06-23;90066
2021-06-22;"Trnavský kraj";2;2996;1;2997;NA;90440;3;2021-06-22;90060
2021-06-21;"Trnavský kraj";6;3114;5;3119;NA;90440;11;2021-06-21;90057
2021-06-20;"Trnavský kraj";0;3952;1;3953;NA;90440;1;2021-06-20;90046
2021-06-19;"Trnavský kraj";3;4735;2;4737;NA;90440;5;2021-06-19;90045
2021-06-18;"Trnavský kraj";5;6125;4;6129;NA;90440;9;2021-06-18;90040
2021-06-17;"Trnavský kraj";3;3340;0;3340;NA;90440;3;2021-06-17;90031
2021-06-16;"Trnavský kraj";6;2926;3;2929;NA;90440;9;2021-06-16;90028
2021-06-15;"Trnavský kraj";8;3234;3;3237;NA;90440;11;2021-06-15;90019
2021-06-14;"Trnavský kraj";2;3829;1;3830;NA;90440;3;2021-06-14;90008
2021-06-13;"Trnavský kraj";0;5001;8;5009;NA;90440;8;2021-06-13;90005
2021-06-12;"Trnavský kraj";11;5807;2;5809;NA;90440;13;2021-06-12;89997
2021-06-11;"Trnavský kraj";17;5850;4;5854;NA;90440;21;2021-06-11;89984
2021-06-10;"Trnavský kraj";14;3476;1;3477;NA;90440;15;2021-06-10;89963
2021-06-09;"Trnavský kraj";10;3681;1;3682;NA;90440;11;2021-06-09;89948
2021-06-08;"Trnavský kraj";8;3344;4;3348;NA;90440;12;2021-06-08;89937
2021-06-07;"Trnavský kraj";12;4498;8;4506;NA;90440;20;2021-06-07;89925
2021-06-06;"Trnavský kraj";0;5517;2;5519;NA;90440;2;2021-06-06;89905
2021-06-05;"Trnavský kraj";20;6905;8;6913;NA;90440;28;2021-06-05;89903
2021-06-04;"Trnavský kraj";9;6731;10;6741;NA;90440;19;2021-06-04;89875
2021-06-03;"Trnavský kraj";14;4361;11;4372;NA;90440;25;2021-06-03;89856
2021-06-02;"Trnavský kraj";4;4148;11;4159;NA;90440;15;2021-06-02;89831
2021-06-01;"Trnavský kraj";18;3662;5;3667;NA;90440;23;2021-06-01;89816
2021-05-31;"Trnavský kraj";14;5515;16;5531;NA;90440;30;2021-05-31;89793
2021-05-30;"Trnavský kraj";0;6473;7;6480;NA;90440;7;2021-05-30;89763
2021-05-29;"Trnavský kraj";11;8964;4;8968;NA;90440;15;2021-05-29;89756
2021-05-28;"Trnavský kraj";14;7160;11;7171;NA;90440;25;2021-05-28;89741
2021-05-27;"Trnavský kraj";22;4753;8;4761;NA;90440;30;2021-05-27;89716
2021-05-26;"Trnavský kraj";6;4870;8;4878;NA;90440;14;2021-05-26;89686
2021-05-25;"Trnavský kraj";19;5026;27;5053;NA;90440;46;2021-05-25;89672
2021-05-24;"Trnavský kraj";15;6520;22;6542;NA;90440;37;2021-05-24;89626
2021-05-23;"Trnavský kraj";0;7920;8;7928;NA;90440;8;2021-05-23;89589
2021-05-22;"Trnavský kraj";13;13381;21;13402;NA;90440;34;2021-05-22;89581
2021-05-21;"Trnavský kraj";16;8525;19;8544;NA;90440;35;2021-05-21;89547
2021-05-20;"Trnavský kraj";15;5511;11;5522;NA;90440;26;2021-05-20;89512
2021-05-19;"Trnavský kraj";18;5431;13;5444;NA;90440;31;2021-05-19;89486
2021-05-18;"Trnavský kraj";26;5768;15;5783;NA;90440;41;2021-05-18;89455
2021-05-17;"Trnavský kraj";17;6262;24;6286;NA;90440;41;2021-05-17;89414
2021-05-16;"Trnavský kraj";10;9984;8;9992;NA;90440;18;2021-05-16;89373
2021-05-15;"Trnavský kraj";11;18525;14;18539;NA;90440;25;2021-05-15;89355
2021-05-14;"Trnavský kraj";34;10279;21;10300;NA;90440;55;2021-05-14;89330
2021-05-13;"Trnavský kraj";26;6913;12;6925;NA;90440;38;2021-05-13;89275
2021-05-12;"Trnavský kraj";34;6621;26;6647;NA;90440;60;2021-05-12;89237
2021-05-11;"Trnavský kraj";32;6393;13;6406;NA;90440;45;2021-05-11;89177
2021-05-10;"Trnavský kraj";58;9139;24;9163;NA;90440;82;2021-05-10;89132
2021-05-09;"Trnavský kraj";21;12570;12;12582;NA;90440;33;2021-05-09;89050
2021-05-08;"Trnavský kraj";4;23028;22;23050;NA;90440;26;2021-05-08;89017
2021-05-07;"Trnavský kraj";26;15465;30;15495;NA;90440;56;2021-05-07;88991
2021-05-06;"Trnavský kraj";22;8407;22;8429;NA;90440;44;2021-05-06;88935
2021-05-05;"Trnavský kraj";34;6273;22;6295;NA;90440;56;2021-05-05;88891
2021-05-04;"Trnavský kraj";51;8538;17;8555;NA;90440;68;2021-05-04;88835
2021-05-03;"Trnavský kraj";20;8957;22;8979;NA;90440;42;2021-05-03;88767
2021-05-02;"Trnavský kraj";0;25657;29;25686;NA;90440;29;2021-05-02;88725
2021-05-01;"Trnavský kraj";30;81353;64;81417;NA;90440;94;2021-05-01;88696
2021-04-30;"Trnavský kraj";45;26846;35;26881;NA;90440;80;2021-04-30;88602
2021-04-29;"Trnavský kraj";25;20323;28;20351;NA;90440;53;2021-04-29;88522
2021-04-28;"Trnavský kraj";46;8896;28;8924;NA;90440;74;2021-04-28;88469
2021-04-27;"Trnavský kraj";54;8756;37;8793;NA;90440;91;2021-04-27;88395
2021-04-26;"Trnavský kraj";53;16116;42;16158;NA;90440;95;2021-04-26;88304
2021-04-25;"Trnavský kraj";0;30183;24;30207;NA;90440;24;2021-04-25;88209
2021-04-24;"Trnavský kraj";46;126077;84;126161;NA;90440;130;2021-04-24;88185
2021-04-23;"Trnavský kraj";71;25741;53;25794;NA;90440;124;2021-04-23;88055
2021-04-22;"Trnavský kraj";40;10904;25;10929;NA;90440;65;2021-04-22;87931
2021-04-21;"Trnavský kraj";60;10748;45;10793;NA;90440;105;2021-04-21;87866
2021-04-20;"Trnavský kraj";57;13504;28;13532;NA;90440;85;2021-04-20;87761
2021-04-19;"Trnavský kraj";46;14603;18;14621;NA;90440;64;2021-04-19;87676
2021-04-18;"Trnavský kraj";7;40843;43;40886;NA;90440;50;2021-04-18;87612
2021-04-17;"Trnavský kraj";58;118102;89;118191;NA;90440;147;2021-04-17;87562
2021-04-16;"Trnavský kraj";67;25962;48;26010;NA;90440;115;2021-04-16;87415
2021-04-15;"Trnavský kraj";65;11373;36;11409;NA;90440;101;2021-04-15;87300
2021-04-14;"Trnavský kraj";78;18442;53;18495;NA;90440;131;2021-04-14;87199
2021-04-13;"Trnavský kraj";126;9871;44;9915;NA;90440;170;2021-04-13;87068
2021-04-12;"Trnavský kraj";40;15577;40;15617;NA;90440;80;2021-04-12;86898
2021-04-11;"Trnavský kraj";3;44420;44;44464;NA;90440;47;2021-04-11;86818
2021-04-10;"Trnavský kraj";60;123822;107;123929;NA;90440;167;2021-04-10;86771
2021-04-09;"Trnavský kraj";95;26191;34;26225;NA;90440;129;2021-04-09;86604
2021-04-08;"Trnavský kraj";85;10913;54;10967;NA;90440;139;2021-04-08;86475
2021-04-07;"Trnavský kraj";131;15979;81;16060;NA;90440;212;2021-04-07;86336
2021-04-06;"Trnavský kraj";92;20586;90;20676;NA;90440;182;2021-04-06;86124
2021-04-05;"Trnavský kraj";91;7542;17;7559;NA;90440;108;2021-04-05;85942
2021-04-04;"Trnavský kraj";9;28831;49;28880;NA;90440;58;2021-04-04;85834
2021-04-03;"Trnavský kraj";29;144452;186;144638;NA;90440;215;2021-04-03;85776
2021-04-02;"Trnavský kraj";91;17538;33;17571;NA;90440;124;2021-04-02;85561
2021-04-01;"Trnavský kraj";118;22279;71;22350;NA;90440;189;2021-04-01;85437
2021-03-31;"Trnavský kraj";140;15828;82;15910;NA;90440;222;2021-03-31;85248
2021-03-30;"Trnavský kraj";182;10482;79;10561;NA;90440;261;2021-03-30;85026
2021-03-29;"Trnavský kraj";126;19255;122;19377;NA;90440;248;2021-03-29;84765
2021-03-28;"Trnavský kraj";26;50664;134;50798;NA;90440;160;2021-03-28;84517
2021-03-27;"Trnavský kraj";64;130217;246;130463;NA;90440;310;2021-03-27;84357
2021-03-26;"Trnavský kraj";139;30217;130;30347;NA;90440;269;2021-03-26;84047
2021-03-25;"Trnavský kraj";135;14212;80;14292;NA;90440;215;2021-03-25;83778
2021-03-24;"Trnavský kraj";159;10521;89;10610;NA;90440;248;2021-03-24;83563
2021-03-23;"Trnavský kraj";221;12735;104;12839;NA;90440;325;2021-03-23;83315
2021-03-22;"Trnavský kraj";103;17118;110;17228;NA;90440;213;2021-03-22;82990
2021-03-21;"Trnavský kraj";31;49119;150;49269;NA;90440;181;2021-03-21;82777
2021-03-20;"Trnavský kraj";112;136963;317;137280;NA;90440;429;2021-03-20;82596
2021-03-19;"Trnavský kraj";174;29071;137;29208;NA;90440;311;2021-03-19;82167
2021-03-18;"Trnavský kraj";158;12217;136;12353;NA;90440;294;2021-03-18;81856
2021-03-17;"Trnavský kraj";245;10434;103;10537;NA;90440;348;2021-03-17;81562
2021-03-16;"Trnavský kraj";311;12811;135;12946;NA;90440;446;2021-03-16;81214
2021-03-15;"Trnavský kraj";127;18271;146;18417;NA;90440;273;2021-03-15;80768
2021-03-14;"Trnavský kraj";14;47608;164;47772;NA;90440;178;2021-03-14;80495
2021-03-13;"Trnavský kraj";155;139224;409;139633;NA;90440;564;2021-03-13;80317
2021-03-12;"Trnavský kraj";201;28566;181;28747;NA;90440;382;2021-03-12;79753
2021-03-11;"Trnavský kraj";204;13301;140;13441;NA;90440;344;2021-03-11;79371
2021-03-10;"Trnavský kraj";242;10583;135;10718;NA;90440;377;2021-03-10;79027
2021-03-09;"Trnavský kraj";442;12824;155;12979;NA;90440;597;2021-03-09;78650
2021-03-08;"Trnavský kraj";182;21812;166;21978;NA;90440;348;2021-03-08;78053
2021-03-07;"Trnavský kraj";30;45463;227;45690;NA;90440;257;2021-03-07;77705
2021-03-06;"Trnavský kraj";154;135784;531;136315;NA;90440;685;2021-03-06;77448
2021-03-05;"Trnavský kraj";299;27959;239;28198;NA;90440;538;2021-03-05;76763
2021-03-04;"Trnavský kraj";238;14505;176;14681;NA;90440;414;2021-03-04;76225
2021-03-03;"Trnavský kraj";413;11583;246;11829;NA;90440;659;2021-03-03;75811
2021-03-02;"Trnavský kraj";477;12367;191;12558;NA;90440;668;2021-03-02;75152
2021-03-01;"Trnavský kraj";189;18586;234;18820;NA;90440;423;2021-03-01;74484
2021-02-28;"Trnavský kraj";87;47709;321;48030;NA;90440;408;2021-02-28;74061
2021-02-27;"Trnavský kraj";264;140224;800;141024;NA;90440;1064;2021-02-27;73653
2021-02-26;"Trnavský kraj";362;26637;284;26921;NA;90440;646;2021-02-26;72589
2021-02-25;"Trnavský kraj";433;10490;227;10717;NA;90440;660;2021-02-25;71943
2021-02-24;"Trnavský kraj";407;9113;290;9403;NA;90440;697;2021-02-24;71283
2021-02-23;"Trnavský kraj";469;11322;284;11606;NA;90440;753;2021-02-23;70586
2021-02-22;"Trnavský kraj";206;19901;330;20231;NA;90440;536;2021-02-22;69833
2021-02-21;"Trnavský kraj";38;48221;329;48550;NA;90440;367;2021-02-21;69297
2021-02-20;"Trnavský kraj";273;135835;859;136694;NA;90440;1132;2021-02-20;68930
2021-02-19;"Trnavský kraj";335;26382;366;26748;NA;90440;701;2021-02-19;67798
2021-02-18;"Trnavský kraj";344;11264;348;11612;NA;90440;692;2021-02-18;67097
2021-02-17;"Trnavský kraj";431;8783;416;9199;NA;90440;847;2021-02-17;66405
2021-02-16;"Trnavský kraj";426;11236;294;11530;NA;90440;720;2021-02-16;65558
2021-02-15;"Trnavský kraj";146;18276;326;18602;NA;90440;472;2021-02-15;64838
2021-02-14;"Trnavský kraj";51;57642;495;58137;NA;90440;546;2021-02-14;64366
2021-02-13;"Trnavský kraj";218;137051;994;138045;NA;90440;1212;2021-02-13;63820
2021-02-12;"Trnavský kraj";300;24090;352;24442;NA;90440;652;2021-02-12;62608
2021-02-11;"Trnavský kraj";422;9831;349;10180;NA;90440;771;2021-02-11;61956
2021-02-10;"Trnavský kraj";511;9194;342;9536;NA;90440;853;2021-02-10;61185
2021-02-09;"Trnavský kraj";544;12755;369;13124;NA;90440;913;2021-02-09;60332
2021-02-08;"Trnavský kraj";220;33414;497;33911;NA;90440;717;2021-02-08;59419
2021-02-07;"Trnavský kraj";140;69694;628;70322;NA;90440;768;2021-02-07;58702
2021-02-06;"Trnavský kraj";348;112687;1482;114169;NA;90440;1830;2021-02-06;57934
2021-02-05;"Trnavský kraj";377;16063;373;16436;NA;90440;750;2021-02-05;56104
2021-02-04;"Trnavský kraj";456;7317;456;7773;NA;90440;912;2021-02-04;55354
2021-02-03;"Trnavský kraj";472;6583;434;7017;NA;90440;906;2021-02-03;54442
2021-02-02;"Trnavský kraj";446;14243;424;14667;NA;90440;870;2021-02-02;53536
2021-02-01;"Trnavský kraj";198;38882;679;39561;NA;90440;877;2021-02-01;52666
2021-01-31;"Trnavský kraj";19;64707;822;65529;NA;90440;841;2021-01-31;51789
2021-01-30;"Trnavský kraj";323;111483;1288;112771;NA;90440;1611;2021-01-30;50948
2021-01-29;"Trnavský kraj";421;9689;290;9979;NA;90440;711;2021-01-29;49337
2021-01-28;"Trnavský kraj";389;5817;289;6106;NA;90440;678;2021-01-28;48626
2021-01-27;"Trnavský kraj";433;5554;225;5779;NA;90440;658;2021-01-27;47948
2021-01-26;"Trnavský kraj";565;25411;636;26047;NA;90440;1201;2021-01-26;47290
2021-01-25;"Trnavský kraj";210;41805;620;42425;NA;90440;830;2021-01-25;46089
2021-01-24;"Trnavský kraj";91;66399;779;67178;NA;90440;870;2021-01-24;45259
2021-01-23;"Trnavský kraj";372;113375;1319;114694;NA;90440;1691;2021-01-23;44389
2021-01-22;"Trnavský kraj";217;32755;505;33260;NA;90440;722;2021-01-22;42698
2021-01-21;"Trnavský kraj";311;13913;377;14290;NA;90440;688;2021-01-21;41976
2021-01-20;"Trnavský kraj";503;8685;283;8968;NA;90440;786;2021-01-20;41288
2021-01-19;"Trnavský kraj";415;7013;347;7360;NA;90440;762;2021-01-19;40502
2021-01-18;"Trnavský kraj";247;6690;513;7203;NA;90440;760;2021-01-18;39740
2021-01-17;"Trnavský kraj";128;854;215;1069;NA;90440;343;2021-01-17;38980
2021-01-16;"Trnavský kraj";103;898;24;922;NA;90440;127;2021-01-16;38637
2021-01-15;"Trnavský kraj";278;5467;336;5803;NA;90440;614;2021-01-15;38510
2021-01-14;"Trnavský kraj";452;4001;338;4339;NA;90440;790;2021-01-14;37896
2021-01-13;"Trnavský kraj";457;4751;378;5129;NA;90440;835;2021-01-13;37106
2021-01-12;"Trnavský kraj";469;6860;470;7330;NA;90440;939;2021-01-12;36271
2021-01-11;"Trnavský kraj";370;4587;360;4947;NA;90440;730;2021-01-11;35332
2021-01-10;"Trnavský kraj";71;13;0;13;NA;90440;71;2021-01-10;34602
2021-01-09;"Trnavský kraj";417;1775;100;1875;NA;90440;517;2021-01-09;34531
2021-01-08;"Trnavský kraj";381;6016;506;6522;NA;90440;887;2021-01-08;34014
2021-01-07;"Trnavský kraj";501;3545;329;3874;NA;90440;830;2021-01-07;33127
2021-01-06;"Trnavský kraj";179;758;132;890;NA;90440;311;2021-01-06;32297
2021-01-05;"Trnavský kraj";611;5165;561;5726;NA;90440;1172;2021-01-05;31986
2021-01-04;"Trnavský kraj";302;5556;709;6265;NA;90440;1011;2021-01-04;30814
2021-01-03;"Trnavský kraj";60;53;7;60;NA;90440;67;2021-01-03;29803
2021-01-02;"Trnavský kraj";282;417;32;449;NA;90440;314;2021-01-02;29736
2021-01-01;"Trnavský kraj";143;455;76;531;NA;90440;219;2021-01-01;29422
2020-12-31;"Trnavský kraj";498;8703;880;9583;NA;90440;1378;2020-12-31;29203
2020-12-30;"Trnavský kraj";785;5318;612;5930;NA;90440;1397;2020-12-30;27825
2020-12-29;"Trnavský kraj";322;5364;639;6003;NA;90440;961;2020-12-29;26428
2020-12-28;"Trnavský kraj";213;5334;615;5949;NA;90440;828;2020-12-28;25467
2020-12-27;"Trnavský kraj";27;20;4;24;NA;90440;31;2020-12-27;24639
2020-12-26;"Trnavský kraj";148;44;1;45;NA;90440;149;2020-12-26;24608
2020-12-25;"Trnavský kraj";65;49;5;54;NA;90440;70;2020-12-25;24459
2020-12-24;"Trnavský kraj";333;1359;117;1476;NA;90440;450;2020-12-24;24389
2020-12-23;"Trnavský kraj";210;7259;414;7673;NA;90440;624;2020-12-23;23939
2020-12-22;"Trnavský kraj";311;5897;515;6412;NA;90440;826;2020-12-22;23315
2020-12-21;"Trnavský kraj";328;4527;399;4926;NA;90440;727;2020-12-21;22489
2020-12-20;"Trnavský kraj";134;133;12;145;NA;90440;146;2020-12-20;21762
2020-12-19;"Trnavský kraj";201;1407;103;1510;NA;90440;304;2020-12-19;21616
2020-12-18;"Trnavský kraj";341;4898;378;5276;NA;90440;719;2020-12-18;21312
2020-12-17;"Trnavský kraj";375;5271;443;5714;NA;90440;818;2020-12-17;20593
2020-12-16;"Trnavský kraj";312;5249;405;5654;NA;90440;717;2020-12-16;19775
2020-12-15;"Trnavský kraj";492;6624;632;7256;NA;90440;1124;2020-12-15;19058
2020-12-14;"Trnavský kraj";161;3505;292;3797;NA;90440;453;2020-12-14;17934
2020-12-13;"Trnavský kraj";7;7;0;7;NA;90440;7;2020-12-13;17481
2020-12-12;"Trnavský kraj";254;1456;114;1570;NA;90440;368;2020-12-12;17474
2020-12-11;"Trnavský kraj";384;4683;262;4945;NA;90440;646;2020-12-11;17106
2020-12-10;"Trnavský kraj";183;5197;320;5517;NA;90440;503;2020-12-10;16460
2020-12-09;"Trnavský kraj";521;4283;321;4604;NA;90440;842;2020-12-09;15957
2020-12-08;"Trnavský kraj";281;4090;304;4394;NA;90440;585;2020-12-08;15115
2020-12-07;"Trnavský kraj";178;2895;199;3094;NA;90440;377;2020-12-07;14530
2020-12-06;"Trnavský kraj";46;0;0;0;NA;90440;46;2020-12-06;14153
2020-12-05;"Trnavský kraj";129;2218;41;2259;NA;90440;170;2020-12-05;14107
2020-12-04;"Trnavský kraj";242;3948;158;4106;NA;90440;400;2020-12-04;13937
2020-12-03;"Trnavský kraj";248;2770;190;2960;NA;90440;438;2020-12-03;13537
2020-12-02;"Trnavský kraj";284;4516;176;4692;NA;90440;460;2020-12-02;13099
2020-12-01;"Trnavský kraj";253;3190;205;3395;NA;90440;458;2020-12-01;12639
2020-11-30;"Trnavský kraj";200;7360;186;7546;NA;90440;386;2020-11-30;12181
2020-11-29;"Trnavský kraj";17;738;36;774;NA;90440;53;2020-11-29;11795
2020-11-28;"Trnavský kraj";83;1453;77;1530;NA;90440;160;2020-11-28;11742
2020-11-27;"Trnavský kraj";148;1779;85;1864;NA;90440;233;2020-11-27;11582
2020-11-26;"Trnavský kraj";234;1123;68;1191;NA;90440;302;2020-11-26;11349
2020-11-25;"Trnavský kraj";232;1168;74;1242;NA;90440;306;2020-11-25;11047
2020-11-24;"Trnavský kraj";295;1909;96;2005;NA;90440;391;2020-11-24;10741
2020-11-23;"Trnavský kraj";242;7393;129;7522;NA;90440;371;2020-11-23;10350
2020-11-22;"Trnavský kraj";10;82;9;91;NA;90440;19;2020-11-22;9979
2020-11-21;"Trnavský kraj";129;1354;36;1390;NA;90440;165;2020-11-21;9960
2020-11-20;"Trnavský kraj";246;1154;64;1218;NA;90440;310;2020-11-20;9795
2020-11-19;"Trnavský kraj";157;823;64;887;NA;90440;221;2020-11-19;9485
2020-11-18;"Trnavský kraj";235;822;82;904;NA;90440;317;2020-11-18;9264
2020-11-17;"Trnavský kraj";129;705;74;779;NA;90440;203;2020-11-17;8947
2020-11-16;"Trnavský kraj";187;732;32;764;NA;90440;219;2020-11-16;8744
2020-11-15;"Trnavský kraj";23;73;4;77;NA;90440;27;2020-11-15;8525
2020-11-14;"Trnavský kraj";86;397;12;409;NA;90440;98;2020-11-14;8498
2020-11-13;"Trnavský kraj";219;1312;21;1333;NA;90440;240;2020-11-13;8400
2020-11-12;"Trnavský kraj";162;420;18;438;NA;90440;180;2020-11-12;8160
2020-11-11;"Trnavský kraj";257;392;15;407;NA;90440;272;2020-11-11;7980
2020-11-10;"Trnavský kraj";189;889;30;919;NA;90440;219;2020-11-10;7708
2020-11-09;"Trnavský kraj";196;369;23;392;NA;90440;219;2020-11-09;7489
2020-11-08;"Trnavský kraj";55;400;4;404;NA;90440;59;2020-11-08;7270
2020-11-07;"Trnavský kraj";207;6070;74;6144;NA;90440;281;2020-11-07;7211
2020-11-06;"Trnavský kraj";260;1531;19;1550;NA;90440;279;2020-11-06;6930
2020-11-05;"Trnavský kraj";150;220;27;247;NA;90440;177;2020-11-05;6651
2020-11-04;"Trnavský kraj";188;212;10;222;NA;90440;198;2020-11-04;6474
2020-11-03;"Trnavský kraj";317;127;8;135;NA;90440;325;2020-11-03;6276
2020-11-02;"Trnavský kraj";281;1728;31;1759;NA;90440;312;2020-11-02;5951
2020-11-01;"Trnavský kraj";87;494;27;521;NA;90440;114;2020-11-01;5639
2020-10-31;"Trnavský kraj";259;5024;41;5065;NA;90440;300;2020-10-31;5525
2020-10-30;"Trnavský kraj";198;3784;27;3811;NA;90440;225;2020-10-30;5225
2020-10-29;"Trnavský kraj";273;1461;16;1477;NA;90440;289;2020-10-29;5000
2020-10-28;"Trnavský kraj";319;117;16;133;NA;90440;335;2020-10-28;4711
2020-10-27;"Trnavský kraj";199;461;36;497;NA;90440;235;2020-10-27;4376
2020-10-26;"Trnavský kraj";153;29;2;31;NA;90440;155;2020-10-26;4141
2020-10-25;"Trnavský kraj";95;19;1;20;NA;90440;96;2020-10-25;3986
2020-10-24;"Trnavský kraj";158;109;2;111;NA;90440;160;2020-10-24;3890
2020-10-23;"Trnavský kraj";201;89;4;93;NA;90440;205;2020-10-23;3730
2020-10-22;"Trnavský kraj";195;55;2;57;NA;90440;197;2020-10-22;3525
2020-10-21;"Trnavský kraj";134;73;3;76;NA;90440;137;2020-10-21;3328
2020-10-20;"Trnavský kraj";202;82;3;85;NA;90440;205;2020-10-20;3191
2020-10-19;"Trnavský kraj";67;55;0;55;NA;90440;67;2020-10-19;2986
2020-10-18;"Trnavský kraj";84;0;0;0;NA;90440;84;2020-10-18;2919
2020-10-17;"Trnavský kraj";123;0;0;0;NA;90440;123;2020-10-17;2835
2020-10-16;"Trnavský kraj";86;45;2;47;NA;90440;88;2020-10-16;2712
2020-10-15;"Trnavský kraj";155;66;2;68;NA;90440;157;2020-10-15;2624
2020-10-14;"Trnavský kraj";236;468;3;471;NA;90440;239;2020-10-14;2467
2020-10-13;"Trnavský kraj";138;16;2;18;NA;90440;140;2020-10-13;2228
2020-10-12;"Trnavský kraj";33;41;1;42;NA;90440;34;2020-10-12;2088
2020-10-11;"Trnavský kraj";31;0;0;0;NA;90440;31;2020-10-11;2054
2020-10-10;"Trnavský kraj";128;0;0;0;NA;90440;128;2020-10-10;2023
2020-10-09;"Trnavský kraj";156;0;0;0;NA;90440;156;2020-10-09;1895
2020-10-08;"Trnavský kraj";153;0;0;0;NA;90440;153;2020-10-08;1739
2020-10-07;"Trnavský kraj";80;0;0;0;NA;90440;80;2020-10-07;1586
2020-10-06;"Trnavský kraj";112;0;0;0;NA;90440;112;2020-10-06;1506
2020-10-05;"Trnavský kraj";33;0;0;0;NA;90440;33;2020-10-05;1394
2020-10-04;"Trnavský kraj";44;0;0;0;NA;90440;44;2020-10-04;1361
2020-10-03;"Trnavský kraj";60;0;0;0;NA;90440;60;2020-10-03;1317
2020-10-02;"Trnavský kraj";41;0;0;0;NA;90440;41;2020-10-02;1257
2020-10-01;"Trnavský kraj";53;0;0;0;NA;90440;53;2020-10-01;1216
2020-09-30;"Trnavský kraj";91;0;0;0;NA;90440;91;2020-09-30;1163
2020-09-29;"Trnavský kraj";40;0;0;0;NA;90440;40;2020-09-29;1072
2020-09-28;"Trnavský kraj";69;0;0;0;NA;90440;69;2020-09-28;1032
2020-09-27;"Trnavský kraj";30;0;0;0;NA;90440;30;2020-09-27;963
2020-09-26;"Trnavský kraj";46;0;0;0;NA;90440;46;2020-09-26;933
2020-09-25;"Trnavský kraj";32;0;0;0;NA;90440;32;2020-09-25;887
2020-09-24;"Trnavský kraj";42;0;0;0;NA;90440;42;2020-09-24;855
2020-09-23;"Trnavský kraj";43;0;0;0;NA;90440;43;2020-09-23;813
2020-09-22;"Trnavský kraj";55;0;0;0;NA;90440;55;2020-09-22;770
2020-09-21;"Trnavský kraj";41;0;0;0;NA;90440;41;2020-09-21;715
2020-09-20;"Trnavský kraj";17;0;0;0;NA;90440;17;2020-09-20;674
2020-09-19;"Trnavský kraj";4;0;0;0;NA;90440;4;2020-09-19;657
2020-09-18;"Trnavský kraj";33;0;0;0;NA;90440;33;2020-09-18;653
2020-09-17;"Trnavský kraj";42;0;0;0;NA;90440;42;2020-09-17;620
2020-09-16;"Trnavský kraj";49;0;0;0;NA;90440;49;2020-09-16;578
2020-09-15;"Trnavský kraj";5;0;0;0;NA;90440;5;2020-09-15;529
2020-09-14;"Trnavský kraj";26;0;0;0;NA;90440;26;2020-09-14;524
2020-09-13;"Trnavský kraj";9;0;0;0;NA;90440;9;2020-09-13;498
2020-09-12;"Trnavský kraj";12;0;0;0;NA;90440;12;2020-09-12;489
2020-09-11;"Trnavský kraj";16;0;0;0;NA;90440;16;2020-09-11;477
2020-09-10;"Trnavský kraj";32;0;0;0;NA;90440;32;2020-09-10;461
2020-09-09;"Trnavský kraj";14;0;0;0;NA;90440;14;2020-09-09;429
2020-09-08;"Trnavský kraj";11;0;0;0;NA;90440;11;2020-09-08;415
2020-09-07;"Trnavský kraj";7;0;0;0;NA;90440;7;2020-09-07;404
2020-09-06;"Trnavský kraj";5;0;0;0;NA;90440;5;2020-09-06;397
2020-09-05;"Trnavský kraj";7;0;0;0;NA;90440;7;2020-09-05;392
2020-09-04;"Trnavský kraj";16;0;0;0;NA;90440;16;2020-09-04;385
2020-09-03;"Trnavský kraj";8;0;0;0;NA;90440;8;2020-09-03;369
2020-09-02;"Trnavský kraj";7;0;0;0;NA;90440;7;2020-09-02;361
2020-09-01;"Trnavský kraj";1;0;0;0;NA;90440;1;2020-09-01;354
2020-08-31;"Trnavský kraj";6;0;0;0;NA;90440;6;2020-08-31;353
2020-08-30;"Trnavský kraj";1;0;0;0;NA;90440;1;2020-08-30;347
2020-08-29;"Trnavský kraj";3;0;0;0;NA;90440;3;2020-08-29;346
2020-08-28;"Trnavský kraj";14;0;0;0;NA;90440;14;2020-08-28;343
2020-08-27;"Trnavský kraj";6;0;0;0;NA;90440;6;2020-08-27;329
2020-08-26;"Trnavský kraj";4;0;0;0;NA;90440;4;2020-08-26;323
2020-08-25;"Trnavský kraj";7;0;0;0;NA;90440;7;2020-08-25;319
2020-08-24;"Trnavský kraj";1;0;0;0;NA;90440;1;2020-08-24;312
2020-08-23;"Trnavský kraj";6;0;0;0;NA;90440;6;2020-08-23;311
2020-08-22;"Trnavský kraj";3;0;0;0;NA;90440;3;2020-08-22;305
2020-08-21;"Trnavský kraj";4;0;0;0;NA;90440;4;2020-08-21;302
2020-08-20;"Trnavský kraj";23;0;0;0;NA;90440;23;2020-08-20;298
2020-08-19;"Trnavský kraj";13;0;0;0;NA;90440;13;2020-08-19;275
2020-08-18;"Trnavský kraj";20;0;0;0;NA;90440;20;2020-08-18;262
2020-08-17;"Trnavský kraj";3;0;0;0;NA;90440;3;2020-08-17;242
2020-08-16;"Trnavský kraj";0;0;0;0;NA;90440;0;2020-08-16;239
2020-08-15;"Trnavský kraj";7;0;0;0;NA;90440;7;2020-08-15;239
2020-08-14;"Trnavský kraj";6;0;0;0;NA;90440;6;2020-08-14;232
2020-08-13;"Trnavský kraj";10;0;0;0;NA;90440;10;2020-08-13;226
2020-08-12;"Trnavský kraj";2;0;0;0;NA;90440;2;2020-08-12;216
2020-08-11;"Trnavský kraj";30;0;0;0;NA;90440;30;2020-08-11;214
2020-08-10;"Trnavský kraj";0;0;0;0;NA;90440;0;2020-08-10;184
2020-08-09;"Trnavský kraj";0;0;0;0;NA;90440;0;2020-08-09;184
2020-08-08;"Trnavský kraj";13;0;0;0;NA;90440;13;2020-08-08;184
2020-08-07;"Trnavský kraj";4;0;0;0;NA;90440;4;2020-08-07;171
2020-08-06;"Trnavský kraj";4;0;0;0;NA;90440;4;2020-08-06;167
2020-08-05;"Trnavský kraj";0;0;0;0;NA;90440;0;2020-08-05;163
2020-08-04;"Trnavský kraj";1;0;0;0;NA;90440;1;2020-08-04;163
2020-08-03;"Trnavský kraj";2;0;0;0;NA;90440;2;2020-08-03;162
2020-08-02;"Trnavský kraj";1;0;0;0;NA;90440;1;2020-08-02;160
2020-08-01;"Trnavský kraj";0;0;0;0;NA;90440;0;2020-08-01;159
2020-07-31;"Trnavský kraj";7;0;0;0;NA;90440;7;2020-07-31;159
2020-07-30;"Trnavský kraj";6;0;0;0;NA;90440;6;2020-07-30;152
2020-07-29;"Trnavský kraj";0;0;0;0;NA;90440;0;2020-07-29;146
2020-07-28;"Trnavský kraj";1;0;0;0;NA;90440;1;2020-07-28;146
2020-07-27;"Trnavský kraj";2;0;0;0;NA;90440;2;2020-07-27;145
2020-07-26;"Trnavský kraj";0;0;0;0;NA;90440;0;2020-07-26;143
2020-07-25;"Trnavský kraj";0;0;0;0;NA;90440;0;2020-07-25;143
2020-07-24;"Trnavský kraj";1;0;0;0;NA;90440;1;2020-07-24;143
2020-07-23;"Trnavský kraj";2;0;0;0;NA;90440;2;2020-07-23;142
2020-07-22;"Trnavský kraj";1;0;0;0;NA;90440;1;2020-07-22;140
2020-07-21;"Trnavský kraj";2;0;0;0;NA;90440;2;2020-07-21;139
2020-07-20;"Trnavský kraj";0;0;0;0;NA;90440;0;2020-07-20;137
2020-07-19;"Trnavský kraj";0;0;0;0;NA;90440;0;2020-07-19;137
2020-07-18;"Trnavský kraj";0;0;0;0;NA;90440;0;2020-07-18;137
2020-07-17;"Trnavský kraj";0;0;0;0;NA;90440;0;2020-07-17;137
2020-07-16;"Trnavský kraj";0;0;0;0;NA;90440;0;2020-07-16;137
2020-07-15;"Trnavský kraj";1;0;0;0;NA;90440;1;2020-07-15;137
2020-07-14;"Trnavský kraj";0;0;0;0;NA;90440;0;2020-07-14;136
2020-07-13;"Trnavský kraj";0;0;0;0;NA;90440;0;2020-07-13;136
2020-07-12;"Trnavský kraj";0;0;0;0;NA;90440;0;2020-07-12;136
2020-07-11;"Trnavský kraj";0;0;0;0;NA;90440;0;2020-07-11;136
2020-07-10;"Trnavský kraj";0;0;0;0;NA;90440;0;2020-07-10;136
2020-07-09;"Trnavský kraj";0;0;0;0;NA;90440;0;2020-07-09;136
2020-07-08;"Trnavský kraj";3;0;0;0;NA;90440;3;2020-07-08;136
2020-07-07;"Trnavský kraj";4;0;0;0;NA;90440;4;2020-07-07;133
2020-07-06;"Trnavský kraj";0;0;0;0;NA;90440;0;2020-07-06;129
2020-07-05;"Trnavský kraj";0;0;0;0;NA;90440;0;2020-07-05;129
2020-07-04;"Trnavský kraj";0;0;0;0;NA;90440;0;2020-07-04;129
2020-07-03;"Trnavský kraj";0;0;0;0;NA;90440;0;2020-07-03;129
2020-07-02;"Trnavský kraj";3;0;0;0;NA;90440;3;2020-07-02;129
2020-07-01;"Trnavský kraj";0;0;0;0;NA;90440;0;2020-07-01;126
2020-06-30;"Trnavský kraj";0;0;0;0;NA;90440;0;2020-06-30;126
2020-06-29;"Trnavský kraj";0;0;0;0;NA;90440;0;2020-06-29;126
2020-06-28;"Trnavský kraj";0;0;0;0;NA;90440;0;2020-06-28;126
2020-06-27;"Trnavský kraj";0;0;0;0;NA;90440;0;2020-06-27;126
2020-06-26;"Trnavský kraj";0;0;0;0;NA;90440;0;2020-06-26;126
2020-06-25;"Trnavský kraj";0;0;0;0;NA;90440;0;2020-06-25;126
2020-06-24;"Trnavský kraj";0;0;0;0;NA;90440;0;2020-06-24;126
2020-06-23;"Trnavský kraj";0;0;0;0;NA;90440;0;2020-06-23;126
2020-06-22;"Trnavský kraj";0;0;0;0;NA;90440;0;2020-06-22;126
2020-06-21;"Trnavský kraj";0;0;0;0;NA;90440;0;2020-06-21;126
2020-06-20;"Trnavský kraj";0;0;0;0;NA;90440;0;2020-06-20;126
2020-06-19;"Trnavský kraj";0;0;0;0;NA;90440;0;2020-06-19;126
2020-06-18;"Trnavský kraj";2;0;0;0;NA;90440;2;2020-06-18;126
2020-06-17;"Trnavský kraj";0;0;0;0;NA;90440;0;2020-06-17;124
2020-06-16;"Trnavský kraj";0;0;0;0;NA;90440;0;2020-06-16;124
2020-06-14;"Trnavský kraj";0;0;0;0;NA;90440;0;2020-06-14;124
2020-06-13;"Trnavský kraj";0;0;0;0;NA;90440;0;2020-06-13;124
2020-06-12;"Trnavský kraj";0;0;0;0;NA;90440;0;2020-06-12;124
2020-06-11;"Trnavský kraj";0;0;0;0;NA;90440;0;2020-06-11;124
2020-06-10;"Trnavský kraj";0;0;0;0;NA;90440;0;2020-06-10;124
2020-06-09;"Trnavský kraj";0;0;0;0;NA;90440;0;2020-06-09;124
2020-06-08;"Trnavský kraj";0;0;0;0;NA;90440;0;2020-06-08;124
2020-06-07;"Trnavský kraj";0;0;0;0;NA;90440;0;2020-06-07;124
2020-06-05;"Trnavský kraj";0;0;0;0;NA;90440;0;2020-06-05;124
2020-06-03;"Trnavský kraj";0;0;0;0;NA;90440;0;2020-06-03;124
2020-06-02;"Trnavský kraj";0;0;0;0;NA;90440;0;2020-06-02;124
2020-05-31;"Trnavský kraj";0;0;0;0;NA;90440;0;2020-05-31;124
2020-05-29;"Trnavský kraj";0;0;0;0;NA;90440;0;2020-05-29;124
2020-05-27;"Trnavský kraj";0;0;0;0;NA;90440;0;2020-05-27;124
2020-05-26;"Trnavský kraj";0;0;0;0;NA;90440;0;2020-05-26;124
2020-05-25;"Trnavský kraj";1;0;0;0;NA;90440;1;2020-05-25;124
2020-05-24;"Trnavský kraj";0;0;0;0;NA;90440;0;2020-05-24;123
2020-05-23;"Trnavský kraj";2;0;0;0;NA;90440;2;2020-05-23;123
2020-05-22;"Trnavský kraj";0;0;0;0;NA;90440;0;2020-05-22;121
2020-05-21;"Trnavský kraj";0;0;0;0;NA;90440;0;2020-05-21;121
2020-05-20;"Trnavský kraj";2;0;0;0;NA;90440;2;2020-05-20;121
2020-05-19;"Trnavský kraj";0;0;0;0;NA;90440;0;2020-05-19;119
2020-05-17;"Trnavský kraj";0;0;0;0;NA;90440;0;2020-05-17;119
2020-05-16;"Trnavský kraj";0;0;0;0;NA;90440;0;2020-05-16;119
2020-05-15;"Trnavský kraj";1;0;0;0;NA;90440;1;2020-05-15;119
2020-05-14;"Trnavský kraj";0;0;0;0;NA;90440;0;2020-05-14;118
2020-05-13;"Trnavský kraj";0;0;0;0;NA;90440;0;2020-05-13;118
2020-05-12;"Trnavský kraj";0;0;0;0;NA;90440;0;2020-05-12;118
2020-05-11;"Trnavský kraj";2;0;0;0;NA;90440;2;2020-05-11;118
2020-05-09;"Trnavský kraj";0;0;0;0;NA;90440;0;2020-05-09;116
2020-05-07;"Trnavský kraj";0;0;0;0;NA;90440;0;2020-05-07;116
2020-05-06;"Trnavský kraj";0;0;0;0;NA;90440;0;2020-05-06;116
2020-05-05;"Trnavský kraj";0;0;0;0;NA;90440;0;2020-05-05;116
2020-05-04;"Trnavský kraj";0;0;0;0;NA;90440;0;2020-05-04;116
2020-05-03;"Trnavský kraj";0;0;0;0;NA;90440;0;2020-05-03;116
2020-05-02;"Trnavský kraj";0;0;0;0;NA;90440;0;2020-05-02;116
2020-05-01;"Trnavský kraj";0;0;0;0;NA;90440;0;2020-05-01;116
2020-04-30;"Trnavský kraj";0;0;0;0;NA;90440;0;2020-04-30;116
2020-04-29;"Trnavský kraj";0;0;0;0;NA;90440;0;2020-04-29;116
2020-04-28;"Trnavský kraj";1;0;0;0;NA;90440;1;2020-04-28;116
2020-04-27;"Trnavský kraj";0;0;0;0;NA;90440;0;2020-04-27;115
2020-04-26;"Trnavský kraj";0;0;0;0;NA;90440;0;2020-04-26;115
2020-04-25;"Trnavský kraj";2;0;0;0;NA;90440;2;2020-04-25;115
2020-04-24;"Trnavský kraj";4;0;0;0;NA;90440;4;2020-04-24;113
2020-04-23;"Trnavský kraj";5;0;0;0;NA;90440;5;2020-04-23;109
2020-04-22;"Trnavský kraj";10;0;0;0;NA;90440;10;2020-04-22;104
2020-04-21;"Trnavský kraj";5;0;0;0;NA;90440;5;2020-04-21;94
2020-04-20;"Trnavský kraj";0;0;0;0;NA;90440;0;2020-04-20;89
2020-04-19;"Trnavský kraj";1;0;0;0;NA;90440;1;2020-04-19;89
2020-04-18;"Trnavský kraj";4;0;0;0;NA;90440;4;2020-04-18;88
2020-04-17;"Trnavský kraj";7;0;0;0;NA;90440;7;2020-04-17;84
2020-04-16;"Trnavský kraj";5;0;0;0;NA;90440;5;2020-04-16;77
2020-04-15;"Trnavský kraj";5;0;0;0;NA;90440;5;2020-04-15;72
2020-04-14;"Trnavský kraj";1;0;0;0;NA;90440;1;2020-04-14;67
2020-04-13;"Trnavský kraj";0;0;0;0;NA;90440;0;2020-04-13;66
2020-04-12;"Trnavský kraj";0;0;0;0;NA;90440;0;2020-04-12;66
2020-04-11;"Trnavský kraj";0;0;0;0;NA;90440;0;2020-04-11;66
2020-04-10;"Trnavský kraj";2;0;0;0;NA;90440;2;2020-04-10;66
2020-04-09;"Trnavský kraj";3;0;0;0;NA;90440;3;2020-04-09;64
2020-04-08;"Trnavský kraj";4;0;0;0;NA;90440;4;2020-04-08;61
2020-04-07;"Trnavský kraj";6;0;0;0;NA;90440;6;2020-04-07;57
2020-04-06;"Trnavský kraj";6;0;0;0;NA;90440;6;2020-04-06;51
2020-04-05;"Trnavský kraj";1;0;0;0;NA;90440;1;2020-04-05;45
2020-04-04;"Trnavský kraj";1;0;0;0;NA;90440;1;2020-04-04;44
2020-04-03;"Trnavský kraj";3;0;0;0;NA;90440;3;2020-04-03;43
2020-04-02;"Trnavský kraj";4;0;0;0;NA;90440;4;2020-04-02;40
2020-04-01;"Trnavský kraj";0;0;0;0;NA;90440;0;2020-04-01;36
2020-03-31;"Trnavský kraj";3;0;0;0;NA;90440;3;2020-03-31;36
2020-03-30;"Trnavský kraj";4;0;0;0;NA;90440;4;2020-03-30;33
2020-03-29;"Trnavský kraj";1;0;0;0;NA;90440;1;2020-03-29;29
2020-03-28;"Trnavský kraj";3;0;0;0;NA;90440;3;2020-03-28;28
2020-03-27;"Trnavský kraj";5;0;0;0;NA;90440;5;2020-03-27;25
2020-03-26;"Trnavský kraj";5;0;0;0;NA;90440;5;2020-03-26;20
2020-03-25;"Trnavský kraj";1;0;0;0;NA;90440;1;2020-03-25;15
2020-03-24;"Trnavský kraj";0;0;0;0;NA;90440;0;2020-03-24;14
2020-03-23;"Trnavský kraj";2;0;0;0;NA;90440;2;2020-03-23;14
2020-03-22;"Trnavský kraj";1;0;0;0;NA;90440;1;2020-03-22;12
2020-03-21;"Trnavský kraj";5;0;0;0;NA;90440;5;2020-03-21;11
2020-03-20;"Trnavský kraj";0;0;0;0;NA;90440;0;2020-03-20;6
2020-03-19;"Trnavský kraj";0;0;0;0;NA;90440;0;2020-03-19;6
2020-03-18;"Trnavský kraj";0;0;0;0;NA;90440;0;2020-03-18;6
2020-03-17;"Trnavský kraj";3;0;0;0;NA;90440;3;2020-03-17;6
2020-03-16;"Trnavský kraj";1;0;0;0;NA;90440;1;2020-03-16;3
2020-03-15;"Trnavský kraj";0;0;0;0;NA;90440;0;2020-03-15;2
2020-03-14;"Trnavský kraj";0;0;0;0;NA;90440;0;2020-03-14;2
2020-03-13;"Trnavský kraj";1;0;0;0;NA;90440;1;2020-03-13;2
2020-03-12;"Trnavský kraj";1;0;0;0;NA;90440;1;2020-03-12;1
2020-03-11;"Trnavský kraj";0;0;0;0;NA;90440;0;2020-03-11;0
2020-03-09;"Trnavský kraj";0;0;0;0;NA;90440;0;2020-03-09;0
2020-03-08;"Trnavský kraj";0;0;0;0;NA;90440;0;2020-03-08;0
2020-03-07;"Trnavský kraj";0;0;0;0;NA;90440;0;2020-03-07;0
2020-03-06;"Trnavský kraj";0;0;0;0;NA;90440;0;2020-03-06;0
2021-08-29;"Žilinský kraj";8;413;4;417;58256;108766;12;2021-08-29;108766
2021-08-28;"Žilinský kraj";2;891;1;892;NA;108766;3;2021-08-28;108754
2021-08-27;"Žilinský kraj";13;1631;12;1643;NA;108766;25;2021-08-27;108751
2021-08-26;"Žilinský kraj";17;1597;7;1604;NA;108766;24;2021-08-26;108726
2021-08-25;"Žilinský kraj";9;1175;11;1186;NA;108766;20;2021-08-25;108702
2021-08-24;"Žilinský kraj";6;1367;9;1376;NA;108766;15;2021-08-24;108682
2021-08-23;"Žilinský kraj";11;1841;7;1848;NA;108766;18;2021-08-23;108667
2021-08-22;"Žilinský kraj";2;692;3;695;NA;108766;5;2021-08-22;108649
2021-08-21;"Žilinský kraj";6;1154;2;1156;NA;108766;8;2021-08-21;108644
2021-08-20;"Žilinský kraj";7;2234;5;2239;NA;108766;12;2021-08-20;108636
2021-08-19;"Žilinský kraj";6;1291;3;1294;NA;108766;9;2021-08-19;108624
2021-08-18;"Žilinský kraj";4;1288;7;1295;NA;108766;11;2021-08-18;108615
2021-08-17;"Žilinský kraj";9;1184;3;1187;NA;108766;12;2021-08-17;108604
2021-08-16;"Žilinský kraj";14;1581;5;1586;NA;108766;19;2021-08-16;108592
2021-08-15;"Žilinský kraj";1;815;2;817;NA;108766;3;2021-08-15;108573
2021-08-14;"Žilinský kraj";5;1165;0;1165;NA;108766;5;2021-08-14;108570
2021-08-13;"Žilinský kraj";6;1612;0;1612;NA;108766;6;2021-08-13;108565
2021-08-12;"Žilinský kraj";4;1215;4;1219;NA;108766;8;2021-08-12;108559
2021-08-11;"Žilinský kraj";13;1219;3;1222;NA;108766;16;2021-08-11;108551
2021-08-10;"Žilinský kraj";12;1257;3;1260;NA;108766;15;2021-08-10;108535
2021-08-09;"Žilinský kraj";9;1103;1;1104;NA;108766;10;2021-08-09;108520
2021-08-08;"Žilinský kraj";1;727;5;732;NA;108766;6;2021-08-08;108510
2021-08-07;"Žilinský kraj";7;1165;1;1166;NA;108766;8;2021-08-07;108504
2021-08-06;"Žilinský kraj";1;1311;0;1311;NA;108766;1;2021-08-06;108496
2021-08-05;"Žilinský kraj";7;1124;3;1127;NA;108766;10;2021-08-05;108495
2021-08-04;"Žilinský kraj";12;853;0;853;NA;108766;12;2021-08-04;108485
2021-08-03;"Žilinský kraj";11;918;0;918;NA;108766;11;2021-08-03;108473
2021-08-02;"Žilinský kraj";5;1507;1;1508;NA;108766;6;2021-08-02;108462
2021-08-01;"Žilinský kraj";0;679;2;681;NA;108766;2;2021-08-01;108456
2021-07-31;"Žilinský kraj";4;1114;0;1114;NA;108766;4;2021-07-31;108454
2021-07-30;"Žilinský kraj";3;1590;0;1590;NA;108766;3;2021-07-30;108450
2021-07-29;"Žilinský kraj";1;1299;0;1299;NA;108766;1;2021-07-29;108447
2021-07-28;"Žilinský kraj";4;901;0;901;NA;108766;4;2021-07-28;108446
2021-07-27;"Žilinský kraj";11;1378;0;1378;NA;108766;11;2021-07-27;108442
2021-07-26;"Žilinský kraj";1;1292;1;1293;NA;108766;2;2021-07-26;108431
2021-07-25;"Žilinský kraj";2;828;2;830;NA;108766;4;2021-07-25;108429
2021-07-24;"Žilinský kraj";2;1338;2;1340;NA;108766;4;2021-07-24;108425
2021-07-23;"Žilinský kraj";4;1730;0;1730;NA;108766;4;2021-07-23;108421
2021-07-22;"Žilinský kraj";2;1207;0;1207;NA;108766;2;2021-07-22;108417
2021-07-21;"Žilinský kraj";2;1021;0;1021;NA;108766;2;2021-07-21;108415
2021-07-20;"Žilinský kraj";4;1439;0;1439;NA;108766;4;2021-07-20;108413
2021-07-19;"Žilinský kraj";4;1759;1;1760;NA;108766;5;2021-07-19;108409
2021-07-18;"Žilinský kraj";0;854;1;855;NA;108766;1;2021-07-18;108404
2021-07-17;"Žilinský kraj";0;1350;0;1350;NA;108766;0;2021-07-17;108403
2021-07-16;"Žilinský kraj";2;1740;0;1740;NA;108766;2;2021-07-16;108403
2021-07-15;"Žilinský kraj";2;1577;0;1577;NA;108766;2;2021-07-15;108401
2021-07-14;"Žilinský kraj";5;1042;1;1043;NA;108766;6;2021-07-14;108399
2021-07-13;"Žilinský kraj";3;1709;1;1710;NA;108766;4;2021-07-13;108393
2021-07-12;"Žilinský kraj";3;1321;1;1322;NA;108766;4;2021-07-12;108389
2021-07-11;"Žilinský kraj";2;989;0;989;NA;108766;2;2021-07-11;108385
2021-07-10;"Žilinský kraj";1;1511;4;1515;NA;108766;5;2021-07-10;108383
2021-07-09;"Žilinský kraj";1;2205;1;2206;NA;108766;2;2021-07-09;108378
2021-07-08;"Žilinský kraj";6;1776;3;1779;NA;108766;9;2021-07-08;108376
2021-07-07;"Žilinský kraj";1;1585;3;1588;NA;108766;4;2021-07-07;108367
2021-07-06;"Žilinský kraj";4;1956;0;1956;NA;108766;4;2021-07-06;108363
2021-07-05;"Žilinský kraj";2;911;1;912;NA;108766;3;2021-07-05;108359
2021-07-04;"Žilinský kraj";0;921;0;921;NA;108766;0;2021-07-04;108356
2021-07-03;"Žilinský kraj";1;1607;1;1608;NA;108766;2;2021-07-03;108356
2021-07-02;"Žilinský kraj";0;3428;3;3431;NA;108766;3;2021-07-02;108354
2021-07-01;"Žilinský kraj";1;1118;0;1118;NA;108766;1;2021-07-01;108351
2021-06-30;"Žilinský kraj";1;10382;6;10388;NA;108766;7;2021-06-30;108350
2021-06-29;"Žilinský kraj";10;5946;0;5946;NA;108766;10;2021-06-29;108343
2021-06-28;"Žilinský kraj";4;6245;2;6247;NA;108766;6;2021-06-28;108333
2021-06-27;"Žilinský kraj";3;4702;1;4703;NA;108766;4;2021-06-27;108327
2021-06-26;"Žilinský kraj";4;5919;0;5919;NA;108766;4;2021-06-26;108323
2021-06-25;"Žilinský kraj";8;9756;5;9761;NA;108766;13;2021-06-25;108319
2021-06-24;"Žilinský kraj";6;5657;3;5660;NA;108766;9;2021-06-24;108306
2021-06-23;"Žilinský kraj";7;5955;10;5965;NA;108766;17;2021-06-23;108297
2021-06-22;"Žilinský kraj";6;5214;8;5222;NA;108766;14;2021-06-22;108280
2021-06-21;"Žilinský kraj";6;6287;8;6295;NA;108766;14;2021-06-21;108266
2021-06-20;"Žilinský kraj";1;5531;8;5539;NA;108766;9;2021-06-20;108252
2021-06-19;"Žilinský kraj";9;8353;2;8355;NA;108766;11;2021-06-19;108243
2021-06-18;"Žilinský kraj";11;10624;12;10636;NA;108766;23;2021-06-18;108232
2021-06-17;"Žilinský kraj";10;6092;12;6104;NA;108766;22;2021-06-17;108209
2021-06-16;"Žilinský kraj";17;5786;11;5797;NA;108766;28;2021-06-16;108187
2021-06-15;"Žilinský kraj";13;5996;13;6009;NA;108766;26;2021-06-15;108159
2021-06-14;"Žilinský kraj";10;7554;21;7575;NA;108766;31;2021-06-14;108133
2021-06-13;"Žilinský kraj";2;6682;9;6691;NA;108766;11;2021-06-13;108102
2021-06-12;"Žilinský kraj";9;8634;11;8645;NA;108766;20;2021-06-12;108091
2021-06-11;"Žilinský kraj";11;11566;14;11580;NA;108766;25;2021-06-11;108071
2021-06-10;"Žilinský kraj";14;6788;14;6802;NA;108766;28;2021-06-10;108046
2021-06-09;"Žilinský kraj";23;5925;14;5939;NA;108766;37;2021-06-09;108018
2021-06-08;"Žilinský kraj";18;6615;16;6631;NA;108766;34;2021-06-08;107981
2021-06-07;"Žilinský kraj";25;8534;21;8555;NA;108766;46;2021-06-07;107947
2021-06-06;"Žilinský kraj";10;8056;27;8083;NA;108766;37;2021-06-06;107901
2021-06-05;"Žilinský kraj";8;9175;10;9185;NA;108766;18;2021-06-05;107864
2021-06-04;"Žilinský kraj";19;12215;34;12249;NA;108766;53;2021-06-04;107846
2021-06-03;"Žilinský kraj";12;7033;33;7066;NA;108766;45;2021-06-03;107793
2021-06-02;"Žilinský kraj";17;7090;28;7118;NA;108766;45;2021-06-02;107748
2021-06-01;"Žilinský kraj";38;8285;46;8331;NA;108766;84;2021-06-01;107703
2021-05-31;"Žilinský kraj";31;9616;59;9675;NA;108766;90;2021-05-31;107619
2021-05-30;"Žilinský kraj";21;9025;35;9060;NA;108766;56;2021-05-30;107529
2021-05-29;"Žilinský kraj";13;11195;23;11218;NA;108766;36;2021-05-29;107473
2021-05-28;"Žilinský kraj";28;13277;30;13307;NA;108766;58;2021-05-28;107437
2021-05-27;"Žilinský kraj";17;8267;39;8306;NA;108766;56;2021-05-27;107379
2021-05-26;"Žilinský kraj";20;8329;25;8354;NA;108766;45;2021-05-26;107323
2021-05-25;"Žilinský kraj";21;9624;38;9662;NA;108766;59;2021-05-25;107278
2021-05-24;"Žilinský kraj";36;11487;57;11544;NA;108766;93;2021-05-24;107219
2021-05-23;"Žilinský kraj";4;10923;56;10979;NA;108766;60;2021-05-23;107126
2021-05-22;"Žilinský kraj";21;11893;28;11921;NA;108766;49;2021-05-22;107066
2021-05-21;"Žilinský kraj";28;15654;50;15704;NA;108766;78;2021-05-21;107017
2021-05-20;"Žilinský kraj";30;9616;30;9646;NA;108766;60;2021-05-20;106939
2021-05-19;"Žilinský kraj";46;8693;41;8734;NA;108766;87;2021-05-19;106879
2021-05-18;"Žilinský kraj";52;10609;44;10653;NA;108766;96;2021-05-18;106792
2021-05-17;"Žilinský kraj";51;12676;84;12760;NA;108766;135;2021-05-17;106696
2021-05-16;"Žilinský kraj";13;14114;42;14156;NA;108766;55;2021-05-16;106561
2021-05-15;"Žilinský kraj";30;18404;35;18439;NA;108766;65;2021-05-15;106506
2021-05-14;"Žilinský kraj";34;21205;82;21287;NA;108766;116;2021-05-14;106441
2021-05-13;"Žilinský kraj";64;11865;51;11916;NA;108766;115;2021-05-13;106325
2021-05-12;"Žilinský kraj";57;10337;51;10388;NA;108766;108;2021-05-12;106210
2021-05-11;"Žilinský kraj";70;12174;51;12225;NA;108766;121;2021-05-11;106102
2021-05-10;"Žilinský kraj";69;16182;72;16254;NA;108766;141;2021-05-10;105981
2021-05-09;"Žilinský kraj";58;20385;77;20462;NA;108766;135;2021-05-09;105840
2021-05-08;"Žilinský kraj";0;24133;63;24196;NA;108766;63;2021-05-08;105705
2021-05-07;"Žilinský kraj";65;26522;87;26609;NA;108766;152;2021-05-07;105642
2021-05-06;"Žilinský kraj";67;16605;72;16677;NA;108766;139;2021-05-06;105490
2021-05-05;"Žilinský kraj";71;13096;73;13169;NA;108766;144;2021-05-05;105351
2021-05-04;"Žilinský kraj";81;16749;80;16829;NA;108766;161;2021-05-04;105207
2021-05-03;"Žilinský kraj";97;20391;111;20502;NA;108766;208;2021-05-03;105046
2021-05-02;"Žilinský kraj";8;28886;64;28950;NA;108766;72;2021-05-02;104838
2021-05-01;"Žilinský kraj";65;55053;105;55158;NA;108766;170;2021-05-01;104766
2021-04-30;"Žilinský kraj";84;44000;117;44117;NA;108766;201;2021-04-30;104596
2021-04-29;"Žilinský kraj";77;24566;101;24667;NA;108766;178;2021-04-29;104395
2021-04-28;"Žilinský kraj";76;19214;91;19305;NA;108766;167;2021-04-28;104217
2021-04-27;"Žilinský kraj";97;21805;110;21915;NA;108766;207;2021-04-27;104050
2021-04-26;"Žilinský kraj";114;27412;136;27548;NA;108766;250;2021-04-26;103843
2021-04-25;"Žilinský kraj";38;35750;82;35832;NA;108766;120;2021-04-25;103593
2021-04-24;"Žilinský kraj";93;78854;157;79011;NA;108766;250;2021-04-24;103473
2021-04-23;"Žilinský kraj";144;49440;153;49593;NA;108766;297;2021-04-23;103223
2021-04-22;"Žilinský kraj";110;25224;132;25356;NA;108766;242;2021-04-22;102926
2021-04-21;"Žilinský kraj";118;20616;145;20761;NA;108766;263;2021-04-21;102684
2021-04-20;"Žilinský kraj";128;23873;136;24009;NA;108766;264;2021-04-20;102421
2021-04-19;"Žilinský kraj";164;32773;210;32983;NA;108766;374;2021-04-19;102157
2021-04-18;"Žilinský kraj";18;36767;91;36858;NA;108766;109;2021-04-18;101783
2021-04-17;"Žilinský kraj";108;89377;156;89533;NA;108766;264;2021-04-17;101674
2021-04-16;"Žilinský kraj";185;47847;208;48055;NA;108766;393;2021-04-16;101410
2021-04-15;"Žilinský kraj";108;24830;130;24960;NA;108766;238;2021-04-15;101017
2021-04-14;"Žilinský kraj";135;23145;145;23290;NA;108766;280;2021-04-14;100779
2021-04-13;"Žilinský kraj";171;25050;135;25185;NA;108766;306;2021-04-13;100499
2021-04-12;"Žilinský kraj";266;30794;189;30983;NA;108766;455;2021-04-12;100193
2021-04-11;"Žilinský kraj";19;37126;107;37233;NA;108766;126;2021-04-11;99738
2021-04-10;"Žilinský kraj";111;86284;237;86521;NA;108766;348;2021-04-10;99612
2021-04-09;"Žilinský kraj";195;41973;206;42179;NA;108766;401;2021-04-09;99264
2021-04-08;"Žilinský kraj";179;24404;141;24545;NA;108766;320;2021-04-08;98863
2021-04-07;"Žilinský kraj";309;28651;174;28825;NA;108766;483;2021-04-07;98543
2021-04-06;"Žilinský kraj";308;40107;301;40408;NA;108766;609;2021-04-06;98060
2021-04-05;"Žilinský kraj";17;14747;140;14887;NA;108766;157;2021-04-05;97451
2021-04-04;"Žilinský kraj";17;16284;69;16353;NA;108766;86;2021-04-04;97294
2021-04-03;"Žilinský kraj";180;100699;403;101102;NA;108766;583;2021-04-03;97208
2021-04-02;"Žilinský kraj";73;22411;83;22494;NA;108766;156;2021-04-02;96625
2021-04-01;"Žilinský kraj";334;43264;240;43504;NA;108766;574;2021-04-01;96469
2021-03-31;"Žilinský kraj";170;31635;247;31882;NA;108766;417;2021-03-31;95895
2021-03-30;"Žilinský kraj";406;26323;243;26566;NA;108766;649;2021-03-30;95478
2021-03-29;"Žilinský kraj";297;28029;268;28297;NA;108766;565;2021-03-29;94829
2021-03-28;"Žilinský kraj";21;36206;239;36445;NA;108766;260;2021-03-28;94264
2021-03-27;"Žilinský kraj";151;89107;353;89460;NA;108766;504;2021-03-27;94004
2021-03-26;"Žilinský kraj";312;51757;330;52087;NA;108766;642;2021-03-26;93500
2021-03-25;"Žilinský kraj";281;27619;214;27833;NA;108766;495;2021-03-25;92858
2021-03-24;"Žilinský kraj";280;21268;260;21528;NA;108766;540;2021-03-24;92363
2021-03-23;"Žilinský kraj";418;23193;278;23471;NA;108766;696;2021-03-23;91823
2021-03-22;"Žilinský kraj";293;29289;314;29603;NA;108766;607;2021-03-22;91127
2021-03-21;"Žilinský kraj";32;33705;227;33932;NA;108766;259;2021-03-21;90520
2021-03-20;"Žilinský kraj";165;93015;497;93512;NA;108766;662;2021-03-20;90261
2021-03-19;"Žilinský kraj";357;51988;414;52402;NA;108766;771;2021-03-19;89599
2021-03-18;"Žilinský kraj";329;28459;294;28753;NA;108766;623;2021-03-18;88828
2021-03-17;"Žilinský kraj";395;21919;269;22188;NA;108766;664;2021-03-17;88205
2021-03-16;"Žilinský kraj";514;24341;317;24658;NA;108766;831;2021-03-16;87541
2021-03-15;"Žilinský kraj";341;29613;419;30032;NA;108766;760;2021-03-15;86710
2021-03-14;"Žilinský kraj";87;34121;267;34388;NA;108766;354;2021-03-14;85950
2021-03-13;"Žilinský kraj";113;93386;581;93967;NA;108766;694;2021-03-13;85596
2021-03-12;"Žilinský kraj";520;52329;411;52740;NA;108766;931;2021-03-12;84902
2021-03-11;"Žilinský kraj";399;28189;302;28491;NA;108766;701;2021-03-11;83971
2021-03-10;"Žilinský kraj";368;22414;378;22792;NA;108766;746;2021-03-10;83270
2021-03-09;"Žilinský kraj";537;24857;316;25173;NA;108766;853;2021-03-09;82524
2021-03-08;"Žilinský kraj";387;30873;458;31331;NA;108766;845;2021-03-08;81671
2021-03-07;"Žilinský kraj";48;33469;290;33759;NA;108766;338;2021-03-07;80826
2021-03-06;"Žilinský kraj";173;92410;589;92999;NA;108766;762;2021-03-06;80488
2021-03-05;"Žilinský kraj";369;51987;484;52471;NA;108766;853;2021-03-05;79726
2021-03-04;"Žilinský kraj";467;30037;377;30414;NA;108766;844;2021-03-04;78873
2021-03-03;"Žilinský kraj";448;26261;394;26655;NA;108766;842;2021-03-03;78029
2021-03-02;"Žilinský kraj";551;25913;378;26291;NA;108766;929;2021-03-02;77187
2021-03-01;"Žilinský kraj";375;30498;441;30939;NA;108766;816;2021-03-01;76258
2021-02-28;"Žilinský kraj";61;34802;327;35129;NA;108766;388;2021-02-28;75442
2021-02-27;"Žilinský kraj";159;83781;639;84420;NA;108766;798;2021-02-27;75054
2021-02-26;"Žilinský kraj";459;47500;508;48008;NA;108766;967;2021-02-26;74256
2021-02-25;"Žilinský kraj";347;30879;393;31272;NA;108766;740;2021-02-25;73289
2021-02-24;"Žilinský kraj";339;18760;395;19155;NA;108766;734;2021-02-24;72549
2021-02-23;"Žilinský kraj";437;22172;418;22590;NA;108766;855;2021-02-23;71815
2021-02-22;"Žilinský kraj";345;29270;438;29708;NA;108766;783;2021-02-22;70960
2021-02-21;"Žilinský kraj";36;28686;322;29008;NA;108766;358;2021-02-21;70177
2021-02-20;"Žilinský kraj";152;89944;671;90615;NA;108766;823;2021-02-20;69819
2021-02-19;"Žilinský kraj";337;45541;417;45958;NA;108766;754;2021-02-19;68996
2021-02-18;"Žilinský kraj";263;24662;337;24999;NA;108766;600;2021-02-18;68242
2021-02-17;"Žilinský kraj";269;17932;355;18287;NA;108766;624;2021-02-17;67642
2021-02-16;"Žilinský kraj";321;24298;325;24623;NA;108766;646;2021-02-16;67018
2021-02-15;"Žilinský kraj";230;30420;311;30731;NA;108766;541;2021-02-15;66372
2021-02-14;"Žilinský kraj";30;28574;231;28805;NA;108766;261;2021-02-14;65831
2021-02-13;"Žilinský kraj";91;69638;453;70091;NA;108766;544;2021-02-13;65570
2021-02-12;"Žilinský kraj";242;43338;336;43674;NA;108766;578;2021-02-12;65026
2021-02-11;"Žilinský kraj";228;23521;300;23821;NA;108766;528;2021-02-11;64448
2021-02-10;"Žilinský kraj";259;17894;267;18161;NA;108766;526;2021-02-10;63920
2021-02-09;"Žilinský kraj";377;24784;274;25058;NA;108766;651;2021-02-09;63394
2021-02-08;"Žilinský kraj";160;41375;390;41765;NA;108766;550;2021-02-08;62743
2021-02-07;"Žilinský kraj";24;46446;252;46698;NA;108766;276;2021-02-07;62193
2021-02-06;"Žilinský kraj";71;72880;367;73247;NA;108766;438;2021-02-06;61917
2021-02-05;"Žilinský kraj";248;31869;323;32192;NA;108766;571;2021-02-05;61479
2021-02-04;"Žilinský kraj";238;13240;258;13498;NA;108766;496;2021-02-04;60908
2021-02-03;"Žilinský kraj";194;9186;255;9441;NA;108766;449;2021-02-03;60412
2021-02-02;"Žilinský kraj";216;9280;272;9552;NA;108766;488;2021-02-02;59963
2021-02-01;"Žilinský kraj";220;19690;370;20060;NA;108766;590;2021-02-01;59475
2021-01-31;"Žilinský kraj";11;2652;27;2679;NA;108766;38;2021-01-31;58885
2021-01-30;"Žilinský kraj";85;18447;187;18634;NA;108766;272;2021-01-30;58847
2021-01-29;"Žilinský kraj";209;22891;304;23195;NA;108766;513;2021-01-29;58575
2021-01-28;"Žilinský kraj";240;5533;172;5705;NA;108766;412;2021-01-28;58062
2021-01-27;"Žilinský kraj";256;6725;119;6844;NA;108766;375;2021-01-27;57650
2021-01-26;"Žilinský kraj";245;49781;348;50129;NA;108766;593;2021-01-26;57275
2021-01-25;"Žilinský kraj";159;21245;150;21395;NA;108766;309;2021-01-25;56682
2021-01-24;"Žilinský kraj";22;55835;268;56103;NA;108766;290;2021-01-24;56373
2021-01-23;"Žilinský kraj";91;101730;444;102174;NA;108766;535;2021-01-23;56083
2021-01-22;"Žilinský kraj";163;32160;237;32397;NA;108766;400;2021-01-22;55548
2021-01-21;"Žilinský kraj";116;19828;181;20009;NA;108766;297;2021-01-21;55148
2021-01-20;"Žilinský kraj";236;17126;159;17285;NA;108766;395;2021-01-20;54851
2021-01-19;"Žilinský kraj";245;15730;285;16015;NA;108766;530;2021-01-19;54456
2021-01-18;"Žilinský kraj";236;12685;326;13011;NA;108766;562;2021-01-18;53926
2021-01-17;"Žilinský kraj";95;147;8;155;NA;108766;103;2021-01-17;53364
2021-01-16;"Žilinský kraj";14;516;31;547;NA;108766;45;2021-01-16;53261
2021-01-15;"Žilinský kraj";248;7486;209;7695;NA;108766;457;2021-01-15;53216
2021-01-14;"Žilinský kraj";166;5319;239;5558;NA;108766;405;2021-01-14;52759
2021-01-13;"Žilinský kraj";247;11263;557;11820;NA;108766;804;2021-01-13;52354
2021-01-12;"Žilinský kraj";376;8410;385;8795;NA;108766;761;2021-01-12;51550
2021-01-11;"Žilinský kraj";351;10058;465;10523;NA;108766;816;2021-01-11;50789
2021-01-10;"Žilinský kraj";38;229;6;235;NA;108766;44;2021-01-10;49973
2021-01-09;"Žilinský kraj";192;1282;60;1342;NA;108766;252;2021-01-09;49929
2021-01-08;"Žilinský kraj";413;8721;462;9183;NA;108766;875;2021-01-08;49677
2021-01-07;"Žilinský kraj";438;23407;1872;25279;NA;108766;2310;2021-01-07;48802
2021-01-06;"Žilinský kraj";145;1076;67;1143;NA;108766;212;2021-01-06;46492
2021-01-05;"Žilinský kraj";717;10227;796;11023;NA;108766;1513;2021-01-05;46280
2021-01-04;"Žilinský kraj";479;9313;893;10206;NA;108766;1372;2021-01-04;44767
2021-01-03;"Žilinský kraj";13;1006;107;1113;NA;108766;120;2021-01-03;43395
2021-01-02;"Žilinský kraj";98;789;91;880;NA;108766;189;2021-01-02;43275
2021-01-01;"Žilinský kraj";118;241;13;254;NA;108766;131;2021-01-01;43086
2020-12-31;"Žilinský kraj";395;9934;811;10745;NA;108766;1206;2020-12-31;42955
2020-12-30;"Žilinský kraj";1038;12071;852;12923;NA;108766;1890;2020-12-30;41749
2020-12-29;"Žilinský kraj";256;10650;1023;11673;NA;108766;1279;2020-12-29;39859
2020-12-28;"Žilinský kraj";406;11507;1086;12593;NA;108766;1492;2020-12-28;38580
2020-12-27;"Žilinský kraj";40;684;94;778;NA;108766;134;2020-12-27;37088
2020-12-26;"Žilinský kraj";135;593;48;641;NA;108766;183;2020-12-26;36954
2020-12-25;"Žilinský kraj";66;83;9;92;NA;108766;75;2020-12-25;36771
2020-12-24;"Žilinský kraj";643;667;55;722;NA;108766;698;2020-12-24;36696
2020-12-23;"Žilinský kraj";228;17294;1043;18337;NA;108766;1271;2020-12-23;35998
2020-12-22;"Žilinský kraj";519;13765;1013;14778;NA;108766;1532;2020-12-22;34727
2020-12-21;"Žilinský kraj";444;12942;1127;14069;NA;108766;1571;2020-12-21;33195
2020-12-20;"Žilinský kraj";36;598;80;678;NA;108766;116;2020-12-20;31624
2020-12-19;"Žilinský kraj";208;1678;127;1805;NA;108766;335;2020-12-19;31508
2020-12-18;"Žilinský kraj";333;7025;397;7422;NA;108766;730;2020-12-18;31173
2020-12-17;"Žilinský kraj";500;4235;281;4516;NA;108766;781;2020-12-17;30443
2020-12-16;"Žilinský kraj";333;4037;280;4317;NA;108766;613;2020-12-16;29662
2020-12-15;"Žilinský kraj";528;4081;359;4440;NA;108766;887;2020-12-15;29049
2020-12-14;"Žilinský kraj";321;4626;393;5019;NA;108766;714;2020-12-14;28162
2020-12-13;"Žilinský kraj";26;494;66;560;NA;108766;92;2020-12-13;27448
2020-12-12;"Žilinský kraj";95;767;46;813;NA;108766;141;2020-12-12;27356
2020-12-11;"Žilinský kraj";455;4518;258;4776;NA;108766;713;2020-12-11;27215
2020-12-10;"Žilinský kraj";166;9297;845;10142;NA;108766;1011;2020-12-10;26502
2020-12-09;"Žilinský kraj";392;2179;132;2311;NA;108766;524;2020-12-09;25491
2020-12-08;"Žilinský kraj";331;3127;101;3228;NA;108766;432;2020-12-08;24967
2020-12-07;"Žilinský kraj";348;2746;162;2908;NA;108766;510;2020-12-07;24535
2020-12-06;"Žilinský kraj";15;128;6;134;NA;108766;21;2020-12-06;24025
2020-12-05;"Žilinský kraj";98;781;41;822;NA;108766;139;2020-12-05;24004
2020-12-04;"Žilinský kraj";228;3091;107;3198;NA;108766;335;2020-12-04;23865
2020-12-03;"Žilinský kraj";237;1609;115;1724;NA;108766;352;2020-12-03;23530
2020-12-02;"Žilinský kraj";181;1710;94;1804;NA;108766;275;2020-12-02;23178
2020-12-01;"Žilinský kraj";209;6239;284;6523;NA;108766;493;2020-12-01;22903
2020-11-30;"Žilinský kraj";203;5326;305;5631;NA;108766;508;2020-11-30;22410
2020-11-29;"Žilinský kraj";18;81;7;88;NA;108766;25;2020-11-29;21902
2020-11-28;"Žilinský kraj";99;349;15;364;NA;108766;114;2020-11-28;21877
2020-11-27;"Žilinský kraj";218;904;46;950;NA;108766;264;2020-11-27;21763
2020-11-26;"Žilinský kraj";190;1041;54;1095;NA;108766;244;2020-11-26;21499
2020-11-25;"Žilinský kraj";225;1217;49;1266;NA;108766;274;2020-11-25;21255
2020-11-24;"Žilinský kraj";213;2139;67;2206;NA;108766;280;2020-11-24;20981
2020-11-23;"Žilinský kraj";170;759;44;803;NA;108766;214;2020-11-23;20701
2020-11-22;"Žilinský kraj";11;67;2;69;NA;108766;13;2020-11-22;20487
2020-11-21;"Žilinský kraj";61;505;20;525;NA;108766;81;2020-11-21;20474
2020-11-20;"Žilinský kraj";251;1074;45;1119;NA;108766;296;2020-11-20;20393
2020-11-19;"Žilinský kraj";252;752;61;813;NA;108766;313;2020-11-19;20097
2020-11-18;"Žilinský kraj";346;348;15;363;NA;108766;361;2020-11-18;19784
2020-11-17;"Žilinský kraj";123;490;15;505;NA;108766;138;2020-11-17;19423
2020-11-16;"Žilinský kraj";227;247;15;262;NA;108766;242;2020-11-16;19285
2020-11-15;"Žilinský kraj";63;13;0;13;NA;108766;63;2020-11-15;19043
2020-11-14;"Žilinský kraj";189;1038;11;1049;NA;108766;200;2020-11-14;18980
2020-11-13;"Žilinský kraj";181;125;9;134;NA;108766;190;2020-11-13;18780
2020-11-12;"Žilinský kraj";334;79;2;81;NA;108766;336;2020-11-12;18590
2020-11-11;"Žilinský kraj";489;147;10;157;NA;108766;499;2020-11-11;18254
2020-11-10;"Žilinský kraj";374;519;9;528;NA;108766;383;2020-11-10;17755
2020-11-09;"Žilinský kraj";143;2335;30;2365;NA;108766;173;2020-11-09;17372
2020-11-08;"Žilinský kraj";59;2538;37;2575;NA;108766;96;2020-11-08;17199
2020-11-07;"Žilinský kraj";312;8175;88;8263;NA;108766;400;2020-11-07;17103
2020-11-06;"Žilinský kraj";503;4090;38;4128;NA;108766;541;2020-11-06;16703
2020-11-05;"Žilinský kraj";473;64;4;68;NA;108766;477;2020-11-05;16162
2020-11-04;"Žilinský kraj";423;178;10;188;NA;108766;433;2020-11-04;15685
2020-11-03;"Žilinský kraj";688;889;16;905;NA;108766;704;2020-11-03;15252
2020-11-02;"Žilinský kraj";472;1043;39;1082;NA;108766;511;2020-11-02;14548
2020-11-01;"Žilinský kraj";349;5096;130;5226;NA;108766;479;2020-11-01;14037
2020-10-31;"Žilinský kraj";661;7963;203;8166;NA;108766;864;2020-10-31;13558
2020-10-30;"Žilinský kraj";529;2575;61;2636;NA;108766;590;2020-10-30;12694
2020-10-29;"Žilinský kraj";740;503;17;520;NA;108766;757;2020-10-29;12104
2020-10-28;"Žilinský kraj";635;105;11;116;NA;108766;646;2020-10-28;11347
2020-10-27;"Žilinský kraj";355;154;24;178;NA;108766;379;2020-10-27;10701
2020-10-26;"Žilinský kraj";148;117;28;145;NA;108766;176;2020-10-26;10322
2020-10-25;"Žilinský kraj";436;0;0;0;NA;108766;436;2020-10-25;10146
2020-10-24;"Žilinský kraj";803;0;0;0;NA;108766;803;2020-10-24;9710
2020-10-23;"Žilinský kraj";659;102;13;115;NA;108766;672;2020-10-23;8907
2020-10-22;"Žilinský kraj";525;33;3;36;NA;108766;528;2020-10-22;8235
2020-10-21;"Žilinský kraj";478;74;14;88;NA;108766;492;2020-10-21;7707
2020-10-20;"Žilinský kraj";524;127;8;135;NA;108766;532;2020-10-20;7215
2020-10-19;"Žilinský kraj";70;80;12;92;NA;108766;82;2020-10-19;6683
2020-10-18;"Žilinský kraj";159;0;0;0;NA;108766;159;2020-10-18;6601
2020-10-17;"Žilinský kraj";509;0;0;0;NA;108766;509;2020-10-17;6442
2020-10-16;"Žilinský kraj";603;51;9;60;NA;108766;612;2020-10-16;5933
2020-10-15;"Žilinský kraj";679;61;3;64;NA;108766;682;2020-10-15;5321
2020-10-14;"Žilinský kraj";523;269;6;275;NA;108766;529;2020-10-14;4639
2020-10-13;"Žilinský kraj";367;458;40;498;NA;108766;407;2020-10-13;4110
2020-10-12;"Žilinský kraj";62;0;0;0;NA;108766;62;2020-10-12;3703
2020-10-11;"Žilinský kraj";50;0;0;0;NA;108766;50;2020-10-11;3641
2020-10-10;"Žilinský kraj";213;0;0;0;NA;108766;213;2020-10-10;3591
2020-10-09;"Žilinský kraj";543;0;0;0;NA;108766;543;2020-10-09;3378
2020-10-08;"Žilinský kraj";238;0;0;0;NA;108766;238;2020-10-08;2835
2020-10-07;"Žilinský kraj";168;0;0;0;NA;108766;168;2020-10-07;2597
2020-10-06;"Žilinský kraj";233;0;0;0;NA;108766;233;2020-10-06;2429
2020-10-05;"Žilinský kraj";33;0;0;0;NA;108766;33;2020-10-05;2196
2020-10-04;"Žilinský kraj";35;0;0;0;NA;108766;35;2020-10-04;2163
2020-10-03;"Žilinský kraj";155;0;0;0;NA;108766;155;2020-10-03;2128
2020-10-02;"Žilinský kraj";105;0;0;0;NA;108766;105;2020-10-02;1973
2020-10-01;"Žilinský kraj";147;0;0;0;NA;108766;147;2020-10-01;1868
2020-09-30;"Žilinský kraj";163;0;0;0;NA;108766;163;2020-09-30;1721
2020-09-29;"Žilinský kraj";105;0;0;0;NA;108766;105;2020-09-29;1558
2020-09-28;"Žilinský kraj";34;0;0;0;NA;108766;34;2020-09-28;1453
2020-09-27;"Žilinský kraj";108;0;0;0;NA;108766;108;2020-09-27;1419
2020-09-26;"Žilinský kraj";96;0;0;0;NA;108766;96;2020-09-26;1311
2020-09-25;"Žilinský kraj";69;0;0;0;NA;108766;69;2020-09-25;1215
2020-09-24;"Žilinský kraj";100;0;0;0;NA;108766;100;2020-09-24;1146
2020-09-23;"Žilinský kraj";65;0;0;0;NA;108766;65;2020-09-23;1046
2020-09-22;"Žilinský kraj";65;0;0;0;NA;108766;65;2020-09-22;981
2020-09-21;"Žilinský kraj";47;0;0;0;NA;108766;47;2020-09-21;916
2020-09-20;"Žilinský kraj";4;0;0;0;NA;108766;4;2020-09-20;869
2020-09-19;"Žilinský kraj";6;0;0;0;NA;108766;6;2020-09-19;865
2020-09-18;"Žilinský kraj";82;0;0;0;NA;108766;82;2020-09-18;859
2020-09-17;"Žilinský kraj";30;0;0;0;NA;108766;30;2020-09-17;777
2020-09-16;"Žilinský kraj";34;0;0;0;NA;108766;34;2020-09-16;747
2020-09-15;"Žilinský kraj";12;0;0;0;NA;108766;12;2020-09-15;713
2020-09-14;"Žilinský kraj";39;0;0;0;NA;108766;39;2020-09-14;701
2020-09-13;"Žilinský kraj";6;0;0;0;NA;108766;6;2020-09-13;662
2020-09-12;"Žilinský kraj";4;0;0;0;NA;108766;4;2020-09-12;656
2020-09-11;"Žilinský kraj";31;0;0;0;NA;108766;31;2020-09-11;652
2020-09-10;"Žilinský kraj";31;0;0;0;NA;108766;31;2020-09-10;621
2020-09-09;"Žilinský kraj";23;0;0;0;NA;108766;23;2020-09-09;590
2020-09-08;"Žilinský kraj";25;0;0;0;NA;108766;25;2020-09-08;567
2020-09-07;"Žilinský kraj";11;0;0;0;NA;108766;11;2020-09-07;542
2020-09-06;"Žilinský kraj";0;0;0;0;NA;108766;0;2020-09-06;531
2020-09-05;"Žilinský kraj";2;0;0;0;NA;108766;2;2020-09-05;531
2020-09-04;"Žilinský kraj";33;0;0;0;NA;108766;33;2020-09-04;529
2020-09-03;"Žilinský kraj";18;0;0;0;NA;108766;18;2020-09-03;496
2020-09-02;"Žilinský kraj";16;0;0;0;NA;108766;16;2020-09-02;478
2020-09-01;"Žilinský kraj";4;0;0;0;NA;108766;4;2020-09-01;462
2020-08-31;"Žilinský kraj";5;0;0;0;NA;108766;5;2020-08-31;458
2020-08-30;"Žilinský kraj";3;0;0;0;NA;108766;3;2020-08-30;453
2020-08-29;"Žilinský kraj";5;0;0;0;NA;108766;5;2020-08-29;450
2020-08-28;"Žilinský kraj";13;0;0;0;NA;108766;13;2020-08-28;445
2020-08-27;"Žilinský kraj";18;0;0;0;NA;108766;18;2020-08-27;432
2020-08-26;"Žilinský kraj";8;0;0;0;NA;108766;8;2020-08-26;414
2020-08-25;"Žilinský kraj";2;0;0;0;NA;108766;2;2020-08-25;406
2020-08-24;"Žilinský kraj";5;0;0;0;NA;108766;5;2020-08-24;404
2020-08-23;"Žilinský kraj";0;0;0;0;NA;108766;0;2020-08-23;399
2020-08-22;"Žilinský kraj";0;0;0;0;NA;108766;0;2020-08-22;399
2020-08-21;"Žilinský kraj";10;0;0;0;NA;108766;10;2020-08-21;399
2020-08-20;"Žilinský kraj";13;0;0;0;NA;108766;13;2020-08-20;389
2020-08-19;"Žilinský kraj";7;0;0;0;NA;108766;7;2020-08-19;376
2020-08-18;"Žilinský kraj";9;0;0;0;NA;108766;9;2020-08-18;369
2020-08-17;"Žilinský kraj";1;0;0;0;NA;108766;1;2020-08-17;360
2020-08-16;"Žilinský kraj";0;0;0;0;NA;108766;0;2020-08-16;359
2020-08-15;"Žilinský kraj";0;0;0;0;NA;108766;0;2020-08-15;359
2020-08-14;"Žilinský kraj";4;0;0;0;NA;108766;4;2020-08-14;359
2020-08-13;"Žilinský kraj";2;0;0;0;NA;108766;2;2020-08-13;355
2020-08-12;"Žilinský kraj";0;0;0;0;NA;108766;0;2020-08-12;353
2020-08-11;"Žilinský kraj";4;0;0;0;NA;108766;4;2020-08-11;353
2020-08-10;"Žilinský kraj";1;0;0;0;NA;108766;1;2020-08-10;349
2020-08-09;"Žilinský kraj";0;0;0;0;NA;108766;0;2020-08-09;348
2020-08-08;"Žilinský kraj";3;0;0;0;NA;108766;3;2020-08-08;348
2020-08-07;"Žilinský kraj";8;0;0;0;NA;108766;8;2020-08-07;345
2020-08-06;"Žilinský kraj";1;0;0;0;NA;108766;1;2020-08-06;337
2020-08-05;"Žilinský kraj";1;0;0;0;NA;108766;1;2020-08-05;336
2020-08-04;"Žilinský kraj";2;0;0;0;NA;108766;2;2020-08-04;335
2020-08-03;"Žilinský kraj";0;0;0;0;NA;108766;0;2020-08-03;333
2020-08-02;"Žilinský kraj";1;0;0;0;NA;108766;1;2020-08-02;333
2020-08-01;"Žilinský kraj";0;0;0;0;NA;108766;0;2020-08-01;332
2020-07-31;"Žilinský kraj";4;0;0;0;NA;108766;4;2020-07-31;332
2020-07-30;"Žilinský kraj";2;0;0;0;NA;108766;2;2020-07-30;328
2020-07-29;"Žilinský kraj";2;0;0;0;NA;108766;2;2020-07-29;326
2020-07-28;"Žilinský kraj";4;0;0;0;NA;108766;4;2020-07-28;324
2020-07-27;"Žilinský kraj";6;0;0;0;NA;108766;6;2020-07-27;320
2020-07-26;"Žilinský kraj";0;0;0;0;NA;108766;0;2020-07-26;314
2020-07-25;"Žilinský kraj";0;0;0;0;NA;108766;0;2020-07-25;314
2020-07-24;"Žilinský kraj";2;0;0;0;NA;108766;2;2020-07-24;314
2020-07-23;"Žilinský kraj";0;0;0;0;NA;108766;0;2020-07-23;312
2020-07-22;"Žilinský kraj";1;0;0;0;NA;108766;1;2020-07-22;312
2020-07-21;"Žilinský kraj";2;0;0;0;NA;108766;2;2020-07-21;311
2020-07-20;"Žilinský kraj";3;0;0;0;NA;108766;3;2020-07-20;309
2020-07-19;"Žilinský kraj";0;0;0;0;NA;108766;0;2020-07-19;306
2020-07-18;"Žilinský kraj";0;0;0;0;NA;108766;0;2020-07-18;306
2020-07-17;"Žilinský kraj";2;0;0;0;NA;108766;2;2020-07-17;306
2020-07-16;"Žilinský kraj";2;0;0;0;NA;108766;2;2020-07-16;304
2020-07-15;"Žilinský kraj";2;0;0;0;NA;108766;2;2020-07-15;302
2020-07-14;"Žilinský kraj";1;0;0;0;NA;108766;1;2020-07-14;300
2020-07-13;"Žilinský kraj";0;0;0;0;NA;108766;0;2020-07-13;299
2020-07-12;"Žilinský kraj";0;0;0;0;NA;108766;0;2020-07-12;299
2020-07-11;"Žilinský kraj";2;0;0;0;NA;108766;2;2020-07-11;299
2020-07-10;"Žilinský kraj";3;0;0;0;NA;108766;3;2020-07-10;297
2020-07-09;"Žilinský kraj";2;0;0;0;NA;108766;2;2020-07-09;294
2020-07-08;"Žilinský kraj";10;0;0;0;NA;108766;10;2020-07-08;292
2020-07-07;"Žilinský kraj";7;0;0;0;NA;108766;7;2020-07-07;282
2020-07-06;"Žilinský kraj";0;0;0;0;NA;108766;0;2020-07-06;275
2020-07-05;"Žilinský kraj";0;0;0;0;NA;108766;0;2020-07-05;275
2020-07-04;"Žilinský kraj";10;0;0;0;NA;108766;10;2020-07-04;275
2020-07-03;"Žilinský kraj";18;0;0;0;NA;108766;18;2020-07-03;265
2020-07-02;"Žilinský kraj";7;0;0;0;NA;108766;7;2020-07-02;247
2020-07-01;"Žilinský kraj";0;0;0;0;NA;108766;0;2020-07-01;240
2020-06-30;"Žilinský kraj";4;0;0;0;NA;108766;4;2020-06-30;240
2020-06-29;"Žilinský kraj";0;0;0;0;NA;108766;0;2020-06-29;236
2020-06-28;"Žilinský kraj";1;0;0;0;NA;108766;1;2020-06-28;236
2020-06-27;"Žilinský kraj";3;0;0;0;NA;108766;3;2020-06-27;235
2020-06-26;"Žilinský kraj";5;0;0;0;NA;108766;5;2020-06-26;232
2020-06-25;"Žilinský kraj";7;0;0;0;NA;108766;7;2020-06-25;227
2020-06-24;"Žilinský kraj";11;0;0;0;NA;108766;11;2020-06-24;220
2020-06-23;"Žilinský kraj";9;0;0;0;NA;108766;9;2020-06-23;209
2020-06-22;"Žilinský kraj";0;0;0;0;NA;108766;0;2020-06-22;200
2020-06-21;"Žilinský kraj";1;0;0;0;NA;108766;1;2020-06-21;200
2020-06-20;"Žilinský kraj";1;0;0;0;NA;108766;1;2020-06-20;199
2020-06-19;"Žilinský kraj";4;0;0;0;NA;108766;4;2020-06-19;198
2020-06-18;"Žilinský kraj";1;0;0;0;NA;108766;1;2020-06-18;194
2020-06-17;"Žilinský kraj";0;0;0;0;NA;108766;0;2020-06-17;193
2020-06-16;"Žilinský kraj";1;0;0;0;NA;108766;1;2020-06-16;193
2020-06-14;"Žilinský kraj";0;0;0;0;NA;108766;0;2020-06-14;192
2020-06-13;"Žilinský kraj";0;0;0;0;NA;108766;0;2020-06-13;192
2020-06-12;"Žilinský kraj";0;0;0;0;NA;108766;0;2020-06-12;192
2020-06-11;"Žilinský kraj";0;0;0;0;NA;108766;0;2020-06-11;192
2020-06-10;"Žilinský kraj";0;0;0;0;NA;108766;0;2020-06-10;192
2020-06-09;"Žilinský kraj";1;0;0;0;NA;108766;1;2020-06-09;192
2020-06-08;"Žilinský kraj";0;0;0;0;NA;108766;0;2020-06-08;191
2020-06-07;"Žilinský kraj";0;0;0;0;NA;108766;0;2020-06-07;191
2020-06-05;"Žilinský kraj";0;0;0;0;NA;108766;0;2020-06-05;191
2020-06-03;"Žilinský kraj";0;0;0;0;NA;108766;0;2020-06-03;191
2020-06-02;"Žilinský kraj";0;0;0;0;NA;108766;0;2020-06-02;191
2020-05-31;"Žilinský kraj";0;0;0;0;NA;108766;0;2020-05-31;191
2020-05-29;"Žilinský kraj";0;0;0;0;NA;108766;0;2020-05-29;191
2020-05-27;"Žilinský kraj";1;0;0;0;NA;108766;1;2020-05-27;191
2020-05-26;"Žilinský kraj";1;0;0;0;NA;108766;1;2020-05-26;190
2020-05-25;"Žilinský kraj";0;0;0;0;NA;108766;0;2020-05-25;189
2020-05-24;"Žilinský kraj";0;0;0;0;NA;108766;0;2020-05-24;189
2020-05-23;"Žilinský kraj";0;0;0;0;NA;108766;0;2020-05-23;189
2020-05-22;"Žilinský kraj";0;0;0;0;NA;108766;0;2020-05-22;189
2020-05-21;"Žilinský kraj";0;0;0;0;NA;108766;0;2020-05-21;189
2020-05-20;"Žilinský kraj";0;0;0;0;NA;108766;0;2020-05-20;189
2020-05-19;"Žilinský kraj";1;0;0;0;NA;108766;1;2020-05-19;189
2020-05-17;"Žilinský kraj";0;0;0;0;NA;108766;0;2020-05-17;188
2020-05-16;"Žilinský kraj";0;0;0;0;NA;108766;0;2020-05-16;188
2020-05-15;"Žilinský kraj";0;0;0;0;NA;108766;0;2020-05-15;188
2020-05-14;"Žilinský kraj";0;0;0;0;NA;108766;0;2020-05-14;188
2020-05-13;"Žilinský kraj";0;0;0;0;NA;108766;0;2020-05-13;188
2020-05-12;"Žilinský kraj";0;0;0;0;NA;108766;0;2020-05-12;188
2020-05-11;"Žilinský kraj";0;0;0;0;NA;108766;0;2020-05-11;188
2020-05-09;"Žilinský kraj";0;0;0;0;NA;108766;0;2020-05-09;188
2020-05-07;"Žilinský kraj";0;0;0;0;NA;108766;0;2020-05-07;188
2020-05-06;"Žilinský kraj";2;0;0;0;NA;108766;2;2020-05-06;188
2020-05-05;"Žilinský kraj";3;0;0;0;NA;108766;3;2020-05-05;186
2020-05-04;"Žilinský kraj";3;0;0;0;NA;108766;3;2020-05-04;183
2020-05-03;"Žilinský kraj";1;0;0;0;NA;108766;1;2020-05-03;180
2020-05-02;"Žilinský kraj";0;0;0;0;NA;108766;0;2020-05-02;179
2020-05-01;"Žilinský kraj";1;0;0;0;NA;108766;1;2020-05-01;179
2020-04-30;"Žilinský kraj";0;0;0;0;NA;108766;0;2020-04-30;178
2020-04-29;"Žilinský kraj";0;0;0;0;NA;108766;0;2020-04-29;178
2020-04-28;"Žilinský kraj";0;0;0;0;NA;108766;0;2020-04-28;178
2020-04-27;"Žilinský kraj";0;0;0;0;NA;108766;0;2020-04-27;178
2020-04-26;"Žilinský kraj";0;0;0;0;NA;108766;0;2020-04-26;178
2020-04-25;"Žilinský kraj";2;0;0;0;NA;108766;2;2020-04-25;178
2020-04-24;"Žilinský kraj";1;0;0;0;NA;108766;1;2020-04-24;176
2020-04-23;"Žilinský kraj";2;0;0;0;NA;108766;2;2020-04-23;175
2020-04-22;"Žilinský kraj";9;0;0;0;NA;108766;9;2020-04-22;173
2020-04-21;"Žilinský kraj";1;0;0;0;NA;108766;1;2020-04-21;164
2020-04-20;"Žilinský kraj";4;0;0;0;NA;108766;4;2020-04-20;163
2020-04-19;"Žilinský kraj";0;0;0;0;NA;108766;0;2020-04-19;159
2020-04-18;"Žilinský kraj";49;0;0;0;NA;108766;49;2020-04-18;159
2020-04-17;"Žilinský kraj";3;0;0;0;NA;108766;3;2020-04-17;110
2020-04-16;"Žilinský kraj";4;0;0;0;NA;108766;4;2020-04-16;107
2020-04-15;"Žilinský kraj";7;0;0;0;NA;108766;7;2020-04-15;103
2020-04-14;"Žilinský kraj";1;0;0;0;NA;108766;1;2020-04-14;96
2020-04-13;"Žilinský kraj";2;0;0;0;NA;108766;2;2020-04-13;95
2020-04-12;"Žilinský kraj";5;0;0;0;NA;108766;5;2020-04-12;93
2020-04-11;"Žilinský kraj";2;0;0;0;NA;108766;2;2020-04-11;88
2020-04-10;"Žilinský kraj";1;0;0;0;NA;108766;1;2020-04-10;86
2020-04-09;"Žilinský kraj";1;0;0;0;NA;108766;1;2020-04-09;85
2020-04-08;"Žilinský kraj";3;0;0;0;NA;108766;3;2020-04-08;84
2020-04-07;"Žilinský kraj";5;0;0;0;NA;108766;5;2020-04-07;81
2020-04-06;"Žilinský kraj";6;0;0;0;NA;108766;6;2020-04-06;76
2020-04-05;"Žilinský kraj";8;0;0;0;NA;108766;8;2020-04-05;70
2020-04-04;"Žilinský kraj";0;0;0;0;NA;108766;0;2020-04-04;62
2020-04-03;"Žilinský kraj";3;0;0;0;NA;108766;3;2020-04-03;62
2020-04-02;"Žilinský kraj";5;0;0;0;NA;108766;5;2020-04-02;59
2020-04-01;"Žilinský kraj";4;0;0;0;NA;108766;4;2020-04-01;54
2020-03-31;"Žilinský kraj";1;0;0;0;NA;108766;1;2020-03-31;50
2020-03-30;"Žilinský kraj";3;0;0;0;NA;108766;3;2020-03-30;49
2020-03-29;"Žilinský kraj";0;0;0;0;NA;108766;0;2020-03-29;46
2020-03-28;"Žilinský kraj";1;0;0;0;NA;108766;1;2020-03-28;46
2020-03-27;"Žilinský kraj";9;0;0;0;NA;108766;9;2020-03-27;45
2020-03-26;"Žilinský kraj";4;0;0;0;NA;108766;4;2020-03-26;36
2020-03-25;"Žilinský kraj";1;0;0;0;NA;108766;1;2020-03-25;32
2020-03-24;"Žilinský kraj";2;0;0;0;NA;108766;2;2020-03-24;31
2020-03-23;"Žilinský kraj";3;0;0;0;NA;108766;3;2020-03-23;29
2020-03-22;"Žilinský kraj";1;0;0;0;NA;108766;1;2020-03-22;26
2020-03-21;"Žilinský kraj";2;0;0;0;NA;108766;2;2020-03-21;25
2020-03-20;"Žilinský kraj";4;0;0;0;NA;108766;4;2020-03-20;23
2020-03-19;"Žilinský kraj";2;0;0;0;NA;108766;2;2020-03-19;19
2020-03-18;"Žilinský kraj";1;0;0;0;NA;108766;1;2020-03-18;17
2020-03-17;"Žilinský kraj";5;0;0;0;NA;108766;5;2020-03-17;16
2020-03-16;"Žilinský kraj";1;0;0;0;NA;108766;1;2020-03-16;11
2020-03-15;"Žilinský kraj";2;0;0;0;NA;108766;2;2020-03-15;10
2020-03-14;"Žilinský kraj";1;0;0;0;NA;108766;1;2020-03-14;8
2020-03-13;"Žilinský kraj";5;0;0;0;NA;108766;5;2020-03-13;7
2020-03-12;"Žilinský kraj";1;0;0;0;NA;108766;1;2020-03-12;2
2020-03-11;"Žilinský kraj";0;0;0;0;NA;108766;0;2020-03-11;1
2020-03-09;"Žilinský kraj";1;0;0;0;NA;108766;1;2020-03-09;1
2020-03-08;"Žilinský kraj";0;0;0;0;NA;108766;0;2020-03-08;0
2020-03-07;"Žilinský kraj";0;0;0;0;NA;108766;0;2020-03-07;0
2020-03-06;"Žilinský kraj";0;0;0;0;NA;108766;0;2020-03-06;0
