"Datum";"Region";"PCR_Pos";"Ag_Neg";"Ag_Pos";"Total";"Pocet.potvrdenych";"Potvrdenych";"newcases";"date";"positive"
2022-03-08;"Banskobystrický kraj";1738;0;0;0;156343;240067;1738;2022-03-08;240067
2022-03-07;"Banskobystrický kraj";1048;0;0;0;NA;240067;1048;2022-03-07;238329
2022-03-06;"Banskobystrický kraj";356;524;194;718;NA;240067;550;2022-03-06;237281
2022-03-05;"Banskobystrický kraj";745;434;161;595;NA;240067;906;2022-03-05;236731
2022-03-04;"Banskobystrický kraj";1302;2440;362;2802;NA;240067;1664;2022-03-04;235825
2022-03-03;"Banskobystrický kraj";1766;3419;377;3796;NA;240067;2143;2022-03-03;234161
2022-03-02;"Banskobystrický kraj";1515;5602;415;6017;NA;240067;1930;2022-03-02;232018
2022-03-01;"Banskobystrický kraj";1842;3325;396;3721;NA;240067;2238;2022-03-01;230088
2022-02-28;"Banskobystrický kraj";1050;4913;708;5621;NA;240067;1758;2022-02-28;227850
2022-02-27;"Banskobystrický kraj";604;1162;303;1465;NA;240067;907;2022-02-27;226092
2022-02-26;"Banskobystrický kraj";909;528;154;682;NA;240067;1063;2022-02-26;225185
2022-02-25;"Banskobystrický kraj";1591;2517;430;2947;NA;240067;2021;2022-02-25;224122
2022-02-24;"Banskobystrický kraj";1781;3857;404;4261;NA;240067;2185;2022-02-24;222101
2022-02-23;"Banskobystrický kraj";2094;2869;454;3323;NA;240067;2548;2022-02-23;219916
2022-02-22;"Banskobystrický kraj";2195;3736;469;4205;NA;240067;2664;2022-02-22;217368
2022-02-21;"Banskobystrický kraj";1409;5730;806;6536;NA;240067;2215;2022-02-21;214704
2022-02-20;"Banskobystrický kraj";484;1717;423;2140;NA;240067;907;2022-02-20;212489
2022-02-19;"Banskobystrický kraj";1180;774;242;1016;NA;240067;1422;2022-02-19;211582
2022-02-18;"Banskobystrický kraj";2473;3620;541;4161;NA;240067;3014;2022-02-18;210160
2022-02-17;"Banskobystrický kraj";1924;4239;460;4699;NA;240067;2384;2022-02-17;207146
2022-02-16;"Banskobystrický kraj";1856;3633;543;4176;NA;240067;2399;2022-02-16;204762
2022-02-15;"Banskobystrický kraj";2287;4459;584;5043;NA;240067;2871;2022-02-15;202363
2022-02-14;"Banskobystrický kraj";2071;6841;891;7732;NA;240067;2962;2022-02-14;199492
2022-02-13;"Banskobystrický kraj";577;2247;471;2718;NA;240067;1048;2022-02-13;196530
2022-02-12;"Banskobystrický kraj";1308;906;308;1214;NA;240067;1616;2022-02-12;195482
2022-02-11;"Banskobystrický kraj";2684;3817;555;4372;NA;240067;3239;2022-02-11;193866
2022-02-10;"Banskobystrický kraj";1765;5732;567;6299;NA;240067;2332;2022-02-10;190627
2022-02-09;"Banskobystrický kraj";2544;3767;569;4336;NA;240067;3113;2022-02-09;188295
2022-02-08;"Banskobystrický kraj";1806;4417;538;4955;NA;240067;2344;2022-02-08;185182
2022-02-07;"Banskobystrický kraj";1683;7384;728;8112;NA;240067;2411;2022-02-07;182838
2022-02-06;"Banskobystrický kraj";604;2244;392;2636;NA;240067;996;2022-02-06;180427
2022-02-05;"Banskobystrický kraj";1032;1434;233;1667;NA;240067;1265;2022-02-05;179431
2022-02-04;"Banskobystrický kraj";1866;3745;438;4183;NA;240067;2304;2022-02-04;178166
2022-02-03;"Banskobystrický kraj";1561;5431;359;5790;NA;240067;1920;2022-02-03;175862
2022-02-02;"Banskobystrický kraj";1716;4780;395;5175;NA;240067;2111;2022-02-02;173942
2022-02-01;"Banskobystrický kraj";1918;4557;410;4967;NA;240067;2328;2022-02-01;171831
2022-01-31;"Banskobystrický kraj";779;9006;553;9559;NA;240067;1332;2022-01-31;169503
2022-01-30;"Banskobystrický kraj";412;3055;267;3322;NA;240067;679;2022-01-30;168171
2022-01-29;"Banskobystrický kraj";981;1155;174;1329;NA;240067;1155;2022-01-29;167492
2022-01-28;"Banskobystrický kraj";1040;3814;313;4127;NA;240067;1353;2022-01-28;166337
2022-01-27;"Banskobystrický kraj";1035;4955;225;5180;NA;240067;1260;2022-01-27;164984
2022-01-26;"Banskobystrický kraj";1060;4035;213;4248;NA;240067;1273;2022-01-26;163724
2022-01-25;"Banskobystrický kraj";1001;6118;257;6375;NA;240067;1258;2022-01-25;162451
2022-01-24;"Banskobystrický kraj";557;10186;257;10443;NA;240067;814;2022-01-24;161193
2022-01-23;"Banskobystrický kraj";246;3710;129;3839;NA;240067;375;2022-01-23;160379
2022-01-22;"Banskobystrický kraj";411;1077;64;1141;NA;240067;475;2022-01-22;160004
2022-01-21;"Banskobystrický kraj";578;3491;113;3604;NA;240067;691;2022-01-21;159529
2022-01-20;"Banskobystrický kraj";490;3809;91;3900;NA;240067;581;2022-01-20;158838
2022-01-19;"Banskobystrický kraj";421;4173;98;4271;NA;240067;519;2022-01-19;158257
2022-01-18;"Banskobystrický kraj";517;4737;95;4832;NA;240067;612;2022-01-18;157738
2022-01-17;"Banskobystrický kraj";269;8102;114;8216;NA;240067;383;2022-01-17;157126
2022-01-16;"Banskobystrický kraj";63;2746;84;2830;NA;240067;147;2022-01-16;156743
2022-01-15;"Banskobystrický kraj";287;858;16;874;NA;240067;303;2022-01-15;156596
2022-01-14;"Banskobystrický kraj";165;2758;67;2825;NA;240067;232;2022-01-14;156293
2022-01-13;"Banskobystrický kraj";182;3411;57;3468;NA;240067;239;2022-01-13;156061
2022-01-12;"Banskobystrický kraj";241;3787;67;3854;NA;240067;308;2022-01-12;155822
2022-01-11;"Banskobystrický kraj";327;4970;74;5044;NA;240067;401;2022-01-11;155514
2022-01-10;"Banskobystrický kraj";219;7978;108;8086;NA;240067;327;2022-01-10;155113
2022-01-09;"Banskobystrický kraj";54;3514;38;3552;NA;240067;92;2022-01-09;154786
2022-01-08;"Banskobystrický kraj";177;1054;40;1094;NA;240067;217;2022-01-08;154694
2022-01-07;"Banskobystrický kraj";320;3087;86;3173;NA;240067;406;2022-01-07;154477
2022-01-06;"Banskobystrický kraj";101;985;21;1006;NA;240067;122;2022-01-06;154071
2022-01-05;"Banskobystrický kraj";376;2852;67;2919;NA;240067;443;2022-01-05;153949
2022-01-04;"Banskobystrický kraj";458;4197;72;4269;NA;240067;530;2022-01-04;153506
2022-01-03;"Banskobystrický kraj";420;8216;115;8331;NA;240067;535;2022-01-03;152976
2022-01-02;"Banskobystrický kraj";117;2239;95;2334;NA;240067;212;2022-01-02;152441
2022-01-01;"Banskobystrický kraj";33;80;4;84;NA;240067;37;2022-01-01;152229
2021-12-31;"Banskobystrický kraj";314;1803;68;1871;NA;240067;382;2021-12-31;152192
2021-12-30;"Banskobystrický kraj";308;2833;88;2921;NA;240067;396;2021-12-30;151810
2021-12-29;"Banskobystrický kraj";390;2448;83;2531;NA;240067;473;2021-12-29;151414
2021-12-28;"Banskobystrický kraj";492;2902;95;2997;NA;240067;587;2021-12-28;150941
2021-12-27;"Banskobystrický kraj";397;5029;203;5232;NA;240067;600;2021-12-27;150354
2021-12-26;"Banskobystrický kraj";76;1245;62;1307;NA;240067;138;2021-12-26;149754
2021-12-25;"Banskobystrický kraj";107;373;45;418;NA;240067;152;2021-12-25;149616
2021-12-24;"Banskobystrický kraj";116;213;10;223;NA;240067;126;2021-12-24;149464
2021-12-23;"Banskobystrický kraj";429;3501;107;3608;NA;240067;536;2021-12-23;149338
2021-12-22;"Banskobystrický kraj";393;3394;106;3500;NA;240067;499;2021-12-22;148802
2021-12-21;"Banskobystrický kraj";508;4173;88;4261;NA;240067;596;2021-12-21;148303
2021-12-20;"Banskobystrický kraj";424;7610;186;7796;NA;240067;610;2021-12-20;147707
2021-12-19;"Banskobystrický kraj";39;2681;87;2768;NA;240067;126;2021-12-19;147097
2021-12-18;"Banskobystrický kraj";333;1036;67;1103;NA;240067;400;2021-12-18;146971
2021-12-17;"Banskobystrický kraj";465;3805;102;3907;NA;240067;567;2021-12-17;146571
2021-12-16;"Banskobystrický kraj";499;4278;116;4394;NA;240067;615;2021-12-16;146004
2021-12-15;"Banskobystrický kraj";554;4772;102;4874;NA;240067;656;2021-12-15;145389
2021-12-14;"Banskobystrický kraj";729;4614;108;4722;NA;240067;837;2021-12-14;144733
2021-12-13;"Banskobystrický kraj";470;8201;222;8423;NA;240067;692;2021-12-13;143896
2021-12-12;"Banskobystrický kraj";161;3332;101;3433;NA;240067;262;2021-12-12;143204
2021-12-11;"Banskobystrický kraj";568;1166;82;1248;NA;240067;650;2021-12-11;142942
2021-12-10;"Banskobystrický kraj";731;4033;185;4218;NA;240067;916;2021-12-10;142292
2021-12-09;"Banskobystrický kraj";652;4381;139;4520;NA;240067;791;2021-12-09;141376
2021-12-08;"Banskobystrický kraj";1087;4100;169;4269;NA;240067;1256;2021-12-08;140585
2021-12-07;"Banskobystrický kraj";1104;5410;201;5611;NA;240067;1305;2021-12-07;139329
2021-12-06;"Banskobystrický kraj";647;9113;324;9437;NA;240067;971;2021-12-06;138024
2021-12-05;"Banskobystrický kraj";217;3425;155;3580;NA;240067;372;2021-12-05;137053
2021-12-04;"Banskobystrický kraj";654;1334;131;1465;NA;240067;785;2021-12-04;136681
2021-12-03;"Banskobystrický kraj";1117;5057;246;5303;NA;240067;1363;2021-12-03;135896
2021-12-02;"Banskobystrický kraj";1710;5259;258;5517;NA;240067;1968;2021-12-02;134533
2021-12-01;"Banskobystrický kraj";947;4753;264;5017;NA;240067;1211;2021-12-01;132565
2021-11-30;"Banskobystrický kraj";1266;6543;245;6788;NA;240067;1511;2021-11-30;131354
2021-11-29;"Banskobystrický kraj";591;10653;468;11121;NA;240067;1059;2021-11-29;129843
2021-11-28;"Banskobystrický kraj";418;4289;216;4505;NA;240067;634;2021-11-28;128784
2021-11-27;"Banskobystrický kraj";827;1781;208;1989;NA;240067;1035;2021-11-27;128150
2021-11-26;"Banskobystrický kraj";963;4771;354;5125;NA;240067;1317;2021-11-26;127115
2021-11-25;"Banskobystrický kraj";1110;5911;350;6261;NA;240067;1460;2021-11-25;125798
2021-11-24;"Banskobystrický kraj";1387;5956;330;6286;NA;240067;1717;2021-11-24;124338
2021-11-23;"Banskobystrický kraj";1436;6082;377;6459;NA;240067;1813;2021-11-23;122621
2021-11-22;"Banskobystrický kraj";489;8727;579;9306;NA;240067;1068;2021-11-22;120808
2021-11-21;"Banskobystrický kraj";408;4109;307;4416;NA;240067;715;2021-11-21;119740
2021-11-20;"Banskobystrický kraj";985;1758;199;1957;NA;240067;1184;2021-11-20;119025
2021-11-19;"Banskobystrický kraj";1006;4886;470;5356;NA;240067;1476;2021-11-19;117841
2021-11-18;"Banskobystrický kraj";979;8037;620;8657;NA;240067;1599;2021-11-18;116365
2021-11-17;"Banskobystrický kraj";772;1051;147;1198;NA;240067;919;2021-11-17;114766
2021-11-16;"Banskobystrický kraj";1130;5473;453;5926;NA;240067;1583;2021-11-16;113847
2021-11-15;"Banskobystrický kraj";749;7884;588;8472;NA;240067;1337;2021-11-15;112264
2021-11-14;"Banskobystrický kraj";311;2629;302;2931;NA;240067;613;2021-11-14;110927
2021-11-13;"Banskobystrický kraj";761;1471;214;1685;NA;240067;975;2021-11-13;110314
2021-11-12;"Banskobystrický kraj";972;5019;434;5453;NA;240067;1406;2021-11-12;109339
2021-11-11;"Banskobystrický kraj";1023;5584;345;5929;NA;240067;1368;2021-11-11;107933
2021-11-10;"Banskobystrický kraj";950;4713;333;5046;NA;240067;1283;2021-11-10;106565
2021-11-09;"Banskobystrický kraj";921;4616;283;4899;NA;240067;1204;2021-11-09;105282
2021-11-08;"Banskobystrický kraj";519;7249;488;7737;NA;240067;1007;2021-11-08;104078
2021-11-07;"Banskobystrický kraj";460;2479;258;2737;NA;240067;718;2021-11-07;103071
2021-11-06;"Banskobystrický kraj";505;1344;170;1514;NA;240067;675;2021-11-06;102353
2021-11-05;"Banskobystrický kraj";997;4773;342;5115;NA;240067;1339;2021-11-05;101678
2021-11-04;"Banskobystrický kraj";1086;4811;248;5059;NA;240067;1334;2021-11-04;100339
2021-11-03;"Banskobystrický kraj";976;4825;330;5155;NA;240067;1306;2021-11-03;99005
2021-11-02;"Banskobystrický kraj";538;5709;492;6201;NA;240067;1030;2021-11-02;97699
2021-11-01;"Banskobystrický kraj";390;1178;132;1310;NA;240067;522;2021-11-01;96669
2021-10-31;"Banskobystrický kraj";150;1700;210;1910;NA;240067;360;2021-10-31;96147
2021-10-30;"Banskobystrický kraj";449;1508;140;1648;NA;240067;589;2021-10-30;95787
2021-10-29;"Banskobystrický kraj";780;4178;286;4464;NA;240067;1066;2021-10-29;95198
2021-10-28;"Banskobystrický kraj";744;4182;247;4429;NA;240067;991;2021-10-28;94132
2021-10-27;"Banskobystrický kraj";664;4577;233;4810;NA;240067;897;2021-10-27;93141
2021-10-26;"Banskobystrický kraj";700;3673;187;3860;NA;240067;887;2021-10-26;92244
2021-10-25;"Banskobystrický kraj";376;5478;257;5735;NA;240067;633;2021-10-25;91357
2021-10-24;"Banskobystrický kraj";161;1707;143;1850;NA;240067;304;2021-10-24;90724
2021-10-23;"Banskobystrický kraj";238;1286;79;1365;NA;240067;317;2021-10-23;90420
2021-10-22;"Banskobystrický kraj";530;3816;185;4001;NA;240067;715;2021-10-22;90103
2021-10-21;"Banskobystrický kraj";416;4128;140;4268;NA;240067;556;2021-10-21;89388
2021-10-20;"Banskobystrický kraj";387;3615;123;3738;NA;240067;510;2021-10-20;88832
2021-10-19;"Banskobystrický kraj";419;4094;103;4197;NA;240067;522;2021-10-19;88322
2021-10-18;"Banskobystrický kraj";162;5286;175;5461;NA;240067;337;2021-10-18;87800
2021-10-17;"Banskobystrický kraj";26;1555;71;1626;NA;240067;97;2021-10-17;87463
2021-10-16;"Banskobystrický kraj";162;1387;50;1437;NA;240067;212;2021-10-16;87366
2021-10-15;"Banskobystrický kraj";187;3693;81;3774;NA;240067;268;2021-10-15;87154
2021-10-14;"Banskobystrický kraj";198;3705;47;3752;NA;240067;245;2021-10-14;86886
2021-10-13;"Banskobystrický kraj";217;3068;55;3123;NA;240067;272;2021-10-13;86641
2021-10-12;"Banskobystrický kraj";301;3743;59;3802;NA;240067;360;2021-10-12;86369
2021-10-11;"Banskobystrický kraj";128;4734;96;4830;NA;240067;224;2021-10-11;86009
2021-10-10;"Banskobystrický kraj";26;1815;53;1868;NA;240067;79;2021-10-10;85785
2021-10-09;"Banskobystrický kraj";73;1122;27;1149;NA;240067;100;2021-10-09;85706
2021-10-08;"Banskobystrický kraj";239;3027;61;3088;NA;240067;300;2021-10-08;85606
2021-10-07;"Banskobystrický kraj";179;3437;42;3479;NA;240067;221;2021-10-07;85306
2021-10-06;"Banskobystrický kraj";136;3862;48;3910;NA;240067;184;2021-10-06;85085
2021-10-05;"Banskobystrický kraj";209;2979;54;3033;NA;240067;263;2021-10-05;84901
2021-10-04;"Banskobystrický kraj";126;3725;64;3789;NA;240067;190;2021-10-04;84638
2021-10-03;"Banskobystrický kraj";11;1407;34;1441;NA;240067;45;2021-10-03;84448
2021-10-02;"Banskobystrický kraj";66;1042;26;1068;NA;240067;92;2021-10-02;84403
2021-10-01;"Banskobystrický kraj";158;3228;51;3279;NA;240067;209;2021-10-01;84311
2021-09-30;"Banskobystrický kraj";120;3362;30;3392;NA;240067;150;2021-09-30;84102
2021-09-29;"Banskobystrický kraj";118;2626;40;2666;NA;240067;158;2021-09-29;83952
2021-09-28;"Banskobystrický kraj";112;3061;45;3106;NA;240067;157;2021-09-28;83794
2021-09-27;"Banskobystrický kraj";90;4456;72;4528;NA;240067;162;2021-09-27;83637
2021-09-26;"Banskobystrický kraj";17;1498;31;1529;NA;240067;48;2021-09-26;83475
2021-09-25;"Banskobystrický kraj";17;1481;7;1488;NA;240067;24;2021-09-25;83427
2021-09-24;"Banskobystrický kraj";98;4254;32;4286;NA;240067;130;2021-09-24;83403
2021-09-23;"Banskobystrický kraj";63;3019;13;3032;NA;240067;76;2021-09-23;83273
2021-09-22;"Banskobystrický kraj";75;2442;19;2461;NA;240067;94;2021-09-22;83197
2021-09-21;"Banskobystrický kraj";125;2976;20;2996;NA;240067;145;2021-09-21;83103
2021-09-20;"Banskobystrický kraj";45;3951;30;3981;NA;240067;75;2021-09-20;82958
2021-09-19;"Banskobystrický kraj";6;1456;24;1480;NA;240067;30;2021-09-19;82883
2021-09-18;"Banskobystrický kraj";44;1318;15;1333;NA;240067;59;2021-09-18;82853
2021-09-17;"Banskobystrický kraj";73;3485;32;3517;NA;240067;105;2021-09-17;82794
2021-09-16;"Banskobystrický kraj";95;3019;29;3048;NA;240067;124;2021-09-16;82689
2021-09-15;"Banskobystrický kraj";22;394;1;395;NA;240067;23;2021-09-15;82565
2021-09-14;"Banskobystrický kraj";95;2508;28;2536;NA;240067;123;2021-09-14;82542
2021-09-13;"Banskobystrický kraj";29;3206;28;3234;NA;240067;57;2021-09-13;82419
2021-09-12;"Banskobystrický kraj";7;958;15;973;NA;240067;22;2021-09-12;82362
2021-09-11;"Banskobystrický kraj";31;865;11;876;NA;240067;42;2021-09-11;82340
2021-09-10;"Banskobystrický kraj";59;2250;24;2274;NA;240067;83;2021-09-10;82298
2021-09-09;"Banskobystrický kraj";46;2011;17;2028;NA;240067;63;2021-09-09;82215
2021-09-08;"Banskobystrický kraj";46;1713;27;1740;NA;240067;73;2021-09-08;82152
2021-09-07;"Banskobystrický kraj";27;1422;21;1443;NA;240067;48;2021-09-07;82079
2021-09-06;"Banskobystrický kraj";26;2570;13;2583;NA;240067;39;2021-09-06;82031
2021-09-05;"Banskobystrický kraj";9;742;2;744;NA;240067;11;2021-09-05;81992
2021-09-04;"Banskobystrický kraj";14;745;10;755;NA;240067;24;2021-09-04;81981
2021-09-03;"Banskobystrický kraj";49;2116;22;2138;NA;240067;71;2021-09-03;81957
2021-09-02;"Banskobystrický kraj";19;1730;25;1755;NA;240067;44;2021-09-02;81886
2021-09-01;"Banskobystrický kraj";6;230;6;236;NA;240067;12;2021-09-01;81842
2021-08-31;"Banskobystrický kraj";18;1406;13;1419;NA;240067;31;2021-08-31;81830
2021-08-30;"Banskobystrický kraj";23;1867;10;1877;NA;240067;33;2021-08-30;81799
2021-08-29;"Banskobystrický kraj";0;351;5;356;NA;240067;5;2021-08-29;81766
2021-08-28;"Banskobystrický kraj";9;827;5;832;NA;240067;14;2021-08-28;81761
2021-08-27;"Banskobystrický kraj";7;1608;12;1620;NA;240067;19;2021-08-27;81747
2021-08-26;"Banskobystrický kraj";7;1161;2;1163;NA;240067;9;2021-08-26;81728
2021-08-25;"Banskobystrický kraj";6;1052;1;1053;NA;240067;7;2021-08-25;81719
2021-08-24;"Banskobystrický kraj";12;1117;1;1118;NA;240067;13;2021-08-24;81712
2021-08-23;"Banskobystrický kraj";7;1368;5;1373;NA;240067;12;2021-08-23;81699
2021-08-22;"Banskobystrický kraj";0;773;2;775;NA;240067;2;2021-08-22;81687
2021-08-21;"Banskobystrický kraj";3;793;1;794;NA;240067;4;2021-08-21;81685
2021-08-20;"Banskobystrický kraj";5;1616;4;1620;NA;240067;9;2021-08-20;81681
2021-08-19;"Banskobystrický kraj";4;1092;3;1095;NA;240067;7;2021-08-19;81672
2021-08-18;"Banskobystrický kraj";1;1044;1;1045;NA;240067;2;2021-08-18;81665
2021-08-17;"Banskobystrický kraj";12;890;0;890;NA;240067;12;2021-08-17;81663
2021-08-16;"Banskobystrický kraj";7;1321;3;1324;NA;240067;10;2021-08-16;81651
2021-08-15;"Banskobystrický kraj";0;366;3;369;NA;240067;3;2021-08-15;81641
2021-08-14;"Banskobystrický kraj";6;435;1;436;NA;240067;7;2021-08-14;81638
2021-08-13;"Banskobystrický kraj";11;898;0;898;NA;240067;11;2021-08-13;81631
2021-08-12;"Banskobystrický kraj";10;951;1;952;NA;240067;11;2021-08-12;81620
2021-08-11;"Banskobystrický kraj";7;575;3;578;NA;240067;10;2021-08-11;81609
2021-08-10;"Banskobystrický kraj";7;678;2;680;NA;240067;9;2021-08-10;81599
2021-08-09;"Banskobystrický kraj";9;1064;0;1064;NA;240067;9;2021-08-09;81590
2021-08-08;"Banskobystrický kraj";4;335;1;336;NA;240067;5;2021-08-08;81581
2021-08-07;"Banskobystrický kraj";0;308;4;312;NA;240067;4;2021-08-07;81576
2021-08-06;"Banskobystrický kraj";5;929;2;931;NA;240067;7;2021-08-06;81572
2021-08-05;"Banskobystrický kraj";2;838;1;839;NA;240067;3;2021-08-05;81565
2021-08-04;"Banskobystrický kraj";2;579;1;580;NA;240067;3;2021-08-04;81562
2021-08-03;"Banskobystrický kraj";4;743;0;743;NA;240067;4;2021-08-03;81559
2021-08-02;"Banskobystrický kraj";6;934;0;934;NA;240067;6;2021-08-02;81555
2021-08-01;"Banskobystrický kraj";0;271;0;271;NA;240067;0;2021-08-01;81549
2021-07-31;"Banskobystrický kraj";1;370;4;374;NA;240067;5;2021-07-31;81549
2021-07-30;"Banskobystrický kraj";27;928;2;930;NA;240067;29;2021-07-30;81544
2021-07-29;"Banskobystrický kraj";2;890;1;891;NA;240067;3;2021-07-29;81515
2021-07-28;"Banskobystrický kraj";4;520;1;521;NA;240067;5;2021-07-28;81512
2021-07-27;"Banskobystrický kraj";15;1092;0;1092;NA;240067;15;2021-07-27;81507
2021-07-26;"Banskobystrický kraj";2;911;1;912;NA;240067;3;2021-07-26;81492
2021-07-25;"Banskobystrický kraj";0;367;1;368;NA;240067;1;2021-07-25;81489
2021-07-24;"Banskobystrický kraj";2;298;0;298;NA;240067;2;2021-07-24;81488
2021-07-23;"Banskobystrický kraj";7;840;0;840;NA;240067;7;2021-07-23;81486
2021-07-22;"Banskobystrický kraj";5;727;3;730;NA;240067;8;2021-07-22;81479
2021-07-21;"Banskobystrický kraj";2;560;0;560;NA;240067;2;2021-07-21;81471
2021-07-20;"Banskobystrický kraj";6;885;2;887;NA;240067;8;2021-07-20;81469
2021-07-19;"Banskobystrický kraj";1;854;3;857;NA;240067;4;2021-07-19;81461
2021-07-18;"Banskobystrický kraj";0;377;1;378;NA;240067;1;2021-07-18;81457
2021-07-17;"Banskobystrický kraj";1;324;0;324;NA;240067;1;2021-07-17;81456
2021-07-16;"Banskobystrický kraj";3;974;1;975;NA;240067;4;2021-07-16;81455
2021-07-15;"Banskobystrický kraj";1;1038;0;1038;NA;240067;1;2021-07-15;81451
2021-07-14;"Banskobystrický kraj";3;765;0;765;NA;240067;3;2021-07-14;81450
2021-07-13;"Banskobystrický kraj";2;695;0;695;NA;240067;2;2021-07-13;81447
2021-07-12;"Banskobystrický kraj";1;1057;0;1057;NA;240067;1;2021-07-12;81445
2021-07-11;"Banskobystrický kraj";0;446;0;446;NA;240067;0;2021-07-11;81444
2021-07-10;"Banskobystrický kraj";2;368;0;368;NA;240067;2;2021-07-10;81444
2021-07-09;"Banskobystrický kraj";3;1209;0;1209;NA;240067;3;2021-07-09;81442
2021-07-08;"Banskobystrický kraj";0;1083;1;1084;NA;240067;1;2021-07-08;81439
2021-07-07;"Banskobystrický kraj";1;798;0;798;NA;240067;1;2021-07-07;81438
2021-07-06;"Banskobystrický kraj";6;1365;0;1365;NA;240067;6;2021-07-06;81437
2021-07-05;"Banskobystrický kraj";2;392;1;393;NA;240067;3;2021-07-05;81431
2021-07-04;"Banskobystrický kraj";0;318;0;318;NA;240067;0;2021-07-04;81428
2021-07-03;"Banskobystrický kraj";1;413;1;414;NA;240067;2;2021-07-03;81428
2021-07-02;"Banskobystrický kraj";3;1045;0;1045;NA;240067;3;2021-07-02;81426
2021-07-01;"Banskobystrický kraj";0;705;1;706;NA;240067;1;2021-07-01;81423
2021-06-30;"Banskobystrický kraj";3;7607;1;7608;NA;240067;4;2021-06-30;81422
2021-06-29;"Banskobystrický kraj";2;4642;1;4643;NA;240067;3;2021-06-29;81418
2021-06-28;"Banskobystrický kraj";3;5695;1;5696;NA;240067;4;2021-06-28;81415
2021-06-27;"Banskobystrický kraj";0;4369;5;4374;NA;240067;5;2021-06-27;81411
2021-06-26;"Banskobystrický kraj";0;4289;4;4293;NA;240067;4;2021-06-26;81406
2021-06-25;"Banskobystrický kraj";2;6717;2;6719;NA;240067;4;2021-06-25;81402
2021-06-24;"Banskobystrický kraj";6;4585;2;4587;NA;240067;8;2021-06-24;81398
2021-06-23;"Banskobystrický kraj";4;4947;0;4947;NA;240067;4;2021-06-23;81390
2021-06-22;"Banskobystrický kraj";7;4527;0;4527;NA;240067;7;2021-06-22;81386
2021-06-21;"Banskobystrický kraj";6;5836;8;5844;NA;240067;14;2021-06-21;81379
2021-06-20;"Banskobystrický kraj";0;5055;7;5062;NA;240067;7;2021-06-20;81365
2021-06-19;"Banskobystrický kraj";0;5639;4;5643;NA;240067;4;2021-06-19;81358
2021-06-18;"Banskobystrický kraj";4;7642;1;7643;NA;240067;5;2021-06-18;81354
2021-06-17;"Banskobystrický kraj";2;5245;3;5248;NA;240067;5;2021-06-17;81349
2021-06-16;"Banskobystrický kraj";10;5951;5;5956;NA;240067;15;2021-06-16;81344
2021-06-15;"Banskobystrický kraj";9;5576;6;5582;NA;240067;15;2021-06-15;81329
2021-06-14;"Banskobystrický kraj";8;6922;7;6929;NA;240067;15;2021-06-14;81314
2021-06-13;"Banskobystrický kraj";0;6407;7;6414;NA;240067;7;2021-06-13;81299
2021-06-12;"Banskobystrický kraj";3;6338;6;6344;NA;240067;9;2021-06-12;81292
2021-06-11;"Banskobystrický kraj";5;9693;15;9708;NA;240067;20;2021-06-11;81283
2021-06-10;"Banskobystrický kraj";10;5726;8;5734;NA;240067;18;2021-06-10;81263
2021-06-09;"Banskobystrický kraj";9;5720;4;5724;NA;240067;13;2021-06-09;81245
2021-06-08;"Banskobystrický kraj";15;5645;10;5655;NA;240067;25;2021-06-08;81232
2021-06-07;"Banskobystrický kraj";4;7582;21;7603;NA;240067;25;2021-06-07;81207
2021-06-06;"Banskobystrický kraj";1;7497;12;7509;NA;240067;13;2021-06-06;81182
2021-06-05;"Banskobystrický kraj";15;7531;9;7540;NA;240067;24;2021-06-05;81169
2021-06-04;"Banskobystrický kraj";2;9352;14;9366;NA;240067;16;2021-06-04;81145
2021-06-03;"Banskobystrický kraj";8;6507;24;6531;NA;240067;32;2021-06-03;81129
2021-06-02;"Banskobystrický kraj";7;6837;6;6843;NA;240067;13;2021-06-02;81097
2021-06-01;"Banskobystrický kraj";12;7146;14;7160;NA;240067;26;2021-06-01;81084
2021-05-31;"Banskobystrický kraj";4;9546;31;9577;NA;240067;35;2021-05-31;81058
2021-05-30;"Banskobystrický kraj";3;8959;19;8978;NA;240067;22;2021-05-30;81023
2021-05-29;"Banskobystrický kraj";11;9763;18;9781;NA;240067;29;2021-05-29;81001
2021-05-28;"Banskobystrický kraj";13;11905;27;11932;NA;240067;40;2021-05-28;80972
2021-05-27;"Banskobystrický kraj";7;8760;12;8772;NA;240067;19;2021-05-27;80932
2021-05-26;"Banskobystrický kraj";18;7905;17;7922;NA;240067;35;2021-05-26;80913
2021-05-25;"Banskobystrický kraj";27;8951;30;8981;NA;240067;57;2021-05-25;80878
2021-05-24;"Banskobystrický kraj";9;12469;44;12513;NA;240067;53;2021-05-24;80821
2021-05-23;"Banskobystrický kraj";0;9798;27;9825;NA;240067;27;2021-05-23;80768
2021-05-22;"Banskobystrický kraj";20;9608;26;9634;NA;240067;46;2021-05-22;80741
2021-05-21;"Banskobystrický kraj";22;12796;25;12821;NA;240067;47;2021-05-21;80695
2021-05-20;"Banskobystrický kraj";14;8994;25;9019;NA;240067;39;2021-05-20;80648
2021-05-19;"Banskobystrický kraj";42;8608;21;8629;NA;240067;63;2021-05-19;80609
2021-05-18;"Banskobystrický kraj";27;9450;25;9475;NA;240067;52;2021-05-18;80546
2021-05-17;"Banskobystrický kraj";11;13399;33;13432;NA;240067;44;2021-05-17;80494
2021-05-16;"Banskobystrický kraj";15;14072;26;14098;NA;240067;41;2021-05-16;80450
2021-05-15;"Banskobystrický kraj";11;15356;29;15385;NA;240067;40;2021-05-15;80409
2021-05-14;"Banskobystrický kraj";35;18939;45;18984;NA;240067;80;2021-05-14;80369
2021-05-13;"Banskobystrický kraj";37;10605;40;10645;NA;240067;77;2021-05-13;80289
2021-05-12;"Banskobystrický kraj";31;10857;45;10902;NA;240067;76;2021-05-12;80212
2021-05-11;"Banskobystrický kraj";42;11325;48;11373;NA;240067;90;2021-05-11;80136
2021-05-10;"Banskobystrický kraj";28;17621;68;17689;NA;240067;96;2021-05-10;80046
2021-05-09;"Banskobystrický kraj";25;21902;68;21970;NA;240067;93;2021-05-09;79950
2021-05-08;"Banskobystrický kraj";11;14285;26;14311;NA;240067;37;2021-05-08;79857
2021-05-07;"Banskobystrický kraj";41;21806;78;21884;NA;240067;119;2021-05-07;79820
2021-05-06;"Banskobystrický kraj";36;12251;70;12321;NA;240067;106;2021-05-06;79701
2021-05-05;"Banskobystrický kraj";34;12592;63;12655;NA;240067;97;2021-05-05;79595
2021-05-04;"Banskobystrický kraj";83;13888;47;13935;NA;240067;130;2021-05-04;79498
2021-05-03;"Banskobystrický kraj";30;20872;80;20952;NA;240067;110;2021-05-03;79368
2021-05-02;"Banskobystrický kraj";6;33040;60;33100;NA;240067;66;2021-05-02;79258
2021-05-01;"Banskobystrický kraj";54;36900;67;36967;NA;240067;121;2021-05-01;79192
2021-04-30;"Banskobystrický kraj";38;34957;86;35043;NA;240067;124;2021-04-30;79071
2021-04-29;"Banskobystrický kraj";55;16839;68;16907;NA;240067;123;2021-04-29;78947
2021-04-28;"Banskobystrický kraj";66;17959;67;18026;NA;240067;133;2021-04-28;78824
2021-04-27;"Banskobystrický kraj";70;19152;73;19225;NA;240067;143;2021-04-27;78691
2021-04-26;"Banskobystrický kraj";34;28517;101;28618;NA;240067;135;2021-04-26;78548
2021-04-25;"Banskobystrický kraj";14;40601;106;40707;NA;240067;120;2021-04-25;78413
2021-04-24;"Banskobystrický kraj";40;51944;98;52042;NA;240067;138;2021-04-24;78293
2021-04-23;"Banskobystrický kraj";78;37922;88;38010;NA;240067;166;2021-04-23;78155
2021-04-22;"Banskobystrický kraj";51;17415;57;17472;NA;240067;108;2021-04-22;77989
2021-04-21;"Banskobystrický kraj";76;19218;94;19312;NA;240067;170;2021-04-21;77881
2021-04-20;"Banskobystrický kraj";116;21234;98;21332;NA;240067;214;2021-04-20;77711
2021-04-19;"Banskobystrický kraj";48;31408;105;31513;NA;240067;153;2021-04-19;77497
2021-04-18;"Banskobystrický kraj";16;43375;90;43465;NA;240067;106;2021-04-18;77344
2021-04-17;"Banskobystrický kraj";42;64939;92;65031;NA;240067;134;2021-04-17;77238
2021-04-16;"Banskobystrický kraj";72;37307;100;37407;NA;240067;172;2021-04-16;77104
2021-04-15;"Banskobystrický kraj";67;20127;83;20210;NA;240067;150;2021-04-15;76932
2021-04-14;"Banskobystrický kraj";69;21260;86;21346;NA;240067;155;2021-04-14;76782
2021-04-13;"Banskobystrický kraj";130;23076;77;23153;NA;240067;207;2021-04-13;76627
2021-04-12;"Banskobystrický kraj";60;32272;130;32402;NA;240067;190;2021-04-12;76420
2021-04-11;"Banskobystrický kraj";0;41367;88;41455;NA;240067;88;2021-04-11;76230
2021-04-10;"Banskobystrický kraj";56;64728;141;64869;NA;240067;197;2021-04-10;76142
2021-04-09;"Banskobystrický kraj";106;31570;118;31688;NA;240067;224;2021-04-09;75945
2021-04-08;"Banskobystrický kraj";132;19000;148;19148;NA;240067;280;2021-04-08;75721
2021-04-07;"Banskobystrický kraj";226;25121;94;25215;NA;240067;320;2021-04-07;75441
2021-04-06;"Banskobystrický kraj";93;42496;187;42683;NA;240067;280;2021-04-06;75121
2021-04-05;"Banskobystrický kraj";15;11797;87;11884;NA;240067;102;2021-04-05;74841
2021-04-04;"Banskobystrický kraj";24;19683;79;19762;NA;240067;103;2021-04-04;74739
2021-04-03;"Banskobystrický kraj";5;72553;211;72764;NA;240067;216;2021-04-03;74636
2021-04-02;"Banskobystrický kraj";71;13455;66;13521;NA;240067;137;2021-04-02;74420
2021-04-01;"Banskobystrický kraj";171;39407;200;39607;NA;240067;371;2021-04-01;74283
2021-03-31;"Banskobystrický kraj";147;25543;161;25704;NA;240067;308;2021-03-31;73912
2021-03-30;"Banskobystrický kraj";167;21442;159;21601;NA;240067;326;2021-03-30;73604
2021-03-29;"Banskobystrický kraj";119;29492;218;29710;NA;240067;337;2021-03-29;73278
2021-03-28;"Banskobystrický kraj";25;40610;189;40799;NA;240067;214;2021-03-28;72941
2021-03-27;"Banskobystrický kraj";85;63414;260;63674;NA;240067;345;2021-03-27;72727
2021-03-26;"Banskobystrický kraj";122;43671;240;43911;NA;240067;362;2021-03-26;72382
2021-03-25;"Banskobystrický kraj";120;21598;240;21838;NA;240067;360;2021-03-25;72020
2021-03-24;"Banskobystrický kraj";200;19337;227;19564;NA;240067;427;2021-03-24;71660
2021-03-23;"Banskobystrický kraj";241;21541;257;21798;NA;240067;498;2021-03-23;71233
2021-03-22;"Banskobystrický kraj";65;30480;274;30754;NA;240067;339;2021-03-22;70735
2021-03-21;"Banskobystrický kraj";31;40039;280;40319;NA;240067;311;2021-03-21;70396
2021-03-20;"Banskobystrický kraj";119;67926;383;68309;NA;240067;502;2021-03-20;70085
2021-03-19;"Banskobystrický kraj";240;44038;306;44344;NA;240067;546;2021-03-19;69583
2021-03-18;"Banskobystrický kraj";160;22469;273;22742;NA;240067;433;2021-03-18;69037
2021-03-17;"Banskobystrický kraj";262;21573;245;21818;NA;240067;507;2021-03-17;68604
2021-03-16;"Banskobystrický kraj";340;23349;224;23573;NA;240067;564;2021-03-16;68097
2021-03-15;"Banskobystrický kraj";95;32306;366;32672;NA;240067;461;2021-03-15;67533
2021-03-14;"Banskobystrický kraj";39;39212;218;39430;NA;240067;257;2021-03-14;67072
2021-03-13;"Banskobystrický kraj";209;67463;395;67858;NA;240067;604;2021-03-13;66815
2021-03-12;"Banskobystrický kraj";206;41444;330;41774;NA;240067;536;2021-03-12;66211
2021-03-11;"Banskobystrický kraj";228;21338;274;21612;NA;240067;502;2021-03-11;65675
2021-03-10;"Banskobystrický kraj";260;20400;238;20638;NA;240067;498;2021-03-10;65173
2021-03-09;"Banskobystrický kraj";352;21790;284;22074;NA;240067;636;2021-03-09;64675
2021-03-08;"Banskobystrický kraj";191;31471;427;31898;NA;240067;618;2021-03-08;64039
2021-03-07;"Banskobystrický kraj";60;39191;295;39486;NA;240067;355;2021-03-07;63421
2021-03-06;"Banskobystrický kraj";164;70897;410;71307;NA;240067;574;2021-03-06;63066
2021-03-05;"Banskobystrický kraj";221;42336;389;42725;NA;240067;610;2021-03-05;62492
2021-03-04;"Banskobystrický kraj";226;22009;334;22343;NA;240067;560;2021-03-04;61882
2021-03-03;"Banskobystrický kraj";317;21949;331;22280;NA;240067;648;2021-03-03;61322
2021-03-02;"Banskobystrický kraj";291;23160;354;23514;NA;240067;645;2021-03-02;60674
2021-03-01;"Banskobystrický kraj";151;31773;434;32207;NA;240067;585;2021-03-01;60029
2021-02-28;"Banskobystrický kraj";45;38665;336;39001;NA;240067;381;2021-02-28;59444
2021-02-27;"Banskobystrický kraj";289;66667;529;67196;NA;240067;818;2021-02-27;59063
2021-02-26;"Banskobystrický kraj";326;39674;468;40142;NA;240067;794;2021-02-26;58245
2021-02-25;"Banskobystrický kraj";375;18081;366;18447;NA;240067;741;2021-02-25;57451
2021-02-24;"Banskobystrický kraj";332;16735;373;17108;NA;240067;705;2021-02-24;56710
2021-02-23;"Banskobystrický kraj";462;19932;439;20371;NA;240067;901;2021-02-23;56005
2021-02-22;"Banskobystrický kraj";67;28643;598;29241;NA;240067;665;2021-02-22;55104
2021-02-21;"Banskobystrický kraj";68;37619;444;38063;NA;240067;512;2021-02-21;54439
2021-02-20;"Banskobystrický kraj";280;68851;598;69449;NA;240067;878;2021-02-20;53927
2021-02-19;"Banskobystrický kraj";420;39888;511;40399;NA;240067;931;2021-02-19;53049
2021-02-18;"Banskobystrický kraj";241;18618;396;19014;NA;240067;637;2021-02-18;52118
2021-02-17;"Banskobystrický kraj";415;16740;389;17129;NA;240067;804;2021-02-17;51481
2021-02-16;"Banskobystrický kraj";338;19731;368;20099;NA;240067;706;2021-02-16;50677
2021-02-15;"Banskobystrický kraj";118;35835;591;36426;NA;240067;709;2021-02-15;49971
2021-02-14;"Banskobystrický kraj";60;31894;386;32280;NA;240067;446;2021-02-14;49262
2021-02-13;"Banskobystrický kraj";202;53889;492;54381;NA;240067;694;2021-02-13;48816
2021-02-12;"Banskobystrický kraj";312;37270;533;37803;NA;240067;845;2021-02-12;48122
2021-02-11;"Banskobystrický kraj";305;21196;386;21582;NA;240067;691;2021-02-11;47277
2021-02-10;"Banskobystrický kraj";333;14790;344;15134;NA;240067;677;2021-02-10;46586
2021-02-09;"Banskobystrický kraj";329;18504;362;18866;NA;240067;691;2021-02-09;45909
2021-02-08;"Banskobystrický kraj";103;49716;695;50411;NA;240067;798;2021-02-08;45218
2021-02-07;"Banskobystrický kraj";70;37659;335;37994;NA;240067;405;2021-02-07;44420
2021-02-06;"Banskobystrický kraj";178;69388;570;69958;NA;240067;748;2021-02-06;44015
2021-02-05;"Banskobystrický kraj";282;24577;363;24940;NA;240067;645;2021-02-05;43267
2021-02-04;"Banskobystrický kraj";240;14367;430;14797;NA;240067;670;2021-02-04;42622
2021-02-03;"Banskobystrický kraj";350;9459;255;9714;NA;240067;605;2021-02-03;41952
2021-02-02;"Banskobystrický kraj";277;15741;334;16075;NA;240067;611;2021-02-02;41347
2021-02-01;"Banskobystrický kraj";75;24346;489;24835;NA;240067;564;2021-02-01;40736
2021-01-31;"Banskobystrický kraj";34;19983;201;20184;NA;240067;235;2021-01-31;40172
2021-01-30;"Banskobystrický kraj";163;63896;525;64421;NA;240067;688;2021-01-30;39937
2021-01-29;"Banskobystrický kraj";196;17368;274;17642;NA;240067;470;2021-01-29;39249
2021-01-28;"Banskobystrický kraj";218;15613;382;15995;NA;240067;600;2021-01-28;38779
2021-01-27;"Banskobystrický kraj";191;8132;200;8332;NA;240067;391;2021-01-27;38179
2021-01-26;"Banskobystrický kraj";238;19795;283;20078;NA;240067;521;2021-01-26;37788
2021-01-25;"Banskobystrický kraj";82;33666;412;34078;NA;240067;494;2021-01-25;37267
2021-01-24;"Banskobystrický kraj";38;35587;278;35865;NA;240067;316;2021-01-24;36773
2021-01-23;"Banskobystrický kraj";142;89058;523;89581;NA;240067;665;2021-01-23;36457
2021-01-22;"Banskobystrický kraj";175;25887;355;26242;NA;240067;530;2021-01-22;35792
2021-01-21;"Banskobystrický kraj";194;17063;279;17342;NA;240067;473;2021-01-21;35262
2021-01-20;"Banskobystrický kraj";231;9142;186;9328;NA;240067;417;2021-01-20;34789
2021-01-19;"Banskobystrický kraj";213;10708;311;11019;NA;240067;524;2021-01-19;34372
2021-01-18;"Banskobystrický kraj";94;7402;401;7803;NA;240067;495;2021-01-18;33848
2021-01-17;"Banskobystrický kraj";110;8154;77;8231;NA;240067;187;2021-01-17;33353
2021-01-16;"Banskobystrický kraj";58;2274;57;2331;NA;240067;115;2021-01-16;33166
2021-01-15;"Banskobystrický kraj";164;7673;217;7890;NA;240067;381;2021-01-15;33051
2021-01-14;"Banskobystrický kraj";220;5760;325;6085;NA;240067;545;2021-01-14;32670
2021-01-13;"Banskobystrický kraj";235;5974;217;6191;NA;240067;452;2021-01-13;32125
2021-01-12;"Banskobystrický kraj";194;6600;290;6890;NA;240067;484;2021-01-12;31673
2021-01-11;"Banskobystrický kraj";76;8231;481;8712;NA;240067;557;2021-01-11;31189
2021-01-10;"Banskobystrický kraj";110;433;4;437;NA;240067;114;2021-01-10;30632
2021-01-09;"Banskobystrický kraj";297;2378;81;2459;NA;240067;378;2021-01-09;30518
2021-01-08;"Banskobystrický kraj";435;9805;443;10248;NA;240067;878;2021-01-08;30140
2021-01-07;"Banskobystrický kraj";127;6322;366;6688;NA;240067;493;2021-01-07;29262
2021-01-06;"Banskobystrický kraj";305;3374;185;3559;NA;240067;490;2021-01-06;28769
2021-01-05;"Banskobystrický kraj";372;7349;533;7882;NA;240067;905;2021-01-05;28279
2021-01-04;"Banskobystrický kraj";130;7087;700;7787;NA;240067;830;2021-01-04;27374
2021-01-03;"Banskobystrický kraj";199;320;19;339;NA;240067;218;2021-01-03;26544
2021-01-02;"Banskobystrický kraj";123;702;85;787;NA;240067;208;2021-01-02;26326
2021-01-01;"Banskobystrický kraj";220;1958;132;2090;NA;240067;352;2021-01-01;26118
2020-12-31;"Banskobystrický kraj";499;7679;633;8312;NA;240067;1132;2020-12-31;25766
2020-12-30;"Banskobystrický kraj";593;7407;541;7948;NA;240067;1134;2020-12-30;24634
2020-12-29;"Banskobystrický kraj";240;7876;660;8536;NA;240067;900;2020-12-29;23500
2020-12-28;"Banskobystrický kraj";131;6120;720;6840;NA;240067;851;2020-12-28;22600
2020-12-27;"Banskobystrický kraj";116;541;25;566;NA;240067;141;2020-12-27;21749
2020-12-26;"Banskobystrický kraj";61;295;35;330;NA;240067;96;2020-12-26;21608
2020-12-25;"Banskobystrický kraj";65;888;10;898;NA;240067;75;2020-12-25;21512
2020-12-24;"Banskobystrický kraj";452;3685;135;3820;NA;240067;587;2020-12-24;21437
2020-12-23;"Banskobystrický kraj";368;9892;473;10365;NA;240067;841;2020-12-23;20850
2020-12-22;"Banskobystrický kraj";307;8468;619;9087;NA;240067;926;2020-12-22;20009
2020-12-21;"Banskobystrický kraj";286;4922;455;5377;NA;240067;741;2020-12-21;19083
2020-12-20;"Banskobystrický kraj";155;250;14;264;NA;240067;169;2020-12-20;18342
2020-12-19;"Banskobystrický kraj";170;3084;138;3222;NA;240067;308;2020-12-19;18173
2020-12-18;"Banskobystrický kraj";432;5959;331;6290;NA;240067;763;2020-12-18;17865
2020-12-17;"Banskobystrický kraj";468;8753;653;9406;NA;240067;1121;2020-12-17;17102
2020-12-16;"Banskobystrický kraj";379;10184;567;10751;NA;240067;946;2020-12-16;15981
2020-12-15;"Banskobystrický kraj";336;5281;425;5706;NA;240067;761;2020-12-15;15035
2020-12-14;"Banskobystrický kraj";148;4012;259;4271;NA;240067;407;2020-12-14;14274
2020-12-13;"Banskobystrický kraj";122;142;1;143;NA;240067;123;2020-12-13;13867
2020-12-12;"Banskobystrický kraj";137;2714;138;2852;NA;240067;275;2020-12-12;13744
2020-12-11;"Banskobystrický kraj";468;6633;362;6995;NA;240067;830;2020-12-11;13469
2020-12-10;"Banskobystrický kraj";280;5501;369;5870;NA;240067;649;2020-12-10;12639
2020-12-09;"Banskobystrický kraj";323;3941;205;4146;NA;240067;528;2020-12-09;11990
2020-12-08;"Banskobystrický kraj";256;3782;272;4054;NA;240067;528;2020-12-08;11462
2020-12-07;"Banskobystrický kraj";175;2633;177;2810;NA;240067;352;2020-12-07;10934
2020-12-06;"Banskobystrický kraj";121;507;11;518;NA;240067;132;2020-12-06;10582
2020-12-05;"Banskobystrický kraj";109;1099;34;1133;NA;240067;143;2020-12-05;10450
2020-12-04;"Banskobystrický kraj";339;3828;174;4002;NA;240067;513;2020-12-04;10307
2020-12-03;"Banskobystrický kraj";240;3193;234;3427;NA;240067;474;2020-12-03;9794
2020-12-02;"Banskobystrický kraj";217;4442;186;4628;NA;240067;403;2020-12-02;9320
2020-12-01;"Banskobystrický kraj";215;2702;134;2836;NA;240067;349;2020-12-01;8917
2020-11-30;"Banskobystrický kraj";74;4314;241;4555;NA;240067;315;2020-11-30;8568
2020-11-29;"Banskobystrický kraj";19;208;7;215;NA;240067;26;2020-11-29;8253
2020-11-28;"Banskobystrický kraj";81;1408;55;1463;NA;240067;136;2020-11-28;8227
2020-11-27;"Banskobystrický kraj";219;2566;123;2689;NA;240067;342;2020-11-27;8091
2020-11-26;"Banskobystrický kraj";208;2124;93;2217;NA;240067;301;2020-11-26;7749
2020-11-25;"Banskobystrický kraj";170;1952;86;2038;NA;240067;256;2020-11-25;7448
2020-11-24;"Banskobystrický kraj";166;2566;69;2635;NA;240067;235;2020-11-24;7192
2020-11-23;"Banskobystrický kraj";66;10147;193;10340;NA;240067;259;2020-11-23;6957
2020-11-22;"Banskobystrický kraj";38;104;1;105;NA;240067;39;2020-11-22;6698
2020-11-21;"Banskobystrický kraj";52;904;14;918;NA;240067;66;2020-11-21;6659
2020-11-20;"Banskobystrický kraj";127;2005;107;2112;NA;240067;234;2020-11-20;6593
2020-11-19;"Banskobystrický kraj";170;1218;82;1300;NA;240067;252;2020-11-19;6359
2020-11-18;"Banskobystrický kraj";153;698;65;763;NA;240067;218;2020-11-18;6107
2020-11-17;"Banskobystrický kraj";52;578;35;613;NA;240067;87;2020-11-17;5889
2020-11-16;"Banskobystrický kraj";106;470;25;495;NA;240067;131;2020-11-16;5802
2020-11-15;"Banskobystrický kraj";52;301;4;305;NA;240067;56;2020-11-15;5671
2020-11-14;"Banskobystrický kraj";73;305;2;307;NA;240067;75;2020-11-14;5615
2020-11-13;"Banskobystrický kraj";157;552;11;563;NA;240067;168;2020-11-13;5540
2020-11-12;"Banskobystrický kraj";218;952;44;996;NA;240067;262;2020-11-12;5372
2020-11-11;"Banskobystrický kraj";224;437;9;446;NA;240067;233;2020-11-11;5110
2020-11-10;"Banskobystrický kraj";263;463;18;481;NA;240067;281;2020-11-10;4877
2020-11-09;"Banskobystrický kraj";80;2678;31;2709;NA;240067;111;2020-11-09;4596
2020-11-08;"Banskobystrický kraj";82;981;16;997;NA;240067;98;2020-11-08;4485
2020-11-07;"Banskobystrický kraj";164;8828;94;8922;NA;240067;258;2020-11-07;4387
2020-11-06;"Banskobystrický kraj";227;2496;16;2512;NA;240067;243;2020-11-06;4129
2020-11-05;"Banskobystrický kraj";240;290;33;323;NA;240067;273;2020-11-05;3886
2020-11-04;"Banskobystrický kraj";254;1366;13;1379;NA;240067;267;2020-11-04;3613
2020-11-03;"Banskobystrický kraj";246;1332;4;1336;NA;240067;250;2020-11-03;3346
2020-11-02;"Banskobystrický kraj";90;2909;65;2974;NA;240067;155;2020-11-02;3096
2020-11-01;"Banskobystrický kraj";101;2671;42;2713;NA;240067;143;2020-11-01;2941
2020-10-31;"Banskobystrický kraj";199;13516;116;13632;NA;240067;315;2020-10-31;2798
2020-10-30;"Banskobystrický kraj";254;2829;20;2849;NA;240067;274;2020-10-30;2483
2020-10-29;"Banskobystrický kraj";372;969;42;1011;NA;240067;414;2020-10-29;2209
2020-10-28;"Banskobystrický kraj";285;302;30;332;NA;240067;315;2020-10-28;1795
2020-10-27;"Banskobystrický kraj";266;654;40;694;NA;240067;306;2020-10-27;1480
2020-10-26;"Banskobystrický kraj";38;234;29;263;NA;240067;67;2020-10-26;1174
2020-10-25;"Banskobystrický kraj";50;140;11;151;NA;240067;61;2020-10-25;1107
2020-10-24;"Banskobystrický kraj";315;114;12;126;NA;240067;327;2020-10-24;1046
2020-10-23;"Banskobystrický kraj";231;230;29;259;NA;240067;260;2020-10-23;719
2020-10-22;"Banskobystrický kraj";264;253;24;277;NA;240067;288;2020-10-22;459
2020-10-21;"Banskobystrický kraj";209;266;3;269;NA;240067;212;2020-10-21;171
2020-10-20;"Banskobystrický kraj";210;66;3;69;NA;240067;213;2020-10-20;-41
2020-10-19;"Banskobystrický kraj";27;73;12;85;NA;240067;39;2020-10-19;-254
2020-10-18;"Banskobystrický kraj";49;0;0;0;NA;240067;49;2020-10-18;-293
2020-10-17;"Banskobystrický kraj";91;0;0;0;NA;240067;91;2020-10-17;-342
2020-10-16;"Banskobystrický kraj";224;37;3;40;NA;240067;227;2020-10-16;-433
2020-10-15;"Banskobystrický kraj";133;29;1;30;NA;240067;134;2020-10-15;-660
2020-10-14;"Banskobystrický kraj";139;31;1;32;NA;240067;140;2020-10-14;-794
2020-10-13;"Banskobystrický kraj";151;169;11;180;NA;240067;162;2020-10-13;-934
2020-10-12;"Banskobystrický kraj";11;110;4;114;NA;240067;15;2020-10-12;-1096
2020-10-11;"Banskobystrický kraj";14;0;0;0;NA;240067;14;2020-10-11;-1111
2020-10-10;"Banskobystrický kraj";53;0;0;0;NA;240067;53;2020-10-10;-1125
2020-10-09;"Banskobystrický kraj";128;0;0;0;NA;240067;128;2020-10-09;-1178
2020-10-08;"Banskobystrický kraj";99;0;0;0;NA;240067;99;2020-10-08;-1306
2020-10-07;"Banskobystrický kraj";124;0;0;0;NA;240067;124;2020-10-07;-1405
2020-10-06;"Banskobystrický kraj";68;0;0;0;NA;240067;68;2020-10-06;-1529
2020-10-05;"Banskobystrický kraj";49;0;0;0;NA;240067;49;2020-10-05;-1597
2020-10-04;"Banskobystrický kraj";8;0;0;0;NA;240067;8;2020-10-04;-1646
2020-10-03;"Banskobystrický kraj";37;0;0;0;NA;240067;37;2020-10-03;-1654
2020-10-02;"Banskobystrický kraj";74;0;0;0;NA;240067;74;2020-10-02;-1691
2020-10-01;"Banskobystrický kraj";49;16;0;16;NA;240067;49;2020-10-01;-1765
2020-09-30;"Banskobystrický kraj";60;0;0;0;NA;240067;60;2020-09-30;-1814
2020-09-29;"Banskobystrický kraj";24;0;0;0;NA;240067;24;2020-09-29;-1874
2020-09-28;"Banskobystrický kraj";0;0;0;0;NA;240067;0;2020-09-28;-1898
2020-09-27;"Banskobystrický kraj";20;0;0;0;NA;240067;20;2020-09-27;-1898
2020-09-26;"Banskobystrický kraj";24;0;0;0;NA;240067;24;2020-09-26;-1918
2020-09-25;"Banskobystrický kraj";29;0;0;0;NA;240067;29;2020-09-25;-1942
2020-09-24;"Banskobystrický kraj";25;0;0;0;NA;240067;25;2020-09-24;-1971
2020-09-23;"Banskobystrický kraj";17;0;0;0;NA;240067;17;2020-09-23;-1996
2020-09-22;"Banskobystrický kraj";25;0;0;0;NA;240067;25;2020-09-22;-2013
2020-09-21;"Banskobystrický kraj";3;0;0;0;NA;240067;3;2020-09-21;-2038
2020-09-20;"Banskobystrický kraj";0;0;0;0;NA;240067;0;2020-09-20;-2041
2020-09-19;"Banskobystrický kraj";3;0;0;0;NA;240067;3;2020-09-19;-2041
2020-09-18;"Banskobystrický kraj";24;0;0;0;NA;240067;24;2020-09-18;-2044
2020-09-17;"Banskobystrický kraj";14;0;0;0;NA;240067;14;2020-09-17;-2068
2020-09-16;"Banskobystrický kraj";6;0;0;0;NA;240067;6;2020-09-16;-2082
2020-09-15;"Banskobystrický kraj";2;0;0;0;NA;240067;2;2020-09-15;-2088
2020-09-14;"Banskobystrický kraj";13;0;0;0;NA;240067;13;2020-09-14;-2090
2020-09-13;"Banskobystrický kraj";1;0;0;0;NA;240067;1;2020-09-13;-2103
2020-09-12;"Banskobystrický kraj";5;0;0;0;NA;240067;5;2020-09-12;-2104
2020-09-11;"Banskobystrický kraj";19;0;0;0;NA;240067;19;2020-09-11;-2109
2020-09-10;"Banskobystrický kraj";11;0;0;0;NA;240067;11;2020-09-10;-2128
2020-09-09;"Banskobystrický kraj";13;0;0;0;NA;240067;13;2020-09-09;-2139
2020-09-08;"Banskobystrický kraj";5;0;0;0;NA;240067;5;2020-09-08;-2152
2020-09-07;"Banskobystrický kraj";2;0;0;0;NA;240067;2;2020-09-07;-2157
2020-09-06;"Banskobystrický kraj";0;0;0;0;NA;240067;0;2020-09-06;-2159
2020-09-05;"Banskobystrický kraj";0;0;0;0;NA;240067;0;2020-09-05;-2159
2020-09-04;"Banskobystrický kraj";9;0;0;0;NA;240067;9;2020-09-04;-2159
2020-09-03;"Banskobystrický kraj";5;0;0;0;NA;240067;5;2020-09-03;-2168
2020-09-02;"Banskobystrický kraj";6;0;0;0;NA;240067;6;2020-09-02;-2173
2020-09-01;"Banskobystrický kraj";2;0;0;0;NA;240067;2;2020-09-01;-2179
2020-08-31;"Banskobystrický kraj";6;0;0;0;NA;240067;6;2020-08-31;-2181
2020-08-30;"Banskobystrický kraj";0;0;0;0;NA;240067;0;2020-08-30;-2187
2020-08-29;"Banskobystrický kraj";1;0;0;0;NA;240067;1;2020-08-29;-2187
2020-08-28;"Banskobystrický kraj";3;0;0;0;NA;240067;3;2020-08-28;-2188
2020-08-27;"Banskobystrický kraj";1;0;0;0;NA;240067;1;2020-08-27;-2191
2020-08-26;"Banskobystrický kraj";2;0;0;0;NA;240067;2;2020-08-26;-2192
2020-08-25;"Banskobystrický kraj";2;0;0;0;NA;240067;2;2020-08-25;-2194
2020-08-24;"Banskobystrický kraj";0;0;0;0;NA;240067;0;2020-08-24;-2196
2020-08-23;"Banskobystrický kraj";0;0;0;0;NA;240067;0;2020-08-23;-2196
2020-08-22;"Banskobystrický kraj";0;0;0;0;NA;240067;0;2020-08-22;-2196
2020-08-21;"Banskobystrický kraj";4;0;0;0;NA;240067;4;2020-08-21;-2196
2020-08-20;"Banskobystrický kraj";1;0;0;0;NA;240067;1;2020-08-20;-2200
2020-08-19;"Banskobystrický kraj";4;0;0;0;NA;240067;4;2020-08-19;-2201
2020-08-18;"Banskobystrický kraj";0;0;0;0;NA;240067;0;2020-08-18;-2205
2020-08-17;"Banskobystrický kraj";1;0;0;0;NA;240067;1;2020-08-17;-2205
2020-08-16;"Banskobystrický kraj";0;0;0;0;NA;240067;0;2020-08-16;-2206
2020-08-15;"Banskobystrický kraj";0;0;0;0;NA;240067;0;2020-08-15;-2206
2020-08-14;"Banskobystrický kraj";5;0;0;0;NA;240067;5;2020-08-14;-2206
2020-08-13;"Banskobystrický kraj";0;0;0;0;NA;240067;0;2020-08-13;-2211
2020-08-12;"Banskobystrický kraj";0;0;0;0;NA;240067;0;2020-08-12;-2211
2020-08-11;"Banskobystrický kraj";2;0;0;0;NA;240067;2;2020-08-11;-2211
2020-08-10;"Banskobystrický kraj";3;0;0;0;NA;240067;3;2020-08-10;-2213
2020-08-09;"Banskobystrický kraj";0;0;0;0;NA;240067;0;2020-08-09;-2216
2020-08-08;"Banskobystrický kraj";2;0;0;0;NA;240067;2;2020-08-08;-2216
2020-08-07;"Banskobystrický kraj";1;0;0;0;NA;240067;1;2020-08-07;-2218
2020-08-06;"Banskobystrický kraj";1;0;0;0;NA;240067;1;2020-08-06;-2219
2020-08-05;"Banskobystrický kraj";0;0;0;0;NA;240067;0;2020-08-05;-2220
2020-08-04;"Banskobystrický kraj";3;0;0;0;NA;240067;3;2020-08-04;-2220
2020-08-03;"Banskobystrický kraj";0;0;0;0;NA;240067;0;2020-08-03;-2223
2020-08-02;"Banskobystrický kraj";0;0;0;0;NA;240067;0;2020-08-02;-2223
2020-08-01;"Banskobystrický kraj";1;0;0;0;NA;240067;1;2020-08-01;-2223
2020-07-31;"Banskobystrický kraj";2;0;0;0;NA;240067;2;2020-07-31;-2224
2020-07-30;"Banskobystrický kraj";1;0;0;0;NA;240067;1;2020-07-30;-2226
2020-07-29;"Banskobystrický kraj";0;0;0;0;NA;240067;0;2020-07-29;-2227
2020-07-28;"Banskobystrický kraj";2;0;0;0;NA;240067;2;2020-07-28;-2227
2020-07-27;"Banskobystrický kraj";3;0;0;0;NA;240067;3;2020-07-27;-2229
2020-07-26;"Banskobystrický kraj";0;0;0;0;NA;240067;0;2020-07-26;-2232
2020-07-25;"Banskobystrický kraj";0;0;0;0;NA;240067;0;2020-07-25;-2232
2020-07-24;"Banskobystrický kraj";9;0;0;0;NA;240067;9;2020-07-24;-2232
2020-07-23;"Banskobystrický kraj";0;0;0;0;NA;240067;0;2020-07-23;-2241
2020-07-22;"Banskobystrický kraj";3;0;0;0;NA;240067;3;2020-07-22;-2241
2020-07-21;"Banskobystrický kraj";3;0;0;0;NA;240067;3;2020-07-21;-2244
2020-07-20;"Banskobystrický kraj";1;0;0;0;NA;240067;1;2020-07-20;-2247
2020-07-19;"Banskobystrický kraj";1;0;0;0;NA;240067;1;2020-07-19;-2248
2020-07-18;"Banskobystrický kraj";0;0;0;0;NA;240067;0;2020-07-18;-2249
2020-07-17;"Banskobystrický kraj";2;0;0;0;NA;240067;2;2020-07-17;-2249
2020-07-16;"Banskobystrický kraj";1;0;0;0;NA;240067;1;2020-07-16;-2251
2020-07-15;"Banskobystrický kraj";4;0;0;0;NA;240067;4;2020-07-15;-2252
2020-07-14;"Banskobystrický kraj";2;0;0;0;NA;240067;2;2020-07-14;-2256
2020-07-13;"Banskobystrický kraj";1;0;0;0;NA;240067;1;2020-07-13;-2258
2020-07-12;"Banskobystrický kraj";0;0;0;0;NA;240067;0;2020-07-12;-2259
2020-07-11;"Banskobystrický kraj";0;0;0;0;NA;240067;0;2020-07-11;-2259
2020-07-10;"Banskobystrický kraj";3;0;0;0;NA;240067;3;2020-07-10;-2259
2020-07-09;"Banskobystrický kraj";9;0;0;0;NA;240067;9;2020-07-09;-2262
2020-07-08;"Banskobystrický kraj";0;0;0;0;NA;240067;0;2020-07-08;-2271
2020-07-07;"Banskobystrický kraj";4;0;0;0;NA;240067;4;2020-07-07;-2271
2020-07-06;"Banskobystrický kraj";0;0;0;0;NA;240067;0;2020-07-06;-2275
2020-07-05;"Banskobystrický kraj";0;0;0;0;NA;240067;0;2020-07-05;-2275
2020-07-04;"Banskobystrický kraj";1;0;0;0;NA;240067;1;2020-07-04;-2275
2020-07-03;"Banskobystrický kraj";4;0;0;0;NA;240067;4;2020-07-03;-2276
2020-07-02;"Banskobystrický kraj";0;0;0;0;NA;240067;0;2020-07-02;-2280
2020-07-01;"Banskobystrický kraj";1;0;0;0;NA;240067;1;2020-07-01;-2280
2020-06-30;"Banskobystrický kraj";0;12;0;12;NA;240067;0;2020-06-30;-2281
2020-06-29;"Banskobystrický kraj";0;0;0;0;NA;240067;0;2020-06-29;-2281
2020-06-28;"Banskobystrický kraj";0;0;0;0;NA;240067;0;2020-06-28;-2281
2020-06-27;"Banskobystrický kraj";0;0;0;0;NA;240067;0;2020-06-27;-2281
2020-06-26;"Banskobystrický kraj";0;0;0;0;NA;240067;0;2020-06-26;-2281
2020-06-25;"Banskobystrický kraj";1;0;0;0;NA;240067;1;2020-06-25;-2281
2020-06-24;"Banskobystrický kraj";0;0;0;0;NA;240067;0;2020-06-24;-2282
2020-06-23;"Banskobystrický kraj";6;0;0;0;NA;240067;6;2020-06-23;-2282
2020-06-22;"Banskobystrický kraj";0;0;0;0;NA;240067;0;2020-06-22;-2288
2020-06-21;"Banskobystrický kraj";0;0;0;0;NA;240067;0;2020-06-21;-2288
2020-06-20;"Banskobystrický kraj";0;0;0;0;NA;240067;0;2020-06-20;-2288
2020-06-19;"Banskobystrický kraj";2;0;0;0;NA;240067;2;2020-06-19;-2288
2020-06-18;"Banskobystrický kraj";10;0;0;0;NA;240067;10;2020-06-18;-2290
2020-06-17;"Banskobystrický kraj";1;0;0;0;NA;240067;1;2020-06-17;-2300
2020-06-16;"Banskobystrický kraj";0;0;0;0;NA;240067;0;2020-06-16;-2301
2020-06-14;"Banskobystrický kraj";2;0;0;0;NA;240067;2;2020-06-14;-2301
2020-06-13;"Banskobystrický kraj";2;0;0;0;NA;240067;2;2020-06-13;-2303
2020-06-12;"Banskobystrický kraj";0;0;0;0;NA;240067;0;2020-06-12;-2305
2020-06-11;"Banskobystrický kraj";1;0;0;0;NA;240067;1;2020-06-11;-2305
2020-06-10;"Banskobystrický kraj";0;0;0;0;NA;240067;0;2020-06-10;-2306
2020-06-09;"Banskobystrický kraj";0;0;0;0;NA;240067;0;2020-06-09;-2306
2020-06-08;"Banskobystrický kraj";0;0;0;0;NA;240067;0;2020-06-08;-2306
2020-06-07;"Banskobystrický kraj";0;0;0;0;NA;240067;0;2020-06-07;-2306
2020-06-05;"Banskobystrický kraj";2;0;0;0;NA;240067;2;2020-06-05;-2306
2020-06-03;"Banskobystrický kraj";0;0;0;0;NA;240067;0;2020-06-03;-2308
2020-06-02;"Banskobystrický kraj";0;0;0;0;NA;240067;0;2020-06-02;-2308
2020-05-31;"Banskobystrický kraj";0;0;0;0;NA;240067;0;2020-05-31;-2308
2020-05-29;"Banskobystrický kraj";0;0;0;0;NA;240067;0;2020-05-29;-2308
2020-05-27;"Banskobystrický kraj";1;0;0;0;NA;240067;1;2020-05-27;-2308
2020-05-26;"Banskobystrický kraj";0;0;0;0;NA;240067;0;2020-05-26;-2309
2020-05-25;"Banskobystrický kraj";0;0;0;0;NA;240067;0;2020-05-25;-2309
2020-05-24;"Banskobystrický kraj";0;0;0;0;NA;240067;0;2020-05-24;-2309
2020-05-23;"Banskobystrický kraj";1;0;0;0;NA;240067;1;2020-05-23;-2309
2020-05-22;"Banskobystrický kraj";0;0;0;0;NA;240067;0;2020-05-22;-2310
2020-05-21;"Banskobystrický kraj";0;0;0;0;NA;240067;0;2020-05-21;-2310
2020-05-20;"Banskobystrický kraj";1;0;0;0;NA;240067;1;2020-05-20;-2310
2020-05-19;"Banskobystrický kraj";0;0;0;0;NA;240067;0;2020-05-19;-2311
2020-05-17;"Banskobystrický kraj";0;0;0;0;NA;240067;0;2020-05-17;-2311
2020-05-16;"Banskobystrický kraj";0;0;0;0;NA;240067;0;2020-05-16;-2311
2020-05-15;"Banskobystrický kraj";0;0;0;0;NA;240067;0;2020-05-15;-2311
2020-05-14;"Banskobystrický kraj";0;0;0;0;NA;240067;0;2020-05-14;-2311
2020-05-13;"Banskobystrický kraj";0;0;0;0;NA;240067;0;2020-05-13;-2311
2020-05-12;"Banskobystrický kraj";1;0;0;0;NA;240067;1;2020-05-12;-2311
2020-05-11;"Banskobystrický kraj";0;0;0;0;NA;240067;0;2020-05-11;-2312
2020-05-09;"Banskobystrický kraj";0;0;0;0;NA;240067;0;2020-05-09;-2312
2020-05-07;"Banskobystrický kraj";2;0;0;0;NA;240067;2;2020-05-07;-2312
2020-05-06;"Banskobystrický kraj";1;0;0;0;NA;240067;1;2020-05-06;-2314
2020-05-05;"Banskobystrický kraj";2;0;0;0;NA;240067;2;2020-05-05;-2315
2020-05-04;"Banskobystrický kraj";0;0;0;0;NA;240067;0;2020-05-04;-2317
2020-05-03;"Banskobystrický kraj";0;0;0;0;NA;240067;0;2020-05-03;-2317
2020-05-02;"Banskobystrický kraj";0;0;0;0;NA;240067;0;2020-05-02;-2317
2020-05-01;"Banskobystrický kraj";0;0;0;0;NA;240067;0;2020-05-01;-2317
2020-04-30;"Banskobystrický kraj";1;0;0;0;NA;240067;1;2020-04-30;-2317
2020-04-29;"Banskobystrický kraj";1;0;0;0;NA;240067;1;2020-04-29;-2318
2020-04-28;"Banskobystrický kraj";0;0;0;0;NA;240067;0;2020-04-28;-2319
2020-04-27;"Banskobystrický kraj";0;0;0;0;NA;240067;0;2020-04-27;-2319
2020-04-26;"Banskobystrický kraj";0;0;0;0;NA;240067;0;2020-04-26;-2319
2020-04-25;"Banskobystrický kraj";2;0;0;0;NA;240067;2;2020-04-25;-2319
2020-04-24;"Banskobystrický kraj";3;0;0;0;NA;240067;3;2020-04-24;-2321
2020-04-23;"Banskobystrický kraj";2;0;0;0;NA;240067;2;2020-04-23;-2324
2020-04-22;"Banskobystrický kraj";2;0;0;0;NA;240067;2;2020-04-22;-2326
2020-04-21;"Banskobystrický kraj";2;0;0;0;NA;240067;2;2020-04-21;-2328
2020-04-20;"Banskobystrický kraj";0;0;0;0;NA;240067;0;2020-04-20;-2330
2020-04-19;"Banskobystrický kraj";0;0;0;0;NA;240067;0;2020-04-19;-2330
2020-04-18;"Banskobystrický kraj";8;0;0;0;NA;240067;8;2020-04-18;-2330
2020-04-17;"Banskobystrický kraj";2;0;0;0;NA;240067;2;2020-04-17;-2338
2020-04-16;"Banskobystrický kraj";0;0;0;0;NA;240067;0;2020-04-16;-2340
2020-04-15;"Banskobystrický kraj";10;0;0;0;NA;240067;10;2020-04-15;-2340
2020-04-14;"Banskobystrický kraj";0;0;0;0;NA;240067;0;2020-04-14;-2350
2020-04-13;"Banskobystrický kraj";2;0;0;0;NA;240067;2;2020-04-13;-2350
2020-04-12;"Banskobystrický kraj";4;0;0;0;NA;240067;4;2020-04-12;-2352
2020-04-11;"Banskobystrický kraj";1;0;0;0;NA;240067;1;2020-04-11;-2356
2020-04-10;"Banskobystrický kraj";0;0;0;0;NA;240067;0;2020-04-10;-2357
2020-04-09;"Banskobystrický kraj";2;0;0;0;NA;240067;2;2020-04-09;-2357
2020-04-08;"Banskobystrický kraj";0;0;0;0;NA;240067;0;2020-04-08;-2359
2020-04-07;"Banskobystrický kraj";4;0;0;0;NA;240067;4;2020-04-07;-2359
2020-04-06;"Banskobystrický kraj";10;0;0;0;NA;240067;10;2020-04-06;-2363
2020-04-05;"Banskobystrický kraj";9;0;0;0;NA;240067;9;2020-04-05;-2373
2020-04-04;"Banskobystrický kraj";0;0;0;0;NA;240067;0;2020-04-04;-2382
2020-04-03;"Banskobystrický kraj";2;0;0;0;NA;240067;2;2020-04-03;-2382
2020-04-02;"Banskobystrický kraj";2;0;0;0;NA;240067;2;2020-04-02;-2384
2020-04-01;"Banskobystrický kraj";5;0;0;0;NA;240067;5;2020-04-01;-2386
2020-03-31;"Banskobystrický kraj";3;0;0;0;NA;240067;3;2020-03-31;-2391
2020-03-30;"Banskobystrický kraj";1;0;0;0;NA;240067;1;2020-03-30;-2394
2020-03-29;"Banskobystrický kraj";2;0;0;0;NA;240067;2;2020-03-29;-2395
2020-03-28;"Banskobystrický kraj";1;0;0;0;NA;240067;1;2020-03-28;-2397
2020-03-27;"Banskobystrický kraj";1;0;0;0;NA;240067;1;2020-03-27;-2398
2020-03-26;"Banskobystrický kraj";1;0;0;0;NA;240067;1;2020-03-26;-2399
2020-03-25;"Banskobystrický kraj";0;0;0;0;NA;240067;0;2020-03-25;-2400
2020-03-24;"Banskobystrický kraj";1;0;0;0;NA;240067;1;2020-03-24;-2400
2020-03-23;"Banskobystrický kraj";1;0;0;0;NA;240067;1;2020-03-23;-2401
2020-03-22;"Banskobystrický kraj";0;0;0;0;NA;240067;0;2020-03-22;-2402
2020-03-21;"Banskobystrický kraj";3;0;0;0;NA;240067;3;2020-03-21;-2402
2020-03-20;"Banskobystrický kraj";0;0;0;0;NA;240067;0;2020-03-20;-2405
2020-03-19;"Banskobystrický kraj";2;0;0;0;NA;240067;2;2020-03-19;-2405
2020-03-18;"Banskobystrický kraj";1;0;0;0;NA;240067;1;2020-03-18;-2407
2020-03-17;"Banskobystrický kraj";1;0;0;0;NA;240067;1;2020-03-17;-2408
2020-03-16;"Banskobystrický kraj";0;0;0;0;NA;240067;0;2020-03-16;-2409
2020-03-15;"Banskobystrický kraj";1;0;0;0;NA;240067;1;2020-03-15;-2409
2020-03-14;"Banskobystrický kraj";0;0;0;0;NA;240067;0;2020-03-14;-2410
2020-03-13;"Banskobystrický kraj";1;0;0;0;NA;240067;1;2020-03-13;-2410
2020-03-12;"Banskobystrický kraj";0;0;0;0;NA;240067;0;2020-03-12;-2411
2020-03-11;"Banskobystrický kraj";0;0;0;0;NA;240067;0;2020-03-11;-2411
2020-03-09;"Banskobystrický kraj";0;0;0;0;NA;240067;0;2020-03-09;-2411
2020-03-08;"Banskobystrický kraj";0;0;0;0;NA;240067;0;2020-03-08;-2411
2020-03-07;"Banskobystrický kraj";0;0;0;0;NA;240067;0;2020-03-07;-2411
2020-03-06;"Banskobystrický kraj";0;0;0;0;NA;240067;0;2020-03-06;-2411
2022-03-08;"Bratislavský kraj";1925;0;0;0;197093;282011;1925;2022-03-08;282011
2022-03-07;"Bratislavský kraj";1451;113;25;138;NA;282011;1476;2022-03-07;280086
2022-03-06;"Bratislavský kraj";850;1269;164;1433;NA;282011;1014;2022-03-06;278610
2022-03-05;"Bratislavský kraj";1203;1243;157;1400;NA;282011;1360;2022-03-05;277596
2022-03-04;"Bratislavský kraj";1443;2583;244;2827;NA;282011;1687;2022-03-04;276236
2022-03-03;"Bratislavský kraj";1599;2869;276;3145;NA;282011;1875;2022-03-03;274549
2022-03-02;"Bratislavský kraj";1677;2529;309;2838;NA;282011;1986;2022-03-02;272674
2022-03-01;"Bratislavský kraj";1560;3548;341;3889;NA;282011;1901;2022-03-01;270688
2022-02-28;"Bratislavský kraj";1593;4005;469;4474;NA;282011;2062;2022-02-28;268787
2022-02-27;"Bratislavský kraj";1156;1746;227;1973;NA;282011;1383;2022-02-27;266725
2022-02-26;"Bratislavský kraj";1228;1743;209;1952;NA;282011;1437;2022-02-26;265342
2022-02-25;"Bratislavský kraj";1692;3595;322;3917;NA;282011;2014;2022-02-25;263905
2022-02-24;"Bratislavský kraj";1760;3992;324;4316;NA;282011;2084;2022-02-24;261891
2022-02-23;"Bratislavský kraj";2105;3450;393;3843;NA;282011;2498;2022-02-23;259807
2022-02-22;"Bratislavský kraj";2951;4213;384;4597;NA;282011;3335;2022-02-22;257309
2022-02-21;"Bratislavský kraj";781;5116;517;5633;NA;282011;1298;2022-02-21;253974
2022-02-20;"Bratislavský kraj";1314;2005;294;2299;NA;282011;1608;2022-02-20;252676
2022-02-19;"Bratislavský kraj";1510;1929;235;2164;NA;282011;1745;2022-02-19;251068
2022-02-18;"Bratislavský kraj";2315;3835;378;4213;NA;282011;2693;2022-02-18;249323
2022-02-17;"Bratislavský kraj";2279;4412;416;4828;NA;282011;2695;2022-02-17;246630
2022-02-16;"Bratislavský kraj";2137;3749;419;4168;NA;282011;2556;2022-02-16;243935
2022-02-15;"Bratislavský kraj";2276;4894;475;5369;NA;282011;2751;2022-02-15;241379
2022-02-14;"Bratislavský kraj";2700;6170;601;6771;NA;282011;3301;2022-02-14;238628
2022-02-13;"Bratislavský kraj";1343;2248;395;2643;NA;282011;1738;2022-02-13;235327
2022-02-12;"Bratislavský kraj";1872;2273;336;2609;NA;282011;2208;2022-02-12;233589
2022-02-11;"Bratislavský kraj";2431;5054;419;5473;NA;282011;2850;2022-02-11;231381
2022-02-10;"Bratislavský kraj";2595;4563;427;4990;NA;282011;3022;2022-02-10;228531
2022-02-09;"Bratislavský kraj";2414;4706;477;5183;NA;282011;2891;2022-02-09;225509
2022-02-08;"Bratislavský kraj";2878;5134;512;5646;NA;282011;3390;2022-02-08;222618
2022-02-07;"Bratislavský kraj";2636;6970;668;7638;NA;282011;3304;2022-02-07;219228
2022-02-06;"Bratislavský kraj";1680;3005;382;3387;NA;282011;2062;2022-02-06;215924
2022-02-05;"Bratislavský kraj";2156;2456;315;2771;NA;282011;2471;2022-02-05;213862
2022-02-04;"Bratislavský kraj";2586;4679;408;5087;NA;282011;2994;2022-02-04;211391
2022-02-03;"Bratislavský kraj";2540;6005;435;6440;NA;282011;2975;2022-02-03;208397
2022-02-02;"Bratislavský kraj";2655;5035;465;5500;NA;282011;3120;2022-02-02;205422
2022-02-01;"Bratislavský kraj";2758;6001;469;6470;NA;282011;3227;2022-02-01;202302
2022-01-31;"Bratislavský kraj";2172;8357;712;9069;NA;282011;2884;2022-01-31;199075
2022-01-30;"Bratislavský kraj";1418;3314;362;3676;NA;282011;1780;2022-01-30;196191
2022-01-29;"Bratislavský kraj";1762;3138;326;3464;NA;282011;2088;2022-01-29;194411
2022-01-28;"Bratislavský kraj";2237;5047;389;5436;NA;282011;2626;2022-01-28;192323
2022-01-27;"Bratislavský kraj";2014;5975;334;6309;NA;282011;2348;2022-01-27;189697
2022-01-26;"Bratislavský kraj";1792;4895;367;5262;NA;282011;2159;2022-01-26;187349
2022-01-25;"Bratislavský kraj";1933;5551;385;5936;NA;282011;2318;2022-01-25;185190
2022-01-24;"Bratislavský kraj";1173;7911;315;8226;NA;282011;1488;2022-01-24;182872
2022-01-23;"Bratislavský kraj";862;3289;151;3440;NA;282011;1013;2022-01-23;181384
2022-01-22;"Bratislavský kraj";1130;2802;125;2927;NA;282011;1255;2022-01-22;180371
2022-01-21;"Bratislavský kraj";1057;4656;166;4822;NA;282011;1223;2022-01-21;179116
2022-01-20;"Bratislavský kraj";940;4893;146;5039;NA;282011;1086;2022-01-20;177893
2022-01-19;"Bratislavský kraj";857;4618;169;4787;NA;282011;1026;2022-01-19;176807
2022-01-18;"Bratislavský kraj";794;5002;163;5165;NA;282011;957;2022-01-18;175781
2022-01-17;"Bratislavský kraj";534;7242;150;7392;NA;282011;684;2022-01-17;174824
2022-01-16;"Bratislavský kraj";300;2854;77;2931;NA;282011;377;2022-01-16;174140
2022-01-15;"Bratislavský kraj";543;2139;71;2210;NA;282011;614;2022-01-15;173763
2022-01-14;"Bratislavský kraj";356;3692;70;3762;NA;282011;426;2022-01-14;173149
2022-01-13;"Bratislavský kraj";382;4579;82;4661;NA;282011;464;2022-01-13;172723
2022-01-12;"Bratislavský kraj";415;4014;71;4085;NA;282011;486;2022-01-12;172259
2022-01-11;"Bratislavský kraj";407;4910;110;5020;NA;282011;517;2022-01-11;171773
2022-01-10;"Bratislavský kraj";413;6380;101;6481;NA;282011;514;2022-01-10;171256
2022-01-09;"Bratislavský kraj";187;3080;71;3151;NA;282011;258;2022-01-09;170742
2022-01-08;"Bratislavský kraj";323;1951;58;2009;NA;282011;381;2022-01-08;170484
2022-01-07;"Bratislavský kraj";436;3809;100;3909;NA;282011;536;2022-01-07;170103
2022-01-06;"Bratislavský kraj";192;2163;51;2214;NA;282011;243;2022-01-06;169567
2022-01-05;"Bratislavský kraj";426;4044;69;4113;NA;282011;495;2022-01-05;169324
2022-01-04;"Bratislavský kraj";446;4467;101;4568;NA;282011;547;2022-01-04;168829
2022-01-03;"Bratislavský kraj";578;5672;129;5801;NA;282011;707;2022-01-03;168282
2022-01-02;"Bratislavský kraj";198;3137;80;3217;NA;282011;278;2022-01-02;167575
2022-01-01;"Bratislavský kraj";7;1103;36;1139;NA;282011;43;2022-01-01;167297
2021-12-31;"Bratislavský kraj";371;3443;92;3535;NA;282011;463;2021-12-31;167254
2021-12-30;"Bratislavský kraj";468;3619;119;3738;NA;282011;587;2021-12-30;166791
2021-12-29;"Bratislavský kraj";404;3598;85;3683;NA;282011;489;2021-12-29;166204
2021-12-28;"Bratislavský kraj";578;4329;121;4450;NA;282011;699;2021-12-28;165715
2021-12-27;"Bratislavský kraj";656;4693;108;4801;NA;282011;764;2021-12-27;165016
2021-12-26;"Bratislavský kraj";198;2549;83;2632;NA;282011;281;2021-12-26;164252
2021-12-25;"Bratislavský kraj";34;1160;53;1213;NA;282011;87;2021-12-25;163971
2021-12-24;"Bratislavský kraj";171;2214;55;2269;NA;282011;226;2021-12-24;163884
2021-12-23;"Bratislavský kraj";678;4134;115;4249;NA;282011;793;2021-12-23;163658
2021-12-22;"Bratislavský kraj";575;4919;118;5037;NA;282011;693;2021-12-22;162865
2021-12-21;"Bratislavský kraj";625;5628;167;5795;NA;282011;792;2021-12-21;162172
2021-12-20;"Bratislavský kraj";528;6163;158;6321;NA;282011;686;2021-12-20;161380
2021-12-19;"Bratislavský kraj";250;3042;98;3140;NA;282011;348;2021-12-19;160694
2021-12-18;"Bratislavský kraj";528;2654;103;2757;NA;282011;631;2021-12-18;160346
2021-12-17;"Bratislavský kraj";683;4917;145;5062;NA;282011;828;2021-12-17;159715
2021-12-16;"Bratislavský kraj";730;5576;162;5738;NA;282011;892;2021-12-16;158887
2021-12-15;"Bratislavský kraj";881;4884;158;5042;NA;282011;1039;2021-12-15;157995
2021-12-14;"Bratislavský kraj";869;5397;179;5576;NA;282011;1048;2021-12-14;156956
2021-12-13;"Bratislavský kraj";648;7614;239;7853;NA;282011;887;2021-12-13;155908
2021-12-12;"Bratislavský kraj";534;3474;129;3603;NA;282011;663;2021-12-12;155021
2021-12-11;"Bratislavský kraj";698;2377;153;2530;NA;282011;851;2021-12-11;154358
2021-12-10;"Bratislavský kraj";796;4728;186;4914;NA;282011;982;2021-12-10;153507
2021-12-09;"Bratislavský kraj";1040;4152;174;4326;NA;282011;1214;2021-12-09;152525
2021-12-08;"Bratislavský kraj";1172;4602;196;4798;NA;282011;1368;2021-12-08;151311
2021-12-07;"Bratislavský kraj";1236;5173;257;5430;NA;282011;1493;2021-12-07;149943
2021-12-06;"Bratislavský kraj";1434;8714;312;9026;NA;282011;1746;2021-12-06;148450
2021-12-05;"Bratislavský kraj";633;3874;197;4071;NA;282011;830;2021-12-05;146704
2021-12-04;"Bratislavský kraj";936;4332;195;4527;NA;282011;1131;2021-12-04;145874
2021-12-03;"Bratislavský kraj";1222;4351;269;4620;NA;282011;1491;2021-12-03;144743
2021-12-02;"Bratislavský kraj";2053;5097;311;5408;NA;282011;2364;2021-12-02;143252
2021-12-01;"Bratislavský kraj";1161;9058;295;9353;NA;282011;1456;2021-12-01;140888
2021-11-30;"Bratislavský kraj";1442;6508;355;6863;NA;282011;1797;2021-11-30;139432
2021-11-29;"Bratislavský kraj";863;8823;452;9275;NA;282011;1315;2021-11-29;137635
2021-11-28;"Bratislavský kraj";617;5102;295;5397;NA;282011;912;2021-11-28;136320
2021-11-27;"Bratislavský kraj";1026;3497;329;3826;NA;282011;1355;2021-11-27;135408
2021-11-26;"Bratislavský kraj";1346;5483;422;5905;NA;282011;1768;2021-11-26;134053
2021-11-25;"Bratislavský kraj";1415;6383;451;6834;NA;282011;1866;2021-11-25;132285
2021-11-24;"Bratislavský kraj";1286;6849;467;7316;NA;282011;1753;2021-11-24;130419
2021-11-23;"Bratislavský kraj";1651;6351;433;6784;NA;282011;2084;2021-11-23;128666
2021-11-22;"Bratislavský kraj";1197;8722;584;9306;NA;282011;1781;2021-11-22;126582
2021-11-21;"Bratislavský kraj";702;4324;320;4644;NA;282011;1022;2021-11-21;124801
2021-11-20;"Bratislavský kraj";1005;3514;360;3874;NA;282011;1365;2021-11-20;123779
2021-11-19;"Bratislavský kraj";1444;5927;549;6476;NA;282011;1993;2021-11-19;122414
2021-11-18;"Bratislavský kraj";1052;6358;548;6906;NA;282011;1600;2021-11-18;120421
2021-11-17;"Bratislavský kraj";832;2439;308;2747;NA;282011;1140;2021-11-17;118821
2021-11-16;"Bratislavský kraj";1067;5792;443;6235;NA;282011;1510;2021-11-16;117681
2021-11-15;"Bratislavský kraj";1014;6330;519;6849;NA;282011;1533;2021-11-15;116171
2021-11-14;"Bratislavský kraj";448;3202;335;3537;NA;282011;783;2021-11-14;114638
2021-11-13;"Bratislavský kraj";587;3251;313;3564;NA;282011;900;2021-11-13;113855
2021-11-12;"Bratislavský kraj";856;5723;357;6080;NA;282011;1213;2021-11-12;112955
2021-11-11;"Bratislavský kraj";787;6028;355;6383;NA;282011;1142;2021-11-11;111742
2021-11-10;"Bratislavský kraj";840;5903;385;6288;NA;282011;1225;2021-11-10;110600
2021-11-09;"Bratislavský kraj";939;5733;350;6083;NA;282011;1289;2021-11-09;109375
2021-11-08;"Bratislavský kraj";579;5641;404;6045;NA;282011;983;2021-11-08;108086
2021-11-07;"Bratislavský kraj";363;2836;244;3080;NA;282011;607;2021-11-07;107103
2021-11-06;"Bratislavský kraj";538;2901;243;3144;NA;282011;781;2021-11-06;106496
2021-11-05;"Bratislavský kraj";801;5640;318;5958;NA;282011;1119;2021-11-05;105715
2021-11-04;"Bratislavský kraj";768;5233;273;5506;NA;282011;1041;2021-11-04;104596
2021-11-03;"Bratislavský kraj";690;5120;290;5410;NA;282011;980;2021-11-03;103555
2021-11-02;"Bratislavský kraj";422;6356;327;6683;NA;282011;749;2021-11-02;102575
2021-11-01;"Bratislavský kraj";395;1733;136;1869;NA;282011;531;2021-11-01;101826
2021-10-31;"Bratislavský kraj";209;2280;163;2443;NA;282011;372;2021-10-31;101295
2021-10-30;"Bratislavský kraj";429;2138;118;2256;NA;282011;547;2021-10-30;100923
2021-10-29;"Bratislavský kraj";445;4757;219;4976;NA;282011;664;2021-10-29;100376
2021-10-28;"Bratislavský kraj";372;4777;179;4956;NA;282011;551;2021-10-28;99712
2021-10-27;"Bratislavský kraj";376;4522;164;4686;NA;282011;540;2021-10-27;99161
2021-10-26;"Bratislavský kraj";461;4492;188;4680;NA;282011;649;2021-10-26;98621
2021-10-25;"Bratislavský kraj";379;5347;192;5539;NA;282011;571;2021-10-25;97972
2021-10-24;"Bratislavský kraj";114;2369;91;2460;NA;282011;205;2021-10-24;97401
2021-10-23;"Bratislavský kraj";301;2666;91;2757;NA;282011;392;2021-10-23;97196
2021-10-22;"Bratislavský kraj";309;4466;122;4588;NA;282011;431;2021-10-22;96804
2021-10-21;"Bratislavský kraj";244;4544;101;4645;NA;282011;345;2021-10-21;96373
2021-10-20;"Bratislavský kraj";262;3897;95;3992;NA;282011;357;2021-10-20;96028
2021-10-19;"Bratislavský kraj";260;4116;68;4184;NA;282011;328;2021-10-19;95671
2021-10-18;"Bratislavský kraj";250;5014;114;5128;NA;282011;364;2021-10-18;95343
2021-10-17;"Bratislavský kraj";54;2460;73;2533;NA;282011;127;2021-10-17;94979
2021-10-16;"Bratislavský kraj";185;2687;63;2750;NA;282011;248;2021-10-16;94852
2021-10-15;"Bratislavský kraj";169;4200;64;4264;NA;282011;233;2021-10-15;94604
2021-10-14;"Bratislavský kraj";173;4714;61;4775;NA;282011;234;2021-10-14;94371
2021-10-13;"Bratislavský kraj";143;3671;76;3747;NA;282011;219;2021-10-13;94137
2021-10-12;"Bratislavský kraj";183;4037;78;4115;NA;282011;261;2021-10-12;93918
2021-10-11;"Bratislavský kraj";191;4798;88;4886;NA;282011;279;2021-10-11;93657
2021-10-10;"Bratislavský kraj";29;2176;43;2219;NA;282011;72;2021-10-10;93378
2021-10-09;"Bratislavský kraj";141;2419;34;2453;NA;282011;175;2021-10-09;93306
2021-10-08;"Bratislavský kraj";130;4511;63;4574;NA;282011;193;2021-10-08;93131
2021-10-07;"Bratislavský kraj";92;4137;61;4198;NA;282011;153;2021-10-07;92938
2021-10-06;"Bratislavský kraj";147;4028;68;4096;NA;282011;215;2021-10-06;92785
2021-10-05;"Bratislavský kraj";164;4468;70;4538;NA;282011;234;2021-10-05;92570
2021-10-04;"Bratislavský kraj";129;4653;79;4732;NA;282011;208;2021-10-04;92336
2021-10-03;"Bratislavský kraj";41;2144;42;2186;NA;282011;83;2021-10-03;92128
2021-10-02;"Bratislavský kraj";104;2605;40;2645;NA;282011;144;2021-10-02;92045
2021-10-01;"Bratislavský kraj";108;4818;57;4875;NA;282011;165;2021-10-01;91901
2021-09-30;"Bratislavský kraj";90;3854;60;3914;NA;282011;150;2021-09-30;91736
2021-09-29;"Bratislavský kraj";115;3508;58;3566;NA;282011;173;2021-09-29;91586
2021-09-28;"Bratislavský kraj";144;4003;48;4051;NA;282011;192;2021-09-28;91413
2021-09-27;"Bratislavský kraj";123;4427;70;4497;NA;282011;193;2021-09-27;91221
2021-09-26;"Bratislavský kraj";32;2194;31;2225;NA;282011;63;2021-09-26;91028
2021-09-25;"Bratislavský kraj";85;2742;38;2780;NA;282011;123;2021-09-25;90965
2021-09-24;"Bratislavský kraj";82;4212;59;4271;NA;282011;141;2021-09-24;90842
2021-09-23;"Bratislavský kraj";90;3975;51;4026;NA;282011;141;2021-09-23;90701
2021-09-22;"Bratislavský kraj";84;3757;63;3820;NA;282011;147;2021-09-22;90560
2021-09-21;"Bratislavský kraj";95;3574;39;3613;NA;282011;134;2021-09-21;90413
2021-09-20;"Bratislavský kraj";84;3937;31;3968;NA;282011;115;2021-09-20;90279
2021-09-19;"Bratislavský kraj";31;1850;28;1878;NA;282011;59;2021-09-19;90164
2021-09-18;"Bratislavský kraj";60;1989;19;2008;NA;282011;79;2021-09-18;90105
2021-09-17;"Bratislavský kraj";87;3443;27;3470;NA;282011;114;2021-09-17;90026
2021-09-16;"Bratislavský kraj";57;3781;43;3824;NA;282011;100;2021-09-16;89912
2021-09-15;"Bratislavský kraj";41;1104;21;1125;NA;282011;62;2021-09-15;89812
2021-09-14;"Bratislavský kraj";78;3518;31;3549;NA;282011;109;2021-09-14;89750
2021-09-13;"Bratislavský kraj";47;3191;28;3219;NA;282011;75;2021-09-13;89641
2021-09-12;"Bratislavský kraj";13;1713;21;1734;NA;282011;34;2021-09-12;89566
2021-09-11;"Bratislavský kraj";36;2064;13;2077;NA;282011;49;2021-09-11;89532
2021-09-10;"Bratislavský kraj";47;3628;18;3646;NA;282011;65;2021-09-10;89483
2021-09-09;"Bratislavský kraj";50;3010;30;3040;NA;282011;80;2021-09-09;89418
2021-09-08;"Bratislavský kraj";56;2925;20;2945;NA;282011;76;2021-09-08;89338
2021-09-07;"Bratislavský kraj";50;3272;18;3290;NA;282011;68;2021-09-07;89262
2021-09-06;"Bratislavský kraj";63;2821;29;2850;NA;282011;92;2021-09-06;89194
2021-09-05;"Bratislavský kraj";10;1682;14;1696;NA;282011;24;2021-09-05;89102
2021-09-04;"Bratislavský kraj";41;2612;11;2623;NA;282011;52;2021-09-04;89078
2021-09-03;"Bratislavský kraj";55;3016;14;3030;NA;282011;69;2021-09-03;89026
2021-09-02;"Bratislavský kraj";35;2423;23;2446;NA;282011;58;2021-09-02;88957
2021-09-01;"Bratislavský kraj";16;929;9;938;NA;282011;25;2021-09-01;88899
2021-08-31;"Bratislavský kraj";28;5197;22;5219;NA;282011;50;2021-08-31;88874
2021-08-30;"Bratislavský kraj";24;2403;13;2416;NA;282011;37;2021-08-30;88824
2021-08-29;"Bratislavský kraj";11;1016;6;1022;NA;282011;17;2021-08-29;88787
2021-08-28;"Bratislavský kraj";24;1714;11;1725;NA;282011;35;2021-08-28;88770
2021-08-27;"Bratislavský kraj";19;2850;9;2859;NA;282011;28;2021-08-27;88735
2021-08-26;"Bratislavský kraj";15;2382;19;2401;NA;282011;34;2021-08-26;88707
2021-08-25;"Bratislavský kraj";29;1888;10;1898;NA;282011;39;2021-08-25;88673
2021-08-24;"Bratislavský kraj";22;1785;4;1789;NA;282011;26;2021-08-24;88634
2021-08-23;"Bratislavský kraj";21;2183;7;2190;NA;282011;28;2021-08-23;88608
2021-08-22;"Bratislavský kraj";5;1383;8;1391;NA;282011;13;2021-08-22;88580
2021-08-21;"Bratislavský kraj";18;1681;4;1685;NA;282011;22;2021-08-21;88567
2021-08-20;"Bratislavský kraj";27;2747;19;2766;NA;282011;46;2021-08-20;88545
2021-08-19;"Bratislavský kraj";15;2122;9;2131;NA;282011;24;2021-08-19;88499
2021-08-18;"Bratislavský kraj";16;1659;11;1670;NA;282011;27;2021-08-18;88475
2021-08-17;"Bratislavský kraj";18;1608;5;1613;NA;282011;23;2021-08-17;88448
2021-08-16;"Bratislavský kraj";18;2559;12;2571;NA;282011;30;2021-08-16;88425
2021-08-15;"Bratislavský kraj";3;1169;6;1175;NA;282011;9;2021-08-15;88395
2021-08-14;"Bratislavský kraj";11;1519;4;1523;NA;282011;15;2021-08-14;88386
2021-08-13;"Bratislavský kraj";32;2634;7;2641;NA;282011;39;2021-08-13;88371
2021-08-12;"Bratislavský kraj";16;1824;9;1833;NA;282011;25;2021-08-12;88332
2021-08-11;"Bratislavský kraj";22;1621;5;1626;NA;282011;27;2021-08-11;88307
2021-08-10;"Bratislavský kraj";15;1630;7;1637;NA;282011;22;2021-08-10;88280
2021-08-09;"Bratislavský kraj";35;1927;9;1936;NA;282011;44;2021-08-09;88258
2021-08-08;"Bratislavský kraj";3;1152;4;1156;NA;282011;7;2021-08-08;88214
2021-08-07;"Bratislavský kraj";6;1572;9;1581;NA;282011;15;2021-08-07;88207
2021-08-06;"Bratislavský kraj";9;2510;10;2520;NA;282011;19;2021-08-06;88192
2021-08-05;"Bratislavský kraj";10;1651;7;1658;NA;282011;17;2021-08-05;88173
2021-08-04;"Bratislavský kraj";9;1578;0;1578;NA;282011;9;2021-08-04;88156
2021-08-03;"Bratislavský kraj";11;1507;5;1512;NA;282011;16;2021-08-03;88147
2021-08-02;"Bratislavský kraj";15;1749;11;1760;NA;282011;26;2021-08-02;88131
2021-08-01;"Bratislavský kraj";4;1224;8;1232;NA;282011;12;2021-08-01;88105
2021-07-31;"Bratislavský kraj";7;1623;2;1625;NA;282011;9;2021-07-31;88093
2021-07-30;"Bratislavský kraj";15;2540;7;2547;NA;282011;22;2021-07-30;88084
2021-07-29;"Bratislavský kraj";19;1790;7;1797;NA;282011;26;2021-07-29;88062
2021-07-28;"Bratislavský kraj";8;1538;11;1549;NA;282011;19;2021-07-28;88036
2021-07-27;"Bratislavský kraj";9;1476;5;1481;NA;282011;14;2021-07-27;88017
2021-07-26;"Bratislavský kraj";17;1806;7;1813;NA;282011;24;2021-07-26;88003
2021-07-25;"Bratislavský kraj";4;1411;2;1413;NA;282011;6;2021-07-25;87979
2021-07-24;"Bratislavský kraj";9;1732;3;1735;NA;282011;12;2021-07-24;87973
2021-07-23;"Bratislavský kraj";6;2400;3;2403;NA;282011;9;2021-07-23;87961
2021-07-22;"Bratislavský kraj";12;1944;6;1950;NA;282011;18;2021-07-22;87952
2021-07-21;"Bratislavský kraj";5;1860;6;1866;NA;282011;11;2021-07-21;87934
2021-07-20;"Bratislavský kraj";19;1559;1;1560;NA;282011;20;2021-07-20;87923
2021-07-19;"Bratislavský kraj";15;2259;3;2262;NA;282011;18;2021-07-19;87903
2021-07-18;"Bratislavský kraj";2;1462;3;1465;NA;282011;5;2021-07-18;87885
2021-07-17;"Bratislavský kraj";3;1870;2;1872;NA;282011;5;2021-07-17;87880
2021-07-16;"Bratislavský kraj";8;2834;4;2838;NA;282011;12;2021-07-16;87875
2021-07-15;"Bratislavský kraj";5;1677;0;1677;NA;282011;5;2021-07-15;87863
2021-07-14;"Bratislavský kraj";5;1904;3;1907;NA;282011;8;2021-07-14;87858
2021-07-13;"Bratislavský kraj";4;1584;4;1588;NA;282011;8;2021-07-13;87850
2021-07-12;"Bratislavský kraj";6;1780;5;1785;NA;282011;11;2021-07-12;87842
2021-07-11;"Bratislavský kraj";3;1896;3;1899;NA;282011;6;2021-07-11;87831
2021-07-10;"Bratislavský kraj";5;2240;3;2243;NA;282011;8;2021-07-10;87825
2021-07-09;"Bratislavský kraj";13;3546;7;3553;NA;282011;20;2021-07-09;87817
2021-07-08;"Bratislavský kraj";9;2433;4;2437;NA;282011;13;2021-07-08;87797
2021-07-07;"Bratislavský kraj";5;2792;4;2796;NA;282011;9;2021-07-07;87784
2021-07-06;"Bratislavský kraj";19;2771;4;2775;NA;282011;23;2021-07-06;87775
2021-07-05;"Bratislavský kraj";5;2481;5;2486;NA;282011;10;2021-07-05;87752
2021-07-04;"Bratislavský kraj";3;1824;2;1826;NA;282011;5;2021-07-04;87742
2021-07-03;"Bratislavský kraj";8;2205;5;2210;NA;282011;13;2021-07-03;87737
2021-07-02;"Bratislavský kraj";4;2227;4;2231;NA;282011;8;2021-07-02;87724
2021-07-01;"Bratislavský kraj";6;1809;5;1814;NA;282011;11;2021-07-01;87716
2021-06-30;"Bratislavský kraj";2;11548;11;11559;NA;282011;13;2021-06-30;87705
2021-06-29;"Bratislavský kraj";5;6831;7;6838;NA;282011;12;2021-06-29;87692
2021-06-28;"Bratislavský kraj";16;6654;24;6678;NA;282011;40;2021-06-28;87680
2021-06-27;"Bratislavský kraj";4;6689;11;6700;NA;282011;15;2021-06-27;87640
2021-06-26;"Bratislavský kraj";3;8741;6;8747;NA;282011;9;2021-06-26;87625
2021-06-25;"Bratislavský kraj";7;10285;15;10300;NA;282011;22;2021-06-25;87616
2021-06-24;"Bratislavský kraj";3;7384;16;7400;NA;282011;19;2021-06-24;87594
2021-06-23;"Bratislavský kraj";4;7346;12;7358;NA;282011;16;2021-06-23;87575
2021-06-22;"Bratislavský kraj";6;7244;10;7254;NA;282011;16;2021-06-22;87559
2021-06-21;"Bratislavský kraj";5;7641;9;7650;NA;282011;14;2021-06-21;87543
2021-06-20;"Bratislavský kraj";0;7369;5;7374;NA;282011;5;2021-06-20;87529
2021-06-19;"Bratislavský kraj";3;9226;4;9230;NA;282011;7;2021-06-19;87524
2021-06-18;"Bratislavský kraj";5;12763;9;12772;NA;282011;14;2021-06-18;87517
2021-06-17;"Bratislavský kraj";3;8625;13;8638;NA;282011;16;2021-06-17;87503
2021-06-16;"Bratislavský kraj";3;7105;4;7109;NA;282011;7;2021-06-16;87487
2021-06-15;"Bratislavský kraj";7;7309;17;7326;NA;282011;24;2021-06-15;87480
2021-06-14;"Bratislavský kraj";4;8231;9;8240;NA;282011;13;2021-06-14;87456
2021-06-13;"Bratislavský kraj";2;8791;11;8802;NA;282011;13;2021-06-13;87443
2021-06-12;"Bratislavský kraj";4;11152;11;11163;NA;282011;15;2021-06-12;87430
2021-06-11;"Bratislavský kraj";9;13644;21;13665;NA;282011;30;2021-06-11;87415
2021-06-10;"Bratislavský kraj";12;8637;15;8652;NA;282011;27;2021-06-10;87385
2021-06-09;"Bratislavský kraj";12;7596;12;7608;NA;282011;24;2021-06-09;87358
2021-06-08;"Bratislavský kraj";13;7907;29;7936;NA;282011;42;2021-06-08;87334
2021-06-07;"Bratislavský kraj";13;9247;43;9290;NA;282011;56;2021-06-07;87292
2021-06-06;"Bratislavský kraj";3;10350;20;10370;NA;282011;23;2021-06-06;87236
2021-06-05;"Bratislavský kraj";2;12692;15;12707;NA;282011;17;2021-06-05;87213
2021-06-04;"Bratislavský kraj";10;13846;31;13877;NA;282011;41;2021-06-04;87196
2021-06-03;"Bratislavský kraj";12;9615;19;9634;NA;282011;31;2021-06-03;87155
2021-06-02;"Bratislavský kraj";10;8684;17;8701;NA;282011;27;2021-06-02;87124
2021-06-01;"Bratislavský kraj";3;8812;25;8837;NA;282011;28;2021-06-01;87097
2021-05-31;"Bratislavský kraj";18;11248;32;11280;NA;282011;50;2021-05-31;87069
2021-05-30;"Bratislavský kraj";1;11758;17;11775;NA;282011;18;2021-05-30;87019
2021-05-29;"Bratislavský kraj";4;12245;8;12253;NA;282011;12;2021-05-29;87001
2021-05-28;"Bratislavský kraj";14;15865;23;15888;NA;282011;37;2021-05-28;86989
2021-05-27;"Bratislavský kraj";5;11321;18;11339;NA;282011;23;2021-05-27;86952
2021-05-26;"Bratislavský kraj";20;10709;17;10726;NA;282011;37;2021-05-26;86929
2021-05-25;"Bratislavský kraj";19;11864;31;11895;NA;282011;50;2021-05-25;86892
2021-05-24;"Bratislavský kraj";12;12966;23;12989;NA;282011;35;2021-05-24;86842
2021-05-23;"Bratislavský kraj";7;13074;24;13098;NA;282011;31;2021-05-23;86807
2021-05-22;"Bratislavský kraj";6;14044;22;14066;NA;282011;28;2021-05-22;86776
2021-05-21;"Bratislavský kraj";15;18996;22;19018;NA;282011;37;2021-05-21;86748
2021-05-20;"Bratislavský kraj";15;14112;17;14129;NA;282011;32;2021-05-20;86711
2021-05-19;"Bratislavský kraj";21;11958;24;11982;NA;282011;45;2021-05-19;86679
2021-05-18;"Bratislavský kraj";14;13005;33;13038;NA;282011;47;2021-05-18;86634
2021-05-17;"Bratislavský kraj";15;13854;29;13883;NA;282011;44;2021-05-17;86587
2021-05-16;"Bratislavský kraj";12;19797;32;19829;NA;282011;44;2021-05-16;86543
2021-05-15;"Bratislavský kraj";1;18113;30;18143;NA;282011;31;2021-05-15;86499
2021-05-14;"Bratislavský kraj";15;22228;30;22258;NA;282011;45;2021-05-14;86468
2021-05-13;"Bratislavský kraj";9;16211;17;16228;NA;282011;26;2021-05-13;86423
2021-05-12;"Bratislavský kraj";11;14638;28;14666;NA;282011;39;2021-05-12;86397
2021-05-11;"Bratislavský kraj";29;16741;32;16773;NA;282011;61;2021-05-11;86358
2021-05-10;"Bratislavský kraj";27;19991;64;20055;NA;282011;91;2021-05-10;86297
2021-05-09;"Bratislavský kraj";9;29358;32;29390;NA;282011;41;2021-05-09;86206
2021-05-08;"Bratislavský kraj";5;19451;24;19475;NA;282011;29;2021-05-08;86165
2021-05-07;"Bratislavský kraj";32;28211;65;28276;NA;282011;97;2021-05-07;86136
2021-05-06;"Bratislavský kraj";19;20079;52;20131;NA;282011;71;2021-05-06;86039
2021-05-05;"Bratislavský kraj";29;15526;31;15557;NA;282011;60;2021-05-05;85968
2021-05-04;"Bratislavský kraj";46;19143;53;19196;NA;282011;99;2021-05-04;85908
2021-05-03;"Bratislavský kraj";37;22322;64;22386;NA;282011;101;2021-05-03;85809
2021-05-02;"Bratislavský kraj";38;43064;75;43139;NA;282011;113;2021-05-02;85708
2021-05-01;"Bratislavský kraj";11;39905;40;39945;NA;282011;51;2021-05-01;85595
2021-04-30;"Bratislavský kraj";43;47403;82;47485;NA;282011;125;2021-04-30;85544
2021-04-29;"Bratislavský kraj";48;30257;96;30353;NA;282011;144;2021-04-29;85419
2021-04-28;"Bratislavský kraj";40;28905;78;28983;NA;282011;118;2021-04-28;85275
2021-04-27;"Bratislavský kraj";41;30168;52;30220;NA;282011;93;2021-04-27;85157
2021-04-26;"Bratislavský kraj";59;34733;97;34830;NA;282011;156;2021-04-26;85064
2021-04-25;"Bratislavský kraj";8;57615;74;57689;NA;282011;82;2021-04-25;84908
2021-04-24;"Bratislavský kraj";28;74858;66;74924;NA;282011;94;2021-04-24;84826
2021-04-23;"Bratislavský kraj";70;48614;62;48676;NA;282011;132;2021-04-23;84732
2021-04-22;"Bratislavský kraj";39;31037;72;31109;NA;282011;111;2021-04-22;84600
2021-04-21;"Bratislavský kraj";48;30442;62;30504;NA;282011;110;2021-04-21;84489
2021-04-20;"Bratislavský kraj";58;35216;63;35279;NA;282011;121;2021-04-20;84379
2021-04-19;"Bratislavský kraj";48;39500;80;39580;NA;282011;128;2021-04-19;84258
2021-04-18;"Bratislavský kraj";35;62300;76;62376;NA;282011;111;2021-04-18;84130
2021-04-17;"Bratislavský kraj";13;80359;111;80470;NA;282011;124;2021-04-17;84019
2021-04-16;"Bratislavský kraj";62;47296;80;47376;NA;282011;142;2021-04-16;83895
2021-04-15;"Bratislavský kraj";34;32176;74;32250;NA;282011;108;2021-04-15;83753
2021-04-14;"Bratislavský kraj";65;33961;88;34049;NA;282011;153;2021-04-14;83645
2021-04-13;"Bratislavský kraj";82;35512;82;35594;NA;282011;164;2021-04-13;83492
2021-04-12;"Bratislavský kraj";77;42286;115;42401;NA;282011;192;2021-04-12;83328
2021-04-11;"Bratislavský kraj";42;61151;123;61274;NA;282011;165;2021-04-11;83136
2021-04-10;"Bratislavský kraj";14;77874;167;78041;NA;282011;181;2021-04-10;82971
2021-04-09;"Bratislavský kraj";72;41556;97;41653;NA;282011;169;2021-04-09;82790
2021-04-08;"Bratislavský kraj";71;28866;95;28961;NA;282011;166;2021-04-08;82621
2021-04-07;"Bratislavský kraj";96;38061;101;38162;NA;282011;197;2021-04-07;82455
2021-04-06;"Bratislavský kraj";94;56204;179;56383;NA;282011;273;2021-04-06;82258
2021-04-05;"Bratislavský kraj";85;18538;85;18623;NA;282011;170;2021-04-05;81985
2021-04-04;"Bratislavský kraj";37;29225;75;29300;NA;282011;112;2021-04-04;81815
2021-04-03;"Bratislavský kraj";52;79865;220;80085;NA;282011;272;2021-04-03;81703
2021-04-02;"Bratislavský kraj";33;23790;104;23894;NA;282011;137;2021-04-02;81431
2021-04-01;"Bratislavský kraj";119;57388;159;57547;NA;282011;278;2021-04-01;81294
2021-03-31;"Bratislavský kraj";105;46371;177;46548;NA;282011;282;2021-03-31;81016
2021-03-30;"Bratislavský kraj";100;39599;144;39743;NA;282011;244;2021-03-30;80734
2021-03-29;"Bratislavský kraj";153;40364;178;40542;NA;282011;331;2021-03-29;80490
2021-03-28;"Bratislavský kraj";59;53372;137;53509;NA;282011;196;2021-03-28;80159
2021-03-27;"Bratislavský kraj";53;79834;240;80074;NA;282011;293;2021-03-27;79963
2021-03-26;"Bratislavský kraj";114;56108;191;56299;NA;282011;305;2021-03-26;79670
2021-03-25;"Bratislavský kraj";76;36859;172;37031;NA;282011;248;2021-03-25;79365
2021-03-24;"Bratislavský kraj";120;30567;201;30768;NA;282011;321;2021-03-24;79117
2021-03-23;"Bratislavský kraj";138;36438;190;36628;NA;282011;328;2021-03-23;78796
2021-03-22;"Bratislavský kraj";110;42756;220;42976;NA;282011;330;2021-03-22;78468
2021-03-21;"Bratislavský kraj";54;61299;212;61511;NA;282011;266;2021-03-21;78138
2021-03-20;"Bratislavský kraj";59;73300;228;73528;NA;282011;287;2021-03-20;77872
2021-03-19;"Bratislavský kraj";139;54576;257;54833;NA;282011;396;2021-03-19;77585
2021-03-18;"Bratislavský kraj";142;34611;192;34803;NA;282011;334;2021-03-18;77189
2021-03-17;"Bratislavský kraj";177;30482;217;30699;NA;282011;394;2021-03-17;76855
2021-03-16;"Bratislavský kraj";258;36798;287;37085;NA;282011;545;2021-03-16;76461
2021-03-15;"Bratislavský kraj";180;38226;255;38481;NA;282011;435;2021-03-15;75916
2021-03-14;"Bratislavský kraj";75;52611;275;52886;NA;282011;350;2021-03-14;75481
2021-03-13;"Bratislavský kraj";110;81405;341;81746;NA;282011;451;2021-03-13;75131
2021-03-12;"Bratislavský kraj";152;55233;312;55545;NA;282011;464;2021-03-12;74680
2021-03-11;"Bratislavský kraj";178;34678;286;34964;NA;282011;464;2021-03-11;74216
2021-03-10;"Bratislavský kraj";164;31061;280;31341;NA;282011;444;2021-03-10;73752
2021-03-09;"Bratislavský kraj";242;37687;267;37954;NA;282011;509;2021-03-09;73308
2021-03-08;"Bratislavský kraj";255;41199;348;41547;NA;282011;603;2021-03-08;72799
2021-03-07;"Bratislavský kraj";142;52812;301;53113;NA;282011;443;2021-03-07;72196
2021-03-06;"Bratislavský kraj";79;71821;415;72236;NA;282011;494;2021-03-06;71753
2021-03-05;"Bratislavský kraj";238;50653;293;50946;NA;282011;531;2021-03-05;71259
2021-03-04;"Bratislavský kraj";204;34544;344;34888;NA;282011;548;2021-03-04;70728
2021-03-03;"Bratislavský kraj";250;30527;364;30891;NA;282011;614;2021-03-03;70180
2021-03-02;"Bratislavský kraj";267;39735;388;40123;NA;282011;655;2021-03-02;69566
2021-03-01;"Bratislavský kraj";320;38222;432;38654;NA;282011;752;2021-03-01;68911
2021-02-28;"Bratislavský kraj";184;50323;323;50646;NA;282011;507;2021-02-28;68159
2021-02-27;"Bratislavský kraj";151;76580;464;77044;NA;282011;615;2021-02-27;67652
2021-02-26;"Bratislavský kraj";277;47326;401;47727;NA;282011;678;2021-02-26;67037
2021-02-25;"Bratislavský kraj";277;28769;405;29174;NA;282011;682;2021-02-25;66359
2021-02-24;"Bratislavský kraj";217;27095;412;27507;NA;282011;629;2021-02-24;65677
2021-02-23;"Bratislavský kraj";257;31297;395;31692;NA;282011;652;2021-02-23;65048
2021-02-22;"Bratislavský kraj";353;36607;483;37090;NA;282011;836;2021-02-22;64396
2021-02-21;"Bratislavský kraj";185;54150;396;54546;NA;282011;581;2021-02-21;63560
2021-02-20;"Bratislavský kraj";167;74814;550;75364;NA;282011;717;2021-02-20;62979
2021-02-19;"Bratislavský kraj";280;44882;416;45298;NA;282011;696;2021-02-19;62262
2021-02-18;"Bratislavský kraj";263;26379;371;26750;NA;282011;634;2021-02-18;61566
2021-02-17;"Bratislavský kraj";264;22820;316;23136;NA;282011;580;2021-02-17;60932
2021-02-16;"Bratislavský kraj";289;28262;352;28614;NA;282011;641;2021-02-16;60352
2021-02-15;"Bratislavský kraj";248;36893;396;37289;NA;282011;644;2021-02-15;59711
2021-02-14;"Bratislavský kraj";153;47948;323;48271;NA;282011;476;2021-02-14;59067
2021-02-13;"Bratislavský kraj";173;68589;515;69104;NA;282011;688;2021-02-13;58591
2021-02-12;"Bratislavský kraj";282;35729;327;36056;NA;282011;609;2021-02-12;57903
2021-02-11;"Bratislavský kraj";337;24565;285;24850;NA;282011;622;2021-02-11;57294
2021-02-10;"Bratislavský kraj";314;22944;356;23300;NA;282011;670;2021-02-10;56672
2021-02-09;"Bratislavský kraj";288;36565;454;37019;NA;282011;742;2021-02-09;56002
2021-02-08;"Bratislavský kraj";484;31896;397;32293;NA;282011;881;2021-02-08;55260
2021-02-07;"Bratislavský kraj";243;51290;425;51715;NA;282011;668;2021-02-07;54379
2021-02-06;"Bratislavský kraj";116;61682;501;62183;NA;282011;617;2021-02-06;53711
2021-02-05;"Bratislavský kraj";327;27033;375;27408;NA;282011;702;2021-02-05;53094
2021-02-04;"Bratislavský kraj";555;17260;348;17608;NA;282011;903;2021-02-04;52392
2021-02-03;"Bratislavský kraj";161;13020;352;13372;NA;282011;513;2021-02-03;51489
2021-02-02;"Bratislavský kraj";397;25947;480;26427;NA;282011;877;2021-02-02;50976
2021-02-01;"Bratislavský kraj";221;35541;513;36054;NA;282011;734;2021-02-01;50099
2021-01-31;"Bratislavský kraj";180;35693;425;36118;NA;282011;605;2021-01-31;49365
2021-01-30;"Bratislavský kraj";310;49588;521;50109;NA;282011;831;2021-01-30;48760
2021-01-29;"Bratislavský kraj";344;16568;344;16912;NA;282011;688;2021-01-29;47929
2021-01-28;"Bratislavský kraj";307;10715;297;11012;NA;282011;604;2021-01-28;47241
2021-01-27;"Bratislavský kraj";336;22222;345;22567;NA;282011;681;2021-01-27;46637
2021-01-26;"Bratislavský kraj";297;21894;300;22194;NA;282011;597;2021-01-26;45956
2021-01-25;"Bratislavský kraj";356;23335;249;23584;NA;282011;605;2021-01-25;45359
2021-01-24;"Bratislavský kraj";175;37903;404;38307;NA;282011;579;2021-01-24;44754
2021-01-23;"Bratislavský kraj";396;79453;690;80143;NA;282011;1086;2021-01-23;44175
2021-01-22;"Bratislavský kraj";199;42055;365;42420;NA;282011;564;2021-01-22;43089
2021-01-21;"Bratislavský kraj";255;105746;1317;107063;NA;282011;1572;2021-01-21;42525
2021-01-20;"Bratislavský kraj";360;27289;452;27741;NA;282011;812;2021-01-20;40953
2021-01-19;"Bratislavský kraj";375;15318;346;15664;NA;282011;721;2021-01-19;40141
2021-01-18;"Bratislavský kraj";357;12533;707;13240;NA;282011;1064;2021-01-18;39420
2021-01-17;"Bratislavský kraj";244;482;26;508;NA;282011;270;2021-01-17;38356
2021-01-16;"Bratislavský kraj";70;3016;156;3172;NA;282011;226;2021-01-16;38086
2021-01-15;"Bratislavský kraj";251;7896;256;8152;NA;282011;507;2021-01-15;37860
2021-01-14;"Bratislavský kraj";363;8523;273;8796;NA;282011;636;2021-01-14;37353
2021-01-13;"Bratislavský kraj";336;8490;327;8817;NA;282011;663;2021-01-13;36717
2021-01-12;"Bratislavský kraj";450;10509;455;10964;NA;282011;905;2021-01-12;36054
2021-01-11;"Bratislavský kraj";397;19863;364;20227;NA;282011;761;2021-01-11;35149
2021-01-10;"Bratislavský kraj";252;1507;79;1586;NA;282011;331;2021-01-10;34388
2021-01-09;"Bratislavský kraj";351;4721;277;4998;NA;282011;628;2021-01-09;34057
2021-01-08;"Bratislavský kraj";556;10045;436;10481;NA;282011;992;2021-01-08;33429
2021-01-07;"Bratislavský kraj";537;6872;352;7224;NA;282011;889;2021-01-07;32437
2021-01-06;"Bratislavský kraj";271;3329;216;3545;NA;282011;487;2021-01-06;31548
2021-01-05;"Bratislavský kraj";619;10635;814;11449;NA;282011;1433;2021-01-05;31061
2021-01-04;"Bratislavský kraj";601;8226;538;8764;NA;282011;1139;2021-01-04;29628
2021-01-03;"Bratislavský kraj";77;433;41;474;NA;282011;118;2021-01-03;28489
2021-01-02;"Bratislavský kraj";185;462;57;519;NA;282011;242;2021-01-02;28371
2021-01-01;"Bratislavský kraj";235;3277;131;3408;NA;282011;366;2021-01-01;28129
2020-12-31;"Bratislavský kraj";925;14135;519;14654;NA;282011;1444;2020-12-31;27763
2020-12-30;"Bratislavský kraj";650;9164;533;9697;NA;282011;1183;2020-12-30;26319
2020-12-29;"Bratislavský kraj";303;10108;699;10807;NA;282011;1002;2020-12-29;25136
2020-12-28;"Bratislavský kraj";255;7784;473;8257;NA;282011;728;2020-12-28;24134
2020-12-27;"Bratislavský kraj";160;709;76;785;NA;282011;236;2020-12-27;23406
2020-12-26;"Bratislavský kraj";75;480;27;507;NA;282011;102;2020-12-26;23170
2020-12-25;"Bratislavský kraj";114;503;38;541;NA;282011;152;2020-12-25;23068
2020-12-24;"Bratislavský kraj";536;3367;104;3471;NA;282011;640;2020-12-24;22916
2020-12-23;"Bratislavský kraj";416;12590;447;13037;NA;282011;863;2020-12-23;22276
2020-12-22;"Bratislavský kraj";327;14587;699;15286;NA;282011;1026;2020-12-22;21413
2020-12-21;"Bratislavský kraj";392;14972;1946;16918;NA;282011;2338;2020-12-21;20387
2020-12-20;"Bratislavský kraj";180;797;57;854;NA;282011;237;2020-12-20;18049
2020-12-19;"Bratislavský kraj";396;3314;130;3444;NA;282011;526;2020-12-19;17812
2020-12-18;"Bratislavský kraj";306;9938;345;10283;NA;282011;651;2020-12-18;17286
2020-12-17;"Bratislavský kraj";502;9739;386;10125;NA;282011;888;2020-12-17;16635
2020-12-16;"Bratislavský kraj";282;10201;418;10619;NA;282011;700;2020-12-16;15747
2020-12-15;"Bratislavský kraj";423;10450;454;10904;NA;282011;877;2020-12-15;15047
2020-12-14;"Bratislavský kraj";279;6793;261;7054;NA;282011;540;2020-12-14;14170
2020-12-13;"Bratislavský kraj";125;139;10;149;NA;282011;135;2020-12-13;13630
2020-12-12;"Bratislavský kraj";361;3886;157;4043;NA;282011;518;2020-12-12;13495
2020-12-11;"Bratislavský kraj";326;6824;235;7059;NA;282011;561;2020-12-11;12977
2020-12-10;"Bratislavský kraj";286;5279;166;5445;NA;282011;452;2020-12-10;12416
2020-12-09;"Bratislavský kraj";382;4778;177;4955;NA;282011;559;2020-12-09;11964
2020-12-08;"Bratislavský kraj";234;6243;207;6450;NA;282011;441;2020-12-08;11405
2020-12-07;"Bratislavský kraj";272;4639;152;4791;NA;282011;424;2020-12-07;10964
2020-12-06;"Bratislavský kraj";61;1625;52;1677;NA;282011;113;2020-12-06;10540
2020-12-05;"Bratislavský kraj";266;2221;41;2262;NA;282011;307;2020-12-05;10427
2020-12-04;"Bratislavský kraj";200;4954;99;5053;NA;282011;299;2020-12-04;10120
2020-12-03;"Bratislavský kraj";213;5672;95;5767;NA;282011;308;2020-12-03;9821
2020-12-02;"Bratislavský kraj";205;3462;103;3565;NA;282011;308;2020-12-02;9513
2020-12-01;"Bratislavský kraj";255;3889;172;4061;NA;282011;427;2020-12-01;9205
2020-11-30;"Bratislavský kraj";152;2153;121;2274;NA;282011;273;2020-11-30;8778
2020-11-29;"Bratislavský kraj";52;201;24;225;NA;282011;76;2020-11-29;8505
2020-11-28;"Bratislavský kraj";232;2624;33;2657;NA;282011;265;2020-11-28;8429
2020-11-27;"Bratislavský kraj";54;2540;64;2604;NA;282011;118;2020-11-27;8164
2020-11-26;"Bratislavský kraj";129;1976;60;2036;NA;282011;189;2020-11-26;8046
2020-11-25;"Bratislavský kraj";140;1770;47;1817;NA;282011;187;2020-11-25;7857
2020-11-24;"Bratislavský kraj";81;2988;67;3055;NA;282011;148;2020-11-24;7670
2020-11-23;"Bratislavský kraj";67;7083;58;7141;NA;282011;125;2020-11-23;7522
2020-11-22;"Bratislavský kraj";36;81;7;88;NA;282011;43;2020-11-22;7397
2020-11-21;"Bratislavský kraj";109;2126;47;2173;NA;282011;156;2020-11-21;7354
2020-11-20;"Bratislavský kraj";118;2876;48;2924;NA;282011;166;2020-11-20;7198
2020-11-19;"Bratislavský kraj";173;987;29;1016;NA;282011;202;2020-11-19;7032
2020-11-18;"Bratislavský kraj";118;616;75;691;NA;282011;193;2020-11-18;6830
2020-11-17;"Bratislavský kraj";108;928;23;951;NA;282011;131;2020-11-17;6637
2020-11-16;"Bratislavský kraj";82;651;9;660;NA;282011;91;2020-11-16;6506
2020-11-15;"Bratislavský kraj";47;236;0;236;NA;282011;47;2020-11-15;6415
2020-11-14;"Bratislavský kraj";53;1834;15;1849;NA;282011;68;2020-11-14;6368
2020-11-13;"Bratislavský kraj";94;2096;21;2117;NA;282011;115;2020-11-13;6300
2020-11-12;"Bratislavský kraj";141;1727;6;1733;NA;282011;147;2020-11-12;6185
2020-11-11;"Bratislavský kraj";159;1429;12;1441;NA;282011;171;2020-11-11;6038
2020-11-10;"Bratislavský kraj";136;805;14;819;NA;282011;150;2020-11-10;5867
2020-11-09;"Bratislavský kraj";70;616;8;624;NA;282011;78;2020-11-09;5717
2020-11-08;"Bratislavský kraj";82;869;6;875;NA;282011;88;2020-11-08;5639
2020-11-07;"Bratislavský kraj";88;4039;17;4056;NA;282011;105;2020-11-07;5551
2020-11-06;"Bratislavský kraj";281;6441;25;6466;NA;282011;306;2020-11-06;5446
2020-11-05;"Bratislavský kraj";175;476;11;487;NA;282011;186;2020-11-05;5140
2020-11-04;"Bratislavský kraj";65;411;10;421;NA;282011;75;2020-11-04;4954
2020-11-03;"Bratislavský kraj";251;1085;12;1097;NA;282011;263;2020-11-03;4879
2020-11-02;"Bratislavský kraj";202;3365;22;3387;NA;282011;224;2020-11-02;4616
2020-11-01;"Bratislavský kraj";227;8694;39;8733;NA;282011;266;2020-11-01;4392
2020-10-31;"Bratislavský kraj";173;22407;123;22530;NA;282011;296;2020-10-31;4126
2020-10-30;"Bratislavský kraj";158;17350;138;17488;NA;282011;296;2020-10-30;3830
2020-10-29;"Bratislavský kraj";262;116;4;120;NA;282011;266;2020-10-29;3534
2020-10-28;"Bratislavský kraj";220;260;15;275;NA;282011;235;2020-10-28;3268
2020-10-27;"Bratislavský kraj";256;145;4;149;NA;282011;260;2020-10-27;3033
2020-10-26;"Bratislavský kraj";123;229;11;240;NA;282011;134;2020-10-26;2773
2020-10-25;"Bratislavský kraj";152;33;2;35;NA;282011;154;2020-10-25;2639
2020-10-24;"Bratislavský kraj";170;221;6;227;NA;282011;176;2020-10-24;2485
2020-10-23;"Bratislavský kraj";151;144;8;152;NA;282011;159;2020-10-23;2309
2020-10-22;"Bratislavský kraj";192;204;15;219;NA;282011;207;2020-10-22;2150
2020-10-21;"Bratislavský kraj";66;90;6;96;NA;282011;72;2020-10-21;1943
2020-10-20;"Bratislavský kraj";183;97;4;101;NA;282011;187;2020-10-20;1871
2020-10-19;"Bratislavský kraj";148;80;3;83;NA;282011;151;2020-10-19;1684
2020-10-18;"Bratislavský kraj";75;92;0;92;NA;282011;75;2020-10-18;1533
2020-10-17;"Bratislavský kraj";136;0;0;0;NA;282011;136;2020-10-17;1458
2020-10-16;"Bratislavský kraj";103;14;1;15;NA;282011;104;2020-10-16;1322
2020-10-15;"Bratislavský kraj";135;6;1;7;NA;282011;136;2020-10-15;1218
2020-10-14;"Bratislavský kraj";127;4;0;4;NA;282011;127;2020-10-14;1082
2020-10-13;"Bratislavský kraj";86;108;8;116;NA;282011;94;2020-10-13;955
2020-10-12;"Bratislavský kraj";46;0;0;0;NA;282011;46;2020-10-12;861
2020-10-11;"Bratislavský kraj";80;0;0;0;NA;282011;80;2020-10-11;815
2020-10-10;"Bratislavský kraj";55;0;0;0;NA;282011;55;2020-10-10;735
2020-10-09;"Bratislavský kraj";148;0;0;0;NA;282011;148;2020-10-09;680
2020-10-08;"Bratislavský kraj";100;0;0;0;NA;282011;100;2020-10-08;532
2020-10-07;"Bratislavský kraj";107;0;0;0;NA;282011;107;2020-10-07;432
2020-10-06;"Bratislavský kraj";108;0;0;0;NA;282011;108;2020-10-06;325
2020-10-05;"Bratislavský kraj";30;0;0;0;NA;282011;30;2020-10-05;217
2020-10-04;"Bratislavský kraj";49;0;0;0;NA;282011;49;2020-10-04;187
2020-10-03;"Bratislavský kraj";82;0;0;0;NA;282011;82;2020-10-03;138
2020-10-02;"Bratislavský kraj";101;0;0;0;NA;282011;101;2020-10-02;56
2020-10-01;"Bratislavský kraj";72;0;0;0;NA;282011;72;2020-10-01;-45
2020-09-30;"Bratislavský kraj";91;0;0;0;NA;282011;91;2020-09-30;-117
2020-09-29;"Bratislavský kraj";74;0;0;0;NA;282011;74;2020-09-29;-208
2020-09-28;"Bratislavský kraj";29;0;0;0;NA;282011;29;2020-09-28;-282
2020-09-27;"Bratislavský kraj";48;0;0;0;NA;282011;48;2020-09-27;-311
2020-09-26;"Bratislavský kraj";86;0;0;0;NA;282011;86;2020-09-26;-359
2020-09-25;"Bratislavský kraj";97;0;0;0;NA;282011;97;2020-09-25;-445
2020-09-24;"Bratislavský kraj";73;0;0;0;NA;282011;73;2020-09-24;-542
2020-09-23;"Bratislavský kraj";55;0;0;0;NA;282011;55;2020-09-23;-615
2020-09-22;"Bratislavský kraj";81;0;0;0;NA;282011;81;2020-09-22;-670
2020-09-21;"Bratislavský kraj";32;0;0;0;NA;282011;32;2020-09-21;-751
2020-09-20;"Bratislavský kraj";25;0;0;0;NA;282011;25;2020-09-20;-783
2020-09-19;"Bratislavský kraj";59;0;0;0;NA;282011;59;2020-09-19;-808
2020-09-18;"Bratislavský kraj";42;0;0;0;NA;282011;42;2020-09-18;-867
2020-09-17;"Bratislavský kraj";52;0;0;0;NA;282011;52;2020-09-17;-909
2020-09-16;"Bratislavský kraj";32;0;0;0;NA;282011;32;2020-09-16;-961
2020-09-15;"Bratislavský kraj";26;0;0;0;NA;282011;26;2020-09-15;-993
2020-09-14;"Bratislavský kraj";24;0;0;0;NA;282011;24;2020-09-14;-1019
2020-09-13;"Bratislavský kraj";11;0;0;0;NA;282011;11;2020-09-13;-1043
2020-09-12;"Bratislavský kraj";24;0;0;0;NA;282011;24;2020-09-12;-1054
2020-09-11;"Bratislavský kraj";50;0;0;0;NA;282011;50;2020-09-11;-1078
2020-09-10;"Bratislavský kraj";47;0;0;0;NA;282011;47;2020-09-10;-1128
2020-09-09;"Bratislavský kraj";40;0;0;0;NA;282011;40;2020-09-09;-1175
2020-09-08;"Bratislavský kraj";58;0;0;0;NA;282011;58;2020-09-08;-1215
2020-09-07;"Bratislavský kraj";39;0;0;0;NA;282011;39;2020-09-07;-1273
2020-09-06;"Bratislavský kraj";11;0;0;0;NA;282011;11;2020-09-06;-1312
2020-09-05;"Bratislavský kraj";37;0;0;0;NA;282011;37;2020-09-05;-1323
2020-09-04;"Bratislavský kraj";87;0;0;0;NA;282011;87;2020-09-04;-1360
2020-09-03;"Bratislavský kraj";51;0;0;0;NA;282011;51;2020-09-03;-1447
2020-09-02;"Bratislavský kraj";50;0;0;0;NA;282011;50;2020-09-02;-1498
2020-09-01;"Bratislavský kraj";16;0;0;0;NA;282011;16;2020-09-01;-1548
2020-08-31;"Bratislavský kraj";19;0;0;0;NA;282011;19;2020-08-31;-1564
2020-08-30;"Bratislavský kraj";9;0;0;0;NA;282011;9;2020-08-30;-1583
2020-08-29;"Bratislavský kraj";12;0;0;0;NA;282011;12;2020-08-29;-1592
2020-08-28;"Bratislavský kraj";35;0;0;0;NA;282011;35;2020-08-28;-1604
2020-08-27;"Bratislavský kraj";33;0;0;0;NA;282011;33;2020-08-27;-1639
2020-08-26;"Bratislavský kraj";27;0;0;0;NA;282011;27;2020-08-26;-1672
2020-08-25;"Bratislavský kraj";29;0;0;0;NA;282011;29;2020-08-25;-1699
2020-08-24;"Bratislavský kraj";6;0;0;0;NA;282011;6;2020-08-24;-1728
2020-08-23;"Bratislavský kraj";45;0;0;0;NA;282011;45;2020-08-23;-1734
2020-08-22;"Bratislavský kraj";13;0;0;0;NA;282011;13;2020-08-22;-1779
2020-08-21;"Bratislavský kraj";46;0;0;0;NA;282011;46;2020-08-21;-1792
2020-08-20;"Bratislavský kraj";41;0;0;0;NA;282011;41;2020-08-20;-1838
2020-08-19;"Bratislavský kraj";27;0;0;0;NA;282011;27;2020-08-19;-1879
2020-08-18;"Bratislavský kraj";47;0;0;0;NA;282011;47;2020-08-18;-1906
2020-08-17;"Bratislavský kraj";2;0;0;0;NA;282011;2;2020-08-17;-1953
2020-08-16;"Bratislavský kraj";3;0;0;0;NA;282011;3;2020-08-16;-1955
2020-08-15;"Bratislavský kraj";18;0;0;0;NA;282011;18;2020-08-15;-1958
2020-08-14;"Bratislavský kraj";16;0;0;0;NA;282011;16;2020-08-14;-1976
2020-08-13;"Bratislavský kraj";12;0;0;0;NA;282011;12;2020-08-13;-1992
2020-08-12;"Bratislavský kraj";10;0;0;0;NA;282011;10;2020-08-12;-2004
2020-08-11;"Bratislavský kraj";23;0;0;0;NA;282011;23;2020-08-11;-2014
2020-08-10;"Bratislavský kraj";2;0;0;0;NA;282011;2;2020-08-10;-2037
2020-08-09;"Bratislavský kraj";2;0;0;0;NA;282011;2;2020-08-09;-2039
2020-08-08;"Bratislavský kraj";1;0;0;0;NA;282011;1;2020-08-08;-2041
2020-08-07;"Bratislavský kraj";9;0;0;0;NA;282011;9;2020-08-07;-2042
2020-08-06;"Bratislavský kraj";15;0;0;0;NA;282011;15;2020-08-06;-2051
2020-08-05;"Bratislavský kraj";11;0;0;0;NA;282011;11;2020-08-05;-2066
2020-08-04;"Bratislavský kraj";21;0;0;0;NA;282011;21;2020-08-04;-2077
2020-08-03;"Bratislavský kraj";7;0;0;0;NA;282011;7;2020-08-03;-2098
2020-08-02;"Bratislavský kraj";0;0;0;0;NA;282011;0;2020-08-02;-2105
2020-08-01;"Bratislavský kraj";0;0;0;0;NA;282011;0;2020-08-01;-2105
2020-07-31;"Bratislavský kraj";14;0;0;0;NA;282011;14;2020-07-31;-2105
2020-07-30;"Bratislavský kraj";6;0;0;0;NA;282011;6;2020-07-30;-2119
2020-07-29;"Bratislavský kraj";7;0;0;0;NA;282011;7;2020-07-29;-2125
2020-07-28;"Bratislavský kraj";14;0;0;0;NA;282011;14;2020-07-28;-2132
2020-07-27;"Bratislavský kraj";3;0;0;0;NA;282011;3;2020-07-27;-2146
2020-07-26;"Bratislavský kraj";0;0;0;0;NA;282011;0;2020-07-26;-2149
2020-07-25;"Bratislavský kraj";8;0;0;0;NA;282011;8;2020-07-25;-2149
2020-07-24;"Bratislavský kraj";2;0;0;0;NA;282011;2;2020-07-24;-2157
2020-07-23;"Bratislavský kraj";8;0;0;0;NA;282011;8;2020-07-23;-2159
2020-07-22;"Bratislavský kraj";11;0;0;0;NA;282011;11;2020-07-22;-2167
2020-07-21;"Bratislavský kraj";8;0;0;0;NA;282011;8;2020-07-21;-2178
2020-07-20;"Bratislavský kraj";12;0;0;0;NA;282011;12;2020-07-20;-2186
2020-07-19;"Bratislavský kraj";0;0;0;0;NA;282011;0;2020-07-19;-2198
2020-07-18;"Bratislavský kraj";2;0;0;0;NA;282011;2;2020-07-18;-2198
2020-07-17;"Bratislavský kraj";2;0;0;0;NA;282011;2;2020-07-17;-2200
2020-07-16;"Bratislavský kraj";6;0;0;0;NA;282011;6;2020-07-16;-2202
2020-07-15;"Bratislavský kraj";3;0;0;0;NA;282011;3;2020-07-15;-2208
2020-07-14;"Bratislavský kraj";2;0;0;0;NA;282011;2;2020-07-14;-2211
2020-07-13;"Bratislavský kraj";2;0;0;0;NA;282011;2;2020-07-13;-2213
2020-07-12;"Bratislavský kraj";0;0;0;0;NA;282011;0;2020-07-12;-2215
2020-07-11;"Bratislavský kraj";0;0;0;0;NA;282011;0;2020-07-11;-2215
2020-07-10;"Bratislavský kraj";8;0;0;0;NA;282011;8;2020-07-10;-2215
2020-07-09;"Bratislavský kraj";2;0;0;0;NA;282011;2;2020-07-09;-2223
2020-07-08;"Bratislavský kraj";11;0;0;0;NA;282011;11;2020-07-08;-2225
2020-07-07;"Bratislavský kraj";5;0;0;0;NA;282011;5;2020-07-07;-2236
2020-07-06;"Bratislavský kraj";1;0;0;0;NA;282011;1;2020-07-06;-2241
2020-07-05;"Bratislavský kraj";0;0;0;0;NA;282011;0;2020-07-05;-2242
2020-07-04;"Bratislavský kraj";3;0;0;0;NA;282011;3;2020-07-04;-2242
2020-07-03;"Bratislavský kraj";1;0;0;0;NA;282011;1;2020-07-03;-2245
2020-07-02;"Bratislavský kraj";0;0;0;0;NA;282011;0;2020-07-02;-2246
2020-07-01;"Bratislavský kraj";7;0;0;0;NA;282011;7;2020-07-01;-2246
2020-06-30;"Bratislavský kraj";3;0;0;0;NA;282011;3;2020-06-30;-2253
2020-06-29;"Bratislavský kraj";1;0;0;0;NA;282011;1;2020-06-29;-2256
2020-06-28;"Bratislavský kraj";0;0;0;0;NA;282011;0;2020-06-28;-2257
2020-06-27;"Bratislavský kraj";1;0;0;0;NA;282011;1;2020-06-27;-2257
2020-06-26;"Bratislavský kraj";6;0;0;0;NA;282011;6;2020-06-26;-2258
2020-06-25;"Bratislavský kraj";0;0;0;0;NA;282011;0;2020-06-25;-2264
2020-06-24;"Bratislavský kraj";3;0;0;0;NA;282011;3;2020-06-24;-2264
2020-06-23;"Bratislavský kraj";0;0;0;0;NA;282011;0;2020-06-23;-2267
2020-06-22;"Bratislavský kraj";1;0;0;0;NA;282011;1;2020-06-22;-2267
2020-06-21;"Bratislavský kraj";0;0;0;0;NA;282011;0;2020-06-21;-2268
2020-06-20;"Bratislavský kraj";0;0;0;0;NA;282011;0;2020-06-20;-2268
2020-06-19;"Bratislavský kraj";3;0;0;0;NA;282011;3;2020-06-19;-2268
2020-06-18;"Bratislavský kraj";0;0;0;0;NA;282011;0;2020-06-18;-2271
2020-06-17;"Bratislavský kraj";0;0;0;0;NA;282011;0;2020-06-17;-2271
2020-06-16;"Bratislavský kraj";0;0;0;0;NA;282011;0;2020-06-16;-2271
2020-06-14;"Bratislavský kraj";2;0;0;0;NA;282011;2;2020-06-14;-2271
2020-06-13;"Bratislavský kraj";1;0;0;0;NA;282011;1;2020-06-13;-2273
2020-06-12;"Bratislavský kraj";2;0;0;0;NA;282011;2;2020-06-12;-2274
2020-06-11;"Bratislavský kraj";0;0;0;0;NA;282011;0;2020-06-11;-2276
2020-06-10;"Bratislavský kraj";0;0;0;0;NA;282011;0;2020-06-10;-2276
2020-06-09;"Bratislavský kraj";0;0;0;0;NA;282011;0;2020-06-09;-2276
2020-06-08;"Bratislavský kraj";1;0;0;0;NA;282011;1;2020-06-08;-2276
2020-06-07;"Bratislavský kraj";0;0;0;0;NA;282011;0;2020-06-07;-2277
2020-06-05;"Bratislavský kraj";0;0;0;0;NA;282011;0;2020-06-05;-2277
2020-06-03;"Bratislavský kraj";1;0;0;0;NA;282011;1;2020-06-03;-2277
2020-06-02;"Bratislavský kraj";0;0;0;0;NA;282011;0;2020-06-02;-2278
2020-05-31;"Bratislavský kraj";0;0;0;0;NA;282011;0;2020-05-31;-2278
2020-05-29;"Bratislavský kraj";0;0;0;0;NA;282011;0;2020-05-29;-2278
2020-05-27;"Bratislavský kraj";1;0;0;0;NA;282011;1;2020-05-27;-2278
2020-05-26;"Bratislavský kraj";0;0;0;0;NA;282011;0;2020-05-26;-2279
2020-05-25;"Bratislavský kraj";0;0;0;0;NA;282011;0;2020-05-25;-2279
2020-05-24;"Bratislavský kraj";0;0;0;0;NA;282011;0;2020-05-24;-2279
2020-05-23;"Bratislavský kraj";2;0;0;0;NA;282011;2;2020-05-23;-2279
2020-05-22;"Bratislavský kraj";0;0;0;0;NA;282011;0;2020-05-22;-2281
2020-05-21;"Bratislavský kraj";0;0;0;0;NA;282011;0;2020-05-21;-2281
2020-05-20;"Bratislavský kraj";0;0;0;0;NA;282011;0;2020-05-20;-2281
2020-05-19;"Bratislavský kraj";0;0;0;0;NA;282011;0;2020-05-19;-2281
2020-05-17;"Bratislavský kraj";0;0;0;0;NA;282011;0;2020-05-17;-2281
2020-05-16;"Bratislavský kraj";0;0;0;0;NA;282011;0;2020-05-16;-2281
2020-05-15;"Bratislavský kraj";0;0;0;0;NA;282011;0;2020-05-15;-2281
2020-05-14;"Bratislavský kraj";0;0;0;0;NA;282011;0;2020-05-14;-2281
2020-05-13;"Bratislavský kraj";0;0;0;0;NA;282011;0;2020-05-13;-2281
2020-05-12;"Bratislavský kraj";2;0;0;0;NA;282011;2;2020-05-12;-2281
2020-05-11;"Bratislavský kraj";0;0;0;0;NA;282011;0;2020-05-11;-2283
2020-05-09;"Bratislavský kraj";0;0;0;0;NA;282011;0;2020-05-09;-2283
2020-05-07;"Bratislavský kraj";1;0;0;0;NA;282011;1;2020-05-07;-2283
2020-05-06;"Bratislavský kraj";3;0;0;0;NA;282011;3;2020-05-06;-2284
2020-05-05;"Bratislavský kraj";0;0;0;0;NA;282011;0;2020-05-05;-2287
2020-05-04;"Bratislavský kraj";0;0;0;0;NA;282011;0;2020-05-04;-2287
2020-05-03;"Bratislavský kraj";2;0;0;0;NA;282011;2;2020-05-03;-2287
2020-05-02;"Bratislavský kraj";0;0;0;0;NA;282011;0;2020-05-02;-2289
2020-05-01;"Bratislavský kraj";0;0;0;0;NA;282011;0;2020-05-01;-2289
2020-04-30;"Bratislavský kraj";5;0;0;0;NA;282011;5;2020-04-30;-2289
2020-04-29;"Bratislavský kraj";0;0;0;0;NA;282011;0;2020-04-29;-2294
2020-04-28;"Bratislavský kraj";2;0;0;0;NA;282011;2;2020-04-28;-2294
2020-04-27;"Bratislavský kraj";0;0;0;0;NA;282011;0;2020-04-27;-2296
2020-04-26;"Bratislavský kraj";1;0;0;0;NA;282011;1;2020-04-26;-2296
2020-04-25;"Bratislavský kraj";0;0;0;0;NA;282011;0;2020-04-25;-2297
2020-04-24;"Bratislavský kraj";2;0;0;0;NA;282011;2;2020-04-24;-2297
2020-04-23;"Bratislavský kraj";6;0;0;0;NA;282011;6;2020-04-23;-2299
2020-04-22;"Bratislavský kraj";11;0;0;0;NA;282011;11;2020-04-22;-2305
2020-04-21;"Bratislavský kraj";4;0;0;0;NA;282011;4;2020-04-21;-2316
2020-04-20;"Bratislavský kraj";0;0;0;0;NA;282011;0;2020-04-20;-2320
2020-04-19;"Bratislavský kraj";4;0;0;0;NA;282011;4;2020-04-19;-2320
2020-04-18;"Bratislavský kraj";5;0;0;0;NA;282011;5;2020-04-18;-2324
2020-04-17;"Bratislavský kraj";6;0;0;0;NA;282011;6;2020-04-17;-2329
2020-04-16;"Bratislavský kraj";15;0;0;0;NA;282011;15;2020-04-16;-2335
2020-04-15;"Bratislavský kraj";11;0;0;0;NA;282011;11;2020-04-15;-2350
2020-04-14;"Bratislavský kraj";19;0;0;0;NA;282011;19;2020-04-14;-2361
2020-04-13;"Bratislavský kraj";53;0;0;0;NA;282011;53;2020-04-13;-2380
2020-04-12;"Bratislavský kraj";3;0;0;0;NA;282011;3;2020-04-12;-2433
2020-04-11;"Bratislavský kraj";1;0;0;0;NA;282011;1;2020-04-11;-2436
2020-04-10;"Bratislavský kraj";8;0;0;0;NA;282011;8;2020-04-10;-2437
2020-04-09;"Bratislavský kraj";3;0;0;0;NA;282011;3;2020-04-09;-2445
2020-04-08;"Bratislavský kraj";3;0;0;0;NA;282011;3;2020-04-08;-2448
2020-04-07;"Bratislavský kraj";24;0;0;0;NA;282011;24;2020-04-07;-2451
2020-04-06;"Bratislavský kraj";5;0;0;0;NA;282011;5;2020-04-06;-2475
2020-04-05;"Bratislavský kraj";6;0;0;0;NA;282011;6;2020-04-05;-2480
2020-04-04;"Bratislavský kraj";2;0;0;0;NA;282011;2;2020-04-04;-2486
2020-04-03;"Bratislavský kraj";1;0;0;0;NA;282011;1;2020-04-03;-2488
2020-04-02;"Bratislavský kraj";2;0;0;0;NA;282011;2;2020-04-02;-2489
2020-04-01;"Bratislavský kraj";5;0;0;0;NA;282011;5;2020-04-01;-2491
2020-03-31;"Bratislavský kraj";19;0;0;0;NA;282011;19;2020-03-31;-2496
2020-03-30;"Bratislavský kraj";6;0;0;0;NA;282011;6;2020-03-30;-2515
2020-03-29;"Bratislavský kraj";8;0;0;0;NA;282011;8;2020-03-29;-2521
2020-03-28;"Bratislavský kraj";4;0;0;0;NA;282011;4;2020-03-28;-2529
2020-03-27;"Bratislavský kraj";3;0;0;0;NA;282011;3;2020-03-27;-2533
2020-03-26;"Bratislavský kraj";15;0;0;0;NA;282011;15;2020-03-26;-2536
2020-03-25;"Bratislavský kraj";1;0;0;0;NA;282011;1;2020-03-25;-2551
2020-03-24;"Bratislavský kraj";4;0;0;0;NA;282011;4;2020-03-24;-2552
2020-03-23;"Bratislavský kraj";9;0;0;0;NA;282011;9;2020-03-23;-2556
2020-03-22;"Bratislavský kraj";2;0;0;0;NA;282011;2;2020-03-22;-2565
2020-03-21;"Bratislavský kraj";22;0;0;0;NA;282011;22;2020-03-21;-2567
2020-03-20;"Bratislavský kraj";3;0;0;0;NA;282011;3;2020-03-20;-2589
2020-03-19;"Bratislavský kraj";4;0;0;0;NA;282011;4;2020-03-19;-2592
2020-03-18;"Bratislavský kraj";3;0;0;0;NA;282011;3;2020-03-18;-2596
2020-03-17;"Bratislavský kraj";13;0;0;0;NA;282011;13;2020-03-17;-2599
2020-03-16;"Bratislavský kraj";1;0;0;0;NA;282011;1;2020-03-16;-2612
2020-03-15;"Bratislavský kraj";4;0;0;0;NA;282011;4;2020-03-15;-2613
2020-03-14;"Bratislavský kraj";9;0;0;0;NA;282011;9;2020-03-14;-2617
2020-03-13;"Bratislavský kraj";2;0;0;0;NA;282011;2;2020-03-13;-2626
2020-03-12;"Bratislavský kraj";8;0;0;0;NA;282011;8;2020-03-12;-2628
2020-03-11;"Bratislavský kraj";3;0;0;0;NA;282011;3;2020-03-11;-2636
2020-03-09;"Bratislavský kraj";0;0;0;0;NA;282011;0;2020-03-09;-2639
2020-03-08;"Bratislavský kraj";2;0;0;0;NA;282011;2;2020-03-08;-2639
2020-03-07;"Bratislavský kraj";2;0;0;0;NA;282011;2;2020-03-07;-2641
2020-03-06;"Bratislavský kraj";1;0;0;0;NA;282011;1;2020-03-06;-2643
2022-03-08;"Košický kraj";1487;0;0;0;199824;296744;1487;2022-03-08;296744
2022-03-07;"Košický kraj";1347;0;0;0;NA;296744;1347;2022-03-07;295257
2022-03-06;"Košický kraj";297;947;234;1181;NA;296744;531;2022-03-06;293910
2022-03-05;"Košický kraj";874;949;197;1146;NA;296744;1071;2022-03-05;293379
2022-03-04;"Košický kraj";1255;2432;366;2798;NA;296744;1621;2022-03-04;292308
2022-03-03;"Košický kraj";1111;3255;411;3666;NA;296744;1522;2022-03-03;290687
2022-03-02;"Košický kraj";1458;3405;439;3844;NA;296744;1897;2022-03-02;289165
2022-03-01;"Košický kraj";1723;3670;474;4144;NA;296744;2197;2022-03-01;287268
2022-02-28;"Košický kraj";1345;5446;797;6243;NA;296744;2142;2022-02-28;285071
2022-02-27;"Košický kraj";465;2347;429;2776;NA;296744;894;2022-02-27;282929
2022-02-26;"Košický kraj";979;1348;329;1677;NA;296744;1308;2022-02-26;282035
2022-02-25;"Košický kraj";1691;3242;498;3740;NA;296744;2189;2022-02-25;280727
2022-02-24;"Košický kraj";1988;4023;591;4614;NA;296744;2579;2022-02-24;278538
2022-02-23;"Košický kraj";1787;4139;556;4695;NA;296744;2343;2022-02-23;275959
2022-02-22;"Košický kraj";2649;4679;658;5337;NA;296744;3307;2022-02-22;273616
2022-02-21;"Košický kraj";1646;6484;907;7391;NA;296744;2553;2022-02-21;270309
2022-02-20;"Košický kraj";577;2891;574;3465;NA;296744;1151;2022-02-20;267756
2022-02-19;"Košický kraj";1941;2169;409;2578;NA;296744;2350;2022-02-19;266605
2022-02-18;"Košický kraj";2210;4520;639;5159;NA;296744;2849;2022-02-18;264255
2022-02-17;"Košický kraj";2555;4649;673;5322;NA;296744;3228;2022-02-17;261406
2022-02-16;"Košický kraj";2153;5454;734;6188;NA;296744;2887;2022-02-16;258178
2022-02-15;"Košický kraj";2768;5470;827;6297;NA;296744;3595;2022-02-15;255291
2022-02-14;"Košický kraj";2337;8044;1101;9145;NA;296744;3438;2022-02-14;251696
2022-02-13;"Košický kraj";1235;4246;807;5053;NA;296744;2042;2022-02-13;248258
2022-02-12;"Košický kraj";1728;2014;524;2538;NA;296744;2252;2022-02-12;246216
2022-02-11;"Košický kraj";2665;4797;633;5430;NA;296744;3298;2022-02-11;243964
2022-02-10;"Košický kraj";2135;5323;728;6051;NA;296744;2863;2022-02-10;240666
2022-02-09;"Košický kraj";2067;5940;743;6683;NA;296744;2810;2022-02-09;237803
2022-02-08;"Košický kraj";2993;6143;762;6905;NA;296744;3755;2022-02-08;234993
2022-02-07;"Košický kraj";1939;7973;978;8951;NA;296744;2917;2022-02-07;231238
2022-02-06;"Košický kraj";998;4482;680;5162;NA;296744;1678;2022-02-06;228321
2022-02-05;"Košický kraj";2209;2454;434;2888;NA;296744;2643;2022-02-05;226643
2022-02-04;"Košický kraj";2563;5634;632;6266;NA;296744;3195;2022-02-04;224000
2022-02-03;"Košický kraj";1916;6379;659;7038;NA;296744;2575;2022-02-03;220805
2022-02-02;"Košický kraj";2498;6923;629;7552;NA;296744;3127;2022-02-02;218230
2022-02-01;"Košický kraj";2173;6706;678;7384;NA;296744;2851;2022-02-01;215103
2022-01-31;"Košický kraj";2020;9960;841;10801;NA;296744;2861;2022-01-31;212252
2022-01-30;"Košický kraj";1002;5716;541;6257;NA;296744;1543;2022-01-30;209391
2022-01-29;"Košický kraj";1731;2720;387;3107;NA;296744;2118;2022-01-29;207848
2022-01-28;"Košický kraj";1743;5571;492;6063;NA;296744;2235;2022-01-28;205730
2022-01-27;"Košický kraj";1553;5792;413;6205;NA;296744;1966;2022-01-27;203495
2022-01-26;"Košický kraj";1683;5613;399;6012;NA;296744;2082;2022-01-26;201529
2022-01-25;"Košický kraj";1409;6210;404;6614;NA;296744;1813;2022-01-25;199447
2022-01-24;"Košický kraj";1141;8669;431;9100;NA;296744;1572;2022-01-24;197634
2022-01-23;"Košický kraj";516;5418;287;5705;NA;296744;803;2022-01-23;196062
2022-01-22;"Košický kraj";914;2528;177;2705;NA;296744;1091;2022-01-22;195259
2022-01-21;"Košický kraj";589;5194;227;5421;NA;296744;816;2022-01-21;194168
2022-01-20;"Košický kraj";769;5379;200;5579;NA;296744;969;2022-01-20;193352
2022-01-19;"Košický kraj";629;5329;178;5507;NA;296744;807;2022-01-19;192383
2022-01-18;"Košický kraj";716;5758;140;5898;NA;296744;856;2022-01-18;191576
2022-01-17;"Košický kraj";486;8867;183;9050;NA;296744;669;2022-01-17;190720
2022-01-16;"Košický kraj";51;5264;137;5401;NA;296744;188;2022-01-16;190051
2022-01-15;"Košický kraj";422;2208;69;2277;NA;296744;491;2022-01-15;189863
2022-01-14;"Košický kraj";175;4208;93;4301;NA;296744;268;2022-01-14;189372
2022-01-13;"Košický kraj";165;4919;77;4996;NA;296744;242;2022-01-13;189104
2022-01-12;"Košický kraj";295;4609;78;4687;NA;296744;373;2022-01-12;188862
2022-01-11;"Košický kraj";349;5295;70;5365;NA;296744;419;2022-01-11;188489
2022-01-10;"Košický kraj";290;8254;128;8382;NA;296744;418;2022-01-10;188070
2022-01-09;"Košický kraj";230;5838;86;5924;NA;296744;316;2022-01-09;187652
2022-01-08;"Košický kraj";157;2417;57;2474;NA;296744;214;2022-01-08;187336
2022-01-07;"Košický kraj";388;5017;129;5146;NA;296744;517;2022-01-07;187122
2022-01-06;"Košický kraj";118;1576;55;1631;NA;296744;173;2022-01-06;186605
2022-01-05;"Košický kraj";354;5082;102;5184;NA;296744;456;2022-01-05;186432
2022-01-04;"Košický kraj";450;5273;84;5357;NA;296744;534;2022-01-04;185976
2022-01-03;"Košický kraj";439;7970;140;8110;NA;296744;579;2022-01-03;185442
2022-01-02;"Košický kraj";284;4614;109;4723;NA;296744;393;2022-01-02;184863
2022-01-01;"Košický kraj";28;360;18;378;NA;296744;46;2022-01-01;184470
2021-12-31;"Košický kraj";122;2999;86;3085;NA;296744;208;2021-12-31;184424
2021-12-30;"Košický kraj";401;3949;118;4067;NA;296744;519;2021-12-30;184216
2021-12-29;"Košický kraj";378;4194;111;4305;NA;296744;489;2021-12-29;183697
2021-12-28;"Košický kraj";509;4450;125;4575;NA;296744;634;2021-12-28;183208
2021-12-27;"Košický kraj";495;6822;205;7027;NA;296744;700;2021-12-27;182574
2021-12-26;"Košický kraj";109;2510;115;2625;NA;296744;224;2021-12-26;181874
2021-12-25;"Košický kraj";30;644;43;687;NA;296744;73;2021-12-25;181650
2021-12-24;"Košický kraj";95;1055;50;1105;NA;296744;145;2021-12-24;181577
2021-12-23;"Košický kraj";644;4479;131;4610;NA;296744;775;2021-12-23;181432
2021-12-22;"Košický kraj";224;4309;106;4415;NA;296744;330;2021-12-22;180657
2021-12-21;"Košický kraj";544;6491;138;6629;NA;296744;682;2021-12-21;180327
2021-12-20;"Košický kraj";464;8510;193;8703;NA;296744;657;2021-12-20;179645
2021-12-19;"Košický kraj";137;5447;177;5624;NA;296744;314;2021-12-19;178988
2021-12-18;"Košický kraj";414;2555;102;2657;NA;296744;516;2021-12-18;178674
2021-12-17;"Košický kraj";428;4832;145;4977;NA;296744;573;2021-12-17;178158
2021-12-16;"Košický kraj";476;5845;168;6013;NA;296744;644;2021-12-16;177585
2021-12-15;"Košický kraj";508;5956;172;6128;NA;296744;680;2021-12-15;176941
2021-12-14;"Košický kraj";957;5789;172;5961;NA;296744;1129;2021-12-14;176261
2021-12-13;"Košický kraj";679;9657;248;9905;NA;296744;927;2021-12-13;175132
2021-12-12;"Košický kraj";243;6657;198;6855;NA;296744;441;2021-12-12;174205
2021-12-11;"Košický kraj";519;2996;134;3130;NA;296744;653;2021-12-11;173764
2021-12-10;"Košický kraj";936;5465;185;5650;NA;296744;1121;2021-12-10;173111
2021-12-09;"Košický kraj";755;5779;198;5977;NA;296744;953;2021-12-09;171990
2021-12-08;"Košický kraj";1095;6574;275;6849;NA;296744;1370;2021-12-08;171037
2021-12-07;"Košický kraj";1212;6323;267;6590;NA;296744;1479;2021-12-07;169667
2021-12-06;"Košický kraj";904;10627;313;10940;NA;296744;1217;2021-12-06;168188
2021-12-05;"Košický kraj";404;7756;263;8019;NA;296744;667;2021-12-05;166971
2021-12-04;"Košický kraj";1007;3097;180;3277;NA;296744;1187;2021-12-04;166304
2021-12-03;"Košický kraj";1338;6065;271;6336;NA;296744;1609;2021-12-03;165117
2021-12-02;"Košický kraj";2209;5654;302;5956;NA;296744;2511;2021-12-02;163508
2021-12-01;"Košický kraj";1016;6483;388;6871;NA;296744;1404;2021-12-01;160997
2021-11-30;"Košický kraj";1125;8173;471;8644;NA;296744;1596;2021-11-30;159593
2021-11-29;"Košický kraj";993;14057;634;14691;NA;296744;1627;2021-11-29;157997
2021-11-28;"Košický kraj";972;10211;473;10684;NA;296744;1445;2021-11-28;156370
2021-11-27;"Košický kraj";1103;3566;219;3785;NA;296744;1322;2021-11-27;154925
2021-11-26;"Košický kraj";1395;6059;383;6442;NA;296744;1778;2021-11-26;153603
2021-11-25;"Košický kraj";1373;6875;476;7351;NA;296744;1849;2021-11-25;151825
2021-11-24;"Košický kraj";1194;6905;457;7362;NA;296744;1651;2021-11-24;149976
2021-11-23;"Košický kraj";1178;7185;488;7673;NA;296744;1666;2021-11-23;148325
2021-11-22;"Košický kraj";861;10709;741;11450;NA;296744;1602;2021-11-22;146659
2021-11-21;"Košický kraj";985;7394;657;8051;NA;296744;1642;2021-11-21;145057
2021-11-20;"Košický kraj";1083;2859;295;3154;NA;296744;1378;2021-11-20;143415
2021-11-19;"Košický kraj";1078;7774;570;8344;NA;296744;1648;2021-11-19;142037
2021-11-18;"Košický kraj";1061;9410;719;10129;NA;296744;1780;2021-11-18;140389
2021-11-17;"Košický kraj";1319;2824;262;3086;NA;296744;1581;2021-11-17;138609
2021-11-16;"Košický kraj";1484;7135;543;7678;NA;296744;2027;2021-11-16;137028
2021-11-15;"Košický kraj";902;10812;754;11566;NA;296744;1656;2021-11-15;135001
2021-11-14;"Košický kraj";715;5756;455;6211;NA;296744;1170;2021-11-14;133345
2021-11-13;"Košický kraj";869;2686;312;2998;NA;296744;1181;2021-11-13;132175
2021-11-12;"Košický kraj";1132;5616;410;6026;NA;296744;1542;2021-11-12;130994
2021-11-11;"Košický kraj";1035;6139;460;6599;NA;296744;1495;2021-11-11;129452
2021-11-10;"Košický kraj";933;6633;497;7130;NA;296744;1430;2021-11-10;127957
2021-11-09;"Košický kraj";967;5540;389;5929;NA;296744;1356;2021-11-09;126527
2021-11-08;"Košický kraj";701;7838;601;8439;NA;296744;1302;2021-11-08;125171
2021-11-07;"Košický kraj";691;4578;425;5003;NA;296744;1116;2021-11-07;123869
2021-11-06;"Košický kraj";996;2276;217;2493;NA;296744;1213;2021-11-06;122753
2021-11-05;"Košický kraj";1029;4905;367;5272;NA;296744;1396;2021-11-05;121540
2021-11-04;"Košický kraj";1000;5354;360;5714;NA;296744;1360;2021-11-04;120144
2021-11-03;"Košický kraj";1051;5749;361;6110;NA;296744;1412;2021-11-03;118784
2021-11-02;"Košický kraj";915;8775;566;9341;NA;296744;1481;2021-11-02;117372
2021-11-01;"Košický kraj";181;1999;265;2264;NA;296744;446;2021-11-01;115891
2021-10-31;"Košický kraj";385;2337;227;2564;NA;296744;612;2021-10-31;115445
2021-10-30;"Košický kraj";641;2380;180;2560;NA;296744;821;2021-10-30;114833
2021-10-29;"Košický kraj";750;4608;289;4897;NA;296744;1039;2021-10-29;114012
2021-10-28;"Košický kraj";823;5115;255;5370;NA;296744;1078;2021-10-28;112973
2021-10-27;"Košický kraj";723;4831;259;5090;NA;296744;982;2021-10-27;111895
2021-10-26;"Košický kraj";618;5049;225;5274;NA;296744;843;2021-10-26;110913
2021-10-25;"Košický kraj";268;6747;292;7039;NA;296744;560;2021-10-25;110070
2021-10-24;"Košický kraj";170;3447;205;3652;NA;296744;375;2021-10-24;109510
2021-10-23;"Košický kraj";397;1953;86;2039;NA;296744;483;2021-10-23;109135
2021-10-22;"Košický kraj";474;4679;130;4809;NA;296744;604;2021-10-22;108652
2021-10-21;"Košický kraj";669;5094;172;5266;NA;296744;841;2021-10-21;108048
2021-10-20;"Košický kraj";398;4963;152;5115;NA;296744;550;2021-10-20;107207
2021-10-19;"Košický kraj";579;4870;161;5031;NA;296744;740;2021-10-19;106657
2021-10-18;"Košický kraj";180;7090;171;7261;NA;296744;351;2021-10-18;105917
2021-10-17;"Košický kraj";70;3614;125;3739;NA;296744;195;2021-10-17;105566
2021-10-16;"Košický kraj";312;1839;40;1879;NA;296744;352;2021-10-16;105371
2021-10-15;"Košický kraj";312;4530;77;4607;NA;296744;389;2021-10-15;105019
2021-10-14;"Košický kraj";327;4652;95;4747;NA;296744;422;2021-10-14;104630
2021-10-13;"Košický kraj";168;4168;88;4256;NA;296744;256;2021-10-13;104208
2021-10-12;"Košický kraj";391;4119;75;4194;NA;296744;466;2021-10-12;103952
2021-10-11;"Košický kraj";119;6351;121;6472;NA;296744;240;2021-10-11;103486
2021-10-10;"Košický kraj";104;2921;63;2984;NA;296744;167;2021-10-10;103246
2021-10-09;"Košický kraj";111;1687;43;1730;NA;296744;154;2021-10-09;103079
2021-10-08;"Košický kraj";274;4143;68;4211;NA;296744;342;2021-10-08;102925
2021-10-07;"Košický kraj";277;4399;74;4473;NA;296744;351;2021-10-07;102583
2021-10-06;"Košický kraj";178;4369;89;4458;NA;296744;267;2021-10-06;102232
2021-10-05;"Košický kraj";345;4542;78;4620;NA;296744;423;2021-10-05;101965
2021-10-04;"Košický kraj";122;6094;110;6204;NA;296744;232;2021-10-04;101542
2021-10-03;"Košický kraj";133;3176;74;3250;NA;296744;207;2021-10-03;101310
2021-10-02;"Košický kraj";124;2567;41;2608;NA;296744;165;2021-10-02;101103
2021-10-01;"Košický kraj";181;4251;73;4324;NA;296744;254;2021-10-01;100938
2021-09-30;"Košický kraj";244;4780;71;4851;NA;296744;315;2021-09-30;100684
2021-09-29;"Košický kraj";183;3824;64;3888;NA;296744;247;2021-09-29;100369
2021-09-28;"Košický kraj";303;4339;80;4419;NA;296744;383;2021-09-28;100122
2021-09-27;"Košický kraj";117;6358;77;6435;NA;296744;194;2021-09-27;99739
2021-09-26;"Košický kraj";13;2809;44;2853;NA;296744;57;2021-09-26;99545
2021-09-25;"Košický kraj";162;2521;35;2556;NA;296744;197;2021-09-25;99488
2021-09-24;"Košický kraj";183;4756;43;4799;NA;296744;226;2021-09-24;99291
2021-09-23;"Košický kraj";142;3880;51;3931;NA;296744;193;2021-09-23;99065
2021-09-22;"Košický kraj";151;4436;52;4488;NA;296744;203;2021-09-22;98872
2021-09-21;"Košický kraj";234;4441;44;4485;NA;296744;278;2021-09-21;98669
2021-09-20;"Košický kraj";158;6017;73;6090;NA;296744;231;2021-09-20;98391
2021-09-19;"Košický kraj";15;2487;30;2517;NA;296744;45;2021-09-19;98160
2021-09-18;"Košický kraj";187;2504;24;2528;NA;296744;211;2021-09-18;98115
2021-09-17;"Košický kraj";121;4797;41;4838;NA;296744;162;2021-09-17;97904
2021-09-16;"Košický kraj";228;4503;71;4574;NA;296744;299;2021-09-16;97742
2021-09-15;"Košický kraj";52;989;16;1005;NA;296744;68;2021-09-15;97443
2021-09-14;"Košický kraj";142;3456;47;3503;NA;296744;189;2021-09-14;97375
2021-09-13;"Košický kraj";96;4949;48;4997;NA;296744;144;2021-09-13;97186
2021-09-12;"Košický kraj";14;2003;31;2034;NA;296744;45;2021-09-12;97042
2021-09-11;"Košický kraj";105;2186;19;2205;NA;296744;124;2021-09-11;96997
2021-09-10;"Košický kraj";125;4293;42;4335;NA;296744;167;2021-09-10;96873
2021-09-09;"Košický kraj";115;3226;30;3256;NA;296744;145;2021-09-09;96706
2021-09-08;"Košický kraj";86;2753;36;2789;NA;296744;122;2021-09-08;96561
2021-09-07;"Košický kraj";79;2686;53;2739;NA;296744;132;2021-09-07;96439
2021-09-06;"Košický kraj";41;2786;36;2822;NA;296744;77;2021-09-06;96307
2021-09-05;"Košický kraj";52;1393;18;1411;NA;296744;70;2021-09-05;96230
2021-09-04;"Košický kraj";37;1678;12;1690;NA;296744;49;2021-09-04;96160
2021-09-03;"Košický kraj";47;2913;35;2948;NA;296744;82;2021-09-03;96111
2021-09-02;"Košický kraj";56;2686;26;2712;NA;296744;82;2021-09-02;96029
2021-09-01;"Košický kraj";95;629;13;642;NA;296744;108;2021-09-01;95947
2021-08-31;"Košický kraj";30;2525;22;2547;NA;296744;52;2021-08-31;95839
2021-08-30;"Košický kraj";8;2404;28;2432;NA;296744;36;2021-08-30;95787
2021-08-29;"Košický kraj";16;603;1;604;NA;296744;17;2021-08-29;95751
2021-08-28;"Košický kraj";14;2103;11;2114;NA;296744;25;2021-08-28;95734
2021-08-27;"Košický kraj";22;2908;16;2924;NA;296744;38;2021-08-27;95709
2021-08-26;"Košický kraj";19;2292;13;2305;NA;296744;32;2021-08-26;95671
2021-08-25;"Košický kraj";33;2010;6;2016;NA;296744;39;2021-08-25;95639
2021-08-24;"Košický kraj";14;2337;3;2340;NA;296744;17;2021-08-24;95600
2021-08-23;"Košický kraj";33;2461;5;2466;NA;296744;38;2021-08-23;95583
2021-08-22;"Košický kraj";4;1457;8;1465;NA;296744;12;2021-08-22;95545
2021-08-21;"Košický kraj";35;2134;5;2139;NA;296744;40;2021-08-21;95533
2021-08-20;"Košický kraj";13;3215;5;3220;NA;296744;18;2021-08-20;95493
2021-08-19;"Košický kraj";14;2178;6;2184;NA;296744;20;2021-08-19;95475
2021-08-18;"Košický kraj";30;1827;8;1835;NA;296744;38;2021-08-18;95455
2021-08-17;"Košický kraj";24;1619;3;1622;NA;296744;27;2021-08-17;95417
2021-08-16;"Košický kraj";3;2236;10;2246;NA;296744;13;2021-08-16;95390
2021-08-15;"Košický kraj";1;778;5;783;NA;296744;6;2021-08-15;95377
2021-08-14;"Košický kraj";15;1222;1;1223;NA;296744;16;2021-08-14;95371
2021-08-13;"Košický kraj";14;1928;8;1936;NA;296744;22;2021-08-13;95355
2021-08-12;"Košický kraj";10;1248;3;1251;NA;296744;13;2021-08-12;95333
2021-08-11;"Košický kraj";6;1368;5;1373;NA;296744;11;2021-08-11;95320
2021-08-10;"Košický kraj";10;1352;8;1360;NA;296744;18;2021-08-10;95309
2021-08-09;"Košický kraj";12;1651;3;1654;NA;296744;15;2021-08-09;95291
2021-08-08;"Košický kraj";8;688;1;689;NA;296744;9;2021-08-08;95276
2021-08-07;"Košický kraj";3;1125;3;1128;NA;296744;6;2021-08-07;95267
2021-08-06;"Košický kraj";9;1614;6;1620;NA;296744;15;2021-08-06;95261
2021-08-05;"Košický kraj";26;1254;6;1260;NA;296744;32;2021-08-05;95246
2021-08-04;"Košický kraj";8;1373;5;1378;NA;296744;13;2021-08-04;95214
2021-08-03;"Košický kraj";33;1121;3;1124;NA;296744;36;2021-08-03;95201
2021-08-02;"Košický kraj";6;1702;8;1710;NA;296744;14;2021-08-02;95165
2021-08-01;"Košický kraj";1;662;1;663;NA;296744;2;2021-08-01;95151
2021-07-31;"Košický kraj";17;1153;2;1155;NA;296744;19;2021-07-31;95149
2021-07-30;"Košický kraj";12;1657;7;1664;NA;296744;19;2021-07-30;95130
2021-07-29;"Košický kraj";7;1242;5;1247;NA;296744;12;2021-07-29;95111
2021-07-28;"Košický kraj";15;956;5;961;NA;296744;20;2021-07-28;95099
2021-07-27;"Košický kraj";17;1180;7;1187;NA;296744;24;2021-07-27;95079
2021-07-26;"Košický kraj";3;1666;9;1675;NA;296744;12;2021-07-26;95055
2021-07-25;"Košický kraj";0;719;3;722;NA;296744;3;2021-07-25;95043
2021-07-24;"Košický kraj";18;996;4;1000;NA;296744;22;2021-07-24;95040
2021-07-23;"Košický kraj";9;1524;5;1529;NA;296744;14;2021-07-23;95018
2021-07-22;"Košický kraj";1;1254;4;1258;NA;296744;5;2021-07-22;95004
2021-07-21;"Košický kraj";4;1117;3;1120;NA;296744;7;2021-07-21;94999
2021-07-20;"Košický kraj";6;1355;1;1356;NA;296744;7;2021-07-20;94992
2021-07-19;"Košický kraj";2;1517;2;1519;NA;296744;4;2021-07-19;94985
2021-07-18;"Košický kraj";0;644;0;644;NA;296744;0;2021-07-18;94981
2021-07-17;"Košický kraj";3;1101;5;1106;NA;296744;8;2021-07-17;94981
2021-07-16;"Košický kraj";3;1609;4;1613;NA;296744;7;2021-07-16;94973
2021-07-15;"Košický kraj";4;1383;4;1387;NA;296744;8;2021-07-15;94966
2021-07-14;"Košický kraj";2;1175;4;1179;NA;296744;6;2021-07-14;94958
2021-07-13;"Košický kraj";4;1331;1;1332;NA;296744;5;2021-07-13;94952
2021-07-12;"Košický kraj";3;1894;3;1897;NA;296744;6;2021-07-12;94947
2021-07-11;"Košický kraj";1;537;2;539;NA;296744;3;2021-07-11;94941
2021-07-10;"Košický kraj";9;1167;0;1167;NA;296744;9;2021-07-10;94938
2021-07-09;"Košický kraj";5;2005;5;2010;NA;296744;10;2021-07-09;94929
2021-07-08;"Košický kraj";13;1282;2;1284;NA;296744;15;2021-07-08;94919
2021-07-07;"Košický kraj";6;1524;1;1525;NA;296744;7;2021-07-07;94904
2021-07-06;"Košický kraj";4;1886;2;1888;NA;296744;6;2021-07-06;94897
2021-07-05;"Košický kraj";1;573;1;574;NA;296744;2;2021-07-05;94891
2021-07-04;"Košický kraj";0;482;2;484;NA;296744;2;2021-07-04;94889
2021-07-03;"Košický kraj";2;1227;0;1227;NA;296744;2;2021-07-03;94887
2021-07-02;"Košický kraj";2;1883;3;1886;NA;296744;5;2021-07-02;94885
2021-07-01;"Košický kraj";0;1211;2;1213;NA;296744;2;2021-07-01;94880
2021-06-30;"Košický kraj";5;9306;7;9313;NA;296744;12;2021-06-30;94878
2021-06-29;"Košický kraj";6;5692;7;5699;NA;296744;13;2021-06-29;94866
2021-06-28;"Košický kraj";5;6129;2;6131;NA;296744;7;2021-06-28;94853
2021-06-27;"Košický kraj";8;4636;3;4639;NA;296744;11;2021-06-27;94846
2021-06-26;"Košický kraj";4;5699;14;5713;NA;296744;18;2021-06-26;94835
2021-06-25;"Košický kraj";5;6981;2;6983;NA;296744;7;2021-06-25;94817
2021-06-24;"Košický kraj";1;5072;3;5075;NA;296744;4;2021-06-24;94810
2021-06-23;"Košický kraj";8;5373;3;5376;NA;296744;11;2021-06-23;94806
2021-06-22;"Košický kraj";1;5269;3;5272;NA;296744;4;2021-06-22;94795
2021-06-21;"Košický kraj";5;6830;11;6841;NA;296744;16;2021-06-21;94791
2021-06-20;"Košický kraj";0;4882;6;4888;NA;296744;6;2021-06-20;94775
2021-06-19;"Košický kraj";7;6473;1;6474;NA;296744;8;2021-06-19;94769
2021-06-18;"Košický kraj";4;7969;8;7977;NA;296744;12;2021-06-18;94761
2021-06-17;"Košický kraj";6;6128;3;6131;NA;296744;9;2021-06-17;94749
2021-06-16;"Košický kraj";11;6059;7;6066;NA;296744;18;2021-06-16;94740
2021-06-15;"Košický kraj";12;6301;2;6303;NA;296744;14;2021-06-15;94722
2021-06-14;"Košický kraj";10;7076;9;7085;NA;296744;19;2021-06-14;94708
2021-06-13;"Košický kraj";7;6948;8;6956;NA;296744;15;2021-06-13;94689
2021-06-12;"Košický kraj";7;7485;9;7494;NA;296744;16;2021-06-12;94674
2021-06-11;"Košický kraj";15;8973;6;8979;NA;296744;21;2021-06-11;94658
2021-06-10;"Košický kraj";11;6588;16;6604;NA;296744;27;2021-06-10;94637
2021-06-09;"Košický kraj";37;6056;7;6063;NA;296744;44;2021-06-09;94610
2021-06-08;"Košický kraj";33;7019;13;7032;NA;296744;46;2021-06-08;94566
2021-06-07;"Košický kraj";11;8106;22;8128;NA;296744;33;2021-06-07;94520
2021-06-06;"Košický kraj";1;7843;7;7850;NA;296744;8;2021-06-06;94487
2021-06-05;"Košický kraj";21;9286;3;9289;NA;296744;24;2021-06-05;94479
2021-06-04;"Košický kraj";26;11418;20;11438;NA;296744;46;2021-06-04;94455
2021-06-03;"Košický kraj";23;6467;14;6481;NA;296744;37;2021-06-03;94409
2021-06-02;"Košický kraj";15;7180;24;7204;NA;296744;39;2021-06-02;94372
2021-06-01;"Košický kraj";13;7562;10;7572;NA;296744;23;2021-06-01;94333
2021-05-31;"Košický kraj";13;9256;18;9274;NA;296744;31;2021-05-31;94310
2021-05-30;"Košický kraj";3;11215;10;11225;NA;296744;13;2021-05-30;94279
2021-05-29;"Košický kraj";25;10942;22;10964;NA;296744;47;2021-05-29;94266
2021-05-28;"Košický kraj";17;13055;29;13084;NA;296744;46;2021-05-28;94219
2021-05-27;"Košický kraj";19;7924;26;7950;NA;296744;45;2021-05-27;94173
2021-05-26;"Košický kraj";35;8118;27;8145;NA;296744;62;2021-05-26;94128
2021-05-25;"Košický kraj";33;9296;29;9325;NA;296744;62;2021-05-25;94066
2021-05-24;"Košický kraj";10;10855;27;10882;NA;296744;37;2021-05-24;94004
2021-05-23;"Košický kraj";4;12151;15;12166;NA;296744;19;2021-05-23;93967
2021-05-22;"Košický kraj";27;12601;19;12620;NA;296744;46;2021-05-22;93948
2021-05-21;"Košický kraj";24;14910;27;14937;NA;296744;51;2021-05-21;93902
2021-05-20;"Košický kraj";20;9422;28;9450;NA;296744;48;2021-05-20;93851
2021-05-19;"Košický kraj";30;10421;21;10442;NA;296744;51;2021-05-19;93803
2021-05-18;"Košický kraj";34;10254;36;10290;NA;296744;70;2021-05-18;93752
2021-05-17;"Košický kraj";20;12686;38;12724;NA;296744;58;2021-05-17;93682
2021-05-16;"Košický kraj";37;17865;20;17885;NA;296744;57;2021-05-16;93624
2021-05-15;"Košický kraj";22;25602;28;25630;NA;296744;50;2021-05-15;93567
2021-05-14;"Košický kraj";32;21824;42;21866;NA;296744;74;2021-05-14;93517
2021-05-13;"Košický kraj";39;10172;32;10204;NA;296744;71;2021-05-13;93443
2021-05-12;"Košický kraj";85;10868;33;10901;NA;296744;118;2021-05-12;93372
2021-05-11;"Košický kraj";68;11166;32;11198;NA;296744;100;2021-05-11;93254
2021-05-10;"Košický kraj";25;17044;42;17086;NA;296744;67;2021-05-10;93154
2021-05-09;"Košický kraj";84;25594;55;25649;NA;296744;139;2021-05-09;93087
2021-05-08;"Košický kraj";18;23399;23;23422;NA;296744;41;2021-05-08;92948
2021-05-07;"Košický kraj";51;24497;57;24554;NA;296744;108;2021-05-07;92907
2021-05-06;"Košický kraj";55;11847;43;11890;NA;296744;98;2021-05-06;92799
2021-05-05;"Košický kraj";23;12124;35;12159;NA;296744;58;2021-05-05;92701
2021-05-04;"Košický kraj";143;13562;38;13600;NA;296744;181;2021-05-04;92643
2021-05-03;"Košický kraj";37;16944;68;17012;NA;296744;105;2021-05-03;92462
2021-05-02;"Košický kraj";45;36096;56;36152;NA;296744;101;2021-05-02;92357
2021-05-01;"Košický kraj";54;52075;76;52151;NA;296744;130;2021-05-01;92256
2021-04-30;"Košický kraj";59;44602;94;44696;NA;296744;153;2021-04-30;92126
2021-04-29;"Košický kraj";76;17014;53;17067;NA;296744;129;2021-04-29;91973
2021-04-28;"Košický kraj";99;17970;52;18022;NA;296744;151;2021-04-28;91844
2021-04-27;"Košický kraj";108;20670;43;20713;NA;296744;151;2021-04-27;91693
2021-04-26;"Košický kraj";39;25915;96;26011;NA;296744;135;2021-04-26;91542
2021-04-25;"Košický kraj";23;48355;57;48412;NA;296744;80;2021-04-25;91407
2021-04-24;"Košický kraj";68;90124;114;90238;NA;296744;182;2021-04-24;91327
2021-04-23;"Košický kraj";110;41232;72;41304;NA;296744;182;2021-04-23;91145
2021-04-22;"Košický kraj";56;16772;44;16816;NA;296744;100;2021-04-22;90963
2021-04-21;"Košický kraj";114;19519;61;19580;NA;296744;175;2021-04-21;90863
2021-04-20;"Košický kraj";81;25432;63;25495;NA;296744;144;2021-04-20;90688
2021-04-19;"Košický kraj";93;29950;108;30058;NA;296744;201;2021-04-19;90544
2021-04-18;"Košický kraj";10;48913;82;48995;NA;296744;92;2021-04-18;90343
2021-04-17;"Košický kraj";187;83856;103;83959;NA;296744;290;2021-04-17;90251
2021-04-16;"Košický kraj";83;41568;127;41695;NA;296744;210;2021-04-16;89961
2021-04-15;"Košický kraj";104;18522;93;18615;NA;296744;197;2021-04-15;89751
2021-04-14;"Košický kraj";119;20089;64;20153;NA;296744;183;2021-04-14;89554
2021-04-13;"Košický kraj";81;23175;120;23295;NA;296744;201;2021-04-13;89371
2021-04-12;"Košický kraj";129;26573;124;26697;NA;296744;253;2021-04-12;89170
2021-04-11;"Košický kraj";29;46949;80;47029;NA;296744;109;2021-04-11;88917
2021-04-10;"Košický kraj";138;100114;183;100297;NA;296744;321;2021-04-10;88808
2021-04-09;"Košický kraj";168;35206;133;35339;NA;296744;301;2021-04-09;88487
2021-04-08;"Košický kraj";81;18530;90;18620;NA;296744;171;2021-04-08;88186
2021-04-07;"Košický kraj";232;28027;194;28221;NA;296744;426;2021-04-07;88015
2021-04-06;"Košický kraj";121;36495;164;36659;NA;296744;285;2021-04-06;87589
2021-04-05;"Košický kraj";19;14361;66;14427;NA;296744;85;2021-04-05;87304
2021-04-04;"Košický kraj";33;15089;66;15155;NA;296744;99;2021-04-04;87219
2021-04-03;"Košický kraj";138;97664;241;97905;NA;296744;379;2021-04-03;87120
2021-04-02;"Košický kraj";128;24515;76;24591;NA;296744;204;2021-04-02;86741
2021-04-01;"Košický kraj";165;46151;156;46307;NA;296744;321;2021-04-01;86537
2021-03-31;"Košický kraj";160;29659;124;29783;NA;296744;284;2021-03-31;86216
2021-03-30;"Košický kraj";229;24038;163;24201;NA;296744;392;2021-03-30;85932
2021-03-29;"Košický kraj";78;28843;194;29037;NA;296744;272;2021-03-29;85540
2021-03-28;"Košický kraj";39;44263;128;44391;NA;296744;167;2021-03-28;85268
2021-03-27;"Košický kraj";222;96602;265;96867;NA;296744;487;2021-03-27;85101
2021-03-26;"Košický kraj";233;45252;202;45454;NA;296744;435;2021-03-26;84614
2021-03-25;"Košický kraj";133;23804;175;23979;NA;296744;308;2021-03-25;84179
2021-03-24;"Košický kraj";165;20696;155;20851;NA;296744;320;2021-03-24;83871
2021-03-23;"Košický kraj";202;22434;192;22626;NA;296744;394;2021-03-23;83551
2021-03-22;"Košický kraj";169;26890;228;27118;NA;296744;397;2021-03-22;83157
2021-03-21;"Košický kraj";109;46746;167;46913;NA;296744;276;2021-03-21;82760
2021-03-20;"Košický kraj";126;101334;311;101645;NA;296744;437;2021-03-20;82484
2021-03-19;"Košický kraj";205;45632;260;45892;NA;296744;465;2021-03-19;82047
2021-03-18;"Košický kraj";274;23827;212;24039;NA;296744;486;2021-03-18;81582
2021-03-17;"Košický kraj";177;21548;195;21743;NA;296744;372;2021-03-17;81096
2021-03-16;"Košický kraj";386;23454;226;23680;NA;296744;612;2021-03-16;80724
2021-03-15;"Košický kraj";173;27900;297;28197;NA;296744;470;2021-03-15;80112
2021-03-14;"Košický kraj";145;44354;220;44574;NA;296744;365;2021-03-14;79642
2021-03-13;"Košický kraj";146;103790;483;104273;NA;296744;629;2021-03-13;79277
2021-03-12;"Košický kraj";366;47871;321;48192;NA;296744;687;2021-03-12;78648
2021-03-11;"Košický kraj";396;23229;263;23492;NA;296744;659;2021-03-11;77961
2021-03-10;"Košický kraj";121;22205;269;22474;NA;296744;390;2021-03-10;77302
2021-03-09;"Košický kraj";676;24509;300;24809;NA;296744;976;2021-03-09;76912
2021-03-08;"Košický kraj";559;29852;344;30196;NA;296744;903;2021-03-08;75936
2021-03-07;"Košický kraj";45;44230;299;44529;NA;296744;344;2021-03-07;75033
2021-03-06;"Košický kraj";177;105598;532;106130;NA;296744;709;2021-03-06;74689
2021-03-05;"Košický kraj";439;45567;424;45991;NA;296744;863;2021-03-05;73980
2021-03-04;"Košický kraj";417;23862;320;24182;NA;296744;737;2021-03-04;73117
2021-03-03;"Košický kraj";390;23169;298;23467;NA;296744;688;2021-03-03;72380
2021-03-02;"Košický kraj";464;24158;368;24526;NA;296744;832;2021-03-02;71692
2021-03-01;"Košický kraj";389;30013;514;30527;NA;296744;903;2021-03-01;70860
2021-02-28;"Košický kraj";265;43053;334;43387;NA;296744;599;2021-02-28;69957
2021-02-27;"Košický kraj";301;100559;784;101343;NA;296744;1085;2021-02-27;69358
2021-02-26;"Košický kraj";440;45466;492;45958;NA;296744;932;2021-02-26;68273
2021-02-25;"Košický kraj";331;19872;342;20214;NA;296744;673;2021-02-25;67341
2021-02-24;"Košický kraj";263;18751;505;19256;NA;296744;768;2021-02-24;66668
2021-02-23;"Košický kraj";642;21605;341;21946;NA;296744;983;2021-02-23;65900
2021-02-22;"Košický kraj";362;30858;434;31292;NA;296744;796;2021-02-22;64917
2021-02-21;"Košický kraj";170;40464;385;40849;NA;296744;555;2021-02-21;64121
2021-02-20;"Košický kraj";283;92550;770;93320;NA;296744;1053;2021-02-20;63566
2021-02-19;"Košický kraj";507;41579;583;42162;NA;296744;1090;2021-02-19;62513
2021-02-18;"Košický kraj";397;18442;345;18787;NA;296744;742;2021-02-18;61423
2021-02-17;"Košický kraj";322;18080;387;18467;NA;296744;709;2021-02-17;60681
2021-02-16;"Košický kraj";600;22111;463;22574;NA;296744;1063;2021-02-16;59972
2021-02-15;"Košický kraj";216;27633;419;28052;NA;296744;635;2021-02-15;58909
2021-02-14;"Košický kraj";241;56743;524;57267;NA;296744;765;2021-02-14;58274
2021-02-13;"Košický kraj";206;93745;765;94510;NA;296744;971;2021-02-13;57509
2021-02-12;"Košický kraj";448;49924;611;50535;NA;296744;1059;2021-02-12;56538
2021-02-11;"Košický kraj";435;14524;323;14847;NA;296744;758;2021-02-11;55479
2021-02-10;"Košický kraj";360;18475;431;18906;NA;296744;791;2021-02-10;54721
2021-02-09;"Košický kraj";544;24841;463;25304;NA;296744;1007;2021-02-09;53930
2021-02-08;"Košický kraj";237;24836;392;25228;NA;296744;629;2021-02-08;52923
2021-02-07;"Košický kraj";208;56897;612;57509;NA;296744;820;2021-02-07;52294
2021-02-06;"Košický kraj";318;104357;884;105241;NA;296744;1202;2021-02-06;51474
2021-02-05;"Košický kraj";384;43186;494;43680;NA;296744;878;2021-02-05;50272
2021-02-04;"Košický kraj";391;14512;371;14883;NA;296744;762;2021-02-04;49394
2021-02-03;"Košický kraj";296;12599;339;12938;NA;296744;635;2021-02-03;48632
2021-02-02;"Košický kraj";473;43883;1212;45095;NA;296744;1685;2021-02-02;47997
2021-02-01;"Košický kraj";415;21984;362;22346;NA;296744;777;2021-02-01;46312
2021-01-31;"Košický kraj";142;54690;617;55307;NA;296744;759;2021-01-31;45535
2021-01-30;"Košický kraj";320;76722;661;77383;NA;296744;981;2021-01-30;44776
2021-01-29;"Košický kraj";311;37164;466;37630;NA;296744;777;2021-01-29;43795
2021-01-28;"Košický kraj";540;9006;244;9250;NA;296744;784;2021-01-28;43018
2021-01-27;"Košický kraj";265;7575;211;7786;NA;296744;476;2021-01-27;42234
2021-01-26;"Košický kraj";530;14210;245;14455;NA;296744;775;2021-01-26;41758
2021-01-25;"Košický kraj";226;26431;413;26844;NA;296744;639;2021-01-25;40983
2021-01-24;"Košický kraj";150;44419;581;45000;NA;296744;731;2021-01-24;40344
2021-01-23;"Košický kraj";232;82705;857;83562;NA;296744;1089;2021-01-23;39613
2021-01-22;"Košický kraj";316;19997;265;20262;NA;296744;581;2021-01-22;38524
2021-01-21;"Košický kraj";274;14053;159;14212;NA;296744;433;2021-01-21;37943
2021-01-20;"Košický kraj";374;10844;201;11045;NA;296744;575;2021-01-20;37510
2021-01-19;"Košický kraj";248;9717;181;9898;NA;296744;429;2021-01-19;36935
2021-01-18;"Košický kraj";333;7659;262;7921;NA;296744;595;2021-01-18;36506
2021-01-17;"Košický kraj";155;535;14;549;NA;296744;169;2021-01-17;35911
2021-01-16;"Košický kraj";153;1403;47;1450;NA;296744;200;2021-01-16;35742
2021-01-15;"Košický kraj";308;6443;213;6656;NA;296744;521;2021-01-15;35542
2021-01-14;"Košický kraj";358;5471;221;5692;NA;296744;579;2021-01-14;35021
2021-01-13;"Košický kraj";421;4897;226;5123;NA;296744;647;2021-01-13;34442
2021-01-12;"Košický kraj";482;6473;237;6710;NA;296744;719;2021-01-12;33795
2021-01-11;"Košický kraj";309;7553;286;7839;NA;296744;595;2021-01-11;33076
2021-01-10;"Košický kraj";193;136;6;142;NA;296744;199;2021-01-10;32481
2021-01-09;"Košický kraj";469;1134;45;1179;NA;296744;514;2021-01-09;32282
2021-01-08;"Košický kraj";551;7106;348;7454;NA;296744;899;2021-01-08;31768
2021-01-07;"Košický kraj";251;5853;398;6251;NA;296744;649;2021-01-07;30869
2021-01-06;"Košický kraj";442;429;33;462;NA;296744;475;2021-01-06;30220
2021-01-05;"Košický kraj";584;7633;527;8160;NA;296744;1111;2021-01-05;29745
2021-01-04;"Košický kraj";407;6479;660;7139;NA;296744;1067;2021-01-04;28634
2021-01-03;"Košický kraj";118;661;22;683;NA;296744;140;2021-01-03;27567
2021-01-02;"Košický kraj";88;440;52;492;NA;296744;140;2021-01-02;27427
2021-01-01;"Košický kraj";398;725;49;774;NA;296744;447;2021-01-01;27287
2020-12-31;"Košický kraj";625;7509;453;7962;NA;296744;1078;2020-12-31;26840
2020-12-30;"Košický kraj";590;6076;395;6471;NA;296744;985;2020-12-30;25762
2020-12-29;"Košický kraj";419;7454;596;8050;NA;296744;1015;2020-12-29;24777
2020-12-28;"Košický kraj";356;7933;756;8689;NA;296744;1112;2020-12-28;23762
2020-12-27;"Košický kraj";159;147;16;163;NA;296744;175;2020-12-27;22650
2020-12-26;"Košický kraj";163;274;23;297;NA;296744;186;2020-12-26;22475
2020-12-25;"Košický kraj";237;140;10;150;NA;296744;247;2020-12-25;22289
2020-12-24;"Košický kraj";564;1470;90;1560;NA;296744;654;2020-12-24;22042
2020-12-23;"Košický kraj";304;7339;327;7666;NA;296744;631;2020-12-23;21388
2020-12-22;"Košický kraj";438;7284;429;7713;NA;296744;867;2020-12-22;20757
2020-12-21;"Košický kraj";405;6703;504;7207;NA;296744;909;2020-12-21;19890
2020-12-20;"Košický kraj";215;73;11;84;NA;296744;226;2020-12-20;18981
2020-12-19;"Košický kraj";207;1309;63;1372;NA;296744;270;2020-12-19;18755
2020-12-18;"Košický kraj";310;7707;292;7999;NA;296744;602;2020-12-18;18485
2020-12-17;"Košický kraj";463;5101;253;5354;NA;296744;716;2020-12-17;17883
2020-12-16;"Košický kraj";455;5725;295;6020;NA;296744;750;2020-12-16;17167
2020-12-15;"Košický kraj";319;4787;327;5114;NA;296744;646;2020-12-15;16417
2020-12-14;"Košický kraj";256;2905;225;3130;NA;296744;481;2020-12-14;15771
2020-12-13;"Košický kraj";47;181;2;183;NA;296744;49;2020-12-13;15290
2020-12-12;"Košický kraj";369;1587;118;1705;NA;296744;487;2020-12-12;15241
2020-12-11;"Košický kraj";354;5328;256;5584;NA;296744;610;2020-12-11;14754
2020-12-10;"Košický kraj";283;3987;174;4161;NA;296744;457;2020-12-10;14144
2020-12-09;"Košický kraj";279;3786;166;3952;NA;296744;445;2020-12-09;13687
2020-12-08;"Košický kraj";226;4105;355;4460;NA;296744;581;2020-12-08;13242
2020-12-07;"Košický kraj";270;2383;106;2489;NA;296744;376;2020-12-07;12661
2020-12-06;"Košický kraj";121;482;33;515;NA;296744;154;2020-12-06;12285
2020-12-05;"Košický kraj";90;1096;48;1144;NA;296744;138;2020-12-05;12131
2020-12-04;"Košický kraj";224;2680;82;2762;NA;296744;306;2020-12-04;11993
2020-12-03;"Košický kraj";211;7717;173;7890;NA;296744;384;2020-12-03;11687
2020-12-02;"Košický kraj";193;8132;496;8628;NA;296744;689;2020-12-02;11303
2020-12-01;"Košický kraj";178;2237;124;2361;NA;296744;302;2020-12-01;10614
2020-11-30;"Košický kraj";171;3598;59;3657;NA;296744;230;2020-11-30;10312
2020-11-29;"Košický kraj";31;325;17;342;NA;296744;48;2020-11-29;10082
2020-11-28;"Košický kraj";69;721;52;773;NA;296744;121;2020-11-28;10034
2020-11-27;"Košický kraj";149;2921;78;2999;NA;296744;227;2020-11-27;9913
2020-11-26;"Košický kraj";239;1234;60;1294;NA;296744;299;2020-11-26;9686
2020-11-25;"Košický kraj";237;1785;123;1908;NA;296744;360;2020-11-25;9387
2020-11-24;"Košický kraj";196;1976;67;2043;NA;296744;263;2020-11-24;9027
2020-11-23;"Košický kraj";51;4115;63;4178;NA;296744;114;2020-11-23;8764
2020-11-22;"Košický kraj";57;57;5;62;NA;296744;62;2020-11-22;8650
2020-11-21;"Košický kraj";87;858;36;894;NA;296744;123;2020-11-21;8588
2020-11-20;"Košický kraj";176;3084;49;3133;NA;296744;225;2020-11-20;8465
2020-11-19;"Košický kraj";206;1736;48;1784;NA;296744;254;2020-11-19;8240
2020-11-18;"Košický kraj";122;532;17;549;NA;296744;139;2020-11-18;7986
2020-11-17;"Košický kraj";152;82;9;91;NA;296744;161;2020-11-17;7847
2020-11-16;"Košický kraj";114;596;27;623;NA;296744;141;2020-11-16;7686
2020-11-15;"Košický kraj";15;338;7;345;NA;296744;22;2020-11-15;7545
2020-11-14;"Košický kraj";234;520;12;532;NA;296744;246;2020-11-14;7523
2020-11-13;"Košický kraj";207;664;29;693;NA;296744;236;2020-11-13;7277
2020-11-12;"Košický kraj";192;736;13;749;NA;296744;205;2020-11-12;7041
2020-11-11;"Košický kraj";301;593;7;600;NA;296744;308;2020-11-11;6836
2020-11-10;"Košický kraj";190;541;11;552;NA;296744;201;2020-11-10;6528
2020-11-09;"Košický kraj";129;380;17;397;NA;296744;146;2020-11-09;6327
2020-11-08;"Košický kraj";78;1306;8;1314;NA;296744;86;2020-11-08;6181
2020-11-07;"Košický kraj";192;3909;22;3931;NA;296744;214;2020-11-07;6095
2020-11-06;"Košický kraj";195;5310;34;5344;NA;296744;229;2020-11-06;5881
2020-11-05;"Košický kraj";342;330;31;361;NA;296744;373;2020-11-05;5652
2020-11-04;"Košický kraj";101;154;6;160;NA;296744;107;2020-11-04;5279
2020-11-03;"Košický kraj";358;1122;13;1135;NA;296744;371;2020-11-03;5172
2020-11-02;"Košický kraj";111;6125;56;6181;NA;296744;167;2020-11-02;4801
2020-11-01;"Košický kraj";346;6522;34;6556;NA;296744;380;2020-11-01;4634
2020-10-31;"Košický kraj";82;14035;106;14141;NA;296744;188;2020-10-31;4254
2020-10-30;"Košický kraj";379;2835;27;2862;NA;296744;406;2020-10-30;4066
2020-10-29;"Košický kraj";333;983;13;996;NA;296744;346;2020-10-29;3660
2020-10-28;"Košický kraj";224;305;13;318;NA;296744;237;2020-10-28;3314
2020-10-27;"Košický kraj";386;439;21;460;NA;296744;407;2020-10-27;3077
2020-10-26;"Košický kraj";56;212;12;224;NA;296744;68;2020-10-26;2670
2020-10-25;"Košický kraj";154;79;2;81;NA;296744;156;2020-10-25;2602
2020-10-24;"Košický kraj";313;118;16;134;NA;296744;329;2020-10-24;2446
2020-10-23;"Košický kraj";315;331;8;339;NA;296744;323;2020-10-23;2117
2020-10-22;"Košický kraj";349;530;16;546;NA;296744;365;2020-10-22;1794
2020-10-21;"Košický kraj";129;84;2;86;NA;296744;131;2020-10-21;1429
2020-10-20;"Košický kraj";181;14;1;15;NA;296744;182;2020-10-20;1298
2020-10-19;"Košický kraj";64;38;1;39;NA;296744;65;2020-10-19;1116
2020-10-18;"Košický kraj";158;0;0;0;NA;296744;158;2020-10-18;1051
2020-10-17;"Košický kraj";142;0;0;0;NA;296744;142;2020-10-17;893
2020-10-16;"Košický kraj";206;19;0;19;NA;296744;206;2020-10-16;751
2020-10-15;"Košický kraj";177;19;5;24;NA;296744;182;2020-10-15;545
2020-10-14;"Košický kraj";211;8;0;8;NA;296744;211;2020-10-14;363
2020-10-13;"Košický kraj";179;80;3;83;NA;296744;182;2020-10-13;152
2020-10-12;"Košický kraj";74;0;0;0;NA;296744;74;2020-10-12;-30
2020-10-11;"Košický kraj";121;0;0;0;NA;296744;121;2020-10-11;-104
2020-10-10;"Košický kraj";70;0;0;0;NA;296744;70;2020-10-10;-225
2020-10-09;"Košický kraj";188;0;0;0;NA;296744;188;2020-10-09;-295
2020-10-08;"Košický kraj";102;0;0;0;NA;296744;102;2020-10-08;-483
2020-10-07;"Košický kraj";158;0;0;0;NA;296744;158;2020-10-07;-585
2020-10-06;"Košický kraj";70;0;0;0;NA;296744;70;2020-10-06;-743
2020-10-05;"Košický kraj";39;0;0;0;NA;296744;39;2020-10-05;-813
2020-10-04;"Košický kraj";45;0;0;0;NA;296744;45;2020-10-04;-852
2020-10-03;"Košický kraj";105;0;0;0;NA;296744;105;2020-10-03;-897
2020-10-02;"Košický kraj";57;0;0;0;NA;296744;57;2020-10-02;-1002
2020-10-01;"Košický kraj";69;0;0;0;NA;296744;69;2020-10-01;-1059
2020-09-30;"Košický kraj";95;0;0;0;NA;296744;95;2020-09-30;-1128
2020-09-29;"Košický kraj";75;0;0;0;NA;296744;75;2020-09-29;-1223
2020-09-28;"Košický kraj";19;0;0;0;NA;296744;19;2020-09-28;-1298
2020-09-27;"Košický kraj";21;0;0;0;NA;296744;21;2020-09-27;-1317
2020-09-26;"Košický kraj";53;0;0;0;NA;296744;53;2020-09-26;-1338
2020-09-25;"Košický kraj";72;0;0;0;NA;296744;72;2020-09-25;-1391
2020-09-24;"Košický kraj";35;0;0;0;NA;296744;35;2020-09-24;-1463
2020-09-23;"Košický kraj";23;0;0;0;NA;296744;23;2020-09-23;-1498
2020-09-22;"Košický kraj";39;0;0;0;NA;296744;39;2020-09-22;-1521
2020-09-21;"Košický kraj";5;0;0;0;NA;296744;5;2020-09-21;-1560
2020-09-20;"Košický kraj";3;0;0;0;NA;296744;3;2020-09-20;-1565
2020-09-19;"Košický kraj";13;0;0;0;NA;296744;13;2020-09-19;-1568
2020-09-18;"Košický kraj";20;0;0;0;NA;296744;20;2020-09-18;-1581
2020-09-17;"Košický kraj";22;0;0;0;NA;296744;22;2020-09-17;-1601
2020-09-16;"Košický kraj";12;0;0;0;NA;296744;12;2020-09-16;-1623
2020-09-15;"Košický kraj";10;0;0;0;NA;296744;10;2020-09-15;-1635
2020-09-14;"Košický kraj";6;0;0;0;NA;296744;6;2020-09-14;-1645
2020-09-13;"Košický kraj";3;0;0;0;NA;296744;3;2020-09-13;-1651
2020-09-12;"Košický kraj";16;0;0;0;NA;296744;16;2020-09-12;-1654
2020-09-11;"Košický kraj";20;0;0;0;NA;296744;20;2020-09-11;-1670
2020-09-10;"Košický kraj";11;0;0;0;NA;296744;11;2020-09-10;-1690
2020-09-09;"Košický kraj";37;0;0;0;NA;296744;37;2020-09-09;-1701
2020-09-08;"Košický kraj";10;0;0;0;NA;296744;10;2020-09-08;-1738
2020-09-07;"Košický kraj";4;0;0;0;NA;296744;4;2020-09-07;-1748
2020-09-06;"Košický kraj";2;0;0;0;NA;296744;2;2020-09-06;-1752
2020-09-05;"Košický kraj";10;0;0;0;NA;296744;10;2020-09-05;-1754
2020-09-04;"Košický kraj";14;0;0;0;NA;296744;14;2020-09-04;-1764
2020-09-03;"Košický kraj";22;0;0;0;NA;296744;22;2020-09-03;-1778
2020-09-02;"Košický kraj";13;0;0;0;NA;296744;13;2020-09-02;-1800
2020-09-01;"Košický kraj";21;0;0;0;NA;296744;21;2020-09-01;-1813
2020-08-31;"Košický kraj";9;0;0;0;NA;296744;9;2020-08-31;-1834
2020-08-30;"Košický kraj";21;0;0;0;NA;296744;21;2020-08-30;-1843
2020-08-29;"Košický kraj";1;0;0;0;NA;296744;1;2020-08-29;-1864
2020-08-28;"Košický kraj";19;0;0;0;NA;296744;19;2020-08-28;-1865
2020-08-27;"Košický kraj";15;0;0;0;NA;296744;15;2020-08-27;-1884
2020-08-26;"Košický kraj";8;0;0;0;NA;296744;8;2020-08-26;-1899
2020-08-25;"Košický kraj";23;0;0;0;NA;296744;23;2020-08-25;-1907
2020-08-24;"Košický kraj";6;0;0;0;NA;296744;6;2020-08-24;-1930
2020-08-23;"Košický kraj";8;0;0;0;NA;296744;8;2020-08-23;-1936
2020-08-22;"Košický kraj";13;0;0;0;NA;296744;13;2020-08-22;-1944
2020-08-21;"Košický kraj";10;0;0;0;NA;296744;10;2020-08-21;-1957
2020-08-20;"Košický kraj";10;0;0;0;NA;296744;10;2020-08-20;-1967
2020-08-19;"Košický kraj";3;0;0;0;NA;296744;3;2020-08-19;-1977
2020-08-18;"Košický kraj";7;0;0;0;NA;296744;7;2020-08-18;-1980
2020-08-17;"Košický kraj";2;0;0;0;NA;296744;2;2020-08-17;-1987
2020-08-16;"Košický kraj";2;0;0;0;NA;296744;2;2020-08-16;-1989
2020-08-15;"Košický kraj";3;0;0;0;NA;296744;3;2020-08-15;-1991
2020-08-14;"Košický kraj";1;0;0;0;NA;296744;1;2020-08-14;-1994
2020-08-13;"Košický kraj";3;0;0;0;NA;296744;3;2020-08-13;-1995
2020-08-12;"Košický kraj";12;0;0;0;NA;296744;12;2020-08-12;-1998
2020-08-11;"Košický kraj";5;0;0;0;NA;296744;5;2020-08-11;-2010
2020-08-10;"Košický kraj";1;0;0;0;NA;296744;1;2020-08-10;-2015
2020-08-09;"Košický kraj";0;0;0;0;NA;296744;0;2020-08-09;-2016
2020-08-08;"Košický kraj";5;0;0;0;NA;296744;5;2020-08-08;-2016
2020-08-07;"Košický kraj";7;0;0;0;NA;296744;7;2020-08-07;-2021
2020-08-06;"Košický kraj";3;0;0;0;NA;296744;3;2020-08-06;-2028
2020-08-05;"Košický kraj";4;0;0;0;NA;296744;4;2020-08-05;-2031
2020-08-04;"Košický kraj";1;0;0;0;NA;296744;1;2020-08-04;-2035
2020-08-03;"Košický kraj";1;0;0;0;NA;296744;1;2020-08-03;-2036
2020-08-02;"Košický kraj";0;0;0;0;NA;296744;0;2020-08-02;-2037
2020-08-01;"Košický kraj";0;0;0;0;NA;296744;0;2020-08-01;-2037
2020-07-31;"Košický kraj";0;0;0;0;NA;296744;0;2020-07-31;-2037
2020-07-30;"Košický kraj";2;0;0;0;NA;296744;2;2020-07-30;-2037
2020-07-29;"Košický kraj";1;0;0;0;NA;296744;1;2020-07-29;-2039
2020-07-28;"Košický kraj";9;0;0;0;NA;296744;9;2020-07-28;-2040
2020-07-27;"Košický kraj";4;0;0;0;NA;296744;4;2020-07-27;-2049
2020-07-26;"Košický kraj";0;0;0;0;NA;296744;0;2020-07-26;-2053
2020-07-25;"Košický kraj";2;0;0;0;NA;296744;2;2020-07-25;-2053
2020-07-24;"Košický kraj";2;0;0;0;NA;296744;2;2020-07-24;-2055
2020-07-23;"Košický kraj";1;0;0;0;NA;296744;1;2020-07-23;-2057
2020-07-22;"Košický kraj";1;0;0;0;NA;296744;1;2020-07-22;-2058
2020-07-21;"Košický kraj";0;0;0;0;NA;296744;0;2020-07-21;-2059
2020-07-20;"Košický kraj";0;0;0;0;NA;296744;0;2020-07-20;-2059
2020-07-19;"Košický kraj";0;0;0;0;NA;296744;0;2020-07-19;-2059
2020-07-18;"Košický kraj";1;0;0;0;NA;296744;1;2020-07-18;-2059
2020-07-17;"Košický kraj";1;0;0;0;NA;296744;1;2020-07-17;-2060
2020-07-16;"Košický kraj";0;0;0;0;NA;296744;0;2020-07-16;-2061
2020-07-15;"Košický kraj";2;0;0;0;NA;296744;2;2020-07-15;-2061
2020-07-14;"Košický kraj";1;0;0;0;NA;296744;1;2020-07-14;-2063
2020-07-13;"Košický kraj";1;0;0;0;NA;296744;1;2020-07-13;-2064
2020-07-12;"Košický kraj";0;0;0;0;NA;296744;0;2020-07-12;-2065
2020-07-11;"Košický kraj";0;0;0;0;NA;296744;0;2020-07-11;-2065
2020-07-10;"Košický kraj";1;0;0;0;NA;296744;1;2020-07-10;-2065
2020-07-09;"Košický kraj";1;0;0;0;NA;296744;1;2020-07-09;-2066
2020-07-08;"Košický kraj";12;0;0;0;NA;296744;12;2020-07-08;-2067
2020-07-07;"Košický kraj";0;0;0;0;NA;296744;0;2020-07-07;-2079
2020-07-06;"Košický kraj";0;0;0;0;NA;296744;0;2020-07-06;-2079
2020-07-05;"Košický kraj";0;0;0;0;NA;296744;0;2020-07-05;-2079
2020-07-04;"Košický kraj";0;0;0;0;NA;296744;0;2020-07-04;-2079
2020-07-03;"Košický kraj";1;0;0;0;NA;296744;1;2020-07-03;-2079
2020-07-02;"Košický kraj";0;0;0;0;NA;296744;0;2020-07-02;-2080
2020-07-01;"Košický kraj";1;0;0;0;NA;296744;1;2020-07-01;-2080
2020-06-30;"Košický kraj";0;0;0;0;NA;296744;0;2020-06-30;-2081
2020-06-29;"Košický kraj";0;0;0;0;NA;296744;0;2020-06-29;-2081
2020-06-28;"Košický kraj";0;0;0;0;NA;296744;0;2020-06-28;-2081
2020-06-27;"Košický kraj";0;0;0;0;NA;296744;0;2020-06-27;-2081
2020-06-26;"Košický kraj";0;0;0;0;NA;296744;0;2020-06-26;-2081
2020-06-25;"Košický kraj";3;0;0;0;NA;296744;3;2020-06-25;-2081
2020-06-24;"Košický kraj";3;0;0;0;NA;296744;3;2020-06-24;-2084
2020-06-23;"Košický kraj";3;0;0;0;NA;296744;3;2020-06-23;-2087
2020-06-22;"Košický kraj";0;0;0;0;NA;296744;0;2020-06-22;-2090
2020-06-21;"Košický kraj";0;0;0;0;NA;296744;0;2020-06-21;-2090
2020-06-20;"Košický kraj";0;0;0;0;NA;296744;0;2020-06-20;-2090
2020-06-19;"Košický kraj";0;0;0;0;NA;296744;0;2020-06-19;-2090
2020-06-18;"Košický kraj";1;0;0;0;NA;296744;1;2020-06-18;-2090
2020-06-17;"Košický kraj";0;0;0;0;NA;296744;0;2020-06-17;-2091
2020-06-16;"Košický kraj";2;0;0;0;NA;296744;2;2020-06-16;-2091
2020-06-14;"Košický kraj";0;0;0;0;NA;296744;0;2020-06-14;-2093
2020-06-13;"Košický kraj";0;0;0;0;NA;296744;0;2020-06-13;-2093
2020-06-12;"Košický kraj";0;0;0;0;NA;296744;0;2020-06-12;-2093
2020-06-11;"Košický kraj";0;0;0;0;NA;296744;0;2020-06-11;-2093
2020-06-10;"Košický kraj";6;0;0;0;NA;296744;6;2020-06-10;-2093
2020-06-09;"Košický kraj";0;0;0;0;NA;296744;0;2020-06-09;-2099
2020-06-08;"Košický kraj";0;0;0;0;NA;296744;0;2020-06-08;-2099
2020-06-07;"Košický kraj";2;0;0;0;NA;296744;2;2020-06-07;-2099
2020-06-05;"Košický kraj";0;0;0;0;NA;296744;0;2020-06-05;-2101
2020-06-03;"Košický kraj";0;0;0;0;NA;296744;0;2020-06-03;-2101
2020-06-02;"Košický kraj";1;0;0;0;NA;296744;1;2020-06-02;-2101
2020-05-31;"Košický kraj";0;0;0;0;NA;296744;0;2020-05-31;-2102
2020-05-29;"Košický kraj";1;0;0;0;NA;296744;1;2020-05-29;-2102
2020-05-27;"Košický kraj";0;0;0;0;NA;296744;0;2020-05-27;-2103
2020-05-26;"Košický kraj";1;0;0;0;NA;296744;1;2020-05-26;-2103
2020-05-25;"Košický kraj";1;0;0;0;NA;296744;1;2020-05-25;-2104
2020-05-24;"Košický kraj";0;0;0;0;NA;296744;0;2020-05-24;-2105
2020-05-23;"Košický kraj";0;0;0;0;NA;296744;0;2020-05-23;-2105
2020-05-22;"Košický kraj";0;0;0;0;NA;296744;0;2020-05-22;-2105
2020-05-21;"Košický kraj";0;0;0;0;NA;296744;0;2020-05-21;-2105
2020-05-20;"Košický kraj";3;0;0;0;NA;296744;3;2020-05-20;-2105
2020-05-19;"Košický kraj";0;0;0;0;NA;296744;0;2020-05-19;-2108
2020-05-17;"Košický kraj";1;0;0;0;NA;296744;1;2020-05-17;-2108
2020-05-16;"Košický kraj";1;0;0;0;NA;296744;1;2020-05-16;-2109
2020-05-15;"Košický kraj";10;0;0;0;NA;296744;10;2020-05-15;-2110
2020-05-14;"Košický kraj";1;0;0;0;NA;296744;1;2020-05-14;-2120
2020-05-13;"Košický kraj";6;0;0;0;NA;296744;6;2020-05-13;-2121
2020-05-12;"Košický kraj";0;0;0;0;NA;296744;0;2020-05-12;-2127
2020-05-11;"Košický kraj";0;0;0;0;NA;296744;0;2020-05-11;-2127
2020-05-09;"Košický kraj";0;0;0;0;NA;296744;0;2020-05-09;-2127
2020-05-07;"Košický kraj";0;0;0;0;NA;296744;0;2020-05-07;-2127
2020-05-06;"Košický kraj";1;0;0;0;NA;296744;1;2020-05-06;-2127
2020-05-05;"Košický kraj";0;0;0;0;NA;296744;0;2020-05-05;-2128
2020-05-04;"Košický kraj";0;0;0;0;NA;296744;0;2020-05-04;-2128
2020-05-03;"Košický kraj";0;0;0;0;NA;296744;0;2020-05-03;-2128
2020-05-02;"Košický kraj";1;0;0;0;NA;296744;1;2020-05-02;-2128
2020-05-01;"Košický kraj";0;0;0;0;NA;296744;0;2020-05-01;-2129
2020-04-30;"Košický kraj";1;0;0;0;NA;296744;1;2020-04-30;-2129
2020-04-29;"Košický kraj";1;0;0;0;NA;296744;1;2020-04-29;-2130
2020-04-28;"Košický kraj";1;0;0;0;NA;296744;1;2020-04-28;-2131
2020-04-27;"Košický kraj";1;0;0;0;NA;296744;1;2020-04-27;-2132
2020-04-26;"Košický kraj";0;0;0;0;NA;296744;0;2020-04-26;-2133
2020-04-25;"Košický kraj";0;0;0;0;NA;296744;0;2020-04-25;-2133
2020-04-24;"Košický kraj";3;0;0;0;NA;296744;3;2020-04-24;-2133
2020-04-23;"Košický kraj";4;0;0;0;NA;296744;4;2020-04-23;-2136
2020-04-22;"Košický kraj";21;0;0;0;NA;296744;21;2020-04-22;-2140
2020-04-21;"Košický kraj";4;0;0;0;NA;296744;4;2020-04-21;-2161
2020-04-20;"Košický kraj";0;0;0;0;NA;296744;0;2020-04-20;-2165
2020-04-19;"Košický kraj";1;0;0;0;NA;296744;1;2020-04-19;-2165
2020-04-18;"Košický kraj";2;0;0;0;NA;296744;2;2020-04-18;-2166
2020-04-17;"Košický kraj";7;0;0;0;NA;296744;7;2020-04-17;-2168
2020-04-16;"Košický kraj";29;0;0;0;NA;296744;29;2020-04-16;-2175
2020-04-15;"Košický kraj";50;0;0;0;NA;296744;50;2020-04-15;-2204
2020-04-14;"Košický kraj";4;0;0;0;NA;296744;4;2020-04-14;-2254
2020-04-13;"Košický kraj";5;0;0;0;NA;296744;5;2020-04-13;-2258
2020-04-12;"Košický kraj";4;0;0;0;NA;296744;4;2020-04-12;-2263
2020-04-11;"Košický kraj";2;0;0;0;NA;296744;2;2020-04-11;-2267
2020-04-10;"Košický kraj";1;0;0;0;NA;296744;1;2020-04-10;-2269
2020-04-09;"Košický kraj";4;0;0;0;NA;296744;4;2020-04-09;-2270
2020-04-08;"Košický kraj";5;0;0;0;NA;296744;5;2020-04-08;-2274
2020-04-07;"Košický kraj";34;0;0;0;NA;296744;34;2020-04-07;-2279
2020-04-06;"Košický kraj";6;0;0;0;NA;296744;6;2020-04-06;-2313
2020-04-05;"Košický kraj";4;0;0;0;NA;296744;4;2020-04-05;-2319
2020-04-04;"Košický kraj";5;0;0;0;NA;296744;5;2020-04-04;-2323
2020-04-03;"Košický kraj";4;0;0;0;NA;296744;4;2020-04-03;-2328
2020-04-02;"Košický kraj";3;0;0;0;NA;296744;3;2020-04-02;-2332
2020-04-01;"Košický kraj";3;0;0;0;NA;296744;3;2020-04-01;-2335
2020-03-31;"Košický kraj";1;0;0;0;NA;296744;1;2020-03-31;-2338
2020-03-30;"Košický kraj";5;0;0;0;NA;296744;5;2020-03-30;-2339
2020-03-29;"Košický kraj";0;0;0;0;NA;296744;0;2020-03-29;-2344
2020-03-28;"Košický kraj";1;0;0;0;NA;296744;1;2020-03-28;-2344
2020-03-27;"Košický kraj";1;0;0;0;NA;296744;1;2020-03-27;-2345
2020-03-26;"Košický kraj";3;0;0;0;NA;296744;3;2020-03-26;-2346
2020-03-25;"Košický kraj";2;0;0;0;NA;296744;2;2020-03-25;-2349
2020-03-24;"Košický kraj";0;0;0;0;NA;296744;0;2020-03-24;-2351
2020-03-23;"Košický kraj";2;0;0;0;NA;296744;2;2020-03-23;-2351
2020-03-22;"Košický kraj";0;0;0;0;NA;296744;0;2020-03-22;-2353
2020-03-21;"Košický kraj";3;0;0;0;NA;296744;3;2020-03-21;-2353
2020-03-20;"Košický kraj";1;0;0;0;NA;296744;1;2020-03-20;-2356
2020-03-19;"Košický kraj";0;0;0;0;NA;296744;0;2020-03-19;-2357
2020-03-18;"Košický kraj";0;0;0;0;NA;296744;0;2020-03-18;-2357
2020-03-17;"Košický kraj";0;0;0;0;NA;296744;0;2020-03-17;-2357
2020-03-16;"Košický kraj";3;0;0;0;NA;296744;3;2020-03-16;-2357
2020-03-15;"Košický kraj";1;0;0;0;NA;296744;1;2020-03-15;-2360
2020-03-14;"Košický kraj";0;0;0;0;NA;296744;0;2020-03-14;-2361
2020-03-13;"Košický kraj";2;0;0;0;NA;296744;2;2020-03-13;-2361
2020-03-12;"Košický kraj";0;0;0;0;NA;296744;0;2020-03-12;-2363
2020-03-11;"Košický kraj";0;0;0;0;NA;296744;0;2020-03-11;-2363
2020-03-09;"Košický kraj";1;0;0;0;NA;296744;1;2020-03-09;-2363
2020-03-08;"Košický kraj";0;0;0;0;NA;296744;0;2020-03-08;-2364
2020-03-07;"Košický kraj";0;0;0;0;NA;296744;0;2020-03-07;-2364
2020-03-06;"Košický kraj";0;0;0;0;NA;296744;0;2020-03-06;-2364
2022-03-08;"Nitriansky kraj";1695;0;0;0;151374;241648;1695;2022-03-08;241648
2022-03-07;"Nitriansky kraj";1115;0;0;0;NA;241648;1115;2022-03-07;239953
2022-03-06;"Nitriansky kraj";566;814;221;1035;NA;241648;787;2022-03-06;238838
2022-03-05;"Nitriansky kraj";614;515;140;655;NA;241648;754;2022-03-05;238051
2022-03-04;"Nitriansky kraj";1315;1169;237;1406;NA;241648;1552;2022-03-04;237297
2022-03-03;"Nitriansky kraj";1405;2903;369;3272;NA;241648;1774;2022-03-03;235745
2022-03-02;"Nitriansky kraj";1417;2671;413;3084;NA;241648;1830;2022-03-02;233971
2022-03-01;"Nitriansky kraj";1380;2386;401;2787;NA;241648;1781;2022-03-01;232141
2022-02-28;"Nitriansky kraj";1577;3999;576;4575;NA;241648;2153;2022-02-28;230360
2022-02-27;"Nitriansky kraj";797;1224;279;1503;NA;241648;1076;2022-02-27;228207
2022-02-26;"Nitriansky kraj";895;783;211;994;NA;241648;1106;2022-02-26;227131
2022-02-25;"Nitriansky kraj";1400;2036;333;2369;NA;241648;1733;2022-02-25;226025
2022-02-24;"Nitriansky kraj";1592;3546;383;3929;NA;241648;1975;2022-02-24;224292
2022-02-23;"Nitriansky kraj";1885;3892;460;4352;NA;241648;2345;2022-02-23;222317
2022-02-22;"Nitriansky kraj";2323;3714;488;4202;NA;241648;2811;2022-02-22;219972
2022-02-21;"Nitriansky kraj";1593;5234;769;6003;NA;241648;2362;2022-02-21;217161
2022-02-20;"Nitriansky kraj";1049;1928;414;2342;NA;241648;1463;2022-02-20;214799
2022-02-19;"Nitriansky kraj";1084;1298;322;1620;NA;241648;1406;2022-02-19;213336
2022-02-18;"Nitriansky kraj";2021;3277;583;3860;NA;241648;2604;2022-02-18;211930
2022-02-17;"Nitriansky kraj";2134;3890;480;4370;NA;241648;2614;2022-02-17;209326
2022-02-16;"Nitriansky kraj";2152;3940;532;4472;NA;241648;2684;2022-02-16;206712
2022-02-15;"Nitriansky kraj";2093;4069;780;4849;NA;241648;2873;2022-02-15;204028
2022-02-14;"Nitriansky kraj";2094;6244;917;7161;NA;241648;3011;2022-02-14;201155
2022-02-13;"Nitriansky kraj";1146;2815;540;3355;NA;241648;1686;2022-02-13;198144
2022-02-12;"Nitriansky kraj";1301;1171;343;1514;NA;241648;1644;2022-02-12;196458
2022-02-11;"Nitriansky kraj";2042;2942;561;3503;NA;241648;2603;2022-02-11;194814
2022-02-10;"Nitriansky kraj";2374;3366;537;3903;NA;241648;2911;2022-02-10;192211
2022-02-09;"Nitriansky kraj";2133;4798;653;5451;NA;241648;2786;2022-02-09;189300
2022-02-08;"Nitriansky kraj";1801;4935;736;5671;NA;241648;2537;2022-02-08;186514
2022-02-07;"Nitriansky kraj";2240;6787;758;7545;NA;241648;2998;2022-02-07;183977
2022-02-06;"Nitriansky kraj";1309;2659;485;3144;NA;241648;1794;2022-02-06;180979
2022-02-05;"Nitriansky kraj";1609;1504;358;1862;NA;241648;1967;2022-02-05;179185
2022-02-04;"Nitriansky kraj";1848;4185;510;4695;NA;241648;2358;2022-02-04;177218
2022-02-03;"Nitriansky kraj";2425;4186;491;4677;NA;241648;2916;2022-02-03;174860
2022-02-02;"Nitriansky kraj";1903;5295;758;6053;NA;241648;2661;2022-02-02;171944
2022-02-01;"Nitriansky kraj";2288;4717;597;5314;NA;241648;2885;2022-02-01;169283
2022-01-31;"Nitriansky kraj";1329;8978;743;9721;NA;241648;2072;2022-01-31;166398
2022-01-30;"Nitriansky kraj";777;3457;464;3921;NA;241648;1241;2022-01-30;164326
2022-01-29;"Nitriansky kraj";1099;1670;298;1968;NA;241648;1397;2022-01-29;163085
2022-01-28;"Nitriansky kraj";1610;4212;374;4586;NA;241648;1984;2022-01-28;161688
2022-01-27;"Nitriansky kraj";1429;3796;289;4085;NA;241648;1718;2022-01-27;159704
2022-01-26;"Nitriansky kraj";1392;4444;306;4750;NA;241648;1698;2022-01-26;157986
2022-01-25;"Nitriansky kraj";1591;4624;426;5050;NA;241648;2017;2022-01-25;156288
2022-01-24;"Nitriansky kraj";770;7459;359;7818;NA;241648;1129;2022-01-24;154271
2022-01-23;"Nitriansky kraj";327;3109;205;3314;NA;241648;532;2022-01-23;153142
2022-01-22;"Nitriansky kraj";596;1974;153;2127;NA;241648;749;2022-01-22;152610
2022-01-21;"Nitriansky kraj";532;3472;141;3613;NA;241648;673;2022-01-21;151861
2022-01-20;"Nitriansky kraj";737;3537;129;3666;NA;241648;866;2022-01-20;151188
2022-01-19;"Nitriansky kraj";614;4581;121;4702;NA;241648;735;2022-01-19;150322
2022-01-18;"Nitriansky kraj";650;3329;125;3454;NA;241648;775;2022-01-18;149587
2022-01-17;"Nitriansky kraj";439;7781;152;7933;NA;241648;591;2022-01-17;148812
2022-01-16;"Nitriansky kraj";140;3191;71;3262;NA;241648;211;2022-01-16;148221
2022-01-15;"Nitriansky kraj";268;1651;50;1701;NA;241648;318;2022-01-15;148010
2022-01-14;"Nitriansky kraj";167;2900;68;2968;NA;241648;235;2022-01-14;147692
2022-01-13;"Nitriansky kraj";244;3297;53;3350;NA;241648;297;2022-01-13;147457
2022-01-12;"Nitriansky kraj";298;4325;66;4391;NA;241648;364;2022-01-12;147160
2022-01-11;"Nitriansky kraj";424;3990;50;4040;NA;241648;474;2022-01-11;146796
2022-01-10;"Nitriansky kraj";292;7648;71;7719;NA;241648;363;2022-01-10;146322
2022-01-09;"Nitriansky kraj";100;3419;48;3467;NA;241648;148;2022-01-09;145959
2022-01-08;"Nitriansky kraj";206;1352;47;1399;NA;241648;253;2022-01-08;145811
2022-01-07;"Nitriansky kraj";326;2970;74;3044;NA;241648;400;2022-01-07;145558
2022-01-06;"Nitriansky kraj";125;910;33;943;NA;241648;158;2022-01-06;145158
2022-01-05;"Nitriansky kraj";357;4227;66;4293;NA;241648;423;2022-01-05;145000
2022-01-04;"Nitriansky kraj";453;3697;85;3782;NA;241648;538;2022-01-04;144577
2022-01-03;"Nitriansky kraj";353;7361;117;7478;NA;241648;470;2022-01-03;144039
2022-01-02;"Nitriansky kraj";25;3035;95;3130;NA;241648;120;2022-01-02;143569
2022-01-01;"Nitriansky kraj";71;177;9;186;NA;241648;80;2022-01-01;143449
2021-12-31;"Nitriansky kraj";382;1506;69;1575;NA;241648;451;2021-12-31;143369
2021-12-30;"Nitriansky kraj";325;3330;89;3419;NA;241648;414;2021-12-30;142918
2021-12-29;"Nitriansky kraj";347;2371;61;2432;NA;241648;408;2021-12-29;142504
2021-12-28;"Nitriansky kraj";628;2501;88;2589;NA;241648;716;2021-12-28;142096
2021-12-27;"Nitriansky kraj";402;4253;169;4422;NA;241648;571;2021-12-27;141380
2021-12-26;"Nitriansky kraj";84;1039;53;1092;NA;241648;137;2021-12-26;140809
2021-12-25;"Nitriansky kraj";22;499;31;530;NA;241648;53;2021-12-25;140672
2021-12-24;"Nitriansky kraj";175;448;26;474;NA;241648;201;2021-12-24;140619
2021-12-23;"Nitriansky kraj";472;3420;110;3530;NA;241648;582;2021-12-23;140418
2021-12-22;"Nitriansky kraj";398;3517;95;3612;NA;241648;493;2021-12-22;139836
2021-12-21;"Nitriansky kraj";735;2913;93;3006;NA;241648;828;2021-12-21;139343
2021-12-20;"Nitriansky kraj";407;6754;169;6923;NA;241648;576;2021-12-20;138515
2021-12-19;"Nitriansky kraj";198;3587;98;3685;NA;241648;296;2021-12-19;137939
2021-12-18;"Nitriansky kraj";361;1456;96;1552;NA;241648;457;2021-12-18;137643
2021-12-17;"Nitriansky kraj";409;4934;153;5087;NA;241648;562;2021-12-17;137186
2021-12-16;"Nitriansky kraj";429;4230;144;4374;NA;241648;573;2021-12-16;136624
2021-12-15;"Nitriansky kraj";639;5682;143;5825;NA;241648;782;2021-12-15;136051
2021-12-14;"Nitriansky kraj";907;4720;200;4920;NA;241648;1107;2021-12-14;135269
2021-12-13;"Nitriansky kraj";524;7388;291;7679;NA;241648;815;2021-12-13;134162
2021-12-12;"Nitriansky kraj";289;3893;174;4067;NA;241648;463;2021-12-12;133347
2021-12-11;"Nitriansky kraj";458;1754;121;1875;NA;241648;579;2021-12-11;132884
2021-12-10;"Nitriansky kraj";591;4868;177;5045;NA;241648;768;2021-12-10;132305
2021-12-09;"Nitriansky kraj";741;3428;202;3630;NA;241648;943;2021-12-09;131537
2021-12-08;"Nitriansky kraj";954;5136;200;5336;NA;241648;1154;2021-12-08;130594
2021-12-07;"Nitriansky kraj";900;4045;197;4242;NA;241648;1097;2021-12-07;129440
2021-12-06;"Nitriansky kraj";699;8196;339;8535;NA;241648;1038;2021-12-06;128343
2021-12-05;"Nitriansky kraj";337;4314;192;4506;NA;241648;529;2021-12-05;127305
2021-12-04;"Nitriansky kraj";758;2045;180;2225;NA;241648;938;2021-12-04;126776
2021-12-03;"Nitriansky kraj";920;5783;237;6020;NA;241648;1157;2021-12-03;125838
2021-12-02;"Nitriansky kraj";1388;3898;267;4165;NA;241648;1655;2021-12-02;124681
2021-12-01;"Nitriansky kraj";982;4107;261;4368;NA;241648;1243;2021-12-01;123026
2021-11-30;"Nitriansky kraj";751;5575;241;5816;NA;241648;992;2021-11-30;121783
2021-11-29;"Nitriansky kraj";665;10153;499;10652;NA;241648;1164;2021-11-29;120791
2021-11-28;"Nitriansky kraj";357;6214;300;6514;NA;241648;657;2021-11-28;119627
2021-11-27;"Nitriansky kraj";560;2879;281;3160;NA;241648;841;2021-11-27;118970
2021-11-26;"Nitriansky kraj";824;5529;290;5819;NA;241648;1114;2021-11-26;118129
2021-11-25;"Nitriansky kraj";847;4154;342;4496;NA;241648;1189;2021-11-25;117015
2021-11-24;"Nitriansky kraj";875;4422;325;4747;NA;241648;1200;2021-11-24;115826
2021-11-23;"Nitriansky kraj";1103;5148;353;5501;NA;241648;1456;2021-11-23;114626
2021-11-22;"Nitriansky kraj";545;7105;465;7570;NA;241648;1010;2021-11-22;113170
2021-11-21;"Nitriansky kraj";345;3410;314;3724;NA;241648;659;2021-11-21;112160
2021-11-20;"Nitriansky kraj";579;1865;252;2117;NA;241648;831;2021-11-20;111501
2021-11-19;"Nitriansky kraj";571;4256;349;4605;NA;241648;920;2021-11-19;110670
2021-11-18;"Nitriansky kraj";677;4883;420;5303;NA;241648;1097;2021-11-18;109750
2021-11-17;"Nitriansky kraj";479;1622;207;1829;NA;241648;686;2021-11-17;108653
2021-11-16;"Nitriansky kraj";668;3882;266;4148;NA;241648;934;2021-11-16;107967
2021-11-15;"Nitriansky kraj";556;6033;440;6473;NA;241648;996;2021-11-15;107033
2021-11-14;"Nitriansky kraj";229;2796;259;3055;NA;241648;488;2021-11-14;106037
2021-11-13;"Nitriansky kraj";387;1473;201;1674;NA;241648;588;2021-11-13;105549
2021-11-12;"Nitriansky kraj";552;3096;270;3366;NA;241648;822;2021-11-12;104961
2021-11-11;"Nitriansky kraj";539;3545;238;3783;NA;241648;777;2021-11-11;104139
2021-11-10;"Nitriansky kraj";411;3494;234;3728;NA;241648;645;2021-11-10;103362
2021-11-09;"Nitriansky kraj";413;3313;210;3523;NA;241648;623;2021-11-09;102717
2021-11-08;"Nitriansky kraj";464;4936;331;5267;NA;241648;795;2021-11-08;102094
2021-11-07;"Nitriansky kraj";209;2074;161;2235;NA;241648;370;2021-11-07;101299
2021-11-06;"Nitriansky kraj";236;1407;114;1521;NA;241648;350;2021-11-06;100929
2021-11-05;"Nitriansky kraj";407;2583;185;2768;NA;241648;592;2021-11-05;100579
2021-11-04;"Nitriansky kraj";437;3083;168;3251;NA;241648;605;2021-11-04;99987
2021-11-03;"Nitriansky kraj";525;2891;157;3048;NA;241648;682;2021-11-03;99382
2021-11-02;"Nitriansky kraj";320;4279;239;4518;NA;241648;559;2021-11-02;98700
2021-11-01;"Nitriansky kraj";136;712;61;773;NA;241648;197;2021-11-01;98141
2021-10-31;"Nitriansky kraj";109;1234;114;1348;NA;241648;223;2021-10-31;97944
2021-10-30;"Nitriansky kraj";202;1218;82;1300;NA;241648;284;2021-10-30;97721
2021-10-29;"Nitriansky kraj";347;2481;120;2601;NA;241648;467;2021-10-29;97437
2021-10-28;"Nitriansky kraj";281;2603;95;2698;NA;241648;376;2021-10-28;96970
2021-10-27;"Nitriansky kraj";340;2923;112;3035;NA;241648;452;2021-10-27;96594
2021-10-26;"Nitriansky kraj";297;2926;117;3043;NA;241648;414;2021-10-26;96142
2021-10-25;"Nitriansky kraj";171;3599;124;3723;NA;241648;295;2021-10-25;95728
2021-10-24;"Nitriansky kraj";58;1914;74;1988;NA;241648;132;2021-10-24;95433
2021-10-23;"Nitriansky kraj";173;1815;77;1892;NA;241648;250;2021-10-23;95301
2021-10-22;"Nitriansky kraj";202;2216;68;2284;NA;241648;270;2021-10-22;95051
2021-10-21;"Nitriansky kraj";214;2793;65;2858;NA;241648;279;2021-10-21;94781
2021-10-20;"Nitriansky kraj";218;2328;74;2402;NA;241648;292;2021-10-20;94502
2021-10-19;"Nitriansky kraj";250;2929;65;2994;NA;241648;315;2021-10-19;94210
2021-10-18;"Nitriansky kraj";81;3259;90;3349;NA;241648;171;2021-10-18;93895
2021-10-17;"Nitriansky kraj";36;3010;92;3102;NA;241648;128;2021-10-17;93724
2021-10-16;"Nitriansky kraj";37;1477;38;1515;NA;241648;75;2021-10-16;93596
2021-10-15;"Nitriansky kraj";145;2653;34;2687;NA;241648;179;2021-10-15;93521
2021-10-14;"Nitriansky kraj";95;2389;30;2419;NA;241648;125;2021-10-14;93342
2021-10-13;"Nitriansky kraj";91;2248;36;2284;NA;241648;127;2021-10-13;93217
2021-10-12;"Nitriansky kraj";119;2905;34;2939;NA;241648;153;2021-10-12;93090
2021-10-11;"Nitriansky kraj";91;2703;42;2745;NA;241648;133;2021-10-11;92937
2021-10-10;"Nitriansky kraj";33;1527;22;1549;NA;241648;55;2021-10-10;92804
2021-10-09;"Nitriansky kraj";17;1395;17;1412;NA;241648;34;2021-10-09;92749
2021-10-08;"Nitriansky kraj";61;3004;37;3041;NA;241648;98;2021-10-08;92715
2021-10-07;"Nitriansky kraj";59;2829;30;2859;NA;241648;89;2021-10-07;92617
2021-10-06;"Nitriansky kraj";66;2657;28;2685;NA;241648;94;2021-10-06;92528
2021-10-05;"Nitriansky kraj";97;2536;32;2568;NA;241648;129;2021-10-05;92434
2021-10-04;"Nitriansky kraj";56;3263;49;3312;NA;241648;105;2021-10-04;92305
2021-10-03;"Nitriansky kraj";10;1591;24;1615;NA;241648;34;2021-10-03;92200
2021-10-02;"Nitriansky kraj";46;1567;20;1587;NA;241648;66;2021-10-02;92166
2021-10-01;"Nitriansky kraj";26;2860;34;2894;NA;241648;60;2021-10-01;92100
2021-09-30;"Nitriansky kraj";66;2468;15;2483;NA;241648;81;2021-09-30;92040
2021-09-29;"Nitriansky kraj";92;2266;16;2282;NA;241648;108;2021-09-29;91959
2021-09-28;"Nitriansky kraj";86;2893;27;2920;NA;241648;113;2021-09-28;91851
2021-09-27;"Nitriansky kraj";50;3633;41;3674;NA;241648;91;2021-09-27;91738
2021-09-26;"Nitriansky kraj";12;1635;20;1655;NA;241648;32;2021-09-26;91647
2021-09-25;"Nitriansky kraj";43;1456;20;1476;NA;241648;63;2021-09-25;91615
2021-09-24;"Nitriansky kraj";35;2783;15;2798;NA;241648;50;2021-09-24;91552
2021-09-23;"Nitriansky kraj";69;2503;20;2523;NA;241648;89;2021-09-23;91502
2021-09-22;"Nitriansky kraj";68;2380;17;2397;NA;241648;85;2021-09-22;91413
2021-09-21;"Nitriansky kraj";70;2684;30;2714;NA;241648;100;2021-09-21;91328
2021-09-20;"Nitriansky kraj";41;2497;21;2518;NA;241648;62;2021-09-20;91228
2021-09-19;"Nitriansky kraj";16;1553;20;1573;NA;241648;36;2021-09-19;91166
2021-09-18;"Nitriansky kraj";42;1421;19;1440;NA;241648;61;2021-09-18;91130
2021-09-17;"Nitriansky kraj";54;2757;30;2787;NA;241648;84;2021-09-17;91069
2021-09-16;"Nitriansky kraj";55;2499;44;2543;NA;241648;99;2021-09-16;90985
2021-09-15;"Nitriansky kraj";34;538;12;550;NA;241648;46;2021-09-15;90886
2021-09-14;"Nitriansky kraj";52;1821;20;1841;NA;241648;72;2021-09-14;90840
2021-09-13;"Nitriansky kraj";27;2373;27;2400;NA;241648;54;2021-09-13;90768
2021-09-12;"Nitriansky kraj";4;1182;17;1199;NA;241648;21;2021-09-12;90714
2021-09-11;"Nitriansky kraj";36;1181;8;1189;NA;241648;44;2021-09-11;90693
2021-09-10;"Nitriansky kraj";25;2133;12;2145;NA;241648;37;2021-09-10;90649
2021-09-09;"Nitriansky kraj";15;1611;20;1631;NA;241648;35;2021-09-09;90612
2021-09-08;"Nitriansky kraj";30;1463;22;1485;NA;241648;52;2021-09-08;90577
2021-09-07;"Nitriansky kraj";35;1460;9;1469;NA;241648;44;2021-09-07;90525
2021-09-06;"Nitriansky kraj";19;1668;27;1695;NA;241648;46;2021-09-06;90481
2021-09-05;"Nitriansky kraj";10;1007;8;1015;NA;241648;18;2021-09-05;90435
2021-09-04;"Nitriansky kraj";18;1119;10;1129;NA;241648;28;2021-09-04;90417
2021-09-03;"Nitriansky kraj";20;1743;17;1760;NA;241648;37;2021-09-03;90389
2021-09-02;"Nitriansky kraj";16;1389;14;1403;NA;241648;30;2021-09-02;90352
2021-09-01;"Nitriansky kraj";9;337;2;339;NA;241648;11;2021-09-01;90322
2021-08-31;"Nitriansky kraj";10;1360;6;1366;NA;241648;16;2021-08-31;90311
2021-08-30;"Nitriansky kraj";8;1381;10;1391;NA;241648;18;2021-08-30;90295
2021-08-29;"Nitriansky kraj";2;450;1;451;NA;241648;3;2021-08-29;90277
2021-08-28;"Nitriansky kraj";5;1071;3;1074;NA;241648;8;2021-08-28;90274
2021-08-27;"Nitriansky kraj";7;1804;4;1808;NA;241648;11;2021-08-27;90266
2021-08-26;"Nitriansky kraj";2;1255;6;1261;NA;241648;8;2021-08-26;90255
2021-08-25;"Nitriansky kraj";15;1087;3;1090;NA;241648;18;2021-08-25;90247
2021-08-24;"Nitriansky kraj";6;990;2;992;NA;241648;8;2021-08-24;90229
2021-08-23;"Nitriansky kraj";13;1271;4;1275;NA;241648;17;2021-08-23;90221
2021-08-22;"Nitriansky kraj";0;1167;3;1170;NA;241648;3;2021-08-22;90204
2021-08-21;"Nitriansky kraj";1;853;2;855;NA;241648;3;2021-08-21;90201
2021-08-20;"Nitriansky kraj";8;1580;5;1585;NA;241648;13;2021-08-20;90198
2021-08-19;"Nitriansky kraj";11;1167;4;1171;NA;241648;15;2021-08-19;90185
2021-08-18;"Nitriansky kraj";8;1180;7;1187;NA;241648;15;2021-08-18;90170
2021-08-17;"Nitriansky kraj";4;1035;3;1038;NA;241648;7;2021-08-17;90155
2021-08-16;"Nitriansky kraj";7;1129;4;1133;NA;241648;11;2021-08-16;90148
2021-08-15;"Nitriansky kraj";2;662;1;663;NA;241648;3;2021-08-15;90137
2021-08-14;"Nitriansky kraj";1;878;5;883;NA;241648;6;2021-08-14;90134
2021-08-13;"Nitriansky kraj";0;957;1;958;NA;241648;1;2021-08-13;90128
2021-08-12;"Nitriansky kraj";5;765;0;765;NA;241648;5;2021-08-12;90127
2021-08-11;"Nitriansky kraj";3;527;1;528;NA;241648;4;2021-08-11;90122
2021-08-10;"Nitriansky kraj";3;570;1;571;NA;241648;4;2021-08-10;90118
2021-08-09;"Nitriansky kraj";3;992;1;993;NA;241648;4;2021-08-09;90114
2021-08-08;"Nitriansky kraj";0;668;1;669;NA;241648;1;2021-08-08;90110
2021-08-07;"Nitriansky kraj";0;557;1;558;NA;241648;1;2021-08-07;90109
2021-08-06;"Nitriansky kraj";5;799;0;799;NA;241648;5;2021-08-06;90108
2021-08-05;"Nitriansky kraj";6;612;0;612;NA;241648;6;2021-08-05;90103
2021-08-04;"Nitriansky kraj";1;497;2;499;NA;241648;3;2021-08-04;90097
2021-08-03;"Nitriansky kraj";5;1455;0;1455;NA;241648;5;2021-08-03;90094
2021-08-02;"Nitriansky kraj";1;683;4;687;NA;241648;5;2021-08-02;90089
2021-08-01;"Nitriansky kraj";1;606;0;606;NA;241648;1;2021-08-01;90084
2021-07-31;"Nitriansky kraj";1;514;1;515;NA;241648;2;2021-07-31;90083
2021-07-30;"Nitriansky kraj";2;827;0;827;NA;241648;2;2021-07-30;90081
2021-07-29;"Nitriansky kraj";3;720;2;722;NA;241648;5;2021-07-29;90079
2021-07-28;"Nitriansky kraj";4;598;0;598;NA;241648;4;2021-07-28;90074
2021-07-27;"Nitriansky kraj";12;602;1;603;NA;241648;13;2021-07-27;90070
2021-07-26;"Nitriansky kraj";7;970;1;971;NA;241648;8;2021-07-26;90057
2021-07-25;"Nitriansky kraj";1;654;1;655;NA;241648;2;2021-07-25;90049
2021-07-24;"Nitriansky kraj";0;620;0;620;NA;241648;0;2021-07-24;90047
2021-07-23;"Nitriansky kraj";3;851;1;852;NA;241648;4;2021-07-23;90047
2021-07-22;"Nitriansky kraj";5;689;0;689;NA;241648;5;2021-07-22;90043
2021-07-21;"Nitriansky kraj";6;650;2;652;NA;241648;8;2021-07-21;90038
2021-07-20;"Nitriansky kraj";1;527;1;528;NA;241648;2;2021-07-20;90030
2021-07-19;"Nitriansky kraj";2;965;0;965;NA;241648;2;2021-07-19;90028
2021-07-18;"Nitriansky kraj";1;747;0;747;NA;241648;1;2021-07-18;90026
2021-07-17;"Nitriansky kraj";5;612;0;612;NA;241648;5;2021-07-17;90025
2021-07-16;"Nitriansky kraj";2;876;0;876;NA;241648;2;2021-07-16;90020
2021-07-15;"Nitriansky kraj";11;708;0;708;NA;241648;11;2021-07-15;90018
2021-07-14;"Nitriansky kraj";4;646;0;646;NA;241648;4;2021-07-14;90007
2021-07-13;"Nitriansky kraj";2;697;2;699;NA;241648;4;2021-07-13;90003
2021-07-12;"Nitriansky kraj";1;819;0;819;NA;241648;1;2021-07-12;89999
2021-07-11;"Nitriansky kraj";1;961;0;961;NA;241648;1;2021-07-11;89998
2021-07-10;"Nitriansky kraj";1;630;0;630;NA;241648;1;2021-07-10;89997
2021-07-09;"Nitriansky kraj";3;1000;0;1000;NA;241648;3;2021-07-09;89996
2021-07-08;"Nitriansky kraj";0;683;0;683;NA;241648;0;2021-07-08;89993
2021-07-07;"Nitriansky kraj";2;935;2;937;NA;241648;4;2021-07-07;89993
2021-07-06;"Nitriansky kraj";1;1269;1;1270;NA;241648;2;2021-07-06;89989
2021-07-05;"Nitriansky kraj";1;507;0;507;NA;241648;1;2021-07-05;89987
2021-07-04;"Nitriansky kraj";0;821;1;822;NA;241648;1;2021-07-04;89986
2021-07-03;"Nitriansky kraj";0;611;0;611;NA;241648;0;2021-07-03;89985
2021-07-02;"Nitriansky kraj";0;1259;0;1259;NA;241648;0;2021-07-02;89985
2021-07-01;"Nitriansky kraj";0;369;1;370;NA;241648;1;2021-07-01;89985
2021-06-30;"Nitriansky kraj";1;6777;2;6779;NA;241648;3;2021-06-30;89984
2021-06-29;"Nitriansky kraj";1;3536;0;3536;NA;241648;1;2021-06-29;89981
2021-06-28;"Nitriansky kraj";3;4393;0;4393;NA;241648;3;2021-06-28;89980
2021-06-27;"Nitriansky kraj";0;3263;0;3263;NA;241648;0;2021-06-27;89977
2021-06-26;"Nitriansky kraj";1;4979;3;4982;NA;241648;4;2021-06-26;89977
2021-06-25;"Nitriansky kraj";8;5182;1;5183;NA;241648;9;2021-06-25;89973
2021-06-24;"Nitriansky kraj";1;3354;0;3354;NA;241648;1;2021-06-24;89964
2021-06-23;"Nitriansky kraj";1;3033;0;3033;NA;241648;1;2021-06-23;89963
2021-06-22;"Nitriansky kraj";1;3240;3;3243;NA;241648;4;2021-06-22;89962
2021-06-21;"Nitriansky kraj";8;5362;8;5370;NA;241648;16;2021-06-21;89958
2021-06-20;"Nitriansky kraj";0;4437;6;4443;NA;241648;6;2021-06-20;89942
2021-06-19;"Nitriansky kraj";0;5983;4;5987;NA;241648;4;2021-06-19;89936
2021-06-18;"Nitriansky kraj";4;6453;3;6456;NA;241648;7;2021-06-18;89932
2021-06-17;"Nitriansky kraj";5;4152;1;4153;NA;241648;6;2021-06-17;89925
2021-06-16;"Nitriansky kraj";4;3694;3;3697;NA;241648;7;2021-06-16;89919
2021-06-15;"Nitriansky kraj";1;3995;0;3995;NA;241648;1;2021-06-15;89912
2021-06-14;"Nitriansky kraj";0;5875;3;5878;NA;241648;3;2021-06-14;89911
2021-06-13;"Nitriansky kraj";0;6073;3;6076;NA;241648;3;2021-06-13;89908
2021-06-12;"Nitriansky kraj";1;8293;1;8294;NA;241648;2;2021-06-12;89905
2021-06-11;"Nitriansky kraj";3;6891;4;6895;NA;241648;7;2021-06-11;89903
2021-06-10;"Nitriansky kraj";7;4539;1;4540;NA;241648;8;2021-06-10;89896
2021-06-09;"Nitriansky kraj";2;4706;2;4708;NA;241648;4;2021-06-09;89888
2021-06-08;"Nitriansky kraj";8;4239;3;4242;NA;241648;11;2021-06-08;89884
2021-06-07;"Nitriansky kraj";6;5841;8;5849;NA;241648;14;2021-06-07;89873
2021-06-06;"Nitriansky kraj";0;6981;4;6985;NA;241648;4;2021-06-06;89859
2021-06-05;"Nitriansky kraj";6;9089;9;9098;NA;241648;15;2021-06-05;89855
2021-06-04;"Nitriansky kraj";9;7639;5;7644;NA;241648;14;2021-06-04;89840
2021-06-03;"Nitriansky kraj";2;5064;6;5070;NA;241648;8;2021-06-03;89826
2021-06-02;"Nitriansky kraj";11;5119;11;5130;NA;241648;22;2021-06-02;89818
2021-06-01;"Nitriansky kraj";3;4847;2;4849;NA;241648;5;2021-06-01;89796
2021-05-31;"Nitriansky kraj";8;8933;8;8941;NA;241648;16;2021-05-31;89791
2021-05-30;"Nitriansky kraj";1;9067;8;9075;NA;241648;9;2021-05-30;89775
2021-05-29;"Nitriansky kraj";2;13610;7;13617;NA;241648;9;2021-05-29;89766
2021-05-28;"Nitriansky kraj";10;8872;6;8878;NA;241648;16;2021-05-28;89757
2021-05-27;"Nitriansky kraj";4;6164;5;6169;NA;241648;9;2021-05-27;89741
2021-05-26;"Nitriansky kraj";11;8509;10;8519;NA;241648;21;2021-05-26;89732
2021-05-25;"Nitriansky kraj";15;7350;8;7358;NA;241648;23;2021-05-25;89711
2021-05-24;"Nitriansky kraj";14;9816;17;9833;NA;241648;31;2021-05-24;89688
2021-05-23;"Nitriansky kraj";1;9456;13;9469;NA;241648;14;2021-05-23;89657
2021-05-22;"Nitriansky kraj";7;16939;11;16950;NA;241648;18;2021-05-22;89643
2021-05-21;"Nitriansky kraj";18;10632;15;10647;NA;241648;33;2021-05-21;89625
2021-05-20;"Nitriansky kraj";8;7185;7;7192;NA;241648;15;2021-05-20;89592
2021-05-19;"Nitriansky kraj";20;6787;14;6801;NA;241648;34;2021-05-19;89577
2021-05-18;"Nitriansky kraj";23;7797;18;7815;NA;241648;41;2021-05-18;89543
2021-05-17;"Nitriansky kraj";22;9774;20;9794;NA;241648;42;2021-05-17;89502
2021-05-16;"Nitriansky kraj";4;13830;15;13845;NA;241648;19;2021-05-16;89460
2021-05-15;"Nitriansky kraj";5;25389;23;25412;NA;241648;28;2021-05-15;89441
2021-05-14;"Nitriansky kraj";18;13385;23;13408;NA;241648;41;2021-05-14;89413
2021-05-13;"Nitriansky kraj";24;8289;19;8308;NA;241648;43;2021-05-13;89372
2021-05-12;"Nitriansky kraj";10;7682;26;7708;NA;241648;36;2021-05-12;89329
2021-05-11;"Nitriansky kraj";36;8169;13;8182;NA;241648;49;2021-05-11;89293
2021-05-10;"Nitriansky kraj";16;13800;42;13842;NA;241648;58;2021-05-10;89244
2021-05-09;"Nitriansky kraj";8;21879;35;21914;NA;241648;43;2021-05-09;89186
2021-05-08;"Nitriansky kraj";0;24318;29;24347;NA;241648;29;2021-05-08;89143
2021-05-07;"Nitriansky kraj";32;14915;20;14935;NA;241648;52;2021-05-07;89114
2021-05-06;"Nitriansky kraj";30;9463;20;9483;NA;241648;50;2021-05-06;89062
2021-05-05;"Nitriansky kraj";19;8527;23;8550;NA;241648;42;2021-05-05;89012
2021-05-04;"Nitriansky kraj";46;9385;27;9412;NA;241648;73;2021-05-04;88970
2021-05-03;"Nitriansky kraj";32;14490;44;14534;NA;241648;76;2021-05-03;88897
2021-05-02;"Nitriansky kraj";4;31751;46;31797;NA;241648;50;2021-05-02;88821
2021-05-01;"Nitriansky kraj";23;60451;43;60494;NA;241648;66;2021-05-01;88771
2021-04-30;"Nitriansky kraj";28;31803;53;31856;NA;241648;81;2021-04-30;88705
2021-04-29;"Nitriansky kraj";27;14265;34;14299;NA;241648;61;2021-04-29;88624
2021-04-28;"Nitriansky kraj";36;14716;45;14761;NA;241648;81;2021-04-28;88563
2021-04-27;"Nitriansky kraj";51;13154;35;13189;NA;241648;86;2021-04-27;88482
2021-04-26;"Nitriansky kraj";38;21029;44;21073;NA;241648;82;2021-04-26;88396
2021-04-25;"Nitriansky kraj";7;44312;46;44358;NA;241648;53;2021-04-25;88314
2021-04-24;"Nitriansky kraj";23;93455;72;93527;NA;241648;95;2021-04-24;88261
2021-04-23;"Nitriansky kraj";54;35145;51;35196;NA;241648;105;2021-04-23;88166
2021-04-22;"Nitriansky kraj";32;15435;44;15479;NA;241648;76;2021-04-22;88061
2021-04-21;"Nitriansky kraj";38;14228;45;14273;NA;241648;83;2021-04-21;87985
2021-04-20;"Nitriansky kraj";67;16058;51;16109;NA;241648;118;2021-04-20;87902
2021-04-19;"Nitriansky kraj";35;24819;59;24878;NA;241648;94;2021-04-19;87784
2021-04-18;"Nitriansky kraj";0;39569;27;39596;NA;241648;27;2021-04-18;87690
2021-04-17;"Nitriansky kraj";34;92102;82;92184;NA;241648;116;2021-04-17;87663
2021-04-16;"Nitriansky kraj";46;32348;37;32385;NA;241648;83;2021-04-16;87547
2021-04-15;"Nitriansky kraj";75;16215;52;16267;NA;241648;127;2021-04-15;87464
2021-04-14;"Nitriansky kraj";43;15303;42;15345;NA;241648;85;2021-04-14;87337
2021-04-13;"Nitriansky kraj";110;15104;44;15148;NA;241648;154;2021-04-13;87252
2021-04-12;"Nitriansky kraj";29;22817;50;22867;NA;241648;79;2021-04-12;87098
2021-04-11;"Nitriansky kraj";1;37537;31;37568;NA;241648;32;2021-04-11;87019
2021-04-10;"Nitriansky kraj";35;95851;115;95966;NA;241648;150;2021-04-10;86987
2021-04-09;"Nitriansky kraj";69;30669;58;30727;NA;241648;127;2021-04-09;86837
2021-04-08;"Nitriansky kraj";71;15361;36;15397;NA;241648;107;2021-04-08;86710
2021-04-07;"Nitriansky kraj";64;18541;47;18588;NA;241648;111;2021-04-07;86603
2021-04-06;"Nitriansky kraj";65;33218;112;33330;NA;241648;177;2021-04-06;86492
2021-04-05;"Nitriansky kraj";37;12673;48;12721;NA;241648;85;2021-04-05;86315
2021-04-04;"Nitriansky kraj";5;17887;35;17922;NA;241648;40;2021-04-04;86230
2021-04-03;"Nitriansky kraj";26;85465;153;85618;NA;241648;179;2021-04-03;86190
2021-04-02;"Nitriansky kraj";32;18743;46;18789;NA;241648;78;2021-04-02;86011
2021-04-01;"Nitriansky kraj";63;24610;83;24693;NA;241648;146;2021-04-01;85933
2021-03-31;"Nitriansky kraj";73;21752;94;21846;NA;241648;167;2021-03-31;85787
2021-03-30;"Nitriansky kraj";125;17122;83;17205;NA;241648;208;2021-03-30;85620
2021-03-29;"Nitriansky kraj";81;25139;100;25239;NA;241648;181;2021-03-29;85412
2021-03-28;"Nitriansky kraj";6;45581;106;45687;NA;241648;112;2021-03-28;85231
2021-03-27;"Nitriansky kraj";39;104104;174;104278;NA;241648;213;2021-03-27;85119
2021-03-26;"Nitriansky kraj";90;40444;115;40559;NA;241648;205;2021-03-26;84906
2021-03-25;"Nitriansky kraj";95;19219;94;19313;NA;241648;189;2021-03-25;84701
2021-03-24;"Nitriansky kraj";90;14787;91;14878;NA;241648;181;2021-03-24;84512
2021-03-23;"Nitriansky kraj";167;16753;66;16819;NA;241648;233;2021-03-23;84331
2021-03-22;"Nitriansky kraj";101;24886;125;25011;NA;241648;226;2021-03-22;84098
2021-03-21;"Nitriansky kraj";27;42773;99;42872;NA;241648;126;2021-03-21;83872
2021-03-20;"Nitriansky kraj";36;100640;207;100847;NA;241648;243;2021-03-20;83746
2021-03-19;"Nitriansky kraj";76;37312;102;37414;NA;241648;178;2021-03-19;83503
2021-03-18;"Nitriansky kraj";103;20051;113;20164;NA;241648;216;2021-03-18;83325
2021-03-17;"Nitriansky kraj";87;15839;127;15966;NA;241648;214;2021-03-17;83109
2021-03-16;"Nitriansky kraj";172;18085;121;18206;NA;241648;293;2021-03-16;82895
2021-03-15;"Nitriansky kraj";130;24481;165;24646;NA;241648;295;2021-03-15;82602
2021-03-14;"Nitriansky kraj";3;45770;107;45877;NA;241648;110;2021-03-14;82307
2021-03-13;"Nitriansky kraj";65;112573;242;112815;NA;241648;307;2021-03-13;82197
2021-03-12;"Nitriansky kraj";127;40777;159;40936;NA;241648;286;2021-03-12;81890
2021-03-11;"Nitriansky kraj";131;18686;130;18816;NA;241648;261;2021-03-11;81604
2021-03-10;"Nitriansky kraj";96;17422;143;17565;NA;241648;239;2021-03-10;81343
2021-03-09;"Nitriansky kraj";260;17635;149;17784;NA;241648;409;2021-03-09;81104
2021-03-08;"Nitriansky kraj";145;27214;172;27386;NA;241648;317;2021-03-08;80695
2021-03-07;"Nitriansky kraj";48;46867;185;47052;NA;241648;233;2021-03-07;80378
2021-03-06;"Nitriansky kraj";86;112027;327;112354;NA;241648;413;2021-03-06;80145
2021-03-05;"Nitriansky kraj";133;39068;200;39268;NA;241648;333;2021-03-05;79732
2021-03-04;"Nitriansky kraj";176;18340;173;18513;NA;241648;349;2021-03-04;79399
2021-03-03;"Nitriansky kraj";172;17210;177;17387;NA;241648;349;2021-03-03;79050
2021-03-02;"Nitriansky kraj";274;21003;366;21369;NA;241648;640;2021-03-02;78701
2021-03-01;"Nitriansky kraj";133;27881;279;28160;NA;241648;412;2021-03-01;78061
2021-02-28;"Nitriansky kraj";80;40866;218;41084;NA;241648;298;2021-02-28;77649
2021-02-27;"Nitriansky kraj";101;106352;496;106848;NA;241648;597;2021-02-27;77351
2021-02-26;"Nitriansky kraj";109;36788;308;37096;NA;241648;417;2021-02-26;76754
2021-02-25;"Nitriansky kraj";188;15243;212;15455;NA;241648;400;2021-02-25;76337
2021-02-24;"Nitriansky kraj";125;13833;260;14093;NA;241648;385;2021-02-24;75937
2021-02-23;"Nitriansky kraj";273;15402;273;15675;NA;241648;546;2021-02-23;75552
2021-02-22;"Nitriansky kraj";154;26478;330;26808;NA;241648;484;2021-02-22;75006
2021-02-21;"Nitriansky kraj";22;43664;320;43984;NA;241648;342;2021-02-21;74522
2021-02-20;"Nitriansky kraj";128;109038;586;109624;NA;241648;714;2021-02-20;74180
2021-02-19;"Nitriansky kraj";173;36849;328;37177;NA;241648;501;2021-02-19;73466
2021-02-18;"Nitriansky kraj";202;17045;275;17320;NA;241648;477;2021-02-18;72965
2021-02-17;"Nitriansky kraj";198;12080;310;12390;NA;241648;508;2021-02-17;72488
2021-02-16;"Nitriansky kraj";284;16066;288;16354;NA;241648;572;2021-02-16;71980
2021-02-15;"Nitriansky kraj";122;28636;474;29110;NA;241648;596;2021-02-15;71408
2021-02-14;"Nitriansky kraj";8;49392;315;49707;NA;241648;323;2021-02-14;70812
2021-02-13;"Nitriansky kraj";127;110294;690;110984;NA;241648;817;2021-02-13;70489
2021-02-12;"Nitriansky kraj";162;33405;407;33812;NA;241648;569;2021-02-12;69672
2021-02-11;"Nitriansky kraj";195;12406;270;12676;NA;241648;465;2021-02-11;69103
2021-02-10;"Nitriansky kraj";186;17770;644;18414;NA;241648;830;2021-02-10;68638
2021-02-09;"Nitriansky kraj";260;18530;385;18915;NA;241648;645;2021-02-09;67808
2021-02-08;"Nitriansky kraj";177;37530;569;38099;NA;241648;746;2021-02-08;67163
2021-02-07;"Nitriansky kraj";20;52307;513;52820;NA;241648;533;2021-02-07;66417
2021-02-06;"Nitriansky kraj";129;101439;764;102203;NA;241648;893;2021-02-06;65884
2021-02-05;"Nitriansky kraj";244;26137;491;26628;NA;241648;735;2021-02-05;64991
2021-02-04;"Nitriansky kraj";308;15681;512;16193;NA;241648;820;2021-02-04;64256
2021-02-03;"Nitriansky kraj";191;13459;382;13841;NA;241648;573;2021-02-03;63436
2021-02-02;"Nitriansky kraj";327;17880;382;18262;NA;241648;709;2021-02-02;62863
2021-02-01;"Nitriansky kraj";221;24002;460;24462;NA;241648;681;2021-02-01;62154
2021-01-31;"Nitriansky kraj";9;46215;507;46722;NA;241648;516;2021-01-31;61473
2021-01-30;"Nitriansky kraj";152;99241;1090;100331;NA;241648;1242;2021-01-30;60957
2021-01-29;"Nitriansky kraj";302;22461;477;22938;NA;241648;779;2021-01-29;59715
2021-01-28;"Nitriansky kraj";269;11370;398;11768;NA;241648;667;2021-01-28;58936
2021-01-27;"Nitriansky kraj";235;6758;299;7057;NA;241648;534;2021-01-27;58269
2021-01-26;"Nitriansky kraj";345;16015;454;16469;NA;241648;799;2021-01-26;57735
2021-01-25;"Nitriansky kraj";201;21909;434;22343;NA;241648;635;2021-01-25;56936
2021-01-24;"Nitriansky kraj";12;79041;897;79938;NA;241648;909;2021-01-24;56301
2021-01-23;"Nitriansky kraj";277;97845;1446;99291;NA;241648;1723;2021-01-23;55392
2021-01-22;"Nitriansky kraj";139;35924;619;36543;NA;241648;758;2021-01-22;53669
2021-01-21;"Nitriansky kraj";305;14649;412;15061;NA;241648;717;2021-01-21;52911
2021-01-20;"Nitriansky kraj";326;11991;625;12616;NA;241648;951;2021-01-20;52194
2021-01-19;"Nitriansky kraj";344;11015;633;11648;NA;241648;977;2021-01-19;51243
2021-01-18;"Nitriansky kraj";367;8901;519;9420;NA;241648;886;2021-01-18;50266
2021-01-17;"Nitriansky kraj";97;15061;275;15336;NA;241648;372;2021-01-17;49380
2021-01-16;"Nitriansky kraj";64;36838;679;37517;NA;241648;743;2021-01-16;49008
2021-01-15;"Nitriansky kraj";373;15940;474;16414;NA;241648;847;2021-01-15;48265
2021-01-14;"Nitriansky kraj";627;10577;452;11029;NA;241648;1079;2021-01-14;47418
2021-01-13;"Nitriansky kraj";663;9234;484;9718;NA;241648;1147;2021-01-13;46339
2021-01-12;"Nitriansky kraj";642;8805;545;9350;NA;241648;1187;2021-01-12;45192
2021-01-11;"Nitriansky kraj";422;8347;513;8860;NA;241648;935;2021-01-11;44005
2021-01-10;"Nitriansky kraj";44;19841;730;20571;NA;241648;774;2021-01-10;43070
2021-01-09;"Nitriansky kraj";532;36823;1071;37894;NA;241648;1603;2021-01-09;42296
2021-01-08;"Nitriansky kraj";817;14001;691;14692;NA;241648;1508;2021-01-08;40693
2021-01-07;"Nitriansky kraj";438;10121;795;10916;NA;241648;1233;2021-01-07;39185
2021-01-06;"Nitriansky kraj";259;3192;197;3389;NA;241648;456;2021-01-06;37952
2021-01-05;"Nitriansky kraj";732;8918;1208;10126;NA;241648;1940;2021-01-05;37496
2021-01-04;"Nitriansky kraj";362;8375;1287;9662;NA;241648;1649;2021-01-04;35556
2021-01-03;"Nitriansky kraj";42;84;20;104;NA;241648;62;2021-01-03;33907
2021-01-02;"Nitriansky kraj";249;1090;26;1116;NA;241648;275;2021-01-02;33845
2021-01-01;"Nitriansky kraj";119;781;95;876;NA;241648;214;2021-01-01;33570
2020-12-31;"Nitriansky kraj";786;7646;962;8608;NA;241648;1748;2020-12-31;33356
2020-12-30;"Nitriansky kraj";1094;9619;1165;10784;NA;241648;2259;2020-12-30;31608
2020-12-29;"Nitriansky kraj";607;8028;1245;9273;NA;241648;1852;2020-12-29;29349
2020-12-28;"Nitriansky kraj";83;6804;1220;8024;NA;241648;1303;2020-12-28;27497
2020-12-27;"Nitriansky kraj";22;60;8;68;NA;241648;30;2020-12-27;26194
2020-12-26;"Nitriansky kraj";54;297;56;353;NA;241648;110;2020-12-26;26164
2020-12-25;"Nitriansky kraj";35;60;11;71;NA;241648;46;2020-12-25;26054
2020-12-24;"Nitriansky kraj";514;1861;176;2037;NA;241648;690;2020-12-24;26008
2020-12-23;"Nitriansky kraj";349;14679;782;15461;NA;241648;1131;2020-12-23;25318
2020-12-22;"Nitriansky kraj";673;10623;949;11572;NA;241648;1622;2020-12-22;24187
2020-12-21;"Nitriansky kraj";128;7587;931;8518;NA;241648;1059;2020-12-21;22565
2020-12-20;"Nitriansky kraj";77;50;10;60;NA;241648;87;2020-12-20;21506
2020-12-19;"Nitriansky kraj";262;2259;159;2418;NA;241648;421;2020-12-19;21419
2020-12-18;"Nitriansky kraj";512;7946;518;8464;NA;241648;1030;2020-12-18;20998
2020-12-17;"Nitriansky kraj";586;6519;486;7005;NA;241648;1072;2020-12-17;19968
2020-12-16;"Nitriansky kraj";357;8097;500;8597;NA;241648;857;2020-12-16;18896
2020-12-15;"Nitriansky kraj";461;9084;750;9834;NA;241648;1211;2020-12-15;18039
2020-12-14;"Nitriansky kraj";217;7816;797;8613;NA;241648;1014;2020-12-14;16828
2020-12-13;"Nitriansky kraj";12;69;6;75;NA;241648;18;2020-12-13;15814
2020-12-12;"Nitriansky kraj";341;1832;125;1957;NA;241648;466;2020-12-12;15796
2020-12-11;"Nitriansky kraj";409;5117;384;5501;NA;241648;793;2020-12-11;15330
2020-12-10;"Nitriansky kraj";360;5239;345;5584;NA;241648;705;2020-12-10;14537
2020-12-09;"Nitriansky kraj";362;5494;529;6023;NA;241648;891;2020-12-09;13832
2020-12-08;"Nitriansky kraj";340;8168;548;8716;NA;241648;888;2020-12-08;12941
2020-12-07;"Nitriansky kraj";139;6243;573;6816;NA;241648;712;2020-12-07;12053
2020-12-06;"Nitriansky kraj";15;89;4;93;NA;241648;19;2020-12-06;11341
2020-12-05;"Nitriansky kraj";136;1388;19;1407;NA;241648;155;2020-12-05;11322
2020-12-04;"Nitriansky kraj";232;2884;74;2958;NA;241648;306;2020-12-04;11167
2020-12-03;"Nitriansky kraj";248;2471;110;2581;NA;241648;358;2020-12-03;10861
2020-12-02;"Nitriansky kraj";252;2580;151;2731;NA;241648;403;2020-12-02;10503
2020-12-01;"Nitriansky kraj";331;2891;131;3022;NA;241648;462;2020-12-01;10100
2020-11-30;"Nitriansky kraj";91;4228;188;4416;NA;241648;279;2020-11-30;9638
2020-11-29;"Nitriansky kraj";3;634;42;676;NA;241648;45;2020-11-29;9359
2020-11-28;"Nitriansky kraj";135;892;31;923;NA;241648;166;2020-11-28;9314
2020-11-27;"Nitriansky kraj";177;2069;73;2142;NA;241648;250;2020-11-27;9148
2020-11-26;"Nitriansky kraj";191;2813;80;2893;NA;241648;271;2020-11-26;8898
2020-11-25;"Nitriansky kraj";325;2478;91;2569;NA;241648;416;2020-11-25;8627
2020-11-24;"Nitriansky kraj";147;1641;64;1705;NA;241648;211;2020-11-24;8211
2020-11-23;"Nitriansky kraj";102;9891;212;10103;NA;241648;314;2020-11-23;8000
2020-11-22;"Nitriansky kraj";7;1176;25;1201;NA;241648;32;2020-11-22;7686
2020-11-21;"Nitriansky kraj";86;1083;38;1121;NA;241648;124;2020-11-21;7654
2020-11-20;"Nitriansky kraj";264;4180;103;4283;NA;241648;367;2020-11-20;7530
2020-11-19;"Nitriansky kraj";185;3065;134;3199;NA;241648;319;2020-11-19;7163
2020-11-18;"Nitriansky kraj";188;2214;79;2293;NA;241648;267;2020-11-18;6844
2020-11-17;"Nitriansky kraj";178;596;29;625;NA;241648;207;2020-11-17;6577
2020-11-16;"Nitriansky kraj";139;1877;75;1952;NA;241648;214;2020-11-16;6370
2020-11-15;"Nitriansky kraj";14;180;5;185;NA;241648;19;2020-11-15;6156
2020-11-14;"Nitriansky kraj";114;1131;32;1163;NA;241648;146;2020-11-14;6137
2020-11-13;"Nitriansky kraj";210;936;46;982;NA;241648;256;2020-11-13;5991
2020-11-12;"Nitriansky kraj";256;1195;35;1230;NA;241648;291;2020-11-12;5735
2020-11-11;"Nitriansky kraj";279;1247;22;1269;NA;241648;301;2020-11-11;5444
2020-11-10;"Nitriansky kraj";192;2623;39;2662;NA;241648;231;2020-11-10;5143
2020-11-09;"Nitriansky kraj";128;3136;43;3179;NA;241648;171;2020-11-09;4912
2020-11-08;"Nitriansky kraj";43;1462;32;1494;NA;241648;75;2020-11-08;4741
2020-11-07;"Nitriansky kraj";130;1046;4;1050;NA;241648;134;2020-11-07;4666
2020-11-06;"Nitriansky kraj";210;2264;32;2296;NA;241648;242;2020-11-06;4532
2020-11-05;"Nitriansky kraj";178;313;14;327;NA;241648;192;2020-11-05;4290
2020-11-04;"Nitriansky kraj";211;297;16;313;NA;241648;227;2020-11-04;4098
2020-11-03;"Nitriansky kraj";216;435;25;460;NA;241648;241;2020-11-03;3871
2020-11-02;"Nitriansky kraj";171;4208;46;4254;NA;241648;217;2020-11-02;3630
2020-11-01;"Nitriansky kraj";130;2546;27;2573;NA;241648;157;2020-11-01;3413
2020-10-31;"Nitriansky kraj";261;10466;134;10600;NA;241648;395;2020-10-31;3256
2020-10-30;"Nitriansky kraj";204;2593;42;2635;NA;241648;246;2020-10-30;2861
2020-10-29;"Nitriansky kraj";293;841;39;880;NA;241648;332;2020-10-29;2615
2020-10-28;"Nitriansky kraj";216;608;59;667;NA;241648;275;2020-10-28;2283
2020-10-27;"Nitriansky kraj";296;550;47;597;NA;241648;343;2020-10-27;2008
2020-10-26;"Nitriansky kraj";69;633;56;689;NA;241648;125;2020-10-26;1665
2020-10-25;"Nitriansky kraj";50;62;8;70;NA;241648;58;2020-10-25;1540
2020-10-24;"Nitriansky kraj";169;237;11;248;NA;241648;180;2020-10-24;1482
2020-10-23;"Nitriansky kraj";282;762;41;803;NA;241648;323;2020-10-23;1302
2020-10-22;"Nitriansky kraj";137;444;39;483;NA;241648;176;2020-10-22;979
2020-10-21;"Nitriansky kraj";146;208;3;211;NA;241648;149;2020-10-21;803
2020-10-20;"Nitriansky kraj";197;78;6;84;NA;241648;203;2020-10-20;654
2020-10-19;"Nitriansky kraj";148;79;1;80;NA;241648;149;2020-10-19;451
2020-10-18;"Nitriansky kraj";22;0;0;0;NA;241648;22;2020-10-18;302
2020-10-17;"Nitriansky kraj";67;0;0;0;NA;241648;67;2020-10-17;280
2020-10-16;"Nitriansky kraj";133;28;3;31;NA;241648;136;2020-10-16;213
2020-10-15;"Nitriansky kraj";106;31;2;33;NA;241648;108;2020-10-15;77
2020-10-14;"Nitriansky kraj";80;22;4;26;NA;241648;84;2020-10-14;-31
2020-10-13;"Nitriansky kraj";101;82;2;84;NA;241648;103;2020-10-13;-115
2020-10-12;"Nitriansky kraj";36;0;0;0;NA;241648;36;2020-10-12;-218
2020-10-11;"Nitriansky kraj";8;0;0;0;NA;241648;8;2020-10-11;-254
2020-10-10;"Nitriansky kraj";107;0;0;0;NA;241648;107;2020-10-10;-262
2020-10-09;"Nitriansky kraj";120;0;0;0;NA;241648;120;2020-10-09;-369
2020-10-08;"Nitriansky kraj";132;0;0;0;NA;241648;132;2020-10-08;-489
2020-10-07;"Nitriansky kraj";81;0;0;0;NA;241648;81;2020-10-07;-621
2020-10-06;"Nitriansky kraj";48;0;0;0;NA;241648;48;2020-10-06;-702
2020-10-05;"Nitriansky kraj";20;0;0;0;NA;241648;20;2020-10-05;-750
2020-10-04;"Nitriansky kraj";17;0;0;0;NA;241648;17;2020-10-04;-770
2020-10-03;"Nitriansky kraj";96;0;0;0;NA;241648;96;2020-10-03;-787
2020-10-02;"Nitriansky kraj";108;0;0;0;NA;241648;108;2020-10-02;-883
2020-10-01;"Nitriansky kraj";95;0;0;0;NA;241648;95;2020-10-01;-991
2020-09-30;"Nitriansky kraj";100;0;0;0;NA;241648;100;2020-09-30;-1086
2020-09-29;"Nitriansky kraj";50;0;0;0;NA;241648;50;2020-09-29;-1186
2020-09-28;"Nitriansky kraj";22;0;0;0;NA;241648;22;2020-09-28;-1236
2020-09-27;"Nitriansky kraj";16;0;0;0;NA;241648;16;2020-09-27;-1258
2020-09-26;"Nitriansky kraj";64;0;0;0;NA;241648;64;2020-09-26;-1274
2020-09-25;"Nitriansky kraj";90;0;0;0;NA;241648;90;2020-09-25;-1338
2020-09-24;"Nitriansky kraj";51;0;0;0;NA;241648;51;2020-09-24;-1428
2020-09-23;"Nitriansky kraj";70;0;0;0;NA;241648;70;2020-09-23;-1479
2020-09-22;"Nitriansky kraj";18;0;0;0;NA;241648;18;2020-09-22;-1549
2020-09-21;"Nitriansky kraj";10;0;0;0;NA;241648;10;2020-09-21;-1567
2020-09-20;"Nitriansky kraj";4;0;0;0;NA;241648;4;2020-09-20;-1577
2020-09-19;"Nitriansky kraj";14;0;0;0;NA;241648;14;2020-09-19;-1581
2020-09-18;"Nitriansky kraj";19;0;0;0;NA;241648;19;2020-09-18;-1595
2020-09-17;"Nitriansky kraj";30;0;0;0;NA;241648;30;2020-09-17;-1614
2020-09-16;"Nitriansky kraj";6;0;0;0;NA;241648;6;2020-09-16;-1644
2020-09-15;"Nitriansky kraj";19;0;0;0;NA;241648;19;2020-09-15;-1650
2020-09-14;"Nitriansky kraj";28;0;0;0;NA;241648;28;2020-09-14;-1669
2020-09-13;"Nitriansky kraj";3;0;0;0;NA;241648;3;2020-09-13;-1697
2020-09-12;"Nitriansky kraj";12;0;0;0;NA;241648;12;2020-09-12;-1700
2020-09-11;"Nitriansky kraj";23;0;0;0;NA;241648;23;2020-09-11;-1712
2020-09-10;"Nitriansky kraj";29;0;0;0;NA;241648;29;2020-09-10;-1735
2020-09-09;"Nitriansky kraj";19;0;0;0;NA;241648;19;2020-09-09;-1764
2020-09-08;"Nitriansky kraj";17;0;0;0;NA;241648;17;2020-09-08;-1783
2020-09-07;"Nitriansky kraj";17;0;0;0;NA;241648;17;2020-09-07;-1800
2020-09-06;"Nitriansky kraj";0;0;0;0;NA;241648;0;2020-09-06;-1817
2020-09-05;"Nitriansky kraj";22;0;0;0;NA;241648;22;2020-09-05;-1817
2020-09-04;"Nitriansky kraj";34;0;0;0;NA;241648;34;2020-09-04;-1839
2020-09-03;"Nitriansky kraj";15;0;0;0;NA;241648;15;2020-09-03;-1873
2020-09-02;"Nitriansky kraj";15;0;0;0;NA;241648;15;2020-09-02;-1888
2020-09-01;"Nitriansky kraj";2;0;0;0;NA;241648;2;2020-09-01;-1903
2020-08-31;"Nitriansky kraj";12;0;0;0;NA;241648;12;2020-08-31;-1905
2020-08-30;"Nitriansky kraj";1;0;0;0;NA;241648;1;2020-08-30;-1917
2020-08-29;"Nitriansky kraj";7;46;0;46;NA;241648;7;2020-08-29;-1918
2020-08-28;"Nitriansky kraj";12;0;0;0;NA;241648;12;2020-08-28;-1925
2020-08-27;"Nitriansky kraj";12;0;0;0;NA;241648;12;2020-08-27;-1937
2020-08-26;"Nitriansky kraj";4;0;0;0;NA;241648;4;2020-08-26;-1949
2020-08-25;"Nitriansky kraj";8;0;0;0;NA;241648;8;2020-08-25;-1953
2020-08-24;"Nitriansky kraj";1;0;0;0;NA;241648;1;2020-08-24;-1961
2020-08-23;"Nitriansky kraj";1;0;0;0;NA;241648;1;2020-08-23;-1962
2020-08-22;"Nitriansky kraj";2;0;0;0;NA;241648;2;2020-08-22;-1963
2020-08-21;"Nitriansky kraj";0;0;0;0;NA;241648;0;2020-08-21;-1965
2020-08-20;"Nitriansky kraj";7;0;0;0;NA;241648;7;2020-08-20;-1965
2020-08-19;"Nitriansky kraj";1;0;0;0;NA;241648;1;2020-08-19;-1972
2020-08-18;"Nitriansky kraj";2;0;0;0;NA;241648;2;2020-08-18;-1973
2020-08-17;"Nitriansky kraj";1;0;0;0;NA;241648;1;2020-08-17;-1975
2020-08-16;"Nitriansky kraj";0;0;0;0;NA;241648;0;2020-08-16;-1976
2020-08-15;"Nitriansky kraj";2;0;0;0;NA;241648;2;2020-08-15;-1976
2020-08-14;"Nitriansky kraj";1;0;0;0;NA;241648;1;2020-08-14;-1978
2020-08-13;"Nitriansky kraj";4;0;0;0;NA;241648;4;2020-08-13;-1979
2020-08-12;"Nitriansky kraj";0;0;0;0;NA;241648;0;2020-08-12;-1983
2020-08-11;"Nitriansky kraj";1;0;0;0;NA;241648;1;2020-08-11;-1983
2020-08-10;"Nitriansky kraj";0;0;0;0;NA;241648;0;2020-08-10;-1984
2020-08-09;"Nitriansky kraj";0;0;0;0;NA;241648;0;2020-08-09;-1984
2020-08-08;"Nitriansky kraj";0;0;0;0;NA;241648;0;2020-08-08;-1984
2020-08-07;"Nitriansky kraj";4;0;0;0;NA;241648;4;2020-08-07;-1984
2020-08-06;"Nitriansky kraj";4;0;0;0;NA;241648;4;2020-08-06;-1988
2020-08-05;"Nitriansky kraj";0;0;0;0;NA;241648;0;2020-08-05;-1992
2020-08-04;"Nitriansky kraj";7;0;0;0;NA;241648;7;2020-08-04;-1992
2020-08-03;"Nitriansky kraj";0;0;0;0;NA;241648;0;2020-08-03;-1999
2020-08-02;"Nitriansky kraj";0;0;0;0;NA;241648;0;2020-08-02;-1999
2020-08-01;"Nitriansky kraj";0;0;0;0;NA;241648;0;2020-08-01;-1999
2020-07-31;"Nitriansky kraj";0;0;0;0;NA;241648;0;2020-07-31;-1999
2020-07-30;"Nitriansky kraj";0;0;0;0;NA;241648;0;2020-07-30;-1999
2020-07-29;"Nitriansky kraj";0;0;0;0;NA;241648;0;2020-07-29;-1999
2020-07-28;"Nitriansky kraj";0;0;0;0;NA;241648;0;2020-07-28;-1999
2020-07-27;"Nitriansky kraj";0;0;0;0;NA;241648;0;2020-07-27;-1999
2020-07-26;"Nitriansky kraj";0;0;0;0;NA;241648;0;2020-07-26;-1999
2020-07-25;"Nitriansky kraj";0;0;0;0;NA;241648;0;2020-07-25;-1999
2020-07-24;"Nitriansky kraj";1;0;0;0;NA;241648;1;2020-07-24;-1999
2020-07-23;"Nitriansky kraj";3;0;0;0;NA;241648;3;2020-07-23;-2000
2020-07-22;"Nitriansky kraj";2;0;0;0;NA;241648;2;2020-07-22;-2003
2020-07-21;"Nitriansky kraj";14;0;0;0;NA;241648;14;2020-07-21;-2005
2020-07-20;"Nitriansky kraj";11;0;0;0;NA;241648;11;2020-07-20;-2019
2020-07-19;"Nitriansky kraj";0;0;0;0;NA;241648;0;2020-07-19;-2030
2020-07-18;"Nitriansky kraj";0;0;0;0;NA;241648;0;2020-07-18;-2030
2020-07-17;"Nitriansky kraj";0;0;0;0;NA;241648;0;2020-07-17;-2030
2020-07-16;"Nitriansky kraj";4;0;0;0;NA;241648;4;2020-07-16;-2030
2020-07-15;"Nitriansky kraj";5;0;0;0;NA;241648;5;2020-07-15;-2034
2020-07-14;"Nitriansky kraj";0;0;0;0;NA;241648;0;2020-07-14;-2039
2020-07-13;"Nitriansky kraj";0;0;0;0;NA;241648;0;2020-07-13;-2039
2020-07-12;"Nitriansky kraj";0;0;0;0;NA;241648;0;2020-07-12;-2039
2020-07-11;"Nitriansky kraj";0;0;0;0;NA;241648;0;2020-07-11;-2039
2020-07-10;"Nitriansky kraj";0;0;0;0;NA;241648;0;2020-07-10;-2039
2020-07-09;"Nitriansky kraj";1;0;0;0;NA;241648;1;2020-07-09;-2039
2020-07-08;"Nitriansky kraj";2;0;0;0;NA;241648;2;2020-07-08;-2040
2020-07-07;"Nitriansky kraj";0;0;0;0;NA;241648;0;2020-07-07;-2042
2020-07-06;"Nitriansky kraj";0;0;0;0;NA;241648;0;2020-07-06;-2042
2020-07-05;"Nitriansky kraj";0;0;0;0;NA;241648;0;2020-07-05;-2042
2020-07-04;"Nitriansky kraj";0;0;0;0;NA;241648;0;2020-07-04;-2042
2020-07-03;"Nitriansky kraj";0;0;0;0;NA;241648;0;2020-07-03;-2042
2020-07-02;"Nitriansky kraj";0;0;0;0;NA;241648;0;2020-07-02;-2042
2020-07-01;"Nitriansky kraj";3;0;0;0;NA;241648;3;2020-07-01;-2042
2020-06-30;"Nitriansky kraj";0;0;0;0;NA;241648;0;2020-06-30;-2045
2020-06-29;"Nitriansky kraj";0;0;0;0;NA;241648;0;2020-06-29;-2045
2020-06-28;"Nitriansky kraj";0;0;0;0;NA;241648;0;2020-06-28;-2045
2020-06-27;"Nitriansky kraj";0;0;0;0;NA;241648;0;2020-06-27;-2045
2020-06-26;"Nitriansky kraj";0;0;0;0;NA;241648;0;2020-06-26;-2045
2020-06-25;"Nitriansky kraj";0;0;0;0;NA;241648;0;2020-06-25;-2045
2020-06-24;"Nitriansky kraj";1;0;0;0;NA;241648;1;2020-06-24;-2045
2020-06-23;"Nitriansky kraj";0;0;0;0;NA;241648;0;2020-06-23;-2046
2020-06-22;"Nitriansky kraj";0;0;0;0;NA;241648;0;2020-06-22;-2046
2020-06-21;"Nitriansky kraj";0;0;0;0;NA;241648;0;2020-06-21;-2046
2020-06-20;"Nitriansky kraj";0;0;0;0;NA;241648;0;2020-06-20;-2046
2020-06-19;"Nitriansky kraj";0;0;0;0;NA;241648;0;2020-06-19;-2046
2020-06-18;"Nitriansky kraj";0;0;0;0;NA;241648;0;2020-06-18;-2046
2020-06-17;"Nitriansky kraj";0;0;0;0;NA;241648;0;2020-06-17;-2046
2020-06-16;"Nitriansky kraj";0;0;0;0;NA;241648;0;2020-06-16;-2046
2020-06-14;"Nitriansky kraj";0;0;0;0;NA;241648;0;2020-06-14;-2046
2020-06-13;"Nitriansky kraj";0;0;0;0;NA;241648;0;2020-06-13;-2046
2020-06-12;"Nitriansky kraj";0;0;0;0;NA;241648;0;2020-06-12;-2046
2020-06-11;"Nitriansky kraj";0;0;0;0;NA;241648;0;2020-06-11;-2046
2020-06-10;"Nitriansky kraj";1;0;0;0;NA;241648;1;2020-06-10;-2046
2020-06-09;"Nitriansky kraj";1;0;0;0;NA;241648;1;2020-06-09;-2047
2020-06-08;"Nitriansky kraj";0;0;0;0;NA;241648;0;2020-06-08;-2048
2020-06-07;"Nitriansky kraj";0;0;0;0;NA;241648;0;2020-06-07;-2048
2020-06-05;"Nitriansky kraj";0;0;0;0;NA;241648;0;2020-06-05;-2048
2020-06-03;"Nitriansky kraj";0;0;0;0;NA;241648;0;2020-06-03;-2048
2020-06-02;"Nitriansky kraj";1;0;0;0;NA;241648;1;2020-06-02;-2048
2020-05-31;"Nitriansky kraj";0;0;0;0;NA;241648;0;2020-05-31;-2049
2020-05-29;"Nitriansky kraj";0;0;0;0;NA;241648;0;2020-05-29;-2049
2020-05-27;"Nitriansky kraj";0;0;0;0;NA;241648;0;2020-05-27;-2049
2020-05-26;"Nitriansky kraj";0;0;0;0;NA;241648;0;2020-05-26;-2049
2020-05-25;"Nitriansky kraj";0;0;0;0;NA;241648;0;2020-05-25;-2049
2020-05-24;"Nitriansky kraj";2;0;0;0;NA;241648;2;2020-05-24;-2049
2020-05-23;"Nitriansky kraj";0;0;0;0;NA;241648;0;2020-05-23;-2051
2020-05-22;"Nitriansky kraj";1;0;0;0;NA;241648;1;2020-05-22;-2051
2020-05-21;"Nitriansky kraj";0;0;0;0;NA;241648;0;2020-05-21;-2052
2020-05-20;"Nitriansky kraj";0;0;0;0;NA;241648;0;2020-05-20;-2052
2020-05-19;"Nitriansky kraj";0;0;0;0;NA;241648;0;2020-05-19;-2052
2020-05-17;"Nitriansky kraj";0;0;0;0;NA;241648;0;2020-05-17;-2052
2020-05-16;"Nitriansky kraj";0;0;0;0;NA;241648;0;2020-05-16;-2052
2020-05-15;"Nitriansky kraj";1;0;0;0;NA;241648;1;2020-05-15;-2052
2020-05-14;"Nitriansky kraj";0;0;0;0;NA;241648;0;2020-05-14;-2053
2020-05-13;"Nitriansky kraj";0;0;0;0;NA;241648;0;2020-05-13;-2053
2020-05-12;"Nitriansky kraj";0;0;0;0;NA;241648;0;2020-05-12;-2053
2020-05-11;"Nitriansky kraj";2;0;0;0;NA;241648;2;2020-05-11;-2053
2020-05-09;"Nitriansky kraj";0;0;0;0;NA;241648;0;2020-05-09;-2055
2020-05-07;"Nitriansky kraj";1;0;0;0;NA;241648;1;2020-05-07;-2055
2020-05-06;"Nitriansky kraj";9;0;0;0;NA;241648;9;2020-05-06;-2056
2020-05-05;"Nitriansky kraj";0;0;0;0;NA;241648;0;2020-05-05;-2065
2020-05-04;"Nitriansky kraj";5;0;0;0;NA;241648;5;2020-05-04;-2065
2020-05-03;"Nitriansky kraj";2;0;0;0;NA;241648;2;2020-05-03;-2070
2020-05-02;"Nitriansky kraj";0;0;0;0;NA;241648;0;2020-05-02;-2072
2020-05-01;"Nitriansky kraj";1;0;0;0;NA;241648;1;2020-05-01;-2072
2020-04-30;"Nitriansky kraj";0;0;0;0;NA;241648;0;2020-04-30;-2073
2020-04-29;"Nitriansky kraj";0;0;0;0;NA;241648;0;2020-04-29;-2073
2020-04-28;"Nitriansky kraj";1;0;0;0;NA;241648;1;2020-04-28;-2073
2020-04-27;"Nitriansky kraj";0;0;0;0;NA;241648;0;2020-04-27;-2074
2020-04-26;"Nitriansky kraj";0;0;0;0;NA;241648;0;2020-04-26;-2074
2020-04-25;"Nitriansky kraj";0;0;0;0;NA;241648;0;2020-04-25;-2074
2020-04-24;"Nitriansky kraj";0;0;0;0;NA;241648;0;2020-04-24;-2074
2020-04-23;"Nitriansky kraj";3;0;0;0;NA;241648;3;2020-04-23;-2074
2020-04-22;"Nitriansky kraj";16;0;0;0;NA;241648;16;2020-04-22;-2077
2020-04-21;"Nitriansky kraj";6;0;0;0;NA;241648;6;2020-04-21;-2093
2020-04-20;"Nitriansky kraj";5;0;0;0;NA;241648;5;2020-04-20;-2099
2020-04-19;"Nitriansky kraj";0;0;0;0;NA;241648;0;2020-04-19;-2104
2020-04-18;"Nitriansky kraj";0;0;0;0;NA;241648;0;2020-04-18;-2104
2020-04-17;"Nitriansky kraj";7;0;0;0;NA;241648;7;2020-04-17;-2104
2020-04-16;"Nitriansky kraj";0;0;0;0;NA;241648;0;2020-04-16;-2111
2020-04-15;"Nitriansky kraj";6;0;0;0;NA;241648;6;2020-04-15;-2111
2020-04-14;"Nitriansky kraj";2;0;0;0;NA;241648;2;2020-04-14;-2117
2020-04-13;"Nitriansky kraj";1;0;0;0;NA;241648;1;2020-04-13;-2119
2020-04-12;"Nitriansky kraj";3;0;0;0;NA;241648;3;2020-04-12;-2120
2020-04-11;"Nitriansky kraj";1;0;0;0;NA;241648;1;2020-04-11;-2123
2020-04-10;"Nitriansky kraj";1;0;0;0;NA;241648;1;2020-04-10;-2124
2020-04-09;"Nitriansky kraj";0;0;0;0;NA;241648;0;2020-04-09;-2125
2020-04-08;"Nitriansky kraj";2;0;0;0;NA;241648;2;2020-04-08;-2125
2020-04-07;"Nitriansky kraj";3;0;0;0;NA;241648;3;2020-04-07;-2127
2020-04-06;"Nitriansky kraj";4;0;0;0;NA;241648;4;2020-04-06;-2130
2020-04-05;"Nitriansky kraj";5;0;0;0;NA;241648;5;2020-04-05;-2134
2020-04-04;"Nitriansky kraj";0;0;0;0;NA;241648;0;2020-04-04;-2139
2020-04-03;"Nitriansky kraj";0;0;0;0;NA;241648;0;2020-04-03;-2139
2020-04-02;"Nitriansky kraj";1;0;0;0;NA;241648;1;2020-04-02;-2139
2020-04-01;"Nitriansky kraj";0;0;0;0;NA;241648;0;2020-04-01;-2140
2020-03-31;"Nitriansky kraj";3;0;0;0;NA;241648;3;2020-03-31;-2140
2020-03-30;"Nitriansky kraj";3;0;0;0;NA;241648;3;2020-03-30;-2143
2020-03-29;"Nitriansky kraj";3;0;0;0;NA;241648;3;2020-03-29;-2146
2020-03-28;"Nitriansky kraj";1;0;0;0;NA;241648;1;2020-03-28;-2149
2020-03-27;"Nitriansky kraj";1;0;0;0;NA;241648;1;2020-03-27;-2150
2020-03-26;"Nitriansky kraj";1;0;0;0;NA;241648;1;2020-03-26;-2151
2020-03-25;"Nitriansky kraj";1;0;0;0;NA;241648;1;2020-03-25;-2152
2020-03-24;"Nitriansky kraj";0;0;0;0;NA;241648;0;2020-03-24;-2153
2020-03-23;"Nitriansky kraj";2;0;0;0;NA;241648;2;2020-03-23;-2153
2020-03-22;"Nitriansky kraj";2;0;0;0;NA;241648;2;2020-03-22;-2155
2020-03-21;"Nitriansky kraj";2;0;0;0;NA;241648;2;2020-03-21;-2157
2020-03-20;"Nitriansky kraj";1;0;0;0;NA;241648;1;2020-03-20;-2159
2020-03-19;"Nitriansky kraj";1;0;0;0;NA;241648;1;2020-03-19;-2160
2020-03-18;"Nitriansky kraj";2;0;0;0;NA;241648;2;2020-03-18;-2161
2020-03-17;"Nitriansky kraj";1;0;0;0;NA;241648;1;2020-03-17;-2163
2020-03-16;"Nitriansky kraj";0;0;0;0;NA;241648;0;2020-03-16;-2164
2020-03-15;"Nitriansky kraj";4;0;0;0;NA;241648;4;2020-03-15;-2164
2020-03-14;"Nitriansky kraj";1;0;0;0;NA;241648;1;2020-03-14;-2168
2020-03-13;"Nitriansky kraj";0;0;0;0;NA;241648;0;2020-03-13;-2169
2020-03-12;"Nitriansky kraj";0;0;0;0;NA;241648;0;2020-03-12;-2169
2020-03-11;"Nitriansky kraj";0;0;0;0;NA;241648;0;2020-03-11;-2169
2020-03-09;"Nitriansky kraj";0;0;0;0;NA;241648;0;2020-03-09;-2169
2020-03-08;"Nitriansky kraj";0;0;0;0;NA;241648;0;2020-03-08;-2169
2020-03-07;"Nitriansky kraj";0;0;0;0;NA;241648;0;2020-03-07;-2169
2020-03-06;"Nitriansky kraj";0;0;0;0;NA;241648;0;2020-03-06;-2169
2022-03-08;"Prešovský kraj";1716;0;0;0;227722;322527;1716;2022-03-08;322527
2022-03-07;"Prešovský kraj";1326;11;1;12;NA;322527;1327;2022-03-07;320811
2022-03-06;"Prešovský kraj";278;974;149;1123;NA;322527;427;2022-03-06;319484
2022-03-05;"Prešovský kraj";785;753;98;851;NA;322527;883;2022-03-05;319057
2022-03-04;"Prešovský kraj";1263;1844;240;2084;NA;322527;1503;2022-03-04;318174
2022-03-03;"Prešovský kraj";1049;2955;359;3314;NA;322527;1408;2022-03-03;316671
2022-03-02;"Prešovský kraj";1526;2910;327;3237;NA;322527;1853;2022-03-02;315263
2022-03-01;"Prešovský kraj";1612;3229;325;3554;NA;322527;1937;2022-03-01;313410
2022-02-28;"Prešovský kraj";1234;4882;515;5397;NA;322527;1749;2022-02-28;311473
2022-02-27;"Prešovský kraj";523;1403;262;1665;NA;322527;785;2022-02-27;309724
2022-02-26;"Prešovský kraj";867;1286;163;1449;NA;322527;1030;2022-02-26;308939
2022-02-25;"Prešovský kraj";1740;2698;339;3037;NA;322527;2079;2022-02-25;307909
2022-02-24;"Prešovský kraj";1435;3221;384;3605;NA;322527;1819;2022-02-24;305830
2022-02-23;"Prešovský kraj";1837;3464;391;3855;NA;322527;2228;2022-02-23;304011
2022-02-22;"Prešovský kraj";2294;3810;399;4209;NA;322527;2693;2022-02-22;301783
2022-02-21;"Prešovský kraj";1609;5025;605;5630;NA;322527;2214;2022-02-21;299090
2022-02-20;"Prešovský kraj";759;1825;295;2120;NA;322527;1054;2022-02-20;296876
2022-02-19;"Prešovský kraj";1535;1521;240;1761;NA;322527;1775;2022-02-19;295822
2022-02-18;"Prešovský kraj";2332;3488;384;3872;NA;322527;2716;2022-02-18;294047
2022-02-17;"Prešovský kraj";2293;3638;444;4082;NA;322527;2737;2022-02-17;291331
2022-02-16;"Prešovský kraj";2494;3942;468;4410;NA;322527;2962;2022-02-16;288594
2022-02-15;"Prešovský kraj";2992;4455;540;4995;NA;322527;3532;2022-02-15;285632
2022-02-14;"Prešovský kraj";2122;6203;845;7048;NA;322527;2967;2022-02-14;282100
2022-02-13;"Prešovský kraj";1338;2452;434;2886;NA;322527;1772;2022-02-13;279133
2022-02-12;"Prešovský kraj";2333;1867;352;2219;NA;322527;2685;2022-02-12;277361
2022-02-11;"Prešovský kraj";2666;3930;520;4450;NA;322527;3186;2022-02-11;274676
2022-02-10;"Prešovský kraj";2977;4516;599;5115;NA;322527;3576;2022-02-10;271490
2022-02-09;"Prešovský kraj";2644;4502;634;5136;NA;322527;3278;2022-02-09;267914
2022-02-08;"Prešovský kraj";3387;4890;651;5541;NA;322527;4038;2022-02-08;264636
2022-02-07;"Prešovský kraj";2132;6919;941;7860;NA;322527;3073;2022-02-07;260598
2022-02-06;"Prešovský kraj";1360;2884;490;3374;NA;322527;1850;2022-02-06;257525
2022-02-05;"Prešovský kraj";2813;1993;334;2327;NA;322527;3147;2022-02-05;255675
2022-02-04;"Prešovský kraj";2944;4556;573;5129;NA;322527;3517;2022-02-04;252528
2022-02-03;"Prešovský kraj";3375;5205;487;5692;NA;322527;3862;2022-02-03;249011
2022-02-02;"Prešovský kraj";3150;5686;562;6248;NA;322527;3712;2022-02-02;245149
2022-02-01;"Prešovský kraj";2791;5693;631;6324;NA;322527;3422;2022-02-01;241437
2022-01-31;"Prešovský kraj";2444;9142;929;10071;NA;322527;3373;2022-01-31;238015
2022-01-30;"Prešovský kraj";1311;3437;495;3932;NA;322527;1806;2022-01-30;234642
2022-01-29;"Prešovský kraj";2291;1949;282;2231;NA;322527;2573;2022-01-29;232836
2022-01-28;"Prešovský kraj";2473;4784;486;5270;NA;322527;2959;2022-01-28;230263
2022-01-27;"Prešovský kraj";2353;4558;412;4970;NA;322527;2765;2022-01-27;227304
2022-01-26;"Prešovský kraj";2311;5628;405;6033;NA;322527;2716;2022-01-26;224539
2022-01-25;"Prešovský kraj";2127;5284;346;5630;NA;322527;2473;2022-01-25;221823
2022-01-24;"Prešovský kraj";1324;7617;410;8027;NA;322527;1734;2022-01-24;219350
2022-01-23;"Prešovský kraj";262;3584;218;3802;NA;322527;480;2022-01-23;217616
2022-01-22;"Prešovský kraj";1448;1764;157;1921;NA;322527;1605;2022-01-22;217136
2022-01-21;"Prešovský kraj";1128;4312;196;4508;NA;322527;1324;2022-01-21;215531
2022-01-20;"Prešovský kraj";1184;4012;156;4168;NA;322527;1340;2022-01-20;214207
2022-01-19;"Prešovský kraj";822;4781;173;4954;NA;322527;995;2022-01-19;212867
2022-01-18;"Prešovský kraj";1032;4918;163;5081;NA;322527;1195;2022-01-18;211872
2022-01-17;"Prešovský kraj";784;7143;150;7293;NA;322527;934;2022-01-17;210677
2022-01-16;"Prešovský kraj";113;3113;98;3211;NA;322527;211;2022-01-16;209743
2022-01-15;"Prešovský kraj";675;1546;64;1610;NA;322527;739;2022-01-15;209532
2022-01-14;"Prešovský kraj";202;3792;78;3870;NA;322527;280;2022-01-14;208793
2022-01-13;"Prešovský kraj";252;3550;89;3639;NA;322527;341;2022-01-13;208513
2022-01-12;"Prešovský kraj";431;4183;77;4260;NA;322527;508;2022-01-12;208172
2022-01-11;"Prešovský kraj";438;4812;80;4892;NA;322527;518;2022-01-11;207664
2022-01-10;"Prešovský kraj";469;7561;135;7696;NA;322527;604;2022-01-10;207146
2022-01-09;"Prešovský kraj";114;4129;78;4207;NA;322527;192;2022-01-09;206542
2022-01-08;"Prešovský kraj";291;2097;39;2136;NA;322527;330;2022-01-08;206350
2022-01-07;"Prešovský kraj";370;3882;106;3988;NA;322527;476;2022-01-07;206020
2022-01-06;"Prešovský kraj";104;1000;43;1043;NA;322527;147;2022-01-06;205544
2022-01-05;"Prešovský kraj";373;4752;100;4852;NA;322527;473;2022-01-05;205397
2022-01-04;"Prešovský kraj";428;4558;77;4635;NA;322527;505;2022-01-04;204924
2022-01-03;"Prešovský kraj";390;6868;105;6973;NA;322527;495;2022-01-03;204419
2022-01-02;"Prešovský kraj";158;3180;75;3255;NA;322527;233;2022-01-02;203924
2022-01-01;"Prešovský kraj";55;379;8;387;NA;322527;63;2022-01-01;203691
2021-12-31;"Prešovský kraj";220;2178;77;2255;NA;322527;297;2021-12-31;203628
2021-12-30;"Prešovský kraj";230;2985;81;3066;NA;322527;311;2021-12-30;203331
2021-12-29;"Prešovský kraj";298;3924;73;3997;NA;322527;371;2021-12-29;203020
2021-12-28;"Prešovský kraj";365;3625;60;3685;NA;322527;425;2021-12-28;202649
2021-12-27;"Prešovský kraj";593;5336;93;5429;NA;322527;686;2021-12-27;202224
2021-12-26;"Prešovský kraj";112;1584;62;1646;NA;322527;174;2021-12-26;201538
2021-12-25;"Prešovský kraj";12;600;29;629;NA;322527;41;2021-12-25;201364
2021-12-24;"Prešovský kraj";27;463;26;489;NA;322527;53;2021-12-24;201323
2021-12-23;"Prešovský kraj";623;3125;76;3201;NA;322527;699;2021-12-23;201270
2021-12-22;"Prešovský kraj";234;3600;86;3686;NA;322527;320;2021-12-22;200571
2021-12-21;"Prešovský kraj";520;4571;78;4649;NA;322527;598;2021-12-21;200251
2021-12-20;"Prešovský kraj";371;7190;107;7297;NA;322527;478;2021-12-20;199653
2021-12-19;"Prešovský kraj";110;3166;74;3240;NA;322527;184;2021-12-19;199175
2021-12-18;"Prešovský kraj";313;1562;61;1623;NA;322527;374;2021-12-18;198991
2021-12-17;"Prešovský kraj";429;4482;96;4578;NA;322527;525;2021-12-17;198617
2021-12-16;"Prešovský kraj";401;4557;95;4652;NA;322527;496;2021-12-16;198092
2021-12-15;"Prešovský kraj";473;4499;79;4578;NA;322527;552;2021-12-15;197596
2021-12-14;"Prešovský kraj";662;5468;125;5593;NA;322527;787;2021-12-14;197044
2021-12-13;"Prešovský kraj";588;8085;175;8260;NA;322527;763;2021-12-13;196257
2021-12-12;"Prešovský kraj";160;3852;106;3958;NA;322527;266;2021-12-12;195494
2021-12-11;"Prešovský kraj";483;2040;91;2131;NA;322527;574;2021-12-11;195228
2021-12-10;"Prešovský kraj";649;5018;140;5158;NA;322527;789;2021-12-10;194654
2021-12-09;"Prešovský kraj";669;4702;135;4837;NA;322527;804;2021-12-09;193865
2021-12-08;"Prešovský kraj";944;4794;167;4961;NA;322527;1111;2021-12-08;193061
2021-12-07;"Prešovský kraj";1217;5853;188;6041;NA;322527;1405;2021-12-07;191950
2021-12-06;"Prešovský kraj";784;8604;247;8851;NA;322527;1031;2021-12-06;190545
2021-12-05;"Prešovský kraj";145;4439;133;4572;NA;322527;278;2021-12-05;189514
2021-12-04;"Prešovský kraj";1025;2290;127;2417;NA;322527;1152;2021-12-04;189236
2021-12-03;"Prešovský kraj";1040;5268;231;5499;NA;322527;1271;2021-12-03;188084
2021-12-02;"Prešovský kraj";2255;5291;183;5474;NA;322527;2438;2021-12-02;186813
2021-12-01;"Prešovský kraj";826;5267;239;5506;NA;322527;1065;2021-12-01;184375
2021-11-30;"Prešovský kraj";1123;6651;265;6916;NA;322527;1388;2021-11-30;183310
2021-11-29;"Prešovský kraj";583;11478;473;11951;NA;322527;1056;2021-11-29;181922
2021-11-28;"Prešovský kraj";919;5898;234;6132;NA;322527;1153;2021-11-28;180866
2021-11-27;"Prešovský kraj";884;2977;219;3196;NA;322527;1103;2021-11-27;179713
2021-11-26;"Prešovský kraj";1311;5890;328;6218;NA;322527;1639;2021-11-26;178610
2021-11-25;"Prešovský kraj";1285;5051;307;5358;NA;322527;1592;2021-11-25;176971
2021-11-24;"Prešovský kraj";1209;6120;357;6477;NA;322527;1566;2021-11-24;175379
2021-11-23;"Prešovský kraj";1099;6631;314;6945;NA;322527;1413;2021-11-23;173813
2021-11-22;"Prešovský kraj";905;8209;529;8738;NA;322527;1434;2021-11-22;172400
2021-11-21;"Prešovský kraj";950;3766;316;4082;NA;322527;1266;2021-11-21;170966
2021-11-20;"Prešovský kraj";1372;2193;222;2415;NA;322527;1594;2021-11-20;169700
2021-11-19;"Prešovský kraj";1629;5864;452;6316;NA;322527;2081;2021-11-19;168106
2021-11-18;"Prešovský kraj";823;6696;518;7214;NA;322527;1341;2021-11-18;166025
2021-11-17;"Prešovský kraj";1648;1336;148;1484;NA;322527;1796;2021-11-17;164684
2021-11-16;"Prešovský kraj";1346;5511;398;5909;NA;322527;1744;2021-11-16;162888
2021-11-15;"Prešovský kraj";897;7804;577;8381;NA;322527;1474;2021-11-15;161144
2021-11-14;"Prešovský kraj";603;3168;311;3479;NA;322527;914;2021-11-14;159670
2021-11-13;"Prešovský kraj";1255;2068;262;2330;NA;322527;1517;2021-11-13;158756
2021-11-12;"Prešovský kraj";1358;5236;371;5607;NA;322527;1729;2021-11-12;157239
2021-11-11;"Prešovský kraj";1218;5087;438;5525;NA;322527;1656;2021-11-11;155510
2021-11-10;"Prešovský kraj";1278;4966;380;5346;NA;322527;1658;2021-11-10;153854
2021-11-09;"Prešovský kraj";1038;5431;407;5838;NA;322527;1445;2021-11-09;152196
2021-11-08;"Prešovský kraj";1068;6987;574;7561;NA;322527;1642;2021-11-08;150751
2021-11-07;"Prešovský kraj";421;2500;242;2742;NA;322527;663;2021-11-07;149109
2021-11-06;"Prešovský kraj";1389;1899;234;2133;NA;322527;1623;2021-11-06;148446
2021-11-05;"Prešovský kraj";1080;4974;367;5341;NA;322527;1447;2021-11-05;146823
2021-11-04;"Prešovský kraj";1743;5162;322;5484;NA;322527;2065;2021-11-04;145376
2021-11-03;"Prešovský kraj";1326;5337;387;5724;NA;322527;1713;2021-11-03;143311
2021-11-02;"Prešovský kraj";1002;7553;556;8109;NA;322527;1558;2021-11-02;141598
2021-11-01;"Prešovský kraj";347;1402;131;1533;NA;322527;478;2021-11-01;140040
2021-10-31;"Prešovský kraj";447;2045;210;2255;NA;322527;657;2021-10-31;139562
2021-10-30;"Prešovský kraj";1148;1928;183;2111;NA;322527;1331;2021-10-30;138905
2021-10-29;"Prešovský kraj";1360;4460;253;4713;NA;322527;1613;2021-10-29;137574
2021-10-28;"Prešovský kraj";960;4500;300;4800;NA;322527;1260;2021-10-28;135961
2021-10-27;"Prešovský kraj";1444;4325;221;4546;NA;322527;1665;2021-10-27;134701
2021-10-26;"Prešovský kraj";940;5125;217;5342;NA;322527;1157;2021-10-26;133036
2021-10-25;"Prešovský kraj";673;6077;348;6425;NA;322527;1021;2021-10-25;131879
2021-10-24;"Prešovský kraj";110;2180;149;2329;NA;322527;259;2021-10-24;130858
2021-10-23;"Prešovský kraj";1145;1928;141;2069;NA;322527;1286;2021-10-23;130599
2021-10-22;"Prešovský kraj";792;4876;177;5053;NA;322527;969;2021-10-22;129313
2021-10-21;"Prešovský kraj";901;4738;191;4929;NA;322527;1092;2021-10-21;128344
2021-10-20;"Prešovský kraj";833;4199;195;4394;NA;322527;1028;2021-10-20;127252
2021-10-19;"Prešovský kraj";830;4728;175;4903;NA;322527;1005;2021-10-19;126224
2021-10-18;"Prešovský kraj";454;5752;240;5992;NA;322527;694;2021-10-18;125219
2021-10-17;"Prešovský kraj";181;2430;131;2561;NA;322527;312;2021-10-17;124525
2021-10-16;"Prešovský kraj";561;1924;94;2018;NA;322527;655;2021-10-16;124213
2021-10-15;"Prešovský kraj";533;4735;107;4842;NA;322527;640;2021-10-15;123558
2021-10-14;"Prešovský kraj";506;3948;85;4033;NA;322527;591;2021-10-14;122918
2021-10-13;"Prešovský kraj";549;3794;98;3892;NA;322527;647;2021-10-13;122327
2021-10-12;"Prešovský kraj";520;3966;101;4067;NA;322527;621;2021-10-12;121680
2021-10-11;"Prešovský kraj";433;5421;131;5552;NA;322527;564;2021-10-11;121059
2021-10-10;"Prešovský kraj";78;2099;64;2163;NA;322527;142;2021-10-10;120495
2021-10-09;"Prešovský kraj";311;2077;47;2124;NA;322527;358;2021-10-09;120353
2021-10-08;"Prešovský kraj";636;4934;94;5028;NA;322527;730;2021-10-08;119995
2021-10-07;"Prešovský kraj";487;3919;101;4020;NA;322527;588;2021-10-07;119265
2021-10-06;"Prešovský kraj";296;3851;104;3955;NA;322527;400;2021-10-06;118677
2021-10-05;"Prešovský kraj";430;4151;90;4241;NA;322527;520;2021-10-05;118277
2021-10-04;"Prešovský kraj";353;5569;125;5694;NA;322527;478;2021-10-04;117757
2021-10-03;"Prešovský kraj";19;2324;47;2371;NA;322527;66;2021-10-03;117279
2021-10-02;"Prešovský kraj";269;2238;58;2296;NA;322527;327;2021-10-02;117213
2021-10-01;"Prešovský kraj";325;4997;63;5060;NA;322527;388;2021-10-01;116886
2021-09-30;"Prešovský kraj";265;4044;83;4127;NA;322527;348;2021-09-30;116498
2021-09-29;"Prešovský kraj";381;3825;55;3880;NA;322527;436;2021-09-29;116150
2021-09-28;"Prešovský kraj";312;4714;69;4783;NA;322527;381;2021-09-28;115714
2021-09-27;"Prešovský kraj";257;5062;104;5166;NA;322527;361;2021-09-27;115333
2021-09-26;"Prešovský kraj";8;2422;67;2489;NA;322527;75;2021-09-26;114972
2021-09-25;"Prešovský kraj";134;2540;46;2586;NA;322527;180;2021-09-25;114897
2021-09-24;"Prešovský kraj";297;4822;61;4883;NA;322527;358;2021-09-24;114717
2021-09-23;"Prešovský kraj";109;4105;45;4150;NA;322527;154;2021-09-23;114359
2021-09-22;"Prešovský kraj";177;3836;41;3877;NA;322527;218;2021-09-22;114205
2021-09-21;"Prešovský kraj";219;5059;66;5125;NA;322527;285;2021-09-21;113987
2021-09-20;"Prešovský kraj";180;5183;68;5251;NA;322527;248;2021-09-20;113702
2021-09-19;"Prešovský kraj";7;2726;30;2756;NA;322527;37;2021-09-19;113454
2021-09-18;"Prešovský kraj";169;2406;37;2443;NA;322527;206;2021-09-18;113417
2021-09-17;"Prešovský kraj";157;4402;52;4454;NA;322527;209;2021-09-17;113211
2021-09-16;"Prešovský kraj";146;4371;71;4442;NA;322527;217;2021-09-16;113002
2021-09-15;"Prešovský kraj";68;701;19;720;NA;322527;87;2021-09-15;112785
2021-09-14;"Prešovský kraj";133;3369;38;3407;NA;322527;171;2021-09-14;112698
2021-09-13;"Prešovský kraj";105;4225;37;4262;NA;322527;142;2021-09-13;112527
2021-09-12;"Prešovský kraj";4;1776;29;1805;NA;322527;33;2021-09-12;112385
2021-09-11;"Prešovský kraj";65;2012;24;2036;NA;322527;89;2021-09-11;112352
2021-09-10;"Prešovský kraj";105;3241;30;3271;NA;322527;135;2021-09-10;112263
2021-09-09;"Prešovský kraj";29;3090;27;3117;NA;322527;56;2021-09-09;112128
2021-09-08;"Prešovský kraj";73;2444;20;2464;NA;322527;93;2021-09-08;112072
2021-09-07;"Prešovský kraj";82;2449;24;2473;NA;322527;106;2021-09-07;111979
2021-09-06;"Prešovský kraj";61;3282;20;3302;NA;322527;81;2021-09-06;111873
2021-09-05;"Prešovský kraj";5;1338;11;1349;NA;322527;16;2021-09-05;111792
2021-09-04;"Prešovský kraj";27;1864;14;1878;NA;322527;41;2021-09-04;111776
2021-09-03;"Prešovský kraj";39;2976;15;2991;NA;322527;54;2021-09-03;111735
2021-09-02;"Prešovský kraj";39;2558;20;2578;NA;322527;59;2021-09-02;111681
2021-09-01;"Prešovský kraj";14;575;6;581;NA;322527;20;2021-09-01;111622
2021-08-31;"Prešovský kraj";47;2438;13;2451;NA;322527;60;2021-08-31;111602
2021-08-30;"Prešovský kraj";23;2827;19;2846;NA;322527;42;2021-08-30;111542
2021-08-29;"Prešovský kraj";3;781;1;782;NA;322527;4;2021-08-29;111500
2021-08-28;"Prešovský kraj";5;2101;8;2109;NA;322527;13;2021-08-28;111496
2021-08-27;"Prešovský kraj";32;3084;8;3092;NA;322527;40;2021-08-27;111483
2021-08-26;"Prešovský kraj";13;2094;8;2102;NA;322527;21;2021-08-26;111443
2021-08-25;"Prešovský kraj";18;1947;4;1951;NA;322527;22;2021-08-25;111422
2021-08-24;"Prešovský kraj";10;2138;5;2143;NA;322527;15;2021-08-24;111400
2021-08-23;"Prešovský kraj";16;2576;6;2582;NA;322527;22;2021-08-23;111385
2021-08-22;"Prešovský kraj";0;1440;6;1446;NA;322527;6;2021-08-22;111363
2021-08-21;"Prešovský kraj";28;2018;4;2022;NA;322527;32;2021-08-21;111357
2021-08-20;"Prešovský kraj";15;2906;7;2913;NA;322527;22;2021-08-20;111325
2021-08-19;"Prešovský kraj";22;2242;8;2250;NA;322527;30;2021-08-19;111303
2021-08-18;"Prešovský kraj";6;1752;11;1763;NA;322527;17;2021-08-18;111273
2021-08-17;"Prešovský kraj";29;1829;6;1835;NA;322527;35;2021-08-17;111256
2021-08-16;"Prešovský kraj";11;2524;7;2531;NA;322527;18;2021-08-16;111221
2021-08-15;"Prešovský kraj";0;896;2;898;NA;322527;2;2021-08-15;111203
2021-08-14;"Prešovský kraj";14;1662;1;1663;NA;322527;15;2021-08-14;111201
2021-08-13;"Prešovský kraj";24;1646;12;1658;NA;322527;36;2021-08-13;111186
2021-08-12;"Prešovský kraj";9;1752;3;1755;NA;322527;12;2021-08-12;111150
2021-08-11;"Prešovský kraj";15;1193;3;1196;NA;322527;18;2021-08-11;111138
2021-08-10;"Prešovský kraj";10;1102;4;1106;NA;322527;14;2021-08-10;111120
2021-08-09;"Prešovský kraj";13;2156;4;2160;NA;322527;17;2021-08-09;111106
2021-08-08;"Prešovský kraj";2;675;2;677;NA;322527;4;2021-08-08;111089
2021-08-07;"Prešovský kraj";5;1114;3;1117;NA;322527;8;2021-08-07;111085
2021-08-06;"Prešovský kraj";9;1459;4;1463;NA;322527;13;2021-08-06;111077
2021-08-05;"Prešovský kraj";9;1370;2;1372;NA;322527;11;2021-08-05;111064
2021-08-04;"Prešovský kraj";6;1007;1;1008;NA;322527;7;2021-08-04;111053
2021-08-03;"Prešovský kraj";8;976;1;977;NA;322527;9;2021-08-03;111046
2021-08-02;"Prešovský kraj";5;1477;6;1483;NA;322527;11;2021-08-02;111037
2021-08-01;"Prešovský kraj";0;738;2;740;NA;322527;2;2021-08-01;111026
2021-07-31;"Prešovský kraj";20;1080;0;1080;NA;322527;20;2021-07-31;111024
2021-07-30;"Prešovský kraj";2;1518;1;1519;NA;322527;3;2021-07-30;111004
2021-07-29;"Prešovský kraj";6;1302;1;1303;NA;322527;7;2021-07-29;111001
2021-07-28;"Prešovský kraj";6;1106;1;1107;NA;322527;7;2021-07-28;110994
2021-07-27;"Prešovský kraj";5;1140;2;1142;NA;322527;7;2021-07-27;110987
2021-07-26;"Prešovský kraj";12;1583;1;1584;NA;322527;13;2021-07-26;110980
2021-07-25;"Prešovský kraj";0;687;1;688;NA;322527;1;2021-07-25;110967
2021-07-24;"Prešovský kraj";8;1040;0;1040;NA;322527;8;2021-07-24;110966
2021-07-23;"Prešovský kraj";8;1608;1;1609;NA;322527;9;2021-07-23;110958
2021-07-22;"Prešovský kraj";13;1431;10;1441;NA;322527;23;2021-07-22;110949
2021-07-21;"Prešovský kraj";5;1076;1;1077;NA;322527;6;2021-07-21;110926
2021-07-20;"Prešovský kraj";4;1064;0;1064;NA;322527;4;2021-07-20;110920
2021-07-19;"Prešovský kraj";2;1644;4;1648;NA;322527;6;2021-07-19;110916
2021-07-18;"Prešovský kraj";1;647;0;647;NA;322527;1;2021-07-18;110910
2021-07-17;"Prešovský kraj";6;1245;1;1246;NA;322527;7;2021-07-17;110909
2021-07-16;"Prešovský kraj";4;1558;2;1560;NA;322527;6;2021-07-16;110902
2021-07-15;"Prešovský kraj";5;1310;4;1314;NA;322527;9;2021-07-15;110896
2021-07-14;"Prešovský kraj";1;1051;2;1053;NA;322527;3;2021-07-14;110887
2021-07-13;"Prešovský kraj";1;1071;2;1073;NA;322527;3;2021-07-13;110884
2021-07-12;"Prešovský kraj";1;1949;2;1951;NA;322527;3;2021-07-12;110881
2021-07-11;"Prešovský kraj";0;660;1;661;NA;322527;1;2021-07-11;110878
2021-07-10;"Prešovský kraj";4;1229;2;1231;NA;322527;6;2021-07-10;110877
2021-07-09;"Prešovský kraj";6;1957;1;1958;NA;322527;7;2021-07-09;110871
2021-07-08;"Prešovský kraj";5;1192;0;1192;NA;322527;5;2021-07-08;110864
2021-07-07;"Prešovský kraj";7;1468;3;1471;NA;322527;10;2021-07-07;110859
2021-07-06;"Prešovský kraj";5;1423;2;1425;NA;322527;7;2021-07-06;110849
2021-07-05;"Prešovský kraj";2;645;0;645;NA;322527;2;2021-07-05;110842
2021-07-04;"Prešovský kraj";0;788;0;788;NA;322527;0;2021-07-04;110840
2021-07-03;"Prešovský kraj";2;1391;0;1391;NA;322527;2;2021-07-03;110840
2021-07-02;"Prešovský kraj";4;1796;0;1796;NA;322527;4;2021-07-02;110838
2021-07-01;"Prešovský kraj";2;1590;1;1591;NA;322527;3;2021-07-01;110834
2021-06-30;"Prešovský kraj";3;8829;4;8833;NA;322527;7;2021-06-30;110831
2021-06-29;"Prešovský kraj";1;4935;3;4938;NA;322527;4;2021-06-29;110824
2021-06-28;"Prešovský kraj";5;6109;2;6111;NA;322527;7;2021-06-28;110820
2021-06-27;"Prešovský kraj";0;3852;1;3853;NA;322527;1;2021-06-27;110813
2021-06-26;"Prešovský kraj";4;5815;1;5816;NA;322527;5;2021-06-26;110812
2021-06-25;"Prešovský kraj";7;7321;4;7325;NA;322527;11;2021-06-25;110807
2021-06-24;"Prešovský kraj";10;5406;5;5411;NA;322527;15;2021-06-24;110796
2021-06-23;"Prešovský kraj";4;5124;2;5126;NA;322527;6;2021-06-23;110781
2021-06-22;"Prešovský kraj";5;5143;1;5144;NA;322527;6;2021-06-22;110775
2021-06-21;"Prešovský kraj";13;7033;6;7039;NA;322527;19;2021-06-21;110769
2021-06-20;"Prešovský kraj";0;5204;3;5207;NA;322527;3;2021-06-20;110750
2021-06-19;"Prešovský kraj";1;7349;5;7354;NA;322527;6;2021-06-19;110747
2021-06-18;"Prešovský kraj";9;8682;10;8692;NA;322527;19;2021-06-18;110741
2021-06-17;"Prešovský kraj";9;6548;5;6553;NA;322527;14;2021-06-17;110722
2021-06-16;"Prešovský kraj";6;6422;3;6425;NA;322527;9;2021-06-16;110708
2021-06-15;"Prešovský kraj";2;5709;4;5713;NA;322527;6;2021-06-15;110699
2021-06-14;"Prešovský kraj";5;8229;13;8242;NA;322527;18;2021-06-14;110693
2021-06-13;"Prešovský kraj";1;6455;7;6462;NA;322527;8;2021-06-13;110675
2021-06-12;"Prešovský kraj";3;8904;9;8913;NA;322527;12;2021-06-12;110667
2021-06-11;"Prešovský kraj";21;9877;9;9886;NA;322527;30;2021-06-11;110655
2021-06-10;"Prešovský kraj";11;6512;10;6522;NA;322527;21;2021-06-10;110625
2021-06-09;"Prešovský kraj";16;6375;3;6378;NA;322527;19;2021-06-09;110604
2021-06-08;"Prešovský kraj";31;6495;12;6507;NA;322527;43;2021-06-08;110585
2021-06-07;"Prešovský kraj";11;9111;15;9126;NA;322527;26;2021-06-07;110542
2021-06-06;"Prešovský kraj";0;8016;5;8021;NA;322527;5;2021-06-06;110516
2021-06-05;"Prešovský kraj";17;10248;15;10263;NA;322527;32;2021-06-05;110511
2021-06-04;"Prešovský kraj";26;10375;18;10393;NA;322527;44;2021-06-04;110479
2021-06-03;"Prešovský kraj";14;6820;16;6836;NA;322527;30;2021-06-03;110435
2021-06-02;"Prešovský kraj";47;7372;14;7386;NA;322527;61;2021-06-02;110405
2021-06-01;"Prešovský kraj";15;6926;14;6940;NA;322527;29;2021-06-01;110344
2021-05-31;"Prešovský kraj";27;9951;22;9973;NA;322527;49;2021-05-31;110315
2021-05-30;"Prešovský kraj";2;9717;14;9731;NA;322527;16;2021-05-30;110266
2021-05-29;"Prešovský kraj";23;12733;24;12757;NA;322527;47;2021-05-29;110250
2021-05-28;"Prešovský kraj";30;12468;19;12487;NA;322527;49;2021-05-28;110203
2021-05-27;"Prešovský kraj";16;7653;37;7690;NA;322527;53;2021-05-27;110154
2021-05-26;"Prešovský kraj";32;8140;23;8163;NA;322527;55;2021-05-26;110101
2021-05-25;"Prešovský kraj";38;8690;20;8710;NA;322527;58;2021-05-25;110046
2021-05-24;"Prešovský kraj";17;13298;37;13335;NA;322527;54;2021-05-24;109988
2021-05-23;"Prešovský kraj";3;11947;20;11967;NA;322527;23;2021-05-23;109934
2021-05-22;"Prešovský kraj";11;14422;44;14466;NA;322527;55;2021-05-22;109911
2021-05-21;"Prešovský kraj";44;13803;24;13827;NA;322527;68;2021-05-21;109856
2021-05-20;"Prešovský kraj";13;9437;29;9466;NA;322527;42;2021-05-20;109788
2021-05-19;"Prešovský kraj";60;10756;36;10792;NA;322527;96;2021-05-19;109746
2021-05-18;"Prešovský kraj";44;9062;27;9089;NA;322527;71;2021-05-18;109650
2021-05-17;"Prešovský kraj";60;12856;47;12903;NA;322527;107;2021-05-17;109579
2021-05-16;"Prešovský kraj";20;16302;66;16368;NA;322527;86;2021-05-16;109472
2021-05-15;"Prešovský kraj";20;24604;81;24685;NA;322527;101;2021-05-15;109386
2021-05-14;"Prešovský kraj";49;18671;68;18739;NA;322527;117;2021-05-14;109285
2021-05-13;"Prešovský kraj";54;11166;71;11237;NA;322527;125;2021-05-13;109168
2021-05-12;"Prešovský kraj";59;10822;39;10861;NA;322527;98;2021-05-12;109043
2021-05-11;"Prešovský kraj";61;10728;48;10776;NA;322527;109;2021-05-11;108945
2021-05-10;"Prešovský kraj";79;15726;67;15793;NA;322527;146;2021-05-10;108836
2021-05-09;"Prešovský kraj";54;21658;82;21740;NA;322527;136;2021-05-09;108690
2021-05-08;"Prešovský kraj";39;23050;52;23102;NA;322527;91;2021-05-08;108554
2021-05-07;"Prešovský kraj";81;23543;66;23609;NA;322527;147;2021-05-07;108463
2021-05-06;"Prešovský kraj";107;12924;66;12990;NA;322527;173;2021-05-06;108316
2021-05-05;"Prešovský kraj";60;12808;84;12892;NA;322527;144;2021-05-05;108143
2021-05-04;"Prešovský kraj";203;13470;67;13537;NA;322527;270;2021-05-04;107999
2021-05-03;"Prešovský kraj";68;18458;109;18567;NA;322527;177;2021-05-03;107729
2021-05-02;"Prešovský kraj";29;36676;102;36778;NA;322527;131;2021-05-02;107552
2021-05-01;"Prešovský kraj";70;57153;183;57336;NA;322527;253;2021-05-01;107421
2021-04-30;"Prešovský kraj";135;39333;118;39451;NA;322527;253;2021-04-30;107168
2021-04-29;"Prešovský kraj";110;16635;97;16732;NA;322527;207;2021-04-29;106915
2021-04-28;"Prešovský kraj";122;18671;89;18760;NA;322527;211;2021-04-28;106708
2021-04-27;"Prešovský kraj";154;19994;120;20114;NA;322527;274;2021-04-27;106497
2021-04-26;"Prešovský kraj";99;27241;123;27364;NA;322527;222;2021-04-26;106223
2021-04-25;"Prešovský kraj";9;52776;156;52932;NA;322527;165;2021-04-25;106001
2021-04-24;"Prešovský kraj";61;85698;243;85941;NA;322527;304;2021-04-24;105836
2021-04-23;"Prešovský kraj";171;40365;137;40502;NA;322527;308;2021-04-23;105532
2021-04-22;"Prešovský kraj";86;18104;125;18229;NA;322527;211;2021-04-22;105224
2021-04-21;"Prešovský kraj";144;21550;139;21689;NA;322527;283;2021-04-21;105013
2021-04-20;"Prešovský kraj";115;23346;128;23474;NA;322527;243;2021-04-20;104730
2021-04-19;"Prešovský kraj";106;29133;145;29278;NA;322527;251;2021-04-19;104487
2021-04-18;"Prešovský kraj";4;51824;129;51953;NA;322527;133;2021-04-18;104236
2021-04-17;"Prešovský kraj";119;97970;238;98208;NA;322527;357;2021-04-17;104103
2021-04-16;"Prešovský kraj";135;40989;146;41135;NA;322527;281;2021-04-16;103746
2021-04-15;"Prešovský kraj";112;20179;137;20316;NA;322527;249;2021-04-15;103465
2021-04-14;"Prešovský kraj";199;23332;130;23462;NA;322527;329;2021-04-14;103216
2021-04-13;"Prešovský kraj";180;23907;116;24023;NA;322527;296;2021-04-13;102887
2021-04-12;"Prešovský kraj";172;30152;175;30327;NA;322527;347;2021-04-12;102591
2021-04-11;"Prešovský kraj";11;49955;187;50142;NA;322527;198;2021-04-11;102244
2021-04-10;"Prešovský kraj";94;90181;297;90478;NA;322527;391;2021-04-10;102046
2021-04-09;"Prešovský kraj";255;37163;200;37363;NA;322527;455;2021-04-09;101655
2021-04-08;"Prešovský kraj";192;18893;157;19050;NA;322527;349;2021-04-08;101200
2021-04-07;"Prešovský kraj";314;27797;154;27951;NA;322527;468;2021-04-07;100851
2021-04-06;"Prešovský kraj";231;41711;268;41979;NA;322527;499;2021-04-06;100383
2021-04-05;"Prešovský kraj";54;18454;132;18586;NA;322527;186;2021-04-05;99884
2021-04-04;"Prešovský kraj";31;18569;91;18660;NA;322527;122;2021-04-04;99698
2021-04-03;"Prešovský kraj";104;90664;321;90985;NA;322527;425;2021-04-03;99576
2021-04-02;"Prešovský kraj";194;23381;134;23515;NA;322527;328;2021-04-02;99151
2021-04-01;"Prešovský kraj";256;42879;195;43074;NA;322527;451;2021-04-01;98823
2021-03-31;"Prešovský kraj";311;30176;227;30403;NA;322527;538;2021-03-31;98372
2021-03-30;"Prešovský kraj";374;20751;203;20954;NA;322527;577;2021-03-30;97834
2021-03-29;"Prešovský kraj";219;28188;229;28417;NA;322527;448;2021-03-29;97257
2021-03-28;"Prešovský kraj";26;46811;256;47067;NA;322527;282;2021-03-28;96809
2021-03-27;"Prešovský kraj";181;88673;372;89045;NA;322527;553;2021-03-27;96527
2021-03-26;"Prešovský kraj";310;47751;299;48050;NA;322527;609;2021-03-26;95974
2021-03-25;"Prešovský kraj";248;22281;213;22494;NA;322527;461;2021-03-25;95365
2021-03-24;"Prešovský kraj";381;19590;213;19803;NA;322527;594;2021-03-24;94904
2021-03-23;"Prešovský kraj";241;20351;255;20606;NA;322527;496;2021-03-23;94310
2021-03-22;"Prešovský kraj";299;28634;287;28921;NA;322527;586;2021-03-22;93814
2021-03-21;"Prešovský kraj";32;49439;266;49705;NA;322527;298;2021-03-21;93228
2021-03-20;"Prešovský kraj";180;92529;426;92955;NA;322527;606;2021-03-20;92930
2021-03-19;"Prešovský kraj";373;46582;326;46908;NA;322527;699;2021-03-19;92324
2021-03-18;"Prešovský kraj";251;21721;217;21938;NA;322527;468;2021-03-18;91625
2021-03-17;"Prešovský kraj";331;20887;231;21118;NA;322527;562;2021-03-17;91157
2021-03-16;"Prešovský kraj";461;21094;278;21372;NA;322527;739;2021-03-16;90595
2021-03-15;"Prešovský kraj";370;28813;324;29137;NA;322527;694;2021-03-15;89856
2021-03-14;"Prešovský kraj";52;50410;356;50766;NA;322527;408;2021-03-14;89162
2021-03-13;"Prešovský kraj";200;94768;531;95299;NA;322527;731;2021-03-13;88754
2021-03-12;"Prešovský kraj";425;47691;368;48059;NA;322527;793;2021-03-12;88023
2021-03-11;"Prešovský kraj";463;22059;253;22312;NA;322527;716;2021-03-11;87230
2021-03-10;"Prešovský kraj";325;20821;293;21114;NA;322527;618;2021-03-10;86514
2021-03-09;"Prešovský kraj";505;21496;288;21784;NA;322527;793;2021-03-09;85896
2021-03-08;"Prešovský kraj";314;28903;333;29236;NA;322527;647;2021-03-08;85103
2021-03-07;"Prešovský kraj";19;48328;388;48716;NA;322527;407;2021-03-07;84456
2021-03-06;"Prešovský kraj";193;97527;591;98118;NA;322527;784;2021-03-06;84049
2021-03-05;"Prešovský kraj";497;46054;397;46451;NA;322527;894;2021-03-05;83265
2021-03-04;"Prešovský kraj";372;22670;359;23029;NA;322527;731;2021-03-04;82371
2021-03-03;"Prešovský kraj";397;21623;333;21956;NA;322527;730;2021-03-03;81640
2021-03-02;"Prešovský kraj";421;22682;357;23039;NA;322527;778;2021-03-02;80910
2021-03-01;"Prešovský kraj";303;27716;406;28122;NA;322527;709;2021-03-01;80132
2021-02-28;"Prešovský kraj";75;45000;387;45387;NA;322527;462;2021-02-28;79423
2021-02-27;"Prešovský kraj";273;90231;734;90965;NA;322527;1007;2021-02-27;78961
2021-02-26;"Prešovský kraj";455;41340;438;41778;NA;322527;893;2021-02-26;77954
2021-02-25;"Prešovský kraj";270;19496;337;19833;NA;322527;607;2021-02-25;77061
2021-02-24;"Prešovský kraj";328;19026;377;19403;NA;322527;705;2021-02-24;76454
2021-02-23;"Prešovský kraj";430;21277;345;21622;NA;322527;775;2021-02-23;75749
2021-02-22;"Prešovský kraj";351;27180;356;27536;NA;322527;707;2021-02-22;74974
2021-02-21;"Prešovský kraj";66;31453;301;31754;NA;322527;367;2021-02-21;74267
2021-02-20;"Prešovský kraj";129;71413;517;71930;NA;322527;646;2021-02-20;73900
2021-02-19;"Prešovský kraj";381;38995;430;39425;NA;322527;811;2021-02-19;73254
2021-02-18;"Prešovský kraj";268;16960;322;17282;NA;322527;590;2021-02-18;72443
2021-02-17;"Prešovský kraj";293;17392;246;17638;NA;322527;539;2021-02-17;71853
2021-02-16;"Prešovský kraj";422;18862;265;19127;NA;322527;687;2021-02-16;71314
2021-02-15;"Prešovský kraj";211;31366;303;31669;NA;322527;514;2021-02-15;70627
2021-02-14;"Prešovský kraj";27;39387;321;39708;NA;322527;348;2021-02-14;70113
2021-02-13;"Prešovský kraj";157;74747;402;75149;NA;322527;559;2021-02-13;69765
2021-02-12;"Prešovský kraj";308;38758;365;39123;NA;322527;673;2021-02-12;69206
2021-02-11;"Prešovský kraj";218;16207;238;16445;NA;322527;456;2021-02-11;68533
2021-02-10;"Prešovský kraj";220;18542;282;18824;NA;322527;502;2021-02-10;68077
2021-02-09;"Prešovský kraj";323;21497;370;21867;NA;322527;693;2021-02-09;67575
2021-02-08;"Prešovský kraj";161;36924;261;37185;NA;322527;422;2021-02-08;66882
2021-02-07;"Prešovský kraj";21;34227;209;34436;NA;322527;230;2021-02-07;66460
2021-02-06;"Prešovský kraj";176;69164;360;69524;NA;322527;536;2021-02-06;66230
2021-02-05;"Prešovský kraj";177;31271;262;31533;NA;322527;439;2021-02-05;65694
2021-02-04;"Prešovský kraj";176;13080;237;13317;NA;322527;413;2021-02-04;65255
2021-02-03;"Prešovský kraj";251;8421;236;8657;NA;322527;487;2021-02-03;64842
2021-02-02;"Prešovský kraj";249;11769;264;12033;NA;322527;513;2021-02-02;64355
2021-02-01;"Prešovský kraj";220;16059;316;16375;NA;322527;536;2021-02-01;63842
2021-01-31;"Prešovský kraj";42;10587;107;10694;NA;322527;149;2021-01-31;63306
2021-01-30;"Prešovský kraj";142;23939;215;24154;NA;322527;357;2021-01-30;63157
2021-01-29;"Prešovský kraj";185;17924;326;18250;NA;322527;511;2021-01-29;62800
2021-01-28;"Prešovský kraj";311;7348;150;7498;NA;322527;461;2021-01-28;62289
2021-01-27;"Prešovský kraj";153;9730;147;9877;NA;322527;300;2021-01-27;61828
2021-01-26;"Prešovský kraj";252;16653;151;16804;NA;322527;403;2021-01-26;61528
2021-01-25;"Prešovský kraj";196;30092;253;30345;NA;322527;449;2021-01-25;61125
2021-01-24;"Prešovský kraj";12;45706;304;46010;NA;322527;316;2021-01-24;60676
2021-01-23;"Prešovský kraj";189;96883;487;97370;NA;322527;676;2021-01-23;60360
2021-01-22;"Prešovský kraj";187;35383;261;35644;NA;322527;448;2021-01-22;59684
2021-01-21;"Prešovský kraj";187;20434;212;20646;NA;322527;399;2021-01-21;59236
2021-01-20;"Prešovský kraj";253;14782;195;14977;NA;322527;448;2021-01-20;58837
2021-01-19;"Prešovský kraj";281;12329;305;12634;NA;322527;586;2021-01-19;58389
2021-01-18;"Prešovský kraj";203;10422;336;10758;NA;322527;539;2021-01-18;57803
2021-01-17;"Prešovský kraj";107;14391;1008;15399;NA;322527;1115;2021-01-17;57264
2021-01-16;"Prešovský kraj";72;1838;81;1919;NA;322527;153;2021-01-16;56149
2021-01-15;"Prešovský kraj";159;7033;257;7290;NA;322527;416;2021-01-15;55996
2021-01-14;"Prešovský kraj";268;5534;256;5790;NA;322527;524;2021-01-14;55580
2021-01-13;"Prešovský kraj";342;5649;226;5875;NA;322527;568;2021-01-13;55056
2021-01-12;"Prešovský kraj";455;8251;386;8637;NA;322527;841;2021-01-12;54488
2021-01-11;"Prešovský kraj";343;8149;471;8620;NA;322527;814;2021-01-11;53647
2021-01-10;"Prešovský kraj";63;476;23;499;NA;322527;86;2021-01-10;52833
2021-01-09;"Prešovský kraj";439;2248;125;2373;NA;322527;564;2021-01-09;52747
2021-01-08;"Prešovský kraj";430;10416;561;10977;NA;322527;991;2021-01-08;52183
2021-01-07;"Prešovský kraj";268;7432;622;8054;NA;322527;890;2021-01-07;51192
2021-01-06;"Prešovský kraj";315;1484;134;1618;NA;322527;449;2021-01-06;50302
2021-01-05;"Prešovský kraj";655;11275;976;12251;NA;322527;1631;2021-01-05;49853
2021-01-04;"Prešovský kraj";371;16845;1789;18634;NA;322527;2160;2021-01-04;48222
2021-01-03;"Prešovský kraj";89;459;41;500;NA;322527;130;2021-01-03;46062
2021-01-02;"Prešovský kraj";65;1556;160;1716;NA;322527;225;2021-01-02;45932
2021-01-01;"Prešovský kraj";174;956;71;1027;NA;322527;245;2021-01-01;45707
2020-12-31;"Prešovský kraj";640;11959;783;12742;NA;322527;1423;2020-12-31;45462
2020-12-30;"Prešovský kraj";729;8729;769;9498;NA;322527;1498;2020-12-30;44039
2020-12-29;"Prešovský kraj";435;9273;949;10222;NA;322527;1384;2020-12-29;42541
2020-12-28;"Prešovský kraj";393;9046;1079;10125;NA;322527;1472;2020-12-28;41157
2020-12-27;"Prešovský kraj";40;613;45;658;NA;322527;85;2020-12-27;39685
2020-12-26;"Prešovský kraj";64;176;12;188;NA;322527;76;2020-12-26;39600
2020-12-25;"Prešovský kraj";208;274;11;285;NA;322527;219;2020-12-25;39524
2020-12-24;"Prešovský kraj";452;1214;85;1299;NA;322527;537;2020-12-24;39305
2020-12-23;"Prešovský kraj";361;11006;618;11624;NA;322527;979;2020-12-23;38768
2020-12-22;"Prešovský kraj";439;9023;695;9718;NA;322527;1134;2020-12-22;37789
2020-12-21;"Prešovský kraj";432;9577;847;10424;NA;322527;1279;2020-12-21;36655
2020-12-20;"Prešovský kraj";184;396;20;416;NA;322527;204;2020-12-20;35376
2020-12-19;"Prešovský kraj";276;1658;151;1809;NA;322527;427;2020-12-19;35172
2020-12-18;"Prešovský kraj";396;8246;566;8812;NA;322527;962;2020-12-18;34745
2020-12-17;"Prešovský kraj";427;10505;866;11371;NA;322527;1293;2020-12-17;33783
2020-12-16;"Prešovský kraj";466;5613;473;6086;NA;322527;939;2020-12-16;32490
2020-12-15;"Prešovský kraj";411;5406;574;5980;NA;322527;985;2020-12-15;31551
2020-12-14;"Prešovský kraj";334;5538;477;6015;NA;322527;811;2020-12-14;30566
2020-12-13;"Prešovský kraj";89;29;8;37;NA;322527;97;2020-12-13;29755
2020-12-12;"Prešovský kraj";319;2474;166;2640;NA;322527;485;2020-12-12;29658
2020-12-11;"Prešovský kraj";560;5602;402;6004;NA;322527;962;2020-12-11;29173
2020-12-10;"Prešovský kraj";337;5019;423;5442;NA;322527;760;2020-12-10;28211
2020-12-09;"Prešovský kraj";358;4357;314;4671;NA;322527;672;2020-12-09;27451
2020-12-08;"Prešovský kraj";350;6629;651;7280;NA;322527;1001;2020-12-08;26779
2020-12-07;"Prešovský kraj";309;4345;327;4672;NA;322527;636;2020-12-07;25778
2020-12-06;"Prešovský kraj";59;655;26;681;NA;322527;85;2020-12-06;25142
2020-12-05;"Prešovský kraj";218;984;87;1071;NA;322527;305;2020-12-05;25057
2020-12-04;"Prešovský kraj";352;5070;293;5363;NA;322527;645;2020-12-04;24752
2020-12-03;"Prešovský kraj";284;2456;179;2635;NA;322527;463;2020-12-03;24107
2020-12-02;"Prešovský kraj";232;2830;225;3055;NA;322527;457;2020-12-02;23644
2020-12-01;"Prešovský kraj";281;1884;196;2080;NA;322527;477;2020-12-01;23187
2020-11-30;"Prešovský kraj";196;5333;97;5430;NA;322527;293;2020-11-30;22710
2020-11-29;"Prešovský kraj";27;379;42;421;NA;322527;69;2020-11-29;22417
2020-11-28;"Prešovský kraj";199;772;77;849;NA;322527;276;2020-11-28;22348
2020-11-27;"Prešovský kraj";232;2350;130;2480;NA;322527;362;2020-11-27;22072
2020-11-26;"Prešovský kraj";263;3014;329;3343;NA;322527;592;2020-11-26;21710
2020-11-25;"Prešovský kraj";302;2174;103;2277;NA;322527;405;2020-11-25;21118
2020-11-24;"Prešovský kraj";365;1777;156;1933;NA;322527;521;2020-11-24;20713
2020-11-23;"Prešovský kraj";164;1099;60;1159;NA;322527;224;2020-11-23;20192
2020-11-22;"Prešovský kraj";46;44;1;45;NA;322527;47;2020-11-22;19968
2020-11-21;"Prešovský kraj";205;754;62;816;NA;322527;267;2020-11-21;19921
2020-11-20;"Prešovský kraj";363;2258;102;2360;NA;322527;465;2020-11-20;19654
2020-11-19;"Prešovský kraj";359;2096;238;2334;NA;322527;597;2020-11-19;19189
2020-11-18;"Prešovský kraj";270;488;43;531;NA;322527;313;2020-11-18;18592
2020-11-17;"Prešovský kraj";347;205;23;228;NA;322527;370;2020-11-17;18279
2020-11-16;"Prešovský kraj";226;540;58;598;NA;322527;284;2020-11-16;17909
2020-11-15;"Prešovský kraj";186;39;4;43;NA;322527;190;2020-11-15;17625
2020-11-14;"Prešovský kraj";261;54;4;58;NA;322527;265;2020-11-14;17435
2020-11-13;"Prešovský kraj";395;166;8;174;NA;322527;403;2020-11-13;17170
2020-11-12;"Prešovský kraj";397;229;50;279;NA;322527;447;2020-11-12;16767
2020-11-11;"Prešovský kraj";516;161;15;176;NA;322527;531;2020-11-11;16320
2020-11-10;"Prešovský kraj";437;197;9;206;NA;322527;446;2020-11-10;15789
2020-11-09;"Prešovský kraj";190;4110;945;5055;NA;322527;1135;2020-11-09;15343
2020-11-08;"Prešovský kraj";97;2817;32;2849;NA;322527;129;2020-11-08;14208
2020-11-07;"Prešovský kraj";416;8578;81;8659;NA;322527;497;2020-11-07;14079
2020-11-06;"Prešovský kraj";520;4791;76;4867;NA;322527;596;2020-11-06;13582
2020-11-05;"Prešovský kraj";397;180;5;185;NA;322527;402;2020-11-05;12986
2020-11-04;"Prešovský kraj";350;807;8;815;NA;322527;358;2020-11-04;12584
2020-11-03;"Prešovský kraj";565;98;12;110;NA;322527;577;2020-11-03;12226
2020-11-02;"Prešovský kraj";203;4158;1004;5162;NA;322527;1207;2020-11-02;11649
2020-11-01;"Prešovský kraj";386;2906;53;2959;NA;322527;439;2020-11-01;10442
2020-10-31;"Prešovský kraj";315;10497;170;10667;NA;322527;485;2020-10-31;10003
2020-10-30;"Prešovský kraj";552;2949;65;3014;NA;322527;617;2020-10-30;9518
2020-10-29;"Prešovský kraj";594;301;38;339;NA;322527;632;2020-10-29;8901
2020-10-28;"Prešovský kraj";617;291;46;337;NA;322527;663;2020-10-28;8269
2020-10-27;"Prešovský kraj";656;268;34;302;NA;322527;690;2020-10-27;7606
2020-10-26;"Prešovský kraj";137;363;57;420;NA;322527;194;2020-10-26;6916
2020-10-25;"Prešovský kraj";237;346;11;357;NA;322527;248;2020-10-25;6722
2020-10-24;"Prešovský kraj";719;200;12;212;NA;322527;731;2020-10-24;6474
2020-10-23;"Prešovský kraj";750;218;8;226;NA;322527;758;2020-10-23;5743
2020-10-22;"Prešovský kraj";646;396;30;426;NA;322527;676;2020-10-22;4985
2020-10-21;"Prešovský kraj";383;58;8;66;NA;322527;391;2020-10-21;4309
2020-10-20;"Prešovský kraj";493;65;7;72;NA;322527;500;2020-10-20;3918
2020-10-19;"Prešovský kraj";140;235;15;250;NA;322527;155;2020-10-19;3418
2020-10-18;"Prešovský kraj";209;0;0;0;NA;322527;209;2020-10-18;3263
2020-10-17;"Prešovský kraj";342;0;0;0;NA;322527;342;2020-10-17;3054
2020-10-16;"Prešovský kraj";388;57;3;60;NA;322527;391;2020-10-16;2712
2020-10-15;"Prešovský kraj";435;85;18;103;NA;322527;453;2020-10-15;2321
2020-10-14;"Prešovský kraj";451;54;10;64;NA;322527;461;2020-10-14;1868
2020-10-13;"Prešovský kraj";264;50;6;56;NA;322527;270;2020-10-13;1407
2020-10-12;"Prešovský kraj";214;334;35;369;NA;322527;249;2020-10-12;1137
2020-10-11;"Prešovský kraj";127;0;0;0;NA;322527;127;2020-10-11;888
2020-10-10;"Prešovský kraj";248;0;0;0;NA;322527;248;2020-10-10;761
2020-10-09;"Prešovský kraj";406;0;0;0;NA;322527;406;2020-10-09;513
2020-10-08;"Prešovský kraj";245;0;0;0;NA;322527;245;2020-10-08;107
2020-10-07;"Prešovský kraj";244;0;0;0;NA;322527;244;2020-10-07;-138
2020-10-06;"Prešovský kraj";166;0;0;0;NA;322527;166;2020-10-06;-382
2020-10-05;"Prešovský kraj";84;0;0;0;NA;322527;84;2020-10-05;-548
2020-10-04;"Prešovský kraj";118;0;0;0;NA;322527;118;2020-10-04;-632
2020-10-03;"Prešovský kraj";204;0;0;0;NA;322527;204;2020-10-03;-750
2020-10-02;"Prešovský kraj";149;0;0;0;NA;322527;149;2020-10-02;-954
2020-10-01;"Prešovský kraj";136;0;0;0;NA;322527;136;2020-10-01;-1103
2020-09-30;"Prešovský kraj";121;0;0;0;NA;322527;121;2020-09-30;-1239
2020-09-29;"Prešovský kraj";156;0;0;0;NA;322527;156;2020-09-29;-1360
2020-09-28;"Prešovský kraj";51;0;0;0;NA;322527;51;2020-09-28;-1516
2020-09-27;"Prešovský kraj";10;0;0;0;NA;322527;10;2020-09-27;-1567
2020-09-26;"Prešovský kraj";72;0;0;0;NA;322527;72;2020-09-26;-1577
2020-09-25;"Prešovský kraj";91;0;0;0;NA;322527;91;2020-09-25;-1649
2020-09-24;"Prešovský kraj";52;0;0;0;NA;322527;52;2020-09-24;-1740
2020-09-23;"Prešovský kraj";55;0;0;0;NA;322527;55;2020-09-23;-1792
2020-09-22;"Prešovský kraj";29;0;0;0;NA;322527;29;2020-09-22;-1847
2020-09-21;"Prešovský kraj";14;0;0;0;NA;322527;14;2020-09-21;-1876
2020-09-20;"Prešovský kraj";5;0;0;0;NA;322527;5;2020-09-20;-1890
2020-09-19;"Prešovský kraj";12;0;0;0;NA;322527;12;2020-09-19;-1895
2020-09-18;"Prešovský kraj";29;0;0;0;NA;322527;29;2020-09-18;-1907
2020-09-17;"Prešovský kraj";25;0;0;0;NA;322527;25;2020-09-17;-1936
2020-09-16;"Prešovský kraj";8;0;0;0;NA;322527;8;2020-09-16;-1961
2020-09-15;"Prešovský kraj";10;0;0;0;NA;322527;10;2020-09-15;-1969
2020-09-14;"Prešovský kraj";47;0;0;0;NA;322527;47;2020-09-14;-1979
2020-09-13;"Prešovský kraj";3;0;0;0;NA;322527;3;2020-09-13;-2026
2020-09-12;"Prešovský kraj";4;0;0;0;NA;322527;4;2020-09-12;-2029
2020-09-11;"Prešovský kraj";15;0;0;0;NA;322527;15;2020-09-11;-2033
2020-09-10;"Prešovský kraj";10;0;0;0;NA;322527;10;2020-09-10;-2048
2020-09-09;"Prešovský kraj";21;0;0;0;NA;322527;21;2020-09-09;-2058
2020-09-08;"Prešovský kraj";23;0;0;0;NA;322527;23;2020-09-08;-2079
2020-09-07;"Prešovský kraj";5;0;0;0;NA;322527;5;2020-09-07;-2102
2020-09-06;"Prešovský kraj";3;0;0;0;NA;322527;3;2020-09-06;-2107
2020-09-05;"Prešovský kraj";7;0;0;0;NA;322527;7;2020-09-05;-2110
2020-09-04;"Prešovský kraj";24;0;0;0;NA;322527;24;2020-09-04;-2117
2020-09-03;"Prešovský kraj";8;0;0;0;NA;322527;8;2020-09-03;-2141
2020-09-02;"Prešovský kraj";9;0;0;0;NA;322527;9;2020-09-02;-2149
2020-09-01;"Prešovský kraj";6;0;0;0;NA;322527;6;2020-09-01;-2158
2020-08-31;"Prešovský kraj";3;0;0;0;NA;322527;3;2020-08-31;-2164
2020-08-30;"Prešovský kraj";6;0;0;0;NA;322527;6;2020-08-30;-2167
2020-08-29;"Prešovský kraj";4;0;0;0;NA;322527;4;2020-08-29;-2173
2020-08-28;"Prešovský kraj";6;0;0;0;NA;322527;6;2020-08-28;-2177
2020-08-27;"Prešovský kraj";7;0;0;0;NA;322527;7;2020-08-27;-2183
2020-08-26;"Prešovský kraj";22;0;0;0;NA;322527;22;2020-08-26;-2190
2020-08-25;"Prešovský kraj";1;0;0;0;NA;322527;1;2020-08-25;-2212
2020-08-24;"Prešovský kraj";5;0;0;0;NA;322527;5;2020-08-24;-2213
2020-08-23;"Prešovský kraj";3;0;0;0;NA;322527;3;2020-08-23;-2218
2020-08-22;"Prešovský kraj";3;0;0;0;NA;322527;3;2020-08-22;-2221
2020-08-21;"Prešovský kraj";11;0;0;0;NA;322527;11;2020-08-21;-2224
2020-08-20;"Prešovský kraj";8;0;0;0;NA;322527;8;2020-08-20;-2235
2020-08-19;"Prešovský kraj";8;0;0;0;NA;322527;8;2020-08-19;-2243
2020-08-18;"Prešovský kraj";6;0;0;0;NA;322527;6;2020-08-18;-2251
2020-08-17;"Prešovský kraj";1;0;0;0;NA;322527;1;2020-08-17;-2257
2020-08-16;"Prešovský kraj";0;0;0;0;NA;322527;0;2020-08-16;-2258
2020-08-15;"Prešovský kraj";8;0;0;0;NA;322527;8;2020-08-15;-2258
2020-08-14;"Prešovský kraj";6;0;0;0;NA;322527;6;2020-08-14;-2266
2020-08-13;"Prešovský kraj";8;0;0;0;NA;322527;8;2020-08-13;-2272
2020-08-12;"Prešovský kraj";19;0;0;0;NA;322527;19;2020-08-12;-2280
2020-08-11;"Prešovský kraj";3;0;0;0;NA;322527;3;2020-08-11;-2299
2020-08-10;"Prešovský kraj";0;0;0;0;NA;322527;0;2020-08-10;-2302
2020-08-09;"Prešovský kraj";0;0;0;0;NA;322527;0;2020-08-09;-2302
2020-08-08;"Prešovský kraj";2;0;0;0;NA;322527;2;2020-08-08;-2302
2020-08-07;"Prešovský kraj";6;0;0;0;NA;322527;6;2020-08-07;-2304
2020-08-06;"Prešovský kraj";2;0;0;0;NA;322527;2;2020-08-06;-2310
2020-08-05;"Prešovský kraj";8;0;0;0;NA;322527;8;2020-08-05;-2312
2020-08-04;"Prešovský kraj";5;0;0;0;NA;322527;5;2020-08-04;-2320
2020-08-03;"Prešovský kraj";4;0;0;0;NA;322527;4;2020-08-03;-2325
2020-08-02;"Prešovský kraj";6;0;0;0;NA;322527;6;2020-08-02;-2329
2020-08-01;"Prešovský kraj";0;0;0;0;NA;322527;0;2020-08-01;-2335
2020-07-31;"Prešovský kraj";2;0;0;0;NA;322527;2;2020-07-31;-2335
2020-07-30;"Prešovský kraj";6;0;0;0;NA;322527;6;2020-07-30;-2337
2020-07-29;"Prešovský kraj";5;0;0;0;NA;322527;5;2020-07-29;-2343
2020-07-28;"Prešovský kraj";0;0;0;0;NA;322527;0;2020-07-28;-2348
2020-07-27;"Prešovský kraj";1;0;0;0;NA;322527;1;2020-07-27;-2348
2020-07-26;"Prešovský kraj";1;0;0;0;NA;322527;1;2020-07-26;-2349
2020-07-25;"Prešovský kraj";21;0;0;0;NA;322527;21;2020-07-25;-2350
2020-07-24;"Prešovský kraj";1;0;0;0;NA;322527;1;2020-07-24;-2371
2020-07-23;"Prešovský kraj";5;0;0;0;NA;322527;5;2020-07-23;-2372
2020-07-22;"Prešovský kraj";1;0;0;0;NA;322527;1;2020-07-22;-2377
2020-07-21;"Prešovský kraj";2;0;0;0;NA;322527;2;2020-07-21;-2378
2020-07-20;"Prešovský kraj";1;0;0;0;NA;322527;1;2020-07-20;-2380
2020-07-19;"Prešovský kraj";0;0;0;0;NA;322527;0;2020-07-19;-2381
2020-07-18;"Prešovský kraj";0;0;0;0;NA;322527;0;2020-07-18;-2381
2020-07-17;"Prešovský kraj";3;0;0;0;NA;322527;3;2020-07-17;-2381
2020-07-16;"Prešovský kraj";1;0;0;0;NA;322527;1;2020-07-16;-2384
2020-07-15;"Prešovský kraj";5;0;0;0;NA;322527;5;2020-07-15;-2385
2020-07-14;"Prešovský kraj";5;0;0;0;NA;322527;5;2020-07-14;-2390
2020-07-13;"Prešovský kraj";1;0;0;0;NA;322527;1;2020-07-13;-2395
2020-07-12;"Prešovský kraj";1;0;0;0;NA;322527;1;2020-07-12;-2396
2020-07-11;"Prešovský kraj";6;0;0;0;NA;322527;6;2020-07-11;-2397
2020-07-10;"Prešovský kraj";5;0;0;0;NA;322527;5;2020-07-10;-2403
2020-07-09;"Prešovský kraj";2;0;0;0;NA;322527;2;2020-07-09;-2408
2020-07-08;"Prešovský kraj";14;0;0;0;NA;322527;14;2020-07-08;-2410
2020-07-07;"Prešovský kraj";2;0;0;0;NA;322527;2;2020-07-07;-2424
2020-07-06;"Prešovský kraj";0;0;0;0;NA;322527;0;2020-07-06;-2426
2020-07-05;"Prešovský kraj";0;0;0;0;NA;322527;0;2020-07-05;-2426
2020-07-04;"Prešovský kraj";1;0;0;0;NA;322527;1;2020-07-04;-2426
2020-07-03;"Prešovský kraj";3;0;0;0;NA;322527;3;2020-07-03;-2427
2020-07-02;"Prešovský kraj";0;0;0;0;NA;322527;0;2020-07-02;-2430
2020-07-01;"Prešovský kraj";0;0;0;0;NA;322527;0;2020-07-01;-2430
2020-06-30;"Prešovský kraj";7;0;0;0;NA;322527;7;2020-06-30;-2430
2020-06-29;"Prešovský kraj";0;0;0;0;NA;322527;0;2020-06-29;-2437
2020-06-28;"Prešovský kraj";0;0;0;0;NA;322527;0;2020-06-28;-2437
2020-06-27;"Prešovský kraj";3;0;0;0;NA;322527;3;2020-06-27;-2437
2020-06-26;"Prešovský kraj";3;0;0;0;NA;322527;3;2020-06-26;-2440
2020-06-25;"Prešovský kraj";0;0;0;0;NA;322527;0;2020-06-25;-2443
2020-06-24;"Prešovský kraj";4;0;0;0;NA;322527;4;2020-06-24;-2443
2020-06-23;"Prešovský kraj";0;0;0;0;NA;322527;0;2020-06-23;-2447
2020-06-22;"Prešovský kraj";0;0;0;0;NA;322527;0;2020-06-22;-2447
2020-06-21;"Prešovský kraj";0;0;0;0;NA;322527;0;2020-06-21;-2447
2020-06-20;"Prešovský kraj";0;0;0;0;NA;322527;0;2020-06-20;-2447
2020-06-19;"Prešovský kraj";1;0;0;0;NA;322527;1;2020-06-19;-2447
2020-06-18;"Prešovský kraj";0;0;0;0;NA;322527;0;2020-06-18;-2448
2020-06-17;"Prešovský kraj";0;0;0;0;NA;322527;0;2020-06-17;-2448
2020-06-16;"Prešovský kraj";6;0;0;0;NA;322527;6;2020-06-16;-2448
2020-06-14;"Prešovský kraj";0;0;0;0;NA;322527;0;2020-06-14;-2454
2020-06-13;"Prešovský kraj";0;0;0;0;NA;322527;0;2020-06-13;-2454
2020-06-12;"Prešovský kraj";1;0;0;0;NA;322527;1;2020-06-12;-2454
2020-06-11;"Prešovský kraj";0;0;0;0;NA;322527;0;2020-06-11;-2455
2020-06-10;"Prešovský kraj";0;0;0;0;NA;322527;0;2020-06-10;-2455
2020-06-09;"Prešovský kraj";0;0;0;0;NA;322527;0;2020-06-09;-2455
2020-06-08;"Prešovský kraj";0;0;0;0;NA;322527;0;2020-06-08;-2455
2020-06-07;"Prešovský kraj";0;0;0;0;NA;322527;0;2020-06-07;-2455
2020-06-05;"Prešovský kraj";0;0;0;0;NA;322527;0;2020-06-05;-2455
2020-06-03;"Prešovský kraj";0;0;0;0;NA;322527;0;2020-06-03;-2455
2020-06-02;"Prešovský kraj";1;0;0;0;NA;322527;1;2020-06-02;-2455
2020-05-31;"Prešovský kraj";1;0;0;0;NA;322527;1;2020-05-31;-2456
2020-05-29;"Prešovský kraj";0;0;0;0;NA;322527;0;2020-05-29;-2457
2020-05-27;"Prešovský kraj";0;0;0;0;NA;322527;0;2020-05-27;-2457
2020-05-26;"Prešovský kraj";0;0;0;0;NA;322527;0;2020-05-26;-2457
2020-05-25;"Prešovský kraj";0;0;0;0;NA;322527;0;2020-05-25;-2457
2020-05-24;"Prešovský kraj";0;0;0;0;NA;322527;0;2020-05-24;-2457
2020-05-23;"Prešovský kraj";0;0;0;0;NA;322527;0;2020-05-23;-2457
2020-05-22;"Prešovský kraj";0;0;0;0;NA;322527;0;2020-05-22;-2457
2020-05-21;"Prešovský kraj";1;0;0;0;NA;322527;1;2020-05-21;-2457
2020-05-20;"Prešovský kraj";0;0;0;0;NA;322527;0;2020-05-20;-2458
2020-05-19;"Prešovský kraj";0;0;0;0;NA;322527;0;2020-05-19;-2458
2020-05-17;"Prešovský kraj";0;0;0;0;NA;322527;0;2020-05-17;-2458
2020-05-16;"Prešovský kraj";0;0;0;0;NA;322527;0;2020-05-16;-2458
2020-05-15;"Prešovský kraj";0;0;0;0;NA;322527;0;2020-05-15;-2458
2020-05-14;"Prešovský kraj";0;0;0;0;NA;322527;0;2020-05-14;-2458
2020-05-13;"Prešovský kraj";1;0;0;0;NA;322527;1;2020-05-13;-2458
2020-05-12;"Prešovský kraj";0;0;0;0;NA;322527;0;2020-05-12;-2459
2020-05-11;"Prešovský kraj";1;0;0;0;NA;322527;1;2020-05-11;-2459
2020-05-09;"Prešovský kraj";0;0;0;0;NA;322527;0;2020-05-09;-2460
2020-05-07;"Prešovský kraj";0;0;0;0;NA;322527;0;2020-05-07;-2460
2020-05-06;"Prešovský kraj";0;0;0;0;NA;322527;0;2020-05-06;-2460
2020-05-05;"Prešovský kraj";1;0;0;0;NA;322527;1;2020-05-05;-2460
2020-05-04;"Prešovský kraj";0;0;0;0;NA;322527;0;2020-05-04;-2461
2020-05-03;"Prešovský kraj";0;0;0;0;NA;322527;0;2020-05-03;-2461
2020-05-02;"Prešovský kraj";0;0;0;0;NA;322527;0;2020-05-02;-2461
2020-05-01;"Prešovský kraj";2;0;0;0;NA;322527;2;2020-05-01;-2461
2020-04-30;"Prešovský kraj";0;0;0;0;NA;322527;0;2020-04-30;-2463
2020-04-29;"Prešovský kraj";1;0;0;0;NA;322527;1;2020-04-29;-2463
2020-04-28;"Prešovský kraj";1;0;0;0;NA;322527;1;2020-04-28;-2464
2020-04-27;"Prešovský kraj";2;0;0;0;NA;322527;2;2020-04-27;-2465
2020-04-26;"Prešovský kraj";0;0;0;0;NA;322527;0;2020-04-26;-2467
2020-04-25;"Prešovský kraj";0;0;0;0;NA;322527;0;2020-04-25;-2467
2020-04-24;"Prešovský kraj";0;0;0;0;NA;322527;0;2020-04-24;-2467
2020-04-23;"Prešovský kraj";2;0;0;0;NA;322527;2;2020-04-23;-2467
2020-04-22;"Prešovský kraj";11;0;0;0;NA;322527;11;2020-04-22;-2469
2020-04-21;"Prešovský kraj";12;0;0;0;NA;322527;12;2020-04-21;-2480
2020-04-20;"Prešovský kraj";2;0;0;0;NA;322527;2;2020-04-20;-2492
2020-04-19;"Prešovský kraj";4;0;0;0;NA;322527;4;2020-04-19;-2494
2020-04-18;"Prešovský kraj";1;0;0;0;NA;322527;1;2020-04-18;-2498
2020-04-17;"Prešovský kraj";4;0;0;0;NA;322527;4;2020-04-17;-2499
2020-04-16;"Prešovský kraj";9;0;0;0;NA;322527;9;2020-04-16;-2503
2020-04-15;"Prešovský kraj";21;0;0;0;NA;322527;21;2020-04-15;-2512
2020-04-14;"Prešovský kraj";1;0;0;0;NA;322527;1;2020-04-14;-2533
2020-04-13;"Prešovský kraj";2;0;0;0;NA;322527;2;2020-04-13;-2534
2020-04-12;"Prešovský kraj";6;0;0;0;NA;322527;6;2020-04-12;-2536
2020-04-11;"Prešovský kraj";4;0;0;0;NA;322527;4;2020-04-11;-2542
2020-04-10;"Prešovský kraj";0;0;0;0;NA;322527;0;2020-04-10;-2546
2020-04-09;"Prešovský kraj";1;0;0;0;NA;322527;1;2020-04-09;-2546
2020-04-08;"Prešovský kraj";0;0;0;0;NA;322527;0;2020-04-08;-2547
2020-04-07;"Prešovský kraj";7;0;0;0;NA;322527;7;2020-04-07;-2547
2020-04-06;"Prešovský kraj";10;0;0;0;NA;322527;10;2020-04-06;-2554
2020-04-05;"Prešovský kraj";13;0;0;0;NA;322527;13;2020-04-05;-2564
2020-04-04;"Prešovský kraj";1;0;0;0;NA;322527;1;2020-04-04;-2577
2020-04-03;"Prešovský kraj";4;0;0;0;NA;322527;4;2020-04-03;-2578
2020-04-02;"Prešovský kraj";6;0;0;0;NA;322527;6;2020-04-02;-2582
2020-04-01;"Prešovský kraj";6;0;0;0;NA;322527;6;2020-04-01;-2588
2020-03-31;"Prešovský kraj";6;0;0;0;NA;322527;6;2020-03-31;-2594
2020-03-30;"Prešovský kraj";2;0;0;0;NA;322527;2;2020-03-30;-2600
2020-03-29;"Prešovský kraj";2;0;0;0;NA;322527;2;2020-03-29;-2602
2020-03-28;"Prešovský kraj";2;0;0;0;NA;322527;2;2020-03-28;-2604
2020-03-27;"Prešovský kraj";1;0;0;0;NA;322527;1;2020-03-27;-2606
2020-03-26;"Prešovský kraj";8;0;0;0;NA;322527;8;2020-03-26;-2607
2020-03-25;"Prešovský kraj";1;0;0;0;NA;322527;1;2020-03-25;-2615
2020-03-24;"Prešovský kraj";4;0;0;0;NA;322527;4;2020-03-24;-2616
2020-03-23;"Prešovský kraj";0;0;0;0;NA;322527;0;2020-03-23;-2620
2020-03-22;"Prešovský kraj";1;0;0;0;NA;322527;1;2020-03-22;-2620
2020-03-21;"Prešovský kraj";2;0;0;0;NA;322527;2;2020-03-21;-2621
2020-03-20;"Prešovský kraj";3;0;0;0;NA;322527;3;2020-03-20;-2623
2020-03-19;"Prešovský kraj";2;0;0;0;NA;322527;2;2020-03-19;-2626
2020-03-18;"Prešovský kraj";1;0;0;0;NA;322527;1;2020-03-18;-2628
2020-03-17;"Prešovský kraj";1;0;0;0;NA;322527;1;2020-03-17;-2629
2020-03-16;"Prešovský kraj";4;0;0;0;NA;322527;4;2020-03-16;-2630
2020-03-15;"Prešovský kraj";0;0;0;0;NA;322527;0;2020-03-15;-2634
2020-03-14;"Prešovský kraj";1;0;0;0;NA;322527;1;2020-03-14;-2634
2020-03-13;"Prešovský kraj";0;0;0;0;NA;322527;0;2020-03-13;-2635
2020-03-12;"Prešovský kraj";0;0;0;0;NA;322527;0;2020-03-12;-2635
2020-03-11;"Prešovský kraj";0;0;0;0;NA;322527;0;2020-03-11;-2635
2020-03-09;"Prešovský kraj";0;0;0;0;NA;322527;0;2020-03-09;-2635
2020-03-08;"Prešovský kraj";0;0;0;0;NA;322527;0;2020-03-08;-2635
2020-03-07;"Prešovský kraj";0;0;0;0;NA;322527;0;2020-03-07;-2635
2020-03-06;"Prešovský kraj";0;0;0;0;NA;322527;0;2020-03-06;-2635
2022-03-08;"Trenčiansky kraj";1059;0;0;0;186171;269163;1059;2022-03-08;269163
2022-03-07;"Trenčiansky kraj";1079;1;0;1;NA;269163;1079;2022-03-07;268104
2022-03-06;"Trenčiansky kraj";354;530;79;609;NA;269163;433;2022-03-06;267025
2022-03-05;"Trenčiansky kraj";583;535;115;650;NA;269163;698;2022-03-05;266592
2022-03-04;"Trenčiansky kraj";1125;950;159;1109;NA;269163;1284;2022-03-04;265894
2022-03-03;"Trenčiansky kraj";1346;1462;197;1659;NA;269163;1543;2022-03-03;264610
2022-03-02;"Trenčiansky kraj";1345;1451;221;1672;NA;269163;1566;2022-03-02;263067
2022-03-01;"Trenčiansky kraj";1409;1551;276;1827;NA;269163;1685;2022-03-01;261501
2022-02-28;"Trenčiansky kraj";1390;2381;363;2744;NA;269163;1753;2022-02-28;259816
2022-02-27;"Trenčiansky kraj";573;1043;218;1261;NA;269163;791;2022-02-27;258063
2022-02-26;"Trenčiansky kraj";934;784;147;931;NA;269163;1081;2022-02-26;257272
2022-02-25;"Trenčiansky kraj";1460;1420;271;1691;NA;269163;1731;2022-02-25;256191
2022-02-24;"Trenčiansky kraj";1372;2288;274;2562;NA;269163;1646;2022-02-24;254460
2022-02-23;"Trenčiansky kraj";1677;1894;291;2185;NA;269163;1968;2022-02-23;252814
2022-02-22;"Trenčiansky kraj";2073;2075;418;2493;NA;269163;2491;2022-02-22;250846
2022-02-21;"Trenčiansky kraj";2172;3615;547;4162;NA;269163;2719;2022-02-21;248355
2022-02-20;"Trenčiansky kraj";1079;1436;322;1758;NA;269163;1401;2022-02-20;245636
2022-02-19;"Trenčiansky kraj";1168;1008;244;1252;NA;269163;1412;2022-02-19;244235
2022-02-18;"Trenčiansky kraj";2456;2175;440;2615;NA;269163;2896;2022-02-18;242823
2022-02-17;"Trenčiansky kraj";2090;2540;388;2928;NA;269163;2478;2022-02-17;239927
2022-02-16;"Trenčiansky kraj";2928;2286;469;2755;NA;269163;3397;2022-02-16;237449
2022-02-15;"Trenčiansky kraj";2372;2408;534;2942;NA;269163;2906;2022-02-15;234052
2022-02-14;"Trenčiansky kraj";2401;3916;686;4602;NA;269163;3087;2022-02-14;231146
2022-02-13;"Trenčiansky kraj";1357;1777;454;2231;NA;269163;1811;2022-02-13;228059
2022-02-12;"Trenčiansky kraj";1802;1448;277;1725;NA;269163;2079;2022-02-12;226248
2022-02-11;"Trenčiansky kraj";2863;2376;456;2832;NA;269163;3319;2022-02-11;224169
2022-02-10;"Trenčiansky kraj";2853;2529;462;2991;NA;269163;3315;2022-02-10;220850
2022-02-09;"Trenčiansky kraj";2788;4158;559;4717;NA;269163;3347;2022-02-09;217535
2022-02-08;"Trenčiansky kraj";2592;2986;621;3607;NA;269163;3213;2022-02-08;214188
2022-02-07;"Trenčiansky kraj";2787;4731;862;5593;NA;269163;3649;2022-02-07;210975
2022-02-06;"Trenčiansky kraj";1431;2181;472;2653;NA;269163;1903;2022-02-06;207326
2022-02-05;"Trenčiansky kraj";1458;1689;323;2012;NA;269163;1781;2022-02-05;205423
2022-02-04;"Trenčiansky kraj";2480;3036;483;3519;NA;269163;2963;2022-02-04;203642
2022-02-03;"Trenčiansky kraj";2391;3381;462;3843;NA;269163;2853;2022-02-03;200679
2022-02-02;"Trenčiansky kraj";2486;4411;563;4974;NA;269163;3049;2022-02-02;197826
2022-02-01;"Trenčiansky kraj";2359;3701;509;4210;NA;269163;2868;2022-02-01;194777
2022-01-31;"Trenčiansky kraj";1823;7070;627;7697;NA;269163;2450;2022-01-31;191909
2022-01-30;"Trenčiansky kraj";680;2463;319;2782;NA;269163;999;2022-01-30;189459
2022-01-29;"Trenčiansky kraj";1227;1772;227;1999;NA;269163;1454;2022-01-29;188460
2022-01-28;"Trenčiansky kraj";1709;3602;322;3924;NA;269163;2031;2022-01-28;187006
2022-01-27;"Trenčiansky kraj";1533;3414;322;3736;NA;269163;1855;2022-01-27;184975
2022-01-26;"Trenčiansky kraj";1415;4533;311;4844;NA;269163;1726;2022-01-26;183120
2022-01-25;"Trenčiansky kraj";1553;3168;258;3426;NA;269163;1811;2022-01-25;181394
2022-01-24;"Trenčiansky kraj";755;6691;290;6981;NA;269163;1045;2022-01-24;179583
2022-01-23;"Trenčiansky kraj";337;2409;179;2588;NA;269163;516;2022-01-23;178538
2022-01-22;"Trenčiansky kraj";683;1675;103;1778;NA;269163;786;2022-01-22;178022
2022-01-21;"Trenčiansky kraj";576;3394;139;3533;NA;269163;715;2022-01-21;177236
2022-01-20;"Trenčiansky kraj";710;2578;104;2682;NA;269163;814;2022-01-20;176521
2022-01-19;"Trenčiansky kraj";621;3627;111;3738;NA;269163;732;2022-01-19;175707
2022-01-18;"Trenčiansky kraj";579;3455;101;3556;NA;269163;680;2022-01-18;174975
2022-01-17;"Trenčiansky kraj";380;6158;122;6280;NA;269163;502;2022-01-17;174295
2022-01-16;"Trenčiansky kraj";89;2319;72;2391;NA;269163;161;2022-01-16;173793
2022-01-15;"Trenčiansky kraj";194;1345;40;1385;NA;269163;234;2022-01-15;173632
2022-01-14;"Trenčiansky kraj";189;2755;48;2803;NA;269163;237;2022-01-14;173398
2022-01-13;"Trenčiansky kraj";134;3201;62;3263;NA;269163;196;2022-01-13;173161
2022-01-12;"Trenčiansky kraj";346;2953;53;3006;NA;269163;399;2022-01-12;172965
2022-01-11;"Trenčiansky kraj";300;2896;50;2946;NA;269163;350;2022-01-11;172566
2022-01-10;"Trenčiansky kraj";218;6882;81;6963;NA;269163;299;2022-01-10;172216
2022-01-09;"Trenčiansky kraj";40;2808;52;2860;NA;269163;92;2022-01-09;171917
2022-01-08;"Trenčiansky kraj";267;1601;45;1646;NA;269163;312;2022-01-08;171825
2022-01-07;"Trenčiansky kraj";334;2717;64;2781;NA;269163;398;2022-01-07;171513
2022-01-06;"Trenčiansky kraj";75;1111;45;1156;NA;269163;120;2022-01-06;171115
2022-01-05;"Trenčiansky kraj";496;2875;64;2939;NA;269163;560;2022-01-05;170995
2022-01-04;"Trenčiansky kraj";521;3760;73;3833;NA;269163;594;2022-01-04;170435
2022-01-03;"Trenčiansky kraj";357;5680;117;5797;NA;269163;474;2022-01-03;169841
2022-01-02;"Trenčiansky kraj";179;2403;74;2477;NA;269163;253;2022-01-02;169367
2022-01-01;"Trenčiansky kraj";4;526;28;554;NA;269163;32;2022-01-01;169114
2021-12-31;"Trenčiansky kraj";443;1426;77;1503;NA;269163;520;2021-12-31;169082
2021-12-30;"Trenčiansky kraj";370;2351;126;2477;NA;269163;496;2021-12-30;168562
2021-12-29;"Trenčiansky kraj";429;2436;83;2519;NA;269163;512;2021-12-29;168066
2021-12-28;"Trenčiansky kraj";609;2696;108;2804;NA;269163;717;2021-12-28;167554
2021-12-27;"Trenčiansky kraj";546;3200;100;3300;NA;269163;646;2021-12-27;166837
2021-12-26;"Trenčiansky kraj";147;1098;78;1176;NA;269163;225;2021-12-26;166191
2021-12-25;"Trenčiansky kraj";52;503;27;530;NA;269163;79;2021-12-25;165966
2021-12-24;"Trenčiansky kraj";176;652;37;689;NA;269163;213;2021-12-24;165887
2021-12-23;"Trenčiansky kraj";532;2380;103;2483;NA;269163;635;2021-12-23;165674
2021-12-22;"Trenčiansky kraj";512;2546;116;2662;NA;269163;628;2021-12-22;165039
2021-12-21;"Trenčiansky kraj";694;3219;119;3338;NA;269163;813;2021-12-21;164411
2021-12-20;"Trenčiansky kraj";488;6613;200;6813;NA;269163;688;2021-12-20;163598
2021-12-19;"Trenčiansky kraj";202;2574;118;2692;NA;269163;320;2021-12-19;162910
2021-12-18;"Trenčiansky kraj";438;1752;108;1860;NA;269163;546;2021-12-18;162590
2021-12-17;"Trenčiansky kraj";427;4006;135;4141;NA;269163;562;2021-12-17;162044
2021-12-16;"Trenčiansky kraj";649;3169;177;3346;NA;269163;826;2021-12-16;161482
2021-12-15;"Trenčiansky kraj";791;4596;165;4761;NA;269163;956;2021-12-15;160656
2021-12-14;"Trenčiansky kraj";885;3590;139;3729;NA;269163;1024;2021-12-14;159700
2021-12-13;"Trenčiansky kraj";573;7310;247;7557;NA;269163;820;2021-12-13;158676
2021-12-12;"Trenčiansky kraj";306;3156;156;3312;NA;269163;462;2021-12-12;157856
2021-12-11;"Trenčiansky kraj";706;1876;138;2014;NA;269163;844;2021-12-11;157394
2021-12-10;"Trenčiansky kraj";789;3643;199;3842;NA;269163;988;2021-12-10;156550
2021-12-09;"Trenčiansky kraj";967;3847;202;4049;NA;269163;1169;2021-12-09;155562
2021-12-08;"Trenčiansky kraj";1020;4428;201;4629;NA;269163;1221;2021-12-08;154393
2021-12-07;"Trenčiansky kraj";1241;6232;214;6446;NA;269163;1455;2021-12-07;153172
2021-12-06;"Trenčiansky kraj";751;8778;421;9199;NA;269163;1172;2021-12-06;151717
2021-12-05;"Trenčiansky kraj";510;3610;210;3820;NA;269163;720;2021-12-05;150545
2021-12-04;"Trenčiansky kraj";1058;2043;156;2199;NA;269163;1214;2021-12-04;149825
2021-12-03;"Trenčiansky kraj";1272;4379;304;4683;NA;269163;1576;2021-12-03;148611
2021-12-02;"Trenčiansky kraj";2007;4087;263;4350;NA;269163;2270;2021-12-02;147035
2021-12-01;"Trenčiansky kraj";1000;4935;296;5231;NA;269163;1296;2021-12-01;144765
2021-11-30;"Trenčiansky kraj";1086;4702;329;5031;NA;269163;1415;2021-11-30;143469
2021-11-29;"Trenčiansky kraj";1165;10325;540;10865;NA;269163;1705;2021-11-29;142054
2021-11-28;"Trenčiansky kraj";664;5566;308;5874;NA;269163;972;2021-11-28;140349
2021-11-27;"Trenčiansky kraj";1080;2782;301;3083;NA;269163;1381;2021-11-27;139377
2021-11-26;"Trenčiansky kraj";1238;4493;346;4839;NA;269163;1584;2021-11-26;137996
2021-11-25;"Trenčiansky kraj";1018;3590;343;3933;NA;269163;1361;2021-11-25;136412
2021-11-24;"Trenčiansky kraj";1362;5559;466;6025;NA;269163;1828;2021-11-24;135051
2021-11-23;"Trenčiansky kraj";1140;3717;347;4064;NA;269163;1487;2021-11-23;133223
2021-11-22;"Trenčiansky kraj";920;6467;566;7033;NA;269163;1486;2021-11-22;131736
2021-11-21;"Trenčiansky kraj";413;3233;377;3610;NA;269163;790;2021-11-21;130250
2021-11-20;"Trenčiansky kraj";914;2379;341;2720;NA;269163;1255;2021-11-20;129460
2021-11-19;"Trenčiansky kraj";1261;3785;445;4230;NA;269163;1706;2021-11-19;128205
2021-11-18;"Trenčiansky kraj";810;5024;524;5548;NA;269163;1334;2021-11-18;126499
2021-11-17;"Trenčiansky kraj";796;1852;237;2089;NA;269163;1033;2021-11-17;125165
2021-11-16;"Trenčiansky kraj";859;4060;401;4461;NA;269163;1260;2021-11-16;124132
2021-11-15;"Trenčiansky kraj";720;5114;550;5664;NA;269163;1270;2021-11-15;122872
2021-11-14;"Trenčiansky kraj";447;2462;343;2805;NA;269163;790;2021-11-14;121602
2021-11-13;"Trenčiansky kraj";478;1879;254;2133;NA;269163;732;2021-11-13;120812
2021-11-12;"Trenčiansky kraj";784;3855;338;4193;NA;269163;1122;2021-11-12;120080
2021-11-11;"Trenčiansky kraj";805;3561;345;3906;NA;269163;1150;2021-11-11;118958
2021-11-10;"Trenčiansky kraj";647;3358;279;3637;NA;269163;926;2021-11-10;117808
2021-11-09;"Trenčiansky kraj";752;2886;304;3190;NA;269163;1056;2021-11-09;116882
2021-11-08;"Trenčiansky kraj";489;4643;348;4991;NA;269163;837;2021-11-08;115826
2021-11-07;"Trenčiansky kraj";405;2043;220;2263;NA;269163;625;2021-11-07;114989
2021-11-06;"Trenčiansky kraj";542;1755;176;1931;NA;269163;718;2021-11-06;114364
2021-11-05;"Trenčiansky kraj";677;3083;238;3321;NA;269163;915;2021-11-05;113646
2021-11-04;"Trenčiansky kraj";563;2713;229;2942;NA;269163;792;2021-11-04;112731
2021-11-03;"Trenčiansky kraj";619;2955;222;3177;NA;269163;841;2021-11-03;111939
2021-11-02;"Trenčiansky kraj";663;3808;309;4117;NA;269163;972;2021-11-02;111098
2021-11-01;"Trenčiansky kraj";219;1029;101;1130;NA;269163;320;2021-11-01;110126
2021-10-31;"Trenčiansky kraj";151;1462;152;1614;NA;269163;303;2021-10-31;109806
2021-10-30;"Trenčiansky kraj";345;1770;130;1900;NA;269163;475;2021-10-30;109503
2021-10-29;"Trenčiansky kraj";415;2860;129;2989;NA;269163;544;2021-10-29;109028
2021-10-28;"Trenčiansky kraj";429;2653;157;2810;NA;269163;586;2021-10-28;108484
2021-10-27;"Trenčiansky kraj";463;2612;93;2705;NA;269163;556;2021-10-27;107898
2021-10-26;"Trenčiansky kraj";419;2635;133;2768;NA;269163;552;2021-10-26;107342
2021-10-25;"Trenčiansky kraj";192;3370;130;3500;NA;269163;322;2021-10-25;106790
2021-10-24;"Trenčiansky kraj";121;1643;79;1722;NA;269163;200;2021-10-24;106468
2021-10-23;"Trenčiansky kraj";326;1737;64;1801;NA;269163;390;2021-10-23;106268
2021-10-22;"Trenčiansky kraj";358;2694;78;2772;NA;269163;436;2021-10-22;105878
2021-10-21;"Trenčiansky kraj";247;2343;74;2417;NA;269163;321;2021-10-21;105442
2021-10-20;"Trenčiansky kraj";302;2101;70;2171;NA;269163;372;2021-10-20;105121
2021-10-19;"Trenčiansky kraj";227;2847;59;2906;NA;269163;286;2021-10-19;104749
2021-10-18;"Trenčiansky kraj";143;2453;71;2524;NA;269163;214;2021-10-18;104463
2021-10-17;"Trenčiansky kraj";46;1457;31;1488;NA;269163;77;2021-10-17;104249
2021-10-16;"Trenčiansky kraj";76;1671;35;1706;NA;269163;111;2021-10-16;104172
2021-10-15;"Trenčiansky kraj";126;2925;50;2975;NA;269163;176;2021-10-15;104061
2021-10-14;"Trenčiansky kraj";103;1717;27;1744;NA;269163;130;2021-10-14;103885
2021-10-13;"Trenčiansky kraj";171;2656;28;2684;NA;269163;199;2021-10-13;103755
2021-10-12;"Trenčiansky kraj";114;2350;32;2382;NA;269163;146;2021-10-12;103556
2021-10-11;"Trenčiansky kraj";109;2541;48;2589;NA;269163;157;2021-10-11;103410
2021-10-10;"Trenčiansky kraj";17;1487;23;1510;NA;269163;40;2021-10-10;103253
2021-10-09;"Trenčiansky kraj";157;1809;16;1825;NA;269163;173;2021-10-09;103213
2021-10-08;"Trenčiansky kraj";82;3087;37;3124;NA;269163;119;2021-10-08;103040
2021-10-07;"Trenčiansky kraj";107;2039;30;2069;NA;269163;137;2021-10-07;102921
2021-10-06;"Trenčiansky kraj";193;2289;36;2325;NA;269163;229;2021-10-06;102784
2021-10-05;"Trenčiansky kraj";119;2229;40;2269;NA;269163;159;2021-10-05;102555
2021-10-04;"Trenčiansky kraj";105;2769;52;2821;NA;269163;157;2021-10-04;102396
2021-10-03;"Trenčiansky kraj";30;1558;27;1585;NA;269163;57;2021-10-03;102239
2021-10-02;"Trenčiansky kraj";107;1794;35;1829;NA;269163;142;2021-10-02;102182
2021-10-01;"Trenčiansky kraj";119;2690;37;2727;NA;269163;156;2021-10-01;102040
2021-09-30;"Trenčiansky kraj";74;2327;50;2377;NA;269163;124;2021-09-30;101884
2021-09-29;"Trenčiansky kraj";170;2150;30;2180;NA;269163;200;2021-09-29;101760
2021-09-28;"Trenčiansky kraj";95;2267;31;2298;NA;269163;126;2021-09-28;101560
2021-09-27;"Trenčiansky kraj";56;2813;57;2870;NA;269163;113;2021-09-27;101434
2021-09-26;"Trenčiansky kraj";20;1675;33;1708;NA;269163;53;2021-09-26;101321
2021-09-25;"Trenčiansky kraj";76;1674;21;1695;NA;269163;97;2021-09-25;101268
2021-09-24;"Trenčiansky kraj";104;3220;35;3255;NA;269163;139;2021-09-24;101171
2021-09-23;"Trenčiansky kraj";91;2251;27;2278;NA;269163;118;2021-09-23;101032
2021-09-22;"Trenčiansky kraj";90;2146;24;2170;NA;269163;114;2021-09-22;100914
2021-09-21;"Trenčiansky kraj";79;2307;29;2336;NA;269163;108;2021-09-21;100800
2021-09-20;"Trenčiansky kraj";78;2612;37;2649;NA;269163;115;2021-09-20;100692
2021-09-19;"Trenčiansky kraj";11;1571;20;1591;NA;269163;31;2021-09-19;100577
2021-09-18;"Trenčiansky kraj";53;2099;14;2113;NA;269163;67;2021-09-18;100546
2021-09-17;"Trenčiansky kraj";55;3143;26;3169;NA;269163;81;2021-09-17;100479
2021-09-16;"Trenčiansky kraj";52;2160;20;2180;NA;269163;72;2021-09-16;100398
2021-09-15;"Trenčiansky kraj";63;1043;7;1050;NA;269163;70;2021-09-15;100326
2021-09-14;"Trenčiansky kraj";67;2449;25;2474;NA;269163;92;2021-09-14;100256
2021-09-13;"Trenčiansky kraj";33;2271;35;2306;NA;269163;68;2021-09-13;100164
2021-09-12;"Trenčiansky kraj";3;1411;11;1422;NA;269163;14;2021-09-12;100096
2021-09-11;"Trenčiansky kraj";55;1729;6;1735;NA;269163;61;2021-09-11;100082
2021-09-10;"Trenčiansky kraj";49;2246;15;2261;NA;269163;64;2021-09-10;100021
2021-09-09;"Trenčiansky kraj";24;1684;30;1714;NA;269163;54;2021-09-09;99957
2021-09-08;"Trenčiansky kraj";54;1770;15;1785;NA;269163;69;2021-09-08;99903
2021-09-07;"Trenčiansky kraj";43;1393;18;1411;NA;269163;61;2021-09-07;99834
2021-09-06;"Trenčiansky kraj";47;1398;15;1413;NA;269163;62;2021-09-06;99773
2021-09-05;"Trenčiansky kraj";2;966;23;989;NA;269163;25;2021-09-05;99711
2021-09-04;"Trenčiansky kraj";41;925;4;929;NA;269163;45;2021-09-04;99686
2021-09-03;"Trenčiansky kraj";53;1421;15;1436;NA;269163;68;2021-09-03;99641
2021-09-02;"Trenčiansky kraj";7;999;14;1013;NA;269163;21;2021-09-02;99573
2021-09-01;"Trenčiansky kraj";27;431;8;439;NA;269163;35;2021-09-01;99552
2021-08-31;"Trenčiansky kraj";21;1146;15;1161;NA;269163;36;2021-08-31;99517
2021-08-30;"Trenčiansky kraj";32;1166;10;1176;NA;269163;42;2021-08-30;99481
2021-08-29;"Trenčiansky kraj";1;482;11;493;NA;269163;12;2021-08-29;99439
2021-08-28;"Trenčiansky kraj";9;976;10;986;NA;269163;19;2021-08-28;99427
2021-08-27;"Trenčiansky kraj";21;1599;1;1600;NA;269163;22;2021-08-27;99408
2021-08-26;"Trenčiansky kraj";8;992;6;998;NA;269163;14;2021-08-26;99386
2021-08-25;"Trenčiansky kraj";40;875;7;882;NA;269163;47;2021-08-25;99372
2021-08-24;"Trenčiansky kraj";4;822;4;826;NA;269163;8;2021-08-24;99325
2021-08-23;"Trenčiansky kraj";6;1165;17;1182;NA;269163;23;2021-08-23;99317
2021-08-22;"Trenčiansky kraj";0;726;10;736;NA;269163;10;2021-08-22;99294
2021-08-21;"Trenčiansky kraj";5;964;7;971;NA;269163;12;2021-08-21;99284
2021-08-20;"Trenčiansky kraj";15;1537;2;1539;NA;269163;17;2021-08-20;99272
2021-08-19;"Trenčiansky kraj";2;985;2;987;NA;269163;4;2021-08-19;99255
2021-08-18;"Trenčiansky kraj";6;814;7;821;NA;269163;13;2021-08-18;99251
2021-08-17;"Trenčiansky kraj";9;633;1;634;NA;269163;10;2021-08-17;99238
2021-08-16;"Trenčiansky kraj";5;925;3;928;NA;269163;8;2021-08-16;99228
2021-08-15;"Trenčiansky kraj";0;558;1;559;NA;269163;1;2021-08-15;99220
2021-08-14;"Trenčiansky kraj";12;574;6;580;NA;269163;18;2021-08-14;99219
2021-08-13;"Trenčiansky kraj";2;933;0;933;NA;269163;2;2021-08-13;99201
2021-08-12;"Trenčiansky kraj";2;564;3;567;NA;269163;5;2021-08-12;99199
2021-08-11;"Trenčiansky kraj";1;680;0;680;NA;269163;1;2021-08-11;99194
2021-08-10;"Trenčiansky kraj";8;530;1;531;NA;269163;9;2021-08-10;99193
2021-08-09;"Trenčiansky kraj";8;694;1;695;NA;269163;9;2021-08-09;99184
2021-08-08;"Trenčiansky kraj";0;468;0;468;NA;269163;0;2021-08-08;99175
2021-08-07;"Trenčiansky kraj";3;464;0;464;NA;269163;3;2021-08-07;99175
2021-08-06;"Trenčiansky kraj";3;955;1;956;NA;269163;4;2021-08-06;99172
2021-08-05;"Trenčiansky kraj";3;579;1;580;NA;269163;4;2021-08-05;99168
2021-08-04;"Trenčiansky kraj";14;546;3;549;NA;269163;17;2021-08-04;99164
2021-08-03;"Trenčiansky kraj";9;508;5;513;NA;269163;14;2021-08-03;99147
2021-08-02;"Trenčiansky kraj";1;807;2;809;NA;269163;3;2021-08-02;99133
2021-08-01;"Trenčiansky kraj";0;458;1;459;NA;269163;1;2021-08-01;99130
2021-07-31;"Trenčiansky kraj";4;525;2;527;NA;269163;6;2021-07-31;99129
2021-07-30;"Trenčiansky kraj";2;1069;0;1069;NA;269163;2;2021-07-30;99123
2021-07-29;"Trenčiansky kraj";5;708;0;708;NA;269163;5;2021-07-29;99121
2021-07-28;"Trenčiansky kraj";3;517;2;519;NA;269163;5;2021-07-28;99116
2021-07-27;"Trenčiansky kraj";6;551;1;552;NA;269163;7;2021-07-27;99111
2021-07-26;"Trenčiansky kraj";7;772;1;773;NA;269163;8;2021-07-26;99104
2021-07-25;"Trenčiansky kraj";0;487;2;489;NA;269163;2;2021-07-25;99096
2021-07-24;"Trenčiansky kraj";3;643;1;644;NA;269163;4;2021-07-24;99094
2021-07-23;"Trenčiansky kraj";3;1151;0;1151;NA;269163;3;2021-07-23;99090
2021-07-22;"Trenčiansky kraj";2;844;2;846;NA;269163;4;2021-07-22;99087
2021-07-21;"Trenčiansky kraj";8;661;2;663;NA;269163;10;2021-07-21;99083
2021-07-20;"Trenčiansky kraj";4;525;1;526;NA;269163;5;2021-07-20;99073
2021-07-19;"Trenčiansky kraj";0;866;4;870;NA;269163;4;2021-07-19;99068
2021-07-18;"Trenčiansky kraj";0;526;0;526;NA;269163;0;2021-07-18;99064
2021-07-17;"Trenčiansky kraj";3;673;0;673;NA;269163;3;2021-07-17;99064
2021-07-16;"Trenčiansky kraj";4;1122;0;1122;NA;269163;4;2021-07-16;99061
2021-07-15;"Trenčiansky kraj";2;824;0;824;NA;269163;2;2021-07-15;99057
2021-07-14;"Trenčiansky kraj";8;645;0;645;NA;269163;8;2021-07-14;99055
2021-07-13;"Trenčiansky kraj";1;520;3;523;NA;269163;4;2021-07-13;99047
2021-07-12;"Trenčiansky kraj";9;820;2;822;NA;269163;11;2021-07-12;99043
2021-07-11;"Trenčiansky kraj";0;611;2;613;NA;269163;2;2021-07-11;99032
2021-07-10;"Trenčiansky kraj";2;535;0;535;NA;269163;2;2021-07-10;99030
2021-07-09;"Trenčiansky kraj";7;1379;0;1379;NA;269163;7;2021-07-09;99028
2021-07-08;"Trenčiansky kraj";2;815;1;816;NA;269163;3;2021-07-08;99021
2021-07-07;"Trenčiansky kraj";2;928;0;928;NA;269163;2;2021-07-07;99018
2021-07-06;"Trenčiansky kraj";4;1041;1;1042;NA;269163;5;2021-07-06;99016
2021-07-05;"Trenčiansky kraj";1;508;0;508;NA;269163;1;2021-07-05;99011
2021-07-04;"Trenčiansky kraj";0;612;1;613;NA;269163;1;2021-07-04;99010
2021-07-03;"Trenčiansky kraj";3;815;1;816;NA;269163;4;2021-07-03;99009
2021-07-02;"Trenčiansky kraj";5;1583;2;1585;NA;269163;7;2021-07-02;99005
2021-07-01;"Trenčiansky kraj";4;1152;1;1153;NA;269163;5;2021-07-01;98998
2021-06-30;"Trenčiansky kraj";2;7021;6;7027;NA;269163;8;2021-06-30;98993
2021-06-29;"Trenčiansky kraj";4;2773;5;2778;NA;269163;9;2021-06-29;98985
2021-06-28;"Trenčiansky kraj";5;3644;4;3648;NA;269163;9;2021-06-28;98976
2021-06-27;"Trenčiansky kraj";0;2861;1;2862;NA;269163;1;2021-06-27;98967
2021-06-26;"Trenčiansky kraj";1;3547;4;3551;NA;269163;5;2021-06-26;98966
2021-06-25;"Trenčiansky kraj";2;4626;1;4627;NA;269163;3;2021-06-25;98961
2021-06-24;"Trenčiansky kraj";3;3320;4;3324;NA;269163;7;2021-06-24;98958
2021-06-23;"Trenčiansky kraj";4;2808;2;2810;NA;269163;6;2021-06-23;98951
2021-06-22;"Trenčiansky kraj";7;3137;4;3141;NA;269163;11;2021-06-22;98945
2021-06-21;"Trenčiansky kraj";10;3891;4;3895;NA;269163;14;2021-06-21;98934
2021-06-20;"Trenčiansky kraj";0;3579;5;3584;NA;269163;5;2021-06-20;98920
2021-06-19;"Trenčiansky kraj";5;4528;1;4529;NA;269163;6;2021-06-19;98915
2021-06-18;"Trenčiansky kraj";7;6725;7;6732;NA;269163;14;2021-06-18;98909
2021-06-17;"Trenčiansky kraj";0;3469;6;3475;NA;269163;6;2021-06-17;98895
2021-06-16;"Trenčiansky kraj";4;3183;3;3186;NA;269163;7;2021-06-16;98889
2021-06-15;"Trenčiansky kraj";10;3697;2;3699;NA;269163;12;2021-06-15;98882
2021-06-14;"Trenčiansky kraj";10;4805;15;4820;NA;269163;25;2021-06-14;98870
2021-06-13;"Trenčiansky kraj";0;4643;4;4647;NA;269163;4;2021-06-13;98845
2021-06-12;"Trenčiansky kraj";4;5260;8;5268;NA;269163;12;2021-06-12;98841
2021-06-11;"Trenčiansky kraj";10;7365;11;7376;NA;269163;21;2021-06-11;98829
2021-06-10;"Trenčiansky kraj";5;4345;7;4352;NA;269163;12;2021-06-10;98808
2021-06-09;"Trenčiansky kraj";7;3693;7;3700;NA;269163;14;2021-06-09;98796
2021-06-08;"Trenčiansky kraj";21;3965;7;3972;NA;269163;28;2021-06-08;98782
2021-06-07;"Trenčiansky kraj";13;5560;10;5570;NA;269163;23;2021-06-07;98754
2021-06-06;"Trenčiansky kraj";0;5500;10;5510;NA;269163;10;2021-06-06;98731
2021-06-05;"Trenčiansky kraj";7;6511;5;6516;NA;269163;12;2021-06-05;98721
2021-06-04;"Trenčiansky kraj";16;7653;3;7656;NA;269163;19;2021-06-04;98709
2021-06-03;"Trenčiansky kraj";9;4485;10;4495;NA;269163;19;2021-06-03;98690
2021-06-02;"Trenčiansky kraj";28;4329;8;4337;NA;269163;36;2021-06-02;98671
2021-06-01;"Trenčiansky kraj";22;5396;18;5414;NA;269163;40;2021-06-01;98635
2021-05-31;"Trenčiansky kraj";30;6117;24;6141;NA;269163;54;2021-05-31;98595
2021-05-30;"Trenčiansky kraj";0;8258;16;8274;NA;269163;16;2021-05-30;98541
2021-05-29;"Trenčiansky kraj";13;7915;14;7929;NA;269163;27;2021-05-29;98525
2021-05-28;"Trenčiansky kraj";22;8995;25;9020;NA;269163;47;2021-05-28;98498
2021-05-27;"Trenčiansky kraj";6;5205;12;5217;NA;269163;18;2021-05-27;98451
2021-05-26;"Trenčiansky kraj";26;5069;15;5084;NA;269163;41;2021-05-26;98433
2021-05-25;"Trenčiansky kraj";18;6168;24;6192;NA;269163;42;2021-05-25;98392
2021-05-24;"Trenčiansky kraj";19;9292;37;9329;NA;269163;56;2021-05-24;98350
2021-05-23;"Trenčiansky kraj";0;9083;26;9109;NA;269163;26;2021-05-23;98294
2021-05-22;"Trenčiansky kraj";11;11314;21;11335;NA;269163;32;2021-05-22;98268
2021-05-21;"Trenčiansky kraj";23;11572;26;11598;NA;269163;49;2021-05-21;98236
2021-05-20;"Trenčiansky kraj";23;6320;25;6345;NA;269163;48;2021-05-20;98187
2021-05-19;"Trenčiansky kraj";16;5694;32;5726;NA;269163;48;2021-05-19;98139
2021-05-18;"Trenčiansky kraj";26;7779;28;7807;NA;269163;54;2021-05-18;98091
2021-05-17;"Trenčiansky kraj";37;7671;43;7714;NA;269163;80;2021-05-17;98037
2021-05-16;"Trenčiansky kraj";25;15615;41;15656;NA;269163;66;2021-05-16;97957
2021-05-15;"Trenčiansky kraj";3;21237;32;21269;NA;269163;35;2021-05-15;97891
2021-05-14;"Trenčiansky kraj";41;18676;42;18718;NA;269163;83;2021-05-14;97856
2021-05-13;"Trenčiansky kraj";41;8195;24;8219;NA;269163;65;2021-05-13;97773
2021-05-12;"Trenčiansky kraj";41;7409;31;7440;NA;269163;72;2021-05-12;97708
2021-05-11;"Trenčiansky kraj";66;10507;32;10539;NA;269163;98;2021-05-11;97636
2021-05-10;"Trenčiansky kraj";48;12989;55;13044;NA;269163;103;2021-05-10;97538
2021-05-09;"Trenčiansky kraj";52;17737;39;17776;NA;269163;91;2021-05-09;97435
2021-05-08;"Trenčiansky kraj";3;23822;33;23855;NA;269163;36;2021-05-08;97344
2021-05-07;"Trenčiansky kraj";45;23549;56;23605;NA;269163;101;2021-05-07;97308
2021-05-06;"Trenčiansky kraj";26;10771;44;10815;NA;269163;70;2021-05-06;97207
2021-05-05;"Trenčiansky kraj";73;9377;41;9418;NA;269163;114;2021-05-05;97137
2021-05-04;"Trenčiansky kraj";55;12733;53;12786;NA;269163;108;2021-05-04;97023
2021-05-03;"Trenčiansky kraj";60;15331;51;15382;NA;269163;111;2021-05-03;96915
2021-05-02;"Trenčiansky kraj";0;31152;65;31217;NA;269163;65;2021-05-02;96804
2021-05-01;"Trenčiansky kraj";71;56982;60;57042;NA;269163;131;2021-05-01;96739
2021-04-30;"Trenčiansky kraj";77;29427;61;29488;NA;269163;138;2021-04-30;96608
2021-04-29;"Trenčiansky kraj";49;13184;59;13243;NA;269163;108;2021-04-29;96470
2021-04-28;"Trenčiansky kraj";79;12537;52;12589;NA;269163;131;2021-04-28;96362
2021-04-27;"Trenčiansky kraj";107;15527;40;15567;NA;269163;147;2021-04-27;96231
2021-04-26;"Trenčiansky kraj";52;21070;63;21133;NA;269163;115;2021-04-26;96084
2021-04-25;"Trenčiansky kraj";0;34560;48;34608;NA;269163;48;2021-04-25;95969
2021-04-24;"Trenčiansky kraj";76;72398;100;72498;NA;269163;176;2021-04-24;95921
2021-04-23;"Trenčiansky kraj";143;29959;79;30038;NA;269163;222;2021-04-23;95745
2021-04-22;"Trenčiansky kraj";71;13847;64;13911;NA;269163;135;2021-04-22;95523
2021-04-21;"Trenčiansky kraj";79;13000;67;13067;NA;269163;146;2021-04-21;95388
2021-04-20;"Trenčiansky kraj";142;17740;80;17820;NA;269163;222;2021-04-20;95242
2021-04-19;"Trenčiansky kraj";102;22631;103;22734;NA;269163;205;2021-04-19;95020
2021-04-18;"Trenčiansky kraj";3;40879;97;40976;NA;269163;100;2021-04-18;94815
2021-04-17;"Trenčiansky kraj";77;81498;136;81634;NA;269163;213;2021-04-17;94715
2021-04-16;"Trenčiansky kraj";100;31961;90;32051;NA;269163;190;2021-04-16;94502
2021-04-15;"Trenčiansky kraj";71;14479;69;14548;NA;269163;140;2021-04-15;94312
2021-04-14;"Trenčiansky kraj";135;15563;72;15635;NA;269163;207;2021-04-14;94172
2021-04-13;"Trenčiansky kraj";189;18721;75;18796;NA;269163;264;2021-04-13;93965
2021-04-12;"Trenčiansky kraj";97;23743;91;23834;NA;269163;188;2021-04-12;93701
2021-04-11;"Trenčiansky kraj";1;34735;75;34810;NA;269163;76;2021-04-11;93513
2021-04-10;"Trenčiansky kraj";81;83093;145;83238;NA;269163;226;2021-04-10;93437
2021-04-09;"Trenčiansky kraj";120;28014;91;28105;NA;269163;211;2021-04-09;93211
2021-04-08;"Trenčiansky kraj";112;13283;85;13368;NA;269163;197;2021-04-08;93000
2021-04-07;"Trenčiansky kraj";204;17688;123;17811;NA;269163;327;2021-04-07;92803
2021-04-06;"Trenčiansky kraj";157;28567;178;28745;NA;269163;335;2021-04-06;92476
2021-04-05;"Trenčiansky kraj";15;9227;64;9291;NA;269163;79;2021-04-05;92141
2021-04-04;"Trenčiansky kraj";2;20291;85;20376;NA;269163;87;2021-04-04;92062
2021-04-03;"Trenčiansky kraj";86;80473;221;80694;NA;269163;307;2021-04-03;91975
2021-04-02;"Trenčiansky kraj";126;21620;81;21701;NA;269163;207;2021-04-02;91668
2021-04-01;"Trenčiansky kraj";159;32376;139;32515;NA;269163;298;2021-04-01;91461
2021-03-31;"Trenčiansky kraj";198;20100;130;20230;NA;269163;328;2021-03-31;91163
2021-03-30;"Trenčiansky kraj";272;17305;136;17441;NA;269163;408;2021-03-30;90835
2021-03-29;"Trenčiansky kraj";142;19479;170;19649;NA;269163;312;2021-03-29;90427
2021-03-28;"Trenčiansky kraj";3;34759;116;34875;NA;269163;119;2021-03-28;90115
2021-03-27;"Trenčiansky kraj";130;77314;293;77607;NA;269163;423;2021-03-27;89996
2021-03-26;"Trenčiansky kraj";211;35095;157;35252;NA;269163;368;2021-03-26;89573
2021-03-25;"Trenčiansky kraj";184;16580;176;16756;NA;269163;360;2021-03-25;89205
2021-03-24;"Trenčiansky kraj";259;13102;171;13273;NA;269163;430;2021-03-24;88845
2021-03-23;"Trenčiansky kraj";349;17589;174;17763;NA;269163;523;2021-03-23;88415
2021-03-22;"Trenčiansky kraj";141;21116;213;21329;NA;269163;354;2021-03-22;87892
2021-03-21;"Trenčiansky kraj";85;32711;164;32875;NA;269163;249;2021-03-21;87538
2021-03-20;"Trenčiansky kraj";128;80035;322;80357;NA;269163;450;2021-03-20;87289
2021-03-19;"Trenčiansky kraj";231;34783;232;35015;NA;269163;463;2021-03-19;86839
2021-03-18;"Trenčiansky kraj";262;16105;178;16283;NA;269163;440;2021-03-18;86376
2021-03-17;"Trenčiansky kraj";366;13435;164;13599;NA;269163;530;2021-03-17;85936
2021-03-16;"Trenčiansky kraj";450;15282;241;15523;NA;269163;691;2021-03-16;85406
2021-03-15;"Trenčiansky kraj";162;21235;261;21496;NA;269163;423;2021-03-15;84715
2021-03-14;"Trenčiansky kraj";42;34416;238;34654;NA;269163;280;2021-03-14;84292
2021-03-13;"Trenčiansky kraj";270;79186;453;79639;NA;269163;723;2021-03-13;84012
2021-03-12;"Trenčiansky kraj";366;34795;307;35102;NA;269163;673;2021-03-12;83289
2021-03-11;"Trenčiansky kraj";302;15558;213;15771;NA;269163;515;2021-03-11;82616
2021-03-10;"Trenčiansky kraj";402;13585;237;13822;NA;269163;639;2021-03-10;82101
2021-03-09;"Trenčiansky kraj";586;17982;285;18267;NA;269163;871;2021-03-09;81462
2021-03-08;"Trenčiansky kraj";174;21704;363;22067;NA;269163;537;2021-03-08;80591
2021-03-07;"Trenčiansky kraj";4;33660;313;33973;NA;269163;317;2021-03-07;80054
2021-03-06;"Trenčiansky kraj";260;79661;529;80190;NA;269163;789;2021-03-06;79737
2021-03-05;"Trenčiansky kraj";326;32969;415;33384;NA;269163;741;2021-03-05;78948
2021-03-04;"Trenčiansky kraj";323;16821;317;17138;NA;269163;640;2021-03-04;78207
2021-03-03;"Trenčiansky kraj";413;13960;347;14307;NA;269163;760;2021-03-03;77567
2021-03-02;"Trenčiansky kraj";612;17794;344;18138;NA;269163;956;2021-03-02;76807
2021-03-01;"Trenčiansky kraj";217;21104;445;21549;NA;269163;662;2021-03-01;75851
2021-02-28;"Trenčiansky kraj";45;30238;376;30614;NA;269163;421;2021-02-28;75189
2021-02-27;"Trenčiansky kraj";277;78735;686;79421;NA;269163;963;2021-02-27;74768
2021-02-26;"Trenčiansky kraj";420;32940;434;33374;NA;269163;854;2021-02-26;73805
2021-02-25;"Trenčiansky kraj";424;14029;328;14357;NA;269163;752;2021-02-25;72951
2021-02-24;"Trenčiansky kraj";427;12014;399;12413;NA;269163;826;2021-02-24;72199
2021-02-23;"Trenčiansky kraj";577;14904;390;15294;NA;269163;967;2021-02-23;71373
2021-02-22;"Trenčiansky kraj";160;19969;468;20437;NA;269163;628;2021-02-22;70406
2021-02-21;"Trenčiansky kraj";64;29478;392;29870;NA;269163;456;2021-02-21;69778
2021-02-20;"Trenčiansky kraj";274;77840;745;78585;NA;269163;1019;2021-02-20;69322
2021-02-19;"Trenčiansky kraj";272;30260;523;30783;NA;269163;795;2021-02-19;68303
2021-02-18;"Trenčiansky kraj";355;14094;403;14497;NA;269163;758;2021-02-18;67508
2021-02-17;"Trenčiansky kraj";363;11412;376;11788;NA;269163;739;2021-02-17;66750
2021-02-16;"Trenčiansky kraj";488;17761;406;18167;NA;269163;894;2021-02-16;66011
2021-02-15;"Trenčiansky kraj";151;21846;463;22309;NA;269163;614;2021-02-15;65117
2021-02-14;"Trenčiansky kraj";2;31255;324;31579;NA;269163;326;2021-02-14;64503
2021-02-13;"Trenčiansky kraj";274;63006;522;63528;NA;269163;796;2021-02-13;64177
2021-02-12;"Trenčiansky kraj";276;27979;412;28391;NA;269163;688;2021-02-12;63381
2021-02-11;"Trenčiansky kraj";291;11567;323;11890;NA;269163;614;2021-02-11;62693
2021-02-10;"Trenčiansky kraj";304;11408;317;11725;NA;269163;621;2021-02-10;62079
2021-02-09;"Trenčiansky kraj";514;18412;360;18772;NA;269163;874;2021-02-09;61458
2021-02-08;"Trenčiansky kraj";182;26832;430;27262;NA;269163;612;2021-02-08;60584
2021-02-07;"Trenčiansky kraj";31;36781;341;37122;NA;269163;372;2021-02-07;59972
2021-02-06;"Trenčiansky kraj";216;63931;560;64491;NA;269163;776;2021-02-06;59600
2021-02-05;"Trenčiansky kraj";202;18164;367;18531;NA;269163;569;2021-02-05;58824
2021-02-04;"Trenčiansky kraj";266;7253;311;7564;NA;269163;577;2021-02-04;58255
2021-02-03;"Trenčiansky kraj";162;6723;320;7043;NA;269163;482;2021-02-03;57678
2021-02-02;"Trenčiansky kraj";347;8074;381;8455;NA;269163;728;2021-02-02;57196
2021-02-01;"Trenčiansky kraj";167;8921;311;9232;NA;269163;478;2021-02-01;56468
2021-01-31;"Trenčiansky kraj";7;19103;159;19262;NA;269163;166;2021-01-31;55990
2021-01-30;"Trenčiansky kraj";228;38167;332;38499;NA;269163;560;2021-01-30;55824
2021-01-29;"Trenčiansky kraj";214;7590;235;7825;NA;269163;449;2021-01-29;55264
2021-01-28;"Trenčiansky kraj";307;5442;158;5600;NA;269163;465;2021-01-28;54815
2021-01-27;"Trenčiansky kraj";166;4842;181;5023;NA;269163;347;2021-01-27;54350
2021-01-26;"Trenčiansky kraj";303;14589;250;14839;NA;269163;553;2021-01-26;54003
2021-01-25;"Trenčiansky kraj";160;24310;207;24517;NA;269163;367;2021-01-25;53450
2021-01-24;"Trenčiansky kraj";51;38369;282;38651;NA;269163;333;2021-01-24;53083
2021-01-23;"Trenčiansky kraj";206;114125;749;114874;NA;269163;955;2021-01-23;52750
2021-01-22;"Trenčiansky kraj";148;21831;241;22072;NA;269163;389;2021-01-22;51795
2021-01-21;"Trenčiansky kraj";143;8586;166;8752;NA;269163;309;2021-01-21;51406
2021-01-20;"Trenčiansky kraj";181;8189;227;8416;NA;269163;408;2021-01-20;51097
2021-01-19;"Trenčiansky kraj";363;6600;262;6862;NA;269163;625;2021-01-19;50689
2021-01-18;"Trenčiansky kraj";72;4970;321;5291;NA;269163;393;2021-01-18;50064
2021-01-17;"Trenčiansky kraj";124;156;11;167;NA;269163;135;2021-01-17;49671
2021-01-16;"Trenčiansky kraj";39;1288;53;1341;NA;269163;92;2021-01-16;49536
2021-01-15;"Trenčiansky kraj";264;4031;214;4245;NA;269163;478;2021-01-15;49444
2021-01-14;"Trenčiansky kraj";275;3193;189;3382;NA;269163;464;2021-01-14;48966
2021-01-13;"Trenčiansky kraj";222;3893;215;4108;NA;269163;437;2021-01-13;48502
2021-01-12;"Trenčiansky kraj";508;4604;261;4865;NA;269163;769;2021-01-12;48065
2021-01-11;"Trenčiansky kraj";142;4367;354;4721;NA;269163;496;2021-01-11;47296
2021-01-10;"Trenčiansky kraj";89;4969;77;5046;NA;269163;166;2021-01-10;46800
2021-01-09;"Trenčiansky kraj";276;8280;128;8408;NA;269163;404;2021-01-09;46634
2021-01-08;"Trenčiansky kraj";489;6435;484;6919;NA;269163;973;2021-01-08;46230
2021-01-07;"Trenčiansky kraj";420;6138;577;6715;NA;269163;997;2021-01-07;45257
2021-01-06;"Trenčiansky kraj";221;1021;64;1085;NA;269163;285;2021-01-06;44260
2021-01-05;"Trenčiansky kraj";669;5753;706;6459;NA;269163;1375;2021-01-05;43975
2021-01-04;"Trenčiansky kraj";337;5248;782;6030;NA;269163;1119;2021-01-04;42600
2021-01-03;"Trenčiansky kraj";38;114;15;129;NA;269163;53;2021-01-03;41481
2021-01-02;"Trenčiansky kraj";129;196;23;219;NA;269163;152;2021-01-02;41428
2021-01-01;"Trenčiansky kraj";329;347;23;370;NA;269163;352;2021-01-01;41276
2020-12-31;"Trenčiansky kraj";597;4943;557;5500;NA;269163;1154;2020-12-31;40924
2020-12-30;"Trenčiansky kraj";836;7012;762;7774;NA;269163;1598;2020-12-30;39770
2020-12-29;"Trenčiansky kraj";459;6121;1009;7130;NA;269163;1468;2020-12-29;38172
2020-12-28;"Trenčiansky kraj";258;4195;777;4972;NA;269163;1035;2020-12-28;36704
2020-12-27;"Trenčiansky kraj";5;208;36;244;NA;269163;41;2020-12-27;35669
2020-12-26;"Trenčiansky kraj";174;74;10;84;NA;269163;184;2020-12-26;35628
2020-12-25;"Trenčiansky kraj";251;325;47;372;NA;269163;298;2020-12-25;35444
2020-12-24;"Trenčiansky kraj";552;2194;256;2450;NA;269163;808;2020-12-24;35146
2020-12-23;"Trenčiansky kraj";421;6552;661;7213;NA;269163;1082;2020-12-23;34338
2020-12-22;"Trenčiansky kraj";673;5760;694;6454;NA;269163;1367;2020-12-22;33256
2020-12-21;"Trenčiansky kraj";248;13395;979;14374;NA;269163;1227;2020-12-21;31889
2020-12-20;"Trenčiansky kraj";238;12504;292;12796;NA;269163;530;2020-12-20;30662
2020-12-19;"Trenčiansky kraj";341;1611;150;1761;NA;269163;491;2020-12-19;30132
2020-12-18;"Trenčiansky kraj";521;5199;615;5814;NA;269163;1136;2020-12-18;29641
2020-12-17;"Trenčiansky kraj";670;3843;524;4367;NA;269163;1194;2020-12-17;28505
2020-12-16;"Trenčiansky kraj";461;4474;648;5122;NA;269163;1109;2020-12-16;27311
2020-12-15;"Trenčiansky kraj";595;3805;670;4475;NA;269163;1265;2020-12-15;26202
2020-12-14;"Trenčiansky kraj";318;2907;552;3459;NA;269163;870;2020-12-14;24937
2020-12-13;"Trenčiansky kraj";77;49;6;55;NA;269163;83;2020-12-13;24067
2020-12-12;"Trenčiansky kraj";314;1191;136;1327;NA;269163;450;2020-12-12;23984
2020-12-11;"Trenčiansky kraj";751;3773;453;4226;NA;269163;1204;2020-12-11;23534
2020-12-10;"Trenčiansky kraj";271;3354;473;3827;NA;269163;744;2020-12-10;22330
2020-12-09;"Trenčiansky kraj";508;3788;466;4254;NA;269163;974;2020-12-09;21586
2020-12-08;"Trenčiansky kraj";546;3440;522;3962;NA;269163;1068;2020-12-08;20612
2020-12-07;"Trenčiansky kraj";258;3832;468;4300;NA;269163;726;2020-12-07;19544
2020-12-06;"Trenčiansky kraj";114;179;10;189;NA;269163;124;2020-12-06;18818
2020-12-05;"Trenčiansky kraj";223;610;56;666;NA;269163;279;2020-12-05;18694
2020-12-04;"Trenčiansky kraj";253;2943;273;3216;NA;269163;526;2020-12-04;18415
2020-12-03;"Trenčiansky kraj";503;1714;178;1892;NA;269163;681;2020-12-03;17889
2020-12-02;"Trenčiansky kraj";418;1844;232;2076;NA;269163;650;2020-12-02;17208
2020-12-01;"Trenčiansky kraj";321;5642;351;5993;NA;269163;672;2020-12-01;16558
2020-11-30;"Trenčiansky kraj";167;11514;520;12034;NA;269163;687;2020-11-30;15886
2020-11-29;"Trenčiansky kraj";29;30;5;35;NA;269163;34;2020-11-29;15199
2020-11-28;"Trenčiansky kraj";202;1051;93;1144;NA;269163;295;2020-11-28;15165
2020-11-27;"Trenčiansky kraj";330;1888;186;2074;NA;269163;516;2020-11-27;14870
2020-11-26;"Trenčiansky kraj";395;1252;122;1374;NA;269163;517;2020-11-26;14354
2020-11-25;"Trenčiansky kraj";322;1444;160;1604;NA;269163;482;2020-11-25;13837
2020-11-24;"Trenčiansky kraj";348;2553;308;2861;NA;269163;656;2020-11-24;13355
2020-11-23;"Trenčiansky kraj";159;1186;122;1308;NA;269163;281;2020-11-23;12699
2020-11-22;"Trenčiansky kraj";26;30;7;37;NA;269163;33;2020-11-22;12418
2020-11-21;"Trenčiansky kraj";255;1376;69;1445;NA;269163;324;2020-11-21;12385
2020-11-20;"Trenčiansky kraj";316;861;93;954;NA;269163;409;2020-11-20;12061
2020-11-19;"Trenčiansky kraj";316;740;113;853;NA;269163;429;2020-11-19;11652
2020-11-18;"Trenčiansky kraj";233;379;66;445;NA;269163;299;2020-11-18;11223
2020-11-17;"Trenčiansky kraj";222;106;15;121;NA;269163;237;2020-11-17;10924
2020-11-16;"Trenčiansky kraj";245;236;45;281;NA;269163;290;2020-11-16;10687
2020-11-15;"Trenčiansky kraj";109;29;6;35;NA;269163;115;2020-11-15;10397
2020-11-14;"Trenčiansky kraj";190;74;11;85;NA;269163;201;2020-11-14;10282
2020-11-13;"Trenčiansky kraj";308;131;13;144;NA;269163;321;2020-11-13;10081
2020-11-12;"Trenčiansky kraj";324;124;5;129;NA;269163;329;2020-11-12;9760
2020-11-11;"Trenčiansky kraj";366;113;10;123;NA;269163;376;2020-11-11;9431
2020-11-10;"Trenčiansky kraj";277;106;6;112;NA;269163;283;2020-11-10;9055
2020-11-09;"Trenčiansky kraj";115;1407;48;1455;NA;269163;163;2020-11-09;8772
2020-11-08;"Trenčiansky kraj";81;1271;8;1279;NA;269163;89;2020-11-08;8609
2020-11-07;"Trenčiansky kraj";319;3662;59;3721;NA;269163;378;2020-11-07;8520
2020-11-06;"Trenčiansky kraj";383;6893;84;6977;NA;269163;467;2020-11-06;8142
2020-11-05;"Trenčiansky kraj";399;98;15;113;NA;269163;414;2020-11-05;7675
2020-11-04;"Trenčiansky kraj";370;91;9;100;NA;269163;379;2020-11-04;7261
2020-11-03;"Trenčiansky kraj";575;97;8;105;NA;269163;583;2020-11-03;6882
2020-11-02;"Trenčiansky kraj";197;1833;68;1901;NA;269163;265;2020-11-02;6299
2020-11-01;"Trenčiansky kraj";257;808;24;832;NA;269163;281;2020-11-01;6034
2020-10-31;"Trenčiansky kraj";332;4719;82;4801;NA;269163;414;2020-10-31;5753
2020-10-30;"Trenčiansky kraj";299;5283;102;5385;NA;269163;401;2020-10-30;5339
2020-10-29;"Trenčiansky kraj";496;764;68;832;NA;269163;564;2020-10-29;4938
2020-10-28;"Trenčiansky kraj";269;192;33;225;NA;269163;302;2020-10-28;4374
2020-10-27;"Trenčiansky kraj";473;127;27;154;NA;269163;500;2020-10-27;4072
2020-10-26;"Trenčiansky kraj";177;107;36;143;NA;269163;213;2020-10-26;3572
2020-10-25;"Trenčiansky kraj";138;9;5;14;NA;269163;143;2020-10-25;3359
2020-10-24;"Trenčiansky kraj";395;128;6;134;NA;269163;401;2020-10-24;3216
2020-10-23;"Trenčiansky kraj";301;154;8;162;NA;269163;309;2020-10-23;2815
2020-10-22;"Trenčiansky kraj";273;82;12;94;NA;269163;285;2020-10-22;2506
2020-10-21;"Trenčiansky kraj";183;53;9;62;NA;269163;192;2020-10-21;2221
2020-10-20;"Trenčiansky kraj";212;47;6;53;NA;269163;218;2020-10-20;2029
2020-10-19;"Trenčiansky kraj";41;83;25;108;NA;269163;66;2020-10-19;1811
2020-10-18;"Trenčiansky kraj";104;0;0;0;NA;269163;104;2020-10-18;1745
2020-10-17;"Trenčiansky kraj";157;0;0;0;NA;269163;157;2020-10-17;1641
2020-10-16;"Trenčiansky kraj";225;42;6;48;NA;269163;231;2020-10-16;1484
2020-10-15;"Trenčiansky kraj";255;39;4;43;NA;269163;259;2020-10-15;1253
2020-10-14;"Trenčiansky kraj";162;42;7;49;NA;269163;169;2020-10-14;994
2020-10-13;"Trenčiansky kraj";124;105;12;117;NA;269163;136;2020-10-13;825
2020-10-12;"Trenčiansky kraj";55;0;0;0;NA;269163;55;2020-10-12;689
2020-10-11;"Trenčiansky kraj";73;0;0;0;NA;269163;73;2020-10-11;634
2020-10-10;"Trenčiansky kraj";180;0;0;0;NA;269163;180;2020-10-10;561
2020-10-09;"Trenčiansky kraj";198;0;0;0;NA;269163;198;2020-10-09;381
2020-10-08;"Trenčiansky kraj";115;0;0;0;NA;269163;115;2020-10-08;183
2020-10-07;"Trenčiansky kraj";75;0;0;0;NA;269163;75;2020-10-07;68
2020-10-06;"Trenčiansky kraj";72;0;0;0;NA;269163;72;2020-10-06;-7
2020-10-05;"Trenčiansky kraj";32;0;0;0;NA;269163;32;2020-10-05;-79
2020-10-04;"Trenčiansky kraj";37;0;0;0;NA;269163;37;2020-10-04;-111
2020-10-03;"Trenčiansky kraj";79;0;0;0;NA;269163;79;2020-10-03;-148
2020-10-02;"Trenčiansky kraj";69;0;0;0;NA;269163;69;2020-10-02;-227
2020-10-01;"Trenčiansky kraj";58;0;0;0;NA;269163;58;2020-10-01;-296
2020-09-30;"Trenčiansky kraj";76;0;0;0;NA;269163;76;2020-09-30;-354
2020-09-29;"Trenčiansky kraj";43;0;0;0;NA;269163;43;2020-09-29;-430
2020-09-28;"Trenčiansky kraj";7;0;0;0;NA;269163;7;2020-09-28;-473
2020-09-27;"Trenčiansky kraj";12;0;0;0;NA;269163;12;2020-09-27;-480
2020-09-26;"Trenčiansky kraj";37;0;0;0;NA;269163;37;2020-09-26;-492
2020-09-25;"Trenčiansky kraj";72;0;0;0;NA;269163;72;2020-09-25;-529
2020-09-24;"Trenčiansky kraj";41;0;0;0;NA;269163;41;2020-09-24;-601
2020-09-23;"Trenčiansky kraj";32;0;0;0;NA;269163;32;2020-09-23;-642
2020-09-22;"Trenčiansky kraj";26;0;0;0;NA;269163;26;2020-09-22;-674
2020-09-21;"Trenčiansky kraj";23;0;0;0;NA;269163;23;2020-09-21;-700
2020-09-20;"Trenčiansky kraj";21;0;0;0;NA;269163;21;2020-09-20;-723
2020-09-19;"Trenčiansky kraj";20;0;0;0;NA;269163;20;2020-09-19;-744
2020-09-18;"Trenčiansky kraj";41;0;0;0;NA;269163;41;2020-09-18;-764
2020-09-17;"Trenčiansky kraj";20;0;0;0;NA;269163;20;2020-09-17;-805
2020-09-16;"Trenčiansky kraj";14;0;0;0;NA;269163;14;2020-09-16;-825
2020-09-15;"Trenčiansky kraj";8;0;0;0;NA;269163;8;2020-09-15;-839
2020-09-14;"Trenčiansky kraj";5;0;0;0;NA;269163;5;2020-09-14;-847
2020-09-13;"Trenčiansky kraj";12;0;0;0;NA;269163;12;2020-09-13;-852
2020-09-12;"Trenčiansky kraj";2;0;0;0;NA;269163;2;2020-09-12;-864
2020-09-11;"Trenčiansky kraj";27;0;0;0;NA;269163;27;2020-09-11;-866
2020-09-10;"Trenčiansky kraj";15;0;0;0;NA;269163;15;2020-09-10;-893
2020-09-09;"Trenčiansky kraj";11;0;0;0;NA;269163;11;2020-09-09;-908
2020-09-08;"Trenčiansky kraj";12;0;0;0;NA;269163;12;2020-09-08;-919
2020-09-07;"Trenčiansky kraj";6;0;0;0;NA;269163;6;2020-09-07;-931
2020-09-06;"Trenčiansky kraj";1;0;0;0;NA;269163;1;2020-09-06;-937
2020-09-05;"Trenčiansky kraj";3;0;0;0;NA;269163;3;2020-09-05;-938
2020-09-04;"Trenčiansky kraj";9;0;0;0;NA;269163;9;2020-09-04;-941
2020-09-03;"Trenčiansky kraj";10;0;0;0;NA;269163;10;2020-09-03;-950
2020-09-02;"Trenčiansky kraj";5;0;0;0;NA;269163;5;2020-09-02;-960
2020-09-01;"Trenčiansky kraj";1;0;0;0;NA;269163;1;2020-09-01;-965
2020-08-31;"Trenčiansky kraj";12;0;0;0;NA;269163;12;2020-08-31;-966
2020-08-30;"Trenčiansky kraj";0;0;0;0;NA;269163;0;2020-08-30;-978
2020-08-29;"Trenčiansky kraj";1;0;0;0;NA;269163;1;2020-08-29;-978
2020-08-28;"Trenčiansky kraj";12;0;0;0;NA;269163;12;2020-08-28;-979
2020-08-27;"Trenčiansky kraj";10;0;0;0;NA;269163;10;2020-08-27;-991
2020-08-26;"Trenčiansky kraj";15;0;0;0;NA;269163;15;2020-08-26;-1001
2020-08-25;"Trenčiansky kraj";12;0;0;0;NA;269163;12;2020-08-25;-1016
2020-08-24;"Trenčiansky kraj";4;0;0;0;NA;269163;4;2020-08-24;-1028
2020-08-23;"Trenčiansky kraj";5;0;0;0;NA;269163;5;2020-08-23;-1032
2020-08-22;"Trenčiansky kraj";6;0;0;0;NA;269163;6;2020-08-22;-1037
2020-08-21;"Trenčiansky kraj";6;0;0;0;NA;269163;6;2020-08-21;-1043
2020-08-20;"Trenčiansky kraj";20;0;0;0;NA;269163;20;2020-08-20;-1049
2020-08-19;"Trenčiansky kraj";17;0;0;0;NA;269163;17;2020-08-19;-1069
2020-08-18;"Trenčiansky kraj";9;0;0;0;NA;269163;9;2020-08-18;-1086
2020-08-17;"Trenčiansky kraj";4;0;0;0;NA;269163;4;2020-08-17;-1095
2020-08-16;"Trenčiansky kraj";0;0;0;0;NA;269163;0;2020-08-16;-1099
2020-08-15;"Trenčiansky kraj";9;0;0;0;NA;269163;9;2020-08-15;-1099
2020-08-14;"Trenčiansky kraj";15;0;0;0;NA;269163;15;2020-08-14;-1108
2020-08-13;"Trenčiansky kraj";23;0;0;0;NA;269163;23;2020-08-13;-1123
2020-08-12;"Trenčiansky kraj";6;0;0;0;NA;269163;6;2020-08-12;-1146
2020-08-11;"Trenčiansky kraj";7;0;0;0;NA;269163;7;2020-08-11;-1152
2020-08-10;"Trenčiansky kraj";9;0;0;0;NA;269163;9;2020-08-10;-1159
2020-08-09;"Trenčiansky kraj";1;0;0;0;NA;269163;1;2020-08-09;-1168
2020-08-08;"Trenčiansky kraj";4;0;0;0;NA;269163;4;2020-08-08;-1169
2020-08-07;"Trenčiansky kraj";4;0;0;0;NA;269163;4;2020-08-07;-1173
2020-08-06;"Trenčiansky kraj";13;0;0;0;NA;269163;13;2020-08-06;-1177
2020-08-05;"Trenčiansky kraj";39;0;0;0;NA;269163;39;2020-08-05;-1190
2020-08-04;"Trenčiansky kraj";9;0;0;0;NA;269163;9;2020-08-04;-1229
2020-08-03;"Trenčiansky kraj";0;0;0;0;NA;269163;0;2020-08-03;-1238
2020-08-02;"Trenčiansky kraj";2;0;0;0;NA;269163;2;2020-08-02;-1238
2020-08-01;"Trenčiansky kraj";6;0;0;0;NA;269163;6;2020-08-01;-1240
2020-07-31;"Trenčiansky kraj";16;0;0;0;NA;269163;16;2020-07-31;-1246
2020-07-30;"Trenčiansky kraj";4;0;0;0;NA;269163;4;2020-07-30;-1262
2020-07-29;"Trenčiansky kraj";5;0;0;0;NA;269163;5;2020-07-29;-1266
2020-07-28;"Trenčiansky kraj";11;0;0;0;NA;269163;11;2020-07-28;-1271
2020-07-27;"Trenčiansky kraj";4;0;0;0;NA;269163;4;2020-07-27;-1282
2020-07-26;"Trenčiansky kraj";1;0;0;0;NA;269163;1;2020-07-26;-1286
2020-07-25;"Trenčiansky kraj";7;0;0;0;NA;269163;7;2020-07-25;-1287
2020-07-24;"Trenčiansky kraj";5;0;0;0;NA;269163;5;2020-07-24;-1294
2020-07-23;"Trenčiansky kraj";10;0;0;0;NA;269163;10;2020-07-23;-1299
2020-07-22;"Trenčiansky kraj";11;0;0;0;NA;269163;11;2020-07-22;-1309
2020-07-21;"Trenčiansky kraj";6;0;0;0;NA;269163;6;2020-07-21;-1320
2020-07-20;"Trenčiansky kraj";13;0;0;0;NA;269163;13;2020-07-20;-1326
2020-07-19;"Trenčiansky kraj";0;0;0;0;NA;269163;0;2020-07-19;-1339
2020-07-18;"Trenčiansky kraj";0;0;0;0;NA;269163;0;2020-07-18;-1339
2020-07-17;"Trenčiansky kraj";1;0;0;0;NA;269163;1;2020-07-17;-1339
2020-07-16;"Trenčiansky kraj";0;0;0;0;NA;269163;0;2020-07-16;-1340
2020-07-15;"Trenčiansky kraj";2;0;0;0;NA;269163;2;2020-07-15;-1340
2020-07-14;"Trenčiansky kraj";8;0;0;0;NA;269163;8;2020-07-14;-1342
2020-07-13;"Trenčiansky kraj";1;0;0;0;NA;269163;1;2020-07-13;-1350
2020-07-12;"Trenčiansky kraj";0;0;0;0;NA;269163;0;2020-07-12;-1351
2020-07-11;"Trenčiansky kraj";0;0;0;0;NA;269163;0;2020-07-11;-1351
2020-07-10;"Trenčiansky kraj";3;0;0;0;NA;269163;3;2020-07-10;-1351
2020-07-09;"Trenčiansky kraj";2;0;0;0;NA;269163;2;2020-07-09;-1354
2020-07-08;"Trenčiansky kraj";1;0;0;0;NA;269163;1;2020-07-08;-1356
2020-07-07;"Trenčiansky kraj";9;0;0;0;NA;269163;9;2020-07-07;-1357
2020-07-06;"Trenčiansky kraj";1;0;0;0;NA;269163;1;2020-07-06;-1366
2020-07-05;"Trenčiansky kraj";1;0;0;0;NA;269163;1;2020-07-05;-1367
2020-07-04;"Trenčiansky kraj";0;0;0;0;NA;269163;0;2020-07-04;-1368
2020-07-03;"Trenčiansky kraj";2;0;0;0;NA;269163;2;2020-07-03;-1368
2020-07-02;"Trenčiansky kraj";10;0;0;0;NA;269163;10;2020-07-02;-1370
2020-07-01;"Trenčiansky kraj";1;0;0;0;NA;269163;1;2020-07-01;-1380
2020-06-30;"Trenčiansky kraj";6;0;0;0;NA;269163;6;2020-06-30;-1381
2020-06-29;"Trenčiansky kraj";1;0;0;0;NA;269163;1;2020-06-29;-1387
2020-06-28;"Trenčiansky kraj";0;0;0;0;NA;269163;0;2020-06-28;-1388
2020-06-27;"Trenčiansky kraj";0;0;0;0;NA;269163;0;2020-06-27;-1388
2020-06-26;"Trenčiansky kraj";0;0;0;0;NA;269163;0;2020-06-26;-1388
2020-06-25;"Trenčiansky kraj";2;0;0;0;NA;269163;2;2020-06-25;-1388
2020-06-24;"Trenčiansky kraj";1;0;0;0;NA;269163;1;2020-06-24;-1390
2020-06-23;"Trenčiansky kraj";0;0;0;0;NA;269163;0;2020-06-23;-1391
2020-06-22;"Trenčiansky kraj";0;0;0;0;NA;269163;0;2020-06-22;-1391
2020-06-21;"Trenčiansky kraj";0;0;0;0;NA;269163;0;2020-06-21;-1391
2020-06-20;"Trenčiansky kraj";0;0;0;0;NA;269163;0;2020-06-20;-1391
2020-06-19;"Trenčiansky kraj";0;0;0;0;NA;269163;0;2020-06-19;-1391
2020-06-18;"Trenčiansky kraj";0;0;0;0;NA;269163;0;2020-06-18;-1391
2020-06-17;"Trenčiansky kraj";0;0;0;0;NA;269163;0;2020-06-17;-1391
2020-06-16;"Trenčiansky kraj";0;0;0;0;NA;269163;0;2020-06-16;-1391
2020-06-14;"Trenčiansky kraj";0;0;0;0;NA;269163;0;2020-06-14;-1391
2020-06-13;"Trenčiansky kraj";0;0;0;0;NA;269163;0;2020-06-13;-1391
2020-06-12;"Trenčiansky kraj";0;0;0;0;NA;269163;0;2020-06-12;-1391
2020-06-11;"Trenčiansky kraj";0;0;0;0;NA;269163;0;2020-06-11;-1391
2020-06-10;"Trenčiansky kraj";1;0;0;0;NA;269163;1;2020-06-10;-1391
2020-06-09;"Trenčiansky kraj";0;0;0;0;NA;269163;0;2020-06-09;-1392
2020-06-08;"Trenčiansky kraj";0;0;0;0;NA;269163;0;2020-06-08;-1392
2020-06-07;"Trenčiansky kraj";0;0;0;0;NA;269163;0;2020-06-07;-1392
2020-06-05;"Trenčiansky kraj";0;0;0;0;NA;269163;0;2020-06-05;-1392
2020-06-03;"Trenčiansky kraj";0;0;0;0;NA;269163;0;2020-06-03;-1392
2020-06-02;"Trenčiansky kraj";0;0;0;0;NA;269163;0;2020-06-02;-1392
2020-05-31;"Trenčiansky kraj";0;0;0;0;NA;269163;0;2020-05-31;-1392
2020-05-29;"Trenčiansky kraj";0;0;0;0;NA;269163;0;2020-05-29;-1392
2020-05-27;"Trenčiansky kraj";2;0;0;0;NA;269163;2;2020-05-27;-1392
2020-05-26;"Trenčiansky kraj";0;0;0;0;NA;269163;0;2020-05-26;-1394
2020-05-25;"Trenčiansky kraj";0;0;0;0;NA;269163;0;2020-05-25;-1394
2020-05-24;"Trenčiansky kraj";0;0;0;0;NA;269163;0;2020-05-24;-1394
2020-05-23;"Trenčiansky kraj";0;0;0;0;NA;269163;0;2020-05-23;-1394
2020-05-22;"Trenčiansky kraj";0;0;0;0;NA;269163;0;2020-05-22;-1394
2020-05-21;"Trenčiansky kraj";0;0;0;0;NA;269163;0;2020-05-21;-1394
2020-05-20;"Trenčiansky kraj";0;0;0;0;NA;269163;0;2020-05-20;-1394
2020-05-19;"Trenčiansky kraj";0;0;0;0;NA;269163;0;2020-05-19;-1394
2020-05-17;"Trenčiansky kraj";0;0;0;0;NA;269163;0;2020-05-17;-1394
2020-05-16;"Trenčiansky kraj";0;0;0;0;NA;269163;0;2020-05-16;-1394
2020-05-15;"Trenčiansky kraj";1;0;0;0;NA;269163;1;2020-05-15;-1394
2020-05-14;"Trenčiansky kraj";2;0;0;0;NA;269163;2;2020-05-14;-1395
2020-05-13;"Trenčiansky kraj";1;0;0;0;NA;269163;1;2020-05-13;-1397
2020-05-12;"Trenčiansky kraj";1;0;0;0;NA;269163;1;2020-05-12;-1398
2020-05-11;"Trenčiansky kraj";3;0;0;0;NA;269163;3;2020-05-11;-1399
2020-05-09;"Trenčiansky kraj";2;0;0;0;NA;269163;2;2020-05-09;-1402
2020-05-07;"Trenčiansky kraj";6;0;0;0;NA;269163;6;2020-05-07;-1404
2020-05-06;"Trenčiansky kraj";0;0;0;0;NA;269163;0;2020-05-06;-1410
2020-05-05;"Trenčiansky kraj";2;0;0;0;NA;269163;2;2020-05-05;-1410
2020-05-04;"Trenčiansky kraj";0;0;0;0;NA;269163;0;2020-05-04;-1412
2020-05-03;"Trenčiansky kraj";0;0;0;0;NA;269163;0;2020-05-03;-1412
2020-05-02;"Trenčiansky kraj";0;0;0;0;NA;269163;0;2020-05-02;-1412
2020-05-01;"Trenčiansky kraj";0;0;0;0;NA;269163;0;2020-05-01;-1412
2020-04-30;"Trenčiansky kraj";0;0;0;0;NA;269163;0;2020-04-30;-1412
2020-04-29;"Trenčiansky kraj";2;0;0;0;NA;269163;2;2020-04-29;-1412
2020-04-28;"Trenčiansky kraj";1;0;0;0;NA;269163;1;2020-04-28;-1414
2020-04-27;"Trenčiansky kraj";0;0;0;0;NA;269163;0;2020-04-27;-1415
2020-04-26;"Trenčiansky kraj";1;0;0;0;NA;269163;1;2020-04-26;-1415
2020-04-25;"Trenčiansky kraj";0;0;0;0;NA;269163;0;2020-04-25;-1416
2020-04-24;"Trenčiansky kraj";0;0;0;0;NA;269163;0;2020-04-24;-1416
2020-04-23;"Trenčiansky kraj";11;0;0;0;NA;269163;11;2020-04-23;-1416
2020-04-22;"Trenčiansky kraj";1;0;0;0;NA;269163;1;2020-04-22;-1427
2020-04-21;"Trenčiansky kraj";11;0;0;0;NA;269163;11;2020-04-21;-1428
2020-04-20;"Trenčiansky kraj";15;0;0;0;NA;269163;15;2020-04-20;-1439
2020-04-19;"Trenčiansky kraj";2;0;0;0;NA;269163;2;2020-04-19;-1454
2020-04-18;"Trenčiansky kraj";3;0;0;0;NA;269163;3;2020-04-18;-1456
2020-04-17;"Trenčiansky kraj";4;0;0;0;NA;269163;4;2020-04-17;-1459
2020-04-16;"Trenčiansky kraj";10;0;0;0;NA;269163;10;2020-04-16;-1463
2020-04-15;"Trenčiansky kraj";4;0;0;0;NA;269163;4;2020-04-15;-1473
2020-04-14;"Trenčiansky kraj";0;0;0;0;NA;269163;0;2020-04-14;-1477
2020-04-13;"Trenčiansky kraj";1;0;0;0;NA;269163;1;2020-04-13;-1477
2020-04-12;"Trenčiansky kraj";2;0;0;0;NA;269163;2;2020-04-12;-1478
2020-04-11;"Trenčiansky kraj";3;0;0;0;NA;269163;3;2020-04-11;-1480
2020-04-10;"Trenčiansky kraj";0;0;0;0;NA;269163;0;2020-04-10;-1483
2020-04-09;"Trenčiansky kraj";0;0;0;0;NA;269163;0;2020-04-09;-1483
2020-04-08;"Trenčiansky kraj";2;0;0;0;NA;269163;2;2020-04-08;-1483
2020-04-07;"Trenčiansky kraj";18;0;0;0;NA;269163;18;2020-04-07;-1485
2020-04-06;"Trenčiansky kraj";0;0;0;0;NA;269163;0;2020-04-06;-1503
2020-04-05;"Trenčiansky kraj";3;0;0;0;NA;269163;3;2020-04-05;-1503
2020-04-04;"Trenčiansky kraj";5;0;0;0;NA;269163;5;2020-04-04;-1506
2020-04-03;"Trenčiansky kraj";4;0;0;0;NA;269163;4;2020-04-03;-1511
2020-04-02;"Trenčiansky kraj";1;0;0;0;NA;269163;1;2020-04-02;-1515
2020-04-01;"Trenčiansky kraj";3;0;0;0;NA;269163;3;2020-04-01;-1516
2020-03-31;"Trenčiansky kraj";1;0;0;0;NA;269163;1;2020-03-31;-1519
2020-03-30;"Trenčiansky kraj";3;0;0;0;NA;269163;3;2020-03-30;-1520
2020-03-29;"Trenčiansky kraj";6;0;0;0;NA;269163;6;2020-03-29;-1523
2020-03-28;"Trenčiansky kraj";9;0;0;0;NA;269163;9;2020-03-28;-1529
2020-03-27;"Trenčiansky kraj";2;0;0;0;NA;269163;2;2020-03-27;-1538
2020-03-26;"Trenčiansky kraj";6;0;0;0;NA;269163;6;2020-03-26;-1540
2020-03-25;"Trenčiansky kraj";3;0;0;0;NA;269163;3;2020-03-25;-1546
2020-03-24;"Trenčiansky kraj";1;0;0;0;NA;269163;1;2020-03-24;-1549
2020-03-23;"Trenčiansky kraj";0;0;0;0;NA;269163;0;2020-03-23;-1550
2020-03-22;"Trenčiansky kraj";0;0;0;0;NA;269163;0;2020-03-22;-1550
2020-03-21;"Trenčiansky kraj";2;0;0;0;NA;269163;2;2020-03-21;-1550
2020-03-20;"Trenčiansky kraj";2;0;0;0;NA;269163;2;2020-03-20;-1552
2020-03-19;"Trenčiansky kraj";8;0;0;0;NA;269163;8;2020-03-19;-1554
2020-03-18;"Trenčiansky kraj";0;0;0;0;NA;269163;0;2020-03-18;-1562
2020-03-17;"Trenčiansky kraj";0;0;0;0;NA;269163;0;2020-03-17;-1562
2020-03-16;"Trenčiansky kraj";1;0;0;0;NA;269163;1;2020-03-16;-1562
2020-03-15;"Trenčiansky kraj";5;0;0;0;NA;269163;5;2020-03-15;-1563
2020-03-14;"Trenčiansky kraj";0;0;0;0;NA;269163;0;2020-03-14;-1568
2020-03-13;"Trenčiansky kraj";0;0;0;0;NA;269163;0;2020-03-13;-1568
2020-03-12;"Trenčiansky kraj";1;0;0;0;NA;269163;1;2020-03-12;-1568
2020-03-11;"Trenčiansky kraj";0;0;0;0;NA;269163;0;2020-03-11;-1569
2020-03-09;"Trenčiansky kraj";0;0;0;0;NA;269163;0;2020-03-09;-1569
2020-03-08;"Trenčiansky kraj";0;0;0;0;NA;269163;0;2020-03-08;-1569
2020-03-07;"Trenčiansky kraj";0;0;0;0;NA;269163;0;2020-03-07;-1569
2020-03-06;"Trenčiansky kraj";0;0;0;0;NA;269163;0;2020-03-06;-1569
2022-03-08;"Trnavský kraj";1393;0;0;0;173052;238883;1393;2022-03-08;238883
2022-03-07;"Trnavský kraj";1005;0;0;0;NA;238883;1005;2022-03-07;237490
2022-03-06;"Trnavský kraj";395;311;63;374;NA;238883;458;2022-03-06;236485
2022-03-05;"Trnavský kraj";806;431;76;507;NA;238883;882;2022-03-05;236027
2022-03-04;"Trnavský kraj";1028;965;105;1070;NA;238883;1133;2022-03-04;235145
2022-03-03;"Trnavský kraj";1513;1104;156;1260;NA;238883;1669;2022-03-03;234012
2022-03-02;"Trnavský kraj";1330;1466;185;1651;NA;238883;1515;2022-03-02;232343
2022-03-01;"Trnavský kraj";1527;1308;190;1498;NA;238883;1717;2022-03-01;230828
2022-02-28;"Trnavský kraj";1318;2101;264;2365;NA;238883;1582;2022-02-28;229111
2022-02-27;"Trnavský kraj";386;640;106;746;NA;238883;492;2022-02-27;227529
2022-02-26;"Trnavský kraj";1268;526;112;638;NA;238883;1380;2022-02-26;227037
2022-02-25;"Trnavský kraj";1439;1490;211;1701;NA;238883;1650;2022-02-25;225657
2022-02-24;"Trnavský kraj";1397;1417;183;1600;NA;238883;1580;2022-02-24;224007
2022-02-23;"Trnavský kraj";2032;1668;238;1906;NA;238883;2270;2022-02-23;222427
2022-02-22;"Trnavský kraj";2171;1891;271;2162;NA;238883;2442;2022-02-22;220157
2022-02-21;"Trnavský kraj";1983;2847;438;3285;NA;238883;2421;2022-02-21;217715
2022-02-20;"Trnavský kraj";888;829;186;1015;NA;238883;1074;2022-02-20;215294
2022-02-19;"Trnavský kraj";1838;707;149;856;NA;238883;1987;2022-02-19;214220
2022-02-18;"Trnavský kraj";2132;1723;269;1992;NA;238883;2401;2022-02-18;212233
2022-02-17;"Trnavský kraj";1987;1763;269;2032;NA;238883;2256;2022-02-17;209832
2022-02-16;"Trnavský kraj";2047;1809;317;2126;NA;238883;2364;2022-02-16;207576
2022-02-15;"Trnavský kraj";2228;2412;400;2812;NA;238883;2628;2022-02-15;205212
2022-02-14;"Trnavský kraj";2216;3424;492;3916;NA;238883;2708;2022-02-14;202584
2022-02-13;"Trnavský kraj";805;1129;247;1376;NA;238883;1052;2022-02-13;199876
2022-02-12;"Trnavský kraj";2081;966;175;1141;NA;238883;2256;2022-02-12;198824
2022-02-11;"Trnavský kraj";1665;2158;266;2424;NA;238883;1931;2022-02-11;196568
2022-02-10;"Trnavský kraj";2491;1942;256;2198;NA;238883;2747;2022-02-10;194637
2022-02-09;"Trnavský kraj";2205;2474;365;2839;NA;238883;2570;2022-02-09;191890
2022-02-08;"Trnavský kraj";1758;2352;353;2705;NA;238883;2111;2022-02-08;189320
2022-02-07;"Trnavský kraj";2581;3356;459;3815;NA;238883;3040;2022-02-07;187209
2022-02-06;"Trnavský kraj";1194;1309;276;1585;NA;238883;1470;2022-02-06;184169
2022-02-05;"Trnavský kraj";2165;1102;187;1289;NA;238883;2352;2022-02-05;182699
2022-02-04;"Trnavský kraj";2191;2179;253;2432;NA;238883;2444;2022-02-04;180347
2022-02-03;"Trnavský kraj";2124;3295;347;3642;NA;238883;2471;2022-02-03;177903
2022-02-02;"Trnavský kraj";1812;2684;281;2965;NA;238883;2093;2022-02-02;175432
2022-02-01;"Trnavský kraj";2344;2656;318;2974;NA;238883;2662;2022-02-01;173339
2022-01-31;"Trnavský kraj";1931;5001;489;5490;NA;238883;2420;2022-01-31;170677
2022-01-30;"Trnavský kraj";709;1672;176;1848;NA;238883;885;2022-01-30;168257
2022-01-29;"Trnavský kraj";2136;1174;159;1333;NA;238883;2295;2022-01-29;167372
2022-01-28;"Trnavský kraj";1734;2340;216;2556;NA;238883;1950;2022-01-28;165077
2022-01-27;"Trnavský kraj";1989;2333;246;2579;NA;238883;2235;2022-01-27;163127
2022-01-26;"Trnavský kraj";1906;2730;217;2947;NA;238883;2123;2022-01-26;160892
2022-01-25;"Trnavský kraj";1631;2422;195;2617;NA;238883;1826;2022-01-25;158769
2022-01-24;"Trnavský kraj";999;4194;236;4430;NA;238883;1235;2022-01-24;156943
2022-01-23;"Trnavský kraj";299;1897;105;2002;NA;238883;404;2022-01-23;155708
2022-01-22;"Trnavský kraj";1169;1197;81;1278;NA;238883;1250;2022-01-22;155304
2022-01-21;"Trnavský kraj";830;2134;104;2238;NA;238883;934;2022-01-21;154054
2022-01-20;"Trnavský kraj";917;2511;100;2611;NA;238883;1017;2022-01-20;153120
2022-01-19;"Trnavský kraj";832;2122;84;2206;NA;238883;916;2022-01-19;152103
2022-01-18;"Trnavský kraj";704;2051;74;2125;NA;238883;778;2022-01-18;151187
2022-01-17;"Trnavský kraj";366;3885;87;3972;NA;238883;453;2022-01-17;150409
2022-01-16;"Trnavský kraj";84;1696;44;1740;NA;238883;128;2022-01-16;149956
2022-01-15;"Trnavský kraj";421;1015;33;1048;NA;238883;454;2022-01-15;149828
2022-01-14;"Trnavský kraj";349;2040;50;2090;NA;238883;399;2022-01-14;149374
2022-01-13;"Trnavský kraj";234;2057;52;2109;NA;238883;286;2022-01-13;148975
2022-01-12;"Trnavský kraj";400;1927;35;1962;NA;238883;435;2022-01-12;148689
2022-01-11;"Trnavský kraj";384;2261;33;2294;NA;238883;417;2022-01-11;148254
2022-01-10;"Trnavský kraj";258;4357;71;4428;NA;238883;329;2022-01-10;147837
2022-01-09;"Trnavský kraj";35;1921;22;1943;NA;238883;57;2022-01-09;147508
2022-01-08;"Trnavský kraj";364;1005;29;1034;NA;238883;393;2022-01-08;147451
2022-01-07;"Trnavský kraj";332;1984;47;2031;NA;238883;379;2022-01-07;147058
2022-01-06;"Trnavský kraj";234;830;20;850;NA;238883;254;2022-01-06;146679
2022-01-05;"Trnavský kraj";416;1925;37;1962;NA;238883;453;2022-01-05;146425
2022-01-04;"Trnavský kraj";538;2337;37;2374;NA;238883;575;2022-01-04;145972
2022-01-03;"Trnavský kraj";441;3897;65;3962;NA;238883;506;2022-01-03;145397
2022-01-02;"Trnavský kraj";79;1561;21;1582;NA;238883;100;2022-01-02;144891
2022-01-01;"Trnavský kraj";4;190;7;197;NA;238883;11;2022-01-01;144791
2021-12-31;"Trnavský kraj";485;1246;60;1306;NA;238883;545;2021-12-31;144780
2021-12-30;"Trnavský kraj";401;1927;58;1985;NA;238883;459;2021-12-30;144235
2021-12-29;"Trnavský kraj";401;1756;70;1826;NA;238883;471;2021-12-29;143776
2021-12-28;"Trnavský kraj";633;1742;73;1815;NA;238883;706;2021-12-28;143305
2021-12-27;"Trnavský kraj";463;2814;134;2948;NA;238883;597;2021-12-27;142599
2021-12-26;"Trnavský kraj";253;1019;30;1049;NA;238883;283;2021-12-26;142002
2021-12-25;"Trnavský kraj";104;341;41;382;NA;238883;145;2021-12-25;141719
2021-12-24;"Trnavský kraj";216;369;27;396;NA;238883;243;2021-12-24;141574
2021-12-23;"Trnavský kraj";570;1825;102;1927;NA;238883;672;2021-12-23;141331
2021-12-22;"Trnavský kraj";545;1732;81;1813;NA;238883;626;2021-12-22;140659
2021-12-21;"Trnavský kraj";699;2577;89;2666;NA;238883;788;2021-12-21;140033
2021-12-20;"Trnavský kraj";438;3941;103;4044;NA;238883;541;2021-12-20;139245
2021-12-19;"Trnavský kraj";155;1762;63;1825;NA;238883;218;2021-12-19;138704
2021-12-18;"Trnavský kraj";627;1302;77;1379;NA;238883;704;2021-12-18;138486
2021-12-17;"Trnavský kraj";576;2276;109;2385;NA;238883;685;2021-12-17;137782
2021-12-16;"Trnavský kraj";653;2530;123;2653;NA;238883;776;2021-12-16;137097
2021-12-15;"Trnavský kraj";746;2198;120;2318;NA;238883;866;2021-12-15;136321
2021-12-14;"Trnavský kraj";976;2718;134;2852;NA;238883;1110;2021-12-14;135455
2021-12-13;"Trnavský kraj";521;4857;175;5032;NA;238883;696;2021-12-13;134345
2021-12-12;"Trnavský kraj";337;2117;87;2204;NA;238883;424;2021-12-12;133649
2021-12-11;"Trnavský kraj";720;1324;83;1407;NA;238883;803;2021-12-11;133225
2021-12-10;"Trnavský kraj";702;2909;136;3045;NA;238883;838;2021-12-10;132422
2021-12-09;"Trnavský kraj";926;2313;96;2409;NA;238883;1022;2021-12-09;131584
2021-12-08;"Trnavský kraj";1233;2547;137;2684;NA;238883;1370;2021-12-08;130562
2021-12-07;"Trnavský kraj";1159;3637;174;3811;NA;238883;1333;2021-12-07;129192
2021-12-06;"Trnavský kraj";911;3649;208;3857;NA;238883;1119;2021-12-06;127859
2021-12-05;"Trnavský kraj";269;2303;106;2409;NA;238883;375;2021-12-05;126740
2021-12-04;"Trnavský kraj";1225;1623;115;1738;NA;238883;1340;2021-12-04;126365
2021-12-03;"Trnavský kraj";1246;2998;201;3199;NA;238883;1447;2021-12-03;125025
2021-12-02;"Trnavský kraj";1809;2379;188;2567;NA;238883;1997;2021-12-02;123578
2021-12-01;"Trnavský kraj";738;3011;179;3190;NA;238883;917;2021-12-01;121581
2021-11-30;"Trnavský kraj";1166;4217;202;4419;NA;238883;1368;2021-11-30;120664
2021-11-29;"Trnavský kraj";814;5360;299;5659;NA;238883;1113;2021-11-29;119296
2021-11-28;"Trnavský kraj";482;3087;146;3233;NA;238883;628;2021-11-28;118183
2021-11-27;"Trnavský kraj";1186;2240;206;2446;NA;238883;1392;2021-11-27;117555
2021-11-26;"Trnavský kraj";880;2895;202;3097;NA;238883;1082;2021-11-26;116163
2021-11-25;"Trnavský kraj";1002;2680;158;2838;NA;238883;1160;2021-11-25;115081
2021-11-24;"Trnavský kraj";1060;3442;250;3692;NA;238883;1310;2021-11-24;113921
2021-11-23;"Trnavský kraj";1078;3714;273;3987;NA;238883;1351;2021-11-23;112611
2021-11-22;"Trnavský kraj";696;4028;295;4323;NA;238883;991;2021-11-22;111260
2021-11-21;"Trnavský kraj";298;2270;212;2482;NA;238883;510;2021-11-21;110269
2021-11-20;"Trnavský kraj";826;1529;196;1725;NA;238883;1022;2021-11-20;109759
2021-11-19;"Trnavský kraj";901;3369;315;3684;NA;238883;1216;2021-11-19;108737
2021-11-18;"Trnavský kraj";796;2872;240;3112;NA;238883;1036;2021-11-18;107521
2021-11-17;"Trnavský kraj";769;1201;139;1340;NA;238883;908;2021-11-17;106485
2021-11-16;"Trnavský kraj";591;2755;206;2961;NA;238883;797;2021-11-16;105577
2021-11-15;"Trnavský kraj";606;3350;239;3589;NA;238883;845;2021-11-15;104780
2021-11-14;"Trnavský kraj";236;1579;141;1720;NA;238883;377;2021-11-14;103935
2021-11-13;"Trnavský kraj";815;1314;132;1446;NA;238883;947;2021-11-13;103558
2021-11-12;"Trnavský kraj";563;2585;157;2742;NA;238883;720;2021-11-12;102611
2021-11-11;"Trnavský kraj";512;2426;161;2587;NA;238883;673;2021-11-11;101891
2021-11-10;"Trnavský kraj";590;2315;173;2488;NA;238883;763;2021-11-10;101218
2021-11-09;"Trnavský kraj";585;2538;187;2725;NA;238883;772;2021-11-09;100455
2021-11-08;"Trnavský kraj";357;2715;163;2878;NA;238883;520;2021-11-08;99683
2021-11-07;"Trnavský kraj";162;1349;111;1460;NA;238883;273;2021-11-07;99163
2021-11-06;"Trnavský kraj";391;1287;82;1369;NA;238883;473;2021-11-06;98890
2021-11-05;"Trnavský kraj";447;2202;102;2304;NA;238883;549;2021-11-05;98417
2021-11-04;"Trnavský kraj";432;2289;112;2401;NA;238883;544;2021-11-04;97868
2021-11-03;"Trnavský kraj";420;2091;97;2188;NA;238883;517;2021-11-03;97324
2021-11-02;"Trnavský kraj";365;2777;124;2901;NA;238883;489;2021-11-02;96807
2021-11-01;"Trnavský kraj";220;583;27;610;NA;238883;247;2021-11-01;96318
2021-10-31;"Trnavský kraj";61;887;62;949;NA;238883;123;2021-10-31;96071
2021-10-30;"Trnavský kraj";251;1099;50;1149;NA;238883;301;2021-10-30;95948
2021-10-29;"Trnavský kraj";312;2123;53;2176;NA;238883;365;2021-10-29;95647
2021-10-28;"Trnavský kraj";339;2034;65;2099;NA;238883;404;2021-10-28;95282
2021-10-27;"Trnavský kraj";232;1884;58;1942;NA;238883;290;2021-10-27;94878
2021-10-26;"Trnavský kraj";366;1964;54;2018;NA;238883;420;2021-10-26;94588
2021-10-25;"Trnavský kraj";142;2786;72;2858;NA;238883;214;2021-10-25;94168
2021-10-24;"Trnavský kraj";11;990;30;1020;NA;238883;41;2021-10-24;93954
2021-10-23;"Trnavský kraj";228;1126;27;1153;NA;238883;255;2021-10-23;93913
2021-10-22;"Trnavský kraj";204;2269;51;2320;NA;238883;255;2021-10-22;93658
2021-10-21;"Trnavský kraj";188;1671;46;1717;NA;238883;234;2021-10-21;93403
2021-10-20;"Trnavský kraj";212;1634;47;1681;NA;238883;259;2021-10-20;93169
2021-10-19;"Trnavský kraj";240;1848;30;1878;NA;238883;270;2021-10-19;92910
2021-10-18;"Trnavský kraj";95;2316;72;2388;NA;238883;167;2021-10-18;92640
2021-10-17;"Trnavský kraj";5;1218;17;1235;NA;238883;22;2021-10-17;92473
2021-10-16;"Trnavský kraj";129;1233;17;1250;NA;238883;146;2021-10-16;92451
2021-10-15;"Trnavský kraj";122;2121;24;2145;NA;238883;146;2021-10-15;92305
2021-10-14;"Trnavský kraj";131;1663;24;1687;NA;238883;155;2021-10-14;92159
2021-10-13;"Trnavský kraj";128;2072;23;2095;NA;238883;151;2021-10-13;92004
2021-10-12;"Trnavský kraj";189;2788;38;2826;NA;238883;227;2021-10-12;91853
2021-10-11;"Trnavský kraj";115;2621;35;2656;NA;238883;150;2021-10-11;91626
2021-10-10;"Trnavský kraj";2;993;15;1008;NA;238883;17;2021-10-10;91476
2021-10-09;"Trnavský kraj";151;1099;10;1109;NA;238883;161;2021-10-09;91459
2021-10-08;"Trnavský kraj";106;2326;34;2360;NA;238883;140;2021-10-08;91298
2021-10-07;"Trnavský kraj";151;1744;25;1769;NA;238883;176;2021-10-07;91158
2021-10-06;"Trnavský kraj";122;1929;27;1956;NA;238883;149;2021-10-06;90982
2021-10-05;"Trnavský kraj";220;3726;34;3760;NA;238883;254;2021-10-05;90833
2021-10-04;"Trnavský kraj";54;1963;47;2010;NA;238883;101;2021-10-04;90579
2021-10-03;"Trnavský kraj";1;1106;17;1123;NA;238883;18;2021-10-03;90478
2021-10-02;"Trnavský kraj";52;1055;12;1067;NA;238883;64;2021-10-02;90460
2021-10-01;"Trnavský kraj";113;2243;17;2260;NA;238883;130;2021-10-01;90396
2021-09-30;"Trnavský kraj";109;1872;18;1890;NA;238883;127;2021-09-30;90266
2021-09-29;"Trnavský kraj";83;1331;11;1342;NA;238883;94;2021-09-29;90139
2021-09-28;"Trnavský kraj";135;1934;31;1965;NA;238883;166;2021-09-28;90045
2021-09-27;"Trnavský kraj";80;2084;25;2109;NA;238883;105;2021-09-27;89879
2021-09-26;"Trnavský kraj";2;1048;12;1060;NA;238883;14;2021-09-26;89774
2021-09-25;"Trnavský kraj";61;1105;9;1114;NA;238883;70;2021-09-25;89760
2021-09-24;"Trnavský kraj";41;2229;15;2244;NA;238883;56;2021-09-24;89690
2021-09-23;"Trnavský kraj";89;1691;16;1707;NA;238883;105;2021-09-23;89634
2021-09-22;"Trnavský kraj";119;1706;28;1734;NA;238883;147;2021-09-22;89529
2021-09-21;"Trnavský kraj";108;1505;17;1522;NA;238883;125;2021-09-21;89382
2021-09-20;"Trnavský kraj";50;1652;20;1672;NA;238883;70;2021-09-20;89257
2021-09-19;"Trnavský kraj";2;924;8;932;NA;238883;10;2021-09-19;89187
2021-09-18;"Trnavský kraj";100;982;6;988;NA;238883;106;2021-09-18;89177
2021-09-17;"Trnavský kraj";77;1709;20;1729;NA;238883;97;2021-09-17;89071
2021-09-16;"Trnavský kraj";105;1279;32;1311;NA;238883;137;2021-09-16;88974
2021-09-15;"Trnavský kraj";59;841;5;846;NA;238883;64;2021-09-15;88837
2021-09-14;"Trnavský kraj";38;1583;12;1595;NA;238883;50;2021-09-14;88773
2021-09-13;"Trnavský kraj";56;1410;16;1426;NA;238883;72;2021-09-13;88723
2021-09-12;"Trnavský kraj";0;653;1;654;NA;238883;1;2021-09-12;88651
2021-09-11;"Trnavský kraj";37;971;10;981;NA;238883;47;2021-09-11;88650
2021-09-10;"Trnavský kraj";43;1441;9;1450;NA;238883;52;2021-09-10;88603
2021-09-09;"Trnavský kraj";42;954;13;967;NA;238883;55;2021-09-09;88551
2021-09-08;"Trnavský kraj";65;802;15;817;NA;238883;80;2021-09-08;88496
2021-09-07;"Trnavský kraj";29;844;5;849;NA;238883;34;2021-09-07;88416
2021-09-06;"Trnavský kraj";18;1234;14;1248;NA;238883;32;2021-09-06;88382
2021-09-05;"Trnavský kraj";2;580;4;584;NA;238883;6;2021-09-05;88350
2021-09-04;"Trnavský kraj";17;868;6;874;NA;238883;23;2021-09-04;88344
2021-09-03;"Trnavský kraj";14;1060;5;1065;NA;238883;19;2021-09-03;88321
2021-09-02;"Trnavský kraj";30;830;10;840;NA;238883;40;2021-09-02;88302
2021-09-01;"Trnavský kraj";6;409;4;413;NA;238883;10;2021-09-01;88262
2021-08-31;"Trnavský kraj";13;884;3;887;NA;238883;16;2021-08-31;88252
2021-08-30;"Trnavský kraj";7;904;1;905;NA;238883;8;2021-08-30;88236
2021-08-29;"Trnavský kraj";8;427;1;428;NA;238883;9;2021-08-29;88228
2021-08-28;"Trnavský kraj";17;694;2;696;NA;238883;19;2021-08-28;88219
2021-08-27;"Trnavský kraj";1;1186;4;1190;NA;238883;5;2021-08-27;88200
2021-08-26;"Trnavský kraj";8;713;3;716;NA;238883;11;2021-08-26;88195
2021-08-25;"Trnavský kraj";11;683;6;689;NA;238883;17;2021-08-25;88184
2021-08-24;"Trnavský kraj";7;801;1;802;NA;238883;8;2021-08-24;88167
2021-08-23;"Trnavský kraj";4;844;1;845;NA;238883;5;2021-08-23;88159
2021-08-22;"Trnavský kraj";0;474;0;474;NA;238883;0;2021-08-22;88154
2021-08-21;"Trnavský kraj";8;703;0;703;NA;238883;8;2021-08-21;88154
2021-08-20;"Trnavský kraj";4;1095;4;1099;NA;238883;8;2021-08-20;88146
2021-08-19;"Trnavský kraj";10;881;3;884;NA;238883;13;2021-08-19;88138
2021-08-18;"Trnavský kraj";6;789;2;791;NA;238883;8;2021-08-18;88125
2021-08-17;"Trnavský kraj";7;524;4;528;NA;238883;11;2021-08-17;88117
2021-08-16;"Trnavský kraj";9;966;3;969;NA;238883;12;2021-08-16;88106
2021-08-15;"Trnavský kraj";0;556;1;557;NA;238883;1;2021-08-15;88094
2021-08-14;"Trnavský kraj";10;801;3;804;NA;238883;13;2021-08-14;88093
2021-08-13;"Trnavský kraj";5;1077;6;1083;NA;238883;11;2021-08-13;88080
2021-08-12;"Trnavský kraj";3;666;3;669;NA;238883;6;2021-08-12;88069
2021-08-11;"Trnavský kraj";7;576;2;578;NA;238883;9;2021-08-11;88063
2021-08-10;"Trnavský kraj";3;757;3;760;NA;238883;6;2021-08-10;88054
2021-08-09;"Trnavský kraj";12;808;0;808;NA;238883;12;2021-08-09;88048
2021-08-08;"Trnavský kraj";1;545;0;545;NA;238883;1;2021-08-08;88036
2021-08-07;"Trnavský kraj";9;724;0;724;NA;238883;9;2021-08-07;88035
2021-08-06;"Trnavský kraj";3;988;0;988;NA;238883;3;2021-08-06;88026
2021-08-05;"Trnavský kraj";2;662;1;663;NA;238883;3;2021-08-05;88023
2021-08-04;"Trnavský kraj";1;891;1;892;NA;238883;2;2021-08-04;88020
2021-08-03;"Trnavský kraj";13;645;0;645;NA;238883;13;2021-08-03;88018
2021-08-02;"Trnavský kraj";2;725;1;726;NA;238883;3;2021-08-02;88005
2021-08-01;"Trnavský kraj";0;565;2;567;NA;238883;2;2021-08-01;88002
2021-07-31;"Trnavský kraj";3;886;0;886;NA;238883;3;2021-07-31;88000
2021-07-30;"Trnavský kraj";3;1084;3;1087;NA;238883;6;2021-07-30;87997
2021-07-29;"Trnavský kraj";1;775;0;775;NA;238883;1;2021-07-29;87991
2021-07-28;"Trnavský kraj";5;794;1;795;NA;238883;6;2021-07-28;87990
2021-07-27;"Trnavský kraj";7;623;2;625;NA;238883;9;2021-07-27;87984
2021-07-26;"Trnavský kraj";2;857;2;859;NA;238883;4;2021-07-26;87975
2021-07-25;"Trnavský kraj";0;707;0;707;NA;238883;0;2021-07-25;87971
2021-07-24;"Trnavský kraj";4;828;2;830;NA;238883;6;2021-07-24;87971
2021-07-23;"Trnavský kraj";3;1057;0;1057;NA;238883;3;2021-07-23;87965
2021-07-22;"Trnavský kraj";0;671;2;673;NA;238883;2;2021-07-22;87962
2021-07-21;"Trnavský kraj";2;660;2;662;NA;238883;4;2021-07-21;87960
2021-07-20;"Trnavský kraj";2;593;0;593;NA;238883;2;2021-07-20;87956
2021-07-19;"Trnavský kraj";9;886;0;886;NA;238883;9;2021-07-19;87954
2021-07-18;"Trnavský kraj";0;600;2;602;NA;238883;2;2021-07-18;87945
2021-07-17;"Trnavský kraj";8;796;0;796;NA;238883;8;2021-07-17;87943
2021-07-16;"Trnavský kraj";11;963;0;963;NA;238883;11;2021-07-16;87935
2021-07-15;"Trnavský kraj";4;832;1;833;NA;238883;5;2021-07-15;87924
2021-07-14;"Trnavský kraj";1;699;1;700;NA;238883;2;2021-07-14;87919
2021-07-13;"Trnavský kraj";1;693;1;694;NA;238883;2;2021-07-13;87917
2021-07-12;"Trnavský kraj";4;959;0;959;NA;238883;4;2021-07-12;87915
2021-07-11;"Trnavský kraj";0;692;0;692;NA;238883;0;2021-07-11;87911
2021-07-10;"Trnavský kraj";1;803;0;803;NA;238883;1;2021-07-10;87911
2021-07-09;"Trnavský kraj";3;1262;3;1265;NA;238883;6;2021-07-09;87910
2021-07-08;"Trnavský kraj";4;755;0;755;NA;238883;4;2021-07-08;87904
2021-07-07;"Trnavský kraj";9;924;2;926;NA;238883;11;2021-07-07;87900
2021-07-06;"Trnavský kraj";2;1401;1;1402;NA;238883;3;2021-07-06;87889
2021-07-05;"Trnavský kraj";1;503;2;505;NA;238883;3;2021-07-05;87886
2021-07-04;"Trnavský kraj";0;1129;3;1132;NA;238883;3;2021-07-04;87883
2021-07-03;"Trnavský kraj";4;815;0;815;NA;238883;4;2021-07-03;87880
2021-07-02;"Trnavský kraj";2;1137;2;1139;NA;238883;4;2021-07-02;87876
2021-07-01;"Trnavský kraj";4;487;0;487;NA;238883;4;2021-07-01;87872
2021-06-30;"Trnavský kraj";0;5135;1;5136;NA;238883;1;2021-06-30;87868
2021-06-29;"Trnavský kraj";4;2563;1;2564;NA;238883;5;2021-06-29;87867
2021-06-28;"Trnavský kraj";2;2600;1;2601;NA;238883;3;2021-06-28;87862
2021-06-27;"Trnavský kraj";0;3213;0;3213;NA;238883;0;2021-06-27;87859
2021-06-26;"Trnavský kraj";3;3871;1;3872;NA;238883;4;2021-06-26;87859
2021-06-25;"Trnavský kraj";2;4374;3;4377;NA;238883;5;2021-06-25;87855
2021-06-24;"Trnavský kraj";4;2520;3;2523;NA;238883;7;2021-06-24;87850
2021-06-23;"Trnavský kraj";4;2842;2;2844;NA;238883;6;2021-06-23;87843
2021-06-22;"Trnavský kraj";2;2996;1;2997;NA;238883;3;2021-06-22;87837
2021-06-21;"Trnavský kraj";6;3114;5;3119;NA;238883;11;2021-06-21;87834
2021-06-20;"Trnavský kraj";0;3952;1;3953;NA;238883;1;2021-06-20;87823
2021-06-19;"Trnavský kraj";3;4735;2;4737;NA;238883;5;2021-06-19;87822
2021-06-18;"Trnavský kraj";5;6125;4;6129;NA;238883;9;2021-06-18;87817
2021-06-17;"Trnavský kraj";3;3340;0;3340;NA;238883;3;2021-06-17;87808
2021-06-16;"Trnavský kraj";6;2926;3;2929;NA;238883;9;2021-06-16;87805
2021-06-15;"Trnavský kraj";8;3234;3;3237;NA;238883;11;2021-06-15;87796
2021-06-14;"Trnavský kraj";2;3829;1;3830;NA;238883;3;2021-06-14;87785
2021-06-13;"Trnavský kraj";0;5001;8;5009;NA;238883;8;2021-06-13;87782
2021-06-12;"Trnavský kraj";11;5807;2;5809;NA;238883;13;2021-06-12;87774
2021-06-11;"Trnavský kraj";17;5850;4;5854;NA;238883;21;2021-06-11;87761
2021-06-10;"Trnavský kraj";14;3476;1;3477;NA;238883;15;2021-06-10;87740
2021-06-09;"Trnavský kraj";10;3681;1;3682;NA;238883;11;2021-06-09;87725
2021-06-08;"Trnavský kraj";8;3344;4;3348;NA;238883;12;2021-06-08;87714
2021-06-07;"Trnavský kraj";12;4498;8;4506;NA;238883;20;2021-06-07;87702
2021-06-06;"Trnavský kraj";0;5517;2;5519;NA;238883;2;2021-06-06;87682
2021-06-05;"Trnavský kraj";20;6905;8;6913;NA;238883;28;2021-06-05;87680
2021-06-04;"Trnavský kraj";9;6735;10;6745;NA;238883;19;2021-06-04;87652
2021-06-03;"Trnavský kraj";14;4361;11;4372;NA;238883;25;2021-06-03;87633
2021-06-02;"Trnavský kraj";4;4148;11;4159;NA;238883;15;2021-06-02;87608
2021-06-01;"Trnavský kraj";18;3662;5;3667;NA;238883;23;2021-06-01;87593
2021-05-31;"Trnavský kraj";14;5515;16;5531;NA;238883;30;2021-05-31;87570
2021-05-30;"Trnavský kraj";0;6473;7;6480;NA;238883;7;2021-05-30;87540
2021-05-29;"Trnavský kraj";11;8964;4;8968;NA;238883;15;2021-05-29;87533
2021-05-28;"Trnavský kraj";14;7160;11;7171;NA;238883;25;2021-05-28;87518
2021-05-27;"Trnavský kraj";22;4753;8;4761;NA;238883;30;2021-05-27;87493
2021-05-26;"Trnavský kraj";6;4870;8;4878;NA;238883;14;2021-05-26;87463
2021-05-25;"Trnavský kraj";19;5026;27;5053;NA;238883;46;2021-05-25;87449
2021-05-24;"Trnavský kraj";15;6520;22;6542;NA;238883;37;2021-05-24;87403
2021-05-23;"Trnavský kraj";0;7920;8;7928;NA;238883;8;2021-05-23;87366
2021-05-22;"Trnavský kraj";13;13381;21;13402;NA;238883;34;2021-05-22;87358
2021-05-21;"Trnavský kraj";16;8525;19;8544;NA;238883;35;2021-05-21;87324
2021-05-20;"Trnavský kraj";15;5511;11;5522;NA;238883;26;2021-05-20;87289
2021-05-19;"Trnavský kraj";18;5431;13;5444;NA;238883;31;2021-05-19;87263
2021-05-18;"Trnavský kraj";26;5768;15;5783;NA;238883;41;2021-05-18;87232
2021-05-17;"Trnavský kraj";17;6262;24;6286;NA;238883;41;2021-05-17;87191
2021-05-16;"Trnavský kraj";10;9984;8;9992;NA;238883;18;2021-05-16;87150
2021-05-15;"Trnavský kraj";11;18525;14;18539;NA;238883;25;2021-05-15;87132
2021-05-14;"Trnavský kraj";34;10279;21;10300;NA;238883;55;2021-05-14;87107
2021-05-13;"Trnavský kraj";26;6913;12;6925;NA;238883;38;2021-05-13;87052
2021-05-12;"Trnavský kraj";34;6621;26;6647;NA;238883;60;2021-05-12;87014
2021-05-11;"Trnavský kraj";32;6393;13;6406;NA;238883;45;2021-05-11;86954
2021-05-10;"Trnavský kraj";58;9139;24;9163;NA;238883;82;2021-05-10;86909
2021-05-09;"Trnavský kraj";21;12570;12;12582;NA;238883;33;2021-05-09;86827
2021-05-08;"Trnavský kraj";4;23028;22;23050;NA;238883;26;2021-05-08;86794
2021-05-07;"Trnavský kraj";26;15465;30;15495;NA;238883;56;2021-05-07;86768
2021-05-06;"Trnavský kraj";22;8407;22;8429;NA;238883;44;2021-05-06;86712
2021-05-05;"Trnavský kraj";34;6273;22;6295;NA;238883;56;2021-05-05;86668
2021-05-04;"Trnavský kraj";51;8538;17;8555;NA;238883;68;2021-05-04;86612
2021-05-03;"Trnavský kraj";20;8957;22;8979;NA;238883;42;2021-05-03;86544
2021-05-02;"Trnavský kraj";0;25657;29;25686;NA;238883;29;2021-05-02;86502
2021-05-01;"Trnavský kraj";30;81353;64;81417;NA;238883;94;2021-05-01;86473
2021-04-30;"Trnavský kraj";45;26846;35;26881;NA;238883;80;2021-04-30;86379
2021-04-29;"Trnavský kraj";25;20323;28;20351;NA;238883;53;2021-04-29;86299
2021-04-28;"Trnavský kraj";46;8896;28;8924;NA;238883;74;2021-04-28;86246
2021-04-27;"Trnavský kraj";54;8756;37;8793;NA;238883;91;2021-04-27;86172
2021-04-26;"Trnavský kraj";53;16116;42;16158;NA;238883;95;2021-04-26;86081
2021-04-25;"Trnavský kraj";0;30183;24;30207;NA;238883;24;2021-04-25;85986
2021-04-24;"Trnavský kraj";46;126077;84;126161;NA;238883;130;2021-04-24;85962
2021-04-23;"Trnavský kraj";71;25741;53;25794;NA;238883;124;2021-04-23;85832
2021-04-22;"Trnavský kraj";40;10904;25;10929;NA;238883;65;2021-04-22;85708
2021-04-21;"Trnavský kraj";60;10748;45;10793;NA;238883;105;2021-04-21;85643
2021-04-20;"Trnavský kraj";57;13504;28;13532;NA;238883;85;2021-04-20;85538
2021-04-19;"Trnavský kraj";46;14603;18;14621;NA;238883;64;2021-04-19;85453
2021-04-18;"Trnavský kraj";7;40843;43;40886;NA;238883;50;2021-04-18;85389
2021-04-17;"Trnavský kraj";58;118102;89;118191;NA;238883;147;2021-04-17;85339
2021-04-16;"Trnavský kraj";67;25962;48;26010;NA;238883;115;2021-04-16;85192
2021-04-15;"Trnavský kraj";65;11373;36;11409;NA;238883;101;2021-04-15;85077
2021-04-14;"Trnavský kraj";78;18442;53;18495;NA;238883;131;2021-04-14;84976
2021-04-13;"Trnavský kraj";126;9871;44;9915;NA;238883;170;2021-04-13;84845
2021-04-12;"Trnavský kraj";40;15577;40;15617;NA;238883;80;2021-04-12;84675
2021-04-11;"Trnavský kraj";3;44420;44;44464;NA;238883;47;2021-04-11;84595
2021-04-10;"Trnavský kraj";60;123822;107;123929;NA;238883;167;2021-04-10;84548
2021-04-09;"Trnavský kraj";95;26191;34;26225;NA;238883;129;2021-04-09;84381
2021-04-08;"Trnavský kraj";85;10913;54;10967;NA;238883;139;2021-04-08;84252
2021-04-07;"Trnavský kraj";131;15979;81;16060;NA;238883;212;2021-04-07;84113
2021-04-06;"Trnavský kraj";92;20586;90;20676;NA;238883;182;2021-04-06;83901
2021-04-05;"Trnavský kraj";91;7542;17;7559;NA;238883;108;2021-04-05;83719
2021-04-04;"Trnavský kraj";9;28831;49;28880;NA;238883;58;2021-04-04;83611
2021-04-03;"Trnavský kraj";29;144452;186;144638;NA;238883;215;2021-04-03;83553
2021-04-02;"Trnavský kraj";91;17538;33;17571;NA;238883;124;2021-04-02;83338
2021-04-01;"Trnavský kraj";118;22279;71;22350;NA;238883;189;2021-04-01;83214
2021-03-31;"Trnavský kraj";140;15828;82;15910;NA;238883;222;2021-03-31;83025
2021-03-30;"Trnavský kraj";182;10482;79;10561;NA;238883;261;2021-03-30;82803
2021-03-29;"Trnavský kraj";126;19255;122;19377;NA;238883;248;2021-03-29;82542
2021-03-28;"Trnavský kraj";26;50664;134;50798;NA;238883;160;2021-03-28;82294
2021-03-27;"Trnavský kraj";64;130217;246;130463;NA;238883;310;2021-03-27;82134
2021-03-26;"Trnavský kraj";139;30217;130;30347;NA;238883;269;2021-03-26;81824
2021-03-25;"Trnavský kraj";135;14212;80;14292;NA;238883;215;2021-03-25;81555
2021-03-24;"Trnavský kraj";159;10521;89;10610;NA;238883;248;2021-03-24;81340
2021-03-23;"Trnavský kraj";221;12735;104;12839;NA;238883;325;2021-03-23;81092
2021-03-22;"Trnavský kraj";103;17118;110;17228;NA;238883;213;2021-03-22;80767
2021-03-21;"Trnavský kraj";31;49119;150;49269;NA;238883;181;2021-03-21;80554
2021-03-20;"Trnavský kraj";112;136963;317;137280;NA;238883;429;2021-03-20;80373
2021-03-19;"Trnavský kraj";174;29071;137;29208;NA;238883;311;2021-03-19;79944
2021-03-18;"Trnavský kraj";158;12217;136;12353;NA;238883;294;2021-03-18;79633
2021-03-17;"Trnavský kraj";245;10434;103;10537;NA;238883;348;2021-03-17;79339
2021-03-16;"Trnavský kraj";311;12811;135;12946;NA;238883;446;2021-03-16;78991
2021-03-15;"Trnavský kraj";127;18271;146;18417;NA;238883;273;2021-03-15;78545
2021-03-14;"Trnavský kraj";14;47608;164;47772;NA;238883;178;2021-03-14;78272
2021-03-13;"Trnavský kraj";155;139224;409;139633;NA;238883;564;2021-03-13;78094
2021-03-12;"Trnavský kraj";201;28566;181;28747;NA;238883;382;2021-03-12;77530
2021-03-11;"Trnavský kraj";204;13301;140;13441;NA;238883;344;2021-03-11;77148
2021-03-10;"Trnavský kraj";242;10583;135;10718;NA;238883;377;2021-03-10;76804
2021-03-09;"Trnavský kraj";442;12824;155;12979;NA;238883;597;2021-03-09;76427
2021-03-08;"Trnavský kraj";182;21812;166;21978;NA;238883;348;2021-03-08;75830
2021-03-07;"Trnavský kraj";30;45463;227;45690;NA;238883;257;2021-03-07;75482
2021-03-06;"Trnavský kraj";154;135784;531;136315;NA;238883;685;2021-03-06;75225
2021-03-05;"Trnavský kraj";299;27959;239;28198;NA;238883;538;2021-03-05;74540
2021-03-04;"Trnavský kraj";238;14505;176;14681;NA;238883;414;2021-03-04;74002
2021-03-03;"Trnavský kraj";413;11583;246;11829;NA;238883;659;2021-03-03;73588
2021-03-02;"Trnavský kraj";477;12367;191;12558;NA;238883;668;2021-03-02;72929
2021-03-01;"Trnavský kraj";189;18586;234;18820;NA;238883;423;2021-03-01;72261
2021-02-28;"Trnavský kraj";87;47709;321;48030;NA;238883;408;2021-02-28;71838
2021-02-27;"Trnavský kraj";264;140224;800;141024;NA;238883;1064;2021-02-27;71430
2021-02-26;"Trnavský kraj";362;26637;284;26921;NA;238883;646;2021-02-26;70366
2021-02-25;"Trnavský kraj";433;10490;227;10717;NA;238883;660;2021-02-25;69720
2021-02-24;"Trnavský kraj";407;9113;290;9403;NA;238883;697;2021-02-24;69060
2021-02-23;"Trnavský kraj";469;11322;284;11606;NA;238883;753;2021-02-23;68363
2021-02-22;"Trnavský kraj";206;19901;330;20231;NA;238883;536;2021-02-22;67610
2021-02-21;"Trnavský kraj";38;48221;329;48550;NA;238883;367;2021-02-21;67074
2021-02-20;"Trnavský kraj";273;135835;859;136694;NA;238883;1132;2021-02-20;66707
2021-02-19;"Trnavský kraj";335;26382;366;26748;NA;238883;701;2021-02-19;65575
2021-02-18;"Trnavský kraj";344;11264;348;11612;NA;238883;692;2021-02-18;64874
2021-02-17;"Trnavský kraj";431;8783;416;9199;NA;238883;847;2021-02-17;64182
2021-02-16;"Trnavský kraj";426;11236;294;11530;NA;238883;720;2021-02-16;63335
2021-02-15;"Trnavský kraj";146;18276;326;18602;NA;238883;472;2021-02-15;62615
2021-02-14;"Trnavský kraj";51;57642;495;58137;NA;238883;546;2021-02-14;62143
2021-02-13;"Trnavský kraj";218;137051;994;138045;NA;238883;1212;2021-02-13;61597
2021-02-12;"Trnavský kraj";300;24090;352;24442;NA;238883;652;2021-02-12;60385
2021-02-11;"Trnavský kraj";422;9831;349;10180;NA;238883;771;2021-02-11;59733
2021-02-10;"Trnavský kraj";511;9194;342;9536;NA;238883;853;2021-02-10;58962
2021-02-09;"Trnavský kraj";544;12755;369;13124;NA;238883;913;2021-02-09;58109
2021-02-08;"Trnavský kraj";220;33414;497;33911;NA;238883;717;2021-02-08;57196
2021-02-07;"Trnavský kraj";140;69694;628;70322;NA;238883;768;2021-02-07;56479
2021-02-06;"Trnavský kraj";348;112687;1482;114169;NA;238883;1830;2021-02-06;55711
2021-02-05;"Trnavský kraj";377;16063;373;16436;NA;238883;750;2021-02-05;53881
2021-02-04;"Trnavský kraj";456;7317;456;7773;NA;238883;912;2021-02-04;53131
2021-02-03;"Trnavský kraj";472;6583;434;7017;NA;238883;906;2021-02-03;52219
2021-02-02;"Trnavský kraj";446;14243;424;14667;NA;238883;870;2021-02-02;51313
2021-02-01;"Trnavský kraj";198;38882;679;39561;NA;238883;877;2021-02-01;50443
2021-01-31;"Trnavský kraj";19;64707;822;65529;NA;238883;841;2021-01-31;49566
2021-01-30;"Trnavský kraj";323;111483;1288;112771;NA;238883;1611;2021-01-30;48725
2021-01-29;"Trnavský kraj";421;9689;290;9979;NA;238883;711;2021-01-29;47114
2021-01-28;"Trnavský kraj";389;5817;289;6106;NA;238883;678;2021-01-28;46403
2021-01-27;"Trnavský kraj";433;5554;225;5779;NA;238883;658;2021-01-27;45725
2021-01-26;"Trnavský kraj";565;25411;636;26047;NA;238883;1201;2021-01-26;45067
2021-01-25;"Trnavský kraj";210;41805;620;42425;NA;238883;830;2021-01-25;43866
2021-01-24;"Trnavský kraj";91;66399;779;67178;NA;238883;870;2021-01-24;43036
2021-01-23;"Trnavský kraj";372;113375;1319;114694;NA;238883;1691;2021-01-23;42166
2021-01-22;"Trnavský kraj";217;32755;505;33260;NA;238883;722;2021-01-22;40475
2021-01-21;"Trnavský kraj";311;13913;377;14290;NA;238883;688;2021-01-21;39753
2021-01-20;"Trnavský kraj";503;8685;283;8968;NA;238883;786;2021-01-20;39065
2021-01-19;"Trnavský kraj";415;7013;347;7360;NA;238883;762;2021-01-19;38279
2021-01-18;"Trnavský kraj";247;6690;513;7203;NA;238883;760;2021-01-18;37517
2021-01-17;"Trnavský kraj";128;854;215;1069;NA;238883;343;2021-01-17;36757
2021-01-16;"Trnavský kraj";103;898;24;922;NA;238883;127;2021-01-16;36414
2021-01-15;"Trnavský kraj";278;5467;336;5803;NA;238883;614;2021-01-15;36287
2021-01-14;"Trnavský kraj";452;4001;338;4339;NA;238883;790;2021-01-14;35673
2021-01-13;"Trnavský kraj";457;4751;378;5129;NA;238883;835;2021-01-13;34883
2021-01-12;"Trnavský kraj";469;6860;470;7330;NA;238883;939;2021-01-12;34048
2021-01-11;"Trnavský kraj";370;4587;360;4947;NA;238883;730;2021-01-11;33109
2021-01-10;"Trnavský kraj";71;13;0;13;NA;238883;71;2021-01-10;32379
2021-01-09;"Trnavský kraj";417;1775;100;1875;NA;238883;517;2021-01-09;32308
2021-01-08;"Trnavský kraj";381;6016;506;6522;NA;238883;887;2021-01-08;31791
2021-01-07;"Trnavský kraj";501;3545;329;3874;NA;238883;830;2021-01-07;30904
2021-01-06;"Trnavský kraj";179;758;132;890;NA;238883;311;2021-01-06;30074
2021-01-05;"Trnavský kraj";611;5165;561;5726;NA;238883;1172;2021-01-05;29763
2021-01-04;"Trnavský kraj";302;5556;709;6265;NA;238883;1011;2021-01-04;28591
2021-01-03;"Trnavský kraj";60;53;7;60;NA;238883;67;2021-01-03;27580
2021-01-02;"Trnavský kraj";282;417;32;449;NA;238883;314;2021-01-02;27513
2021-01-01;"Trnavský kraj";143;455;76;531;NA;238883;219;2021-01-01;27199
2020-12-31;"Trnavský kraj";498;8325;820;9145;NA;238883;1318;2020-12-31;26980
2020-12-30;"Trnavský kraj";785;5318;612;5930;NA;238883;1397;2020-12-30;25662
2020-12-29;"Trnavský kraj";322;4913;565;5478;NA;238883;887;2020-12-29;24265
2020-12-28;"Trnavský kraj";213;4900;552;5452;NA;238883;765;2020-12-28;23378
2020-12-27;"Trnavský kraj";27;20;4;24;NA;238883;31;2020-12-27;22613
2020-12-26;"Trnavský kraj";148;44;1;45;NA;238883;149;2020-12-26;22582
2020-12-25;"Trnavský kraj";65;49;5;54;NA;238883;70;2020-12-25;22433
2020-12-24;"Trnavský kraj";333;1359;117;1476;NA;238883;450;2020-12-24;22363
2020-12-23;"Trnavský kraj";210;6672;414;7086;NA;238883;624;2020-12-23;21913
2020-12-22;"Trnavský kraj";311;5427;455;5882;NA;238883;766;2020-12-22;21289
2020-12-21;"Trnavský kraj";328;4092;350;4442;NA;238883;678;2020-12-21;20523
2020-12-20;"Trnavský kraj";134;133;12;145;NA;238883;146;2020-12-20;19845
2020-12-19;"Trnavský kraj";201;1407;103;1510;NA;238883;304;2020-12-19;19699
2020-12-18;"Trnavský kraj";341;4432;334;4766;NA;238883;675;2020-12-18;19395
2020-12-17;"Trnavský kraj";375;4880;414;5294;NA;238883;789;2020-12-17;18720
2020-12-16;"Trnavský kraj";312;4945;383;5328;NA;238883;695;2020-12-16;17931
2020-12-15;"Trnavský kraj";492;6240;598;6838;NA;238883;1090;2020-12-15;17236
2020-12-14;"Trnavský kraj";161;3505;292;3797;NA;238883;453;2020-12-14;16146
2020-12-13;"Trnavský kraj";7;7;0;7;NA;238883;7;2020-12-13;15693
2020-12-12;"Trnavský kraj";254;1456;114;1570;NA;238883;368;2020-12-12;15686
2020-12-11;"Trnavský kraj";384;4289;241;4530;NA;238883;625;2020-12-11;15318
2020-12-10;"Trnavský kraj";183;5197;320;5517;NA;238883;503;2020-12-10;14693
2020-12-09;"Trnavský kraj";521;4199;317;4516;NA;238883;838;2020-12-09;14190
2020-12-08;"Trnavský kraj";281;4090;304;4394;NA;238883;585;2020-12-08;13352
2020-12-07;"Trnavský kraj";178;2895;199;3094;NA;238883;377;2020-12-07;12767
2020-12-06;"Trnavský kraj";46;0;0;0;NA;238883;46;2020-12-06;12390
2020-12-05;"Trnavský kraj";129;2218;41;2259;NA;238883;170;2020-12-05;12344
2020-12-04;"Trnavský kraj";242;3948;158;4106;NA;238883;400;2020-12-04;12174
2020-12-03;"Trnavský kraj";248;2770;190;2960;NA;238883;438;2020-12-03;11774
2020-12-02;"Trnavský kraj";284;4516;176;4692;NA;238883;460;2020-12-02;11336
2020-12-01;"Trnavský kraj";253;3190;205;3395;NA;238883;458;2020-12-01;10876
2020-11-30;"Trnavský kraj";200;7360;186;7546;NA;238883;386;2020-11-30;10418
2020-11-29;"Trnavský kraj";17;738;36;774;NA;238883;53;2020-11-29;10032
2020-11-28;"Trnavský kraj";83;1453;77;1530;NA;238883;160;2020-11-28;9979
2020-11-27;"Trnavský kraj";148;1779;85;1864;NA;238883;233;2020-11-27;9819
2020-11-26;"Trnavský kraj";234;1123;68;1191;NA;238883;302;2020-11-26;9586
2020-11-25;"Trnavský kraj";232;1168;74;1242;NA;238883;306;2020-11-25;9284
2020-11-24;"Trnavský kraj";295;1909;96;2005;NA;238883;391;2020-11-24;8978
2020-11-23;"Trnavský kraj";242;7393;129;7522;NA;238883;371;2020-11-23;8587
2020-11-22;"Trnavský kraj";10;82;9;91;NA;238883;19;2020-11-22;8216
2020-11-21;"Trnavský kraj";129;1354;36;1390;NA;238883;165;2020-11-21;8197
2020-11-20;"Trnavský kraj";246;1154;64;1218;NA;238883;310;2020-11-20;8032
2020-11-19;"Trnavský kraj";157;823;64;887;NA;238883;221;2020-11-19;7722
2020-11-18;"Trnavský kraj";235;822;82;904;NA;238883;317;2020-11-18;7501
2020-11-17;"Trnavský kraj";129;705;74;779;NA;238883;203;2020-11-17;7184
2020-11-16;"Trnavský kraj";187;732;32;764;NA;238883;219;2020-11-16;6981
2020-11-15;"Trnavský kraj";23;73;4;77;NA;238883;27;2020-11-15;6762
2020-11-14;"Trnavský kraj";86;397;12;409;NA;238883;98;2020-11-14;6735
2020-11-13;"Trnavský kraj";219;1312;21;1333;NA;238883;240;2020-11-13;6637
2020-11-12;"Trnavský kraj";162;420;18;438;NA;238883;180;2020-11-12;6397
2020-11-11;"Trnavský kraj";257;392;15;407;NA;238883;272;2020-11-11;6217
2020-11-10;"Trnavský kraj";189;889;30;919;NA;238883;219;2020-11-10;5945
2020-11-09;"Trnavský kraj";196;369;23;392;NA;238883;219;2020-11-09;5726
2020-11-08;"Trnavský kraj";55;400;4;404;NA;238883;59;2020-11-08;5507
2020-11-07;"Trnavský kraj";207;6070;74;6144;NA;238883;281;2020-11-07;5448
2020-11-06;"Trnavský kraj";260;1531;19;1550;NA;238883;279;2020-11-06;5167
2020-11-05;"Trnavský kraj";150;220;27;247;NA;238883;177;2020-11-05;4888
2020-11-04;"Trnavský kraj";188;212;10;222;NA;238883;198;2020-11-04;4711
2020-11-03;"Trnavský kraj";317;127;8;135;NA;238883;325;2020-11-03;4513
2020-11-02;"Trnavský kraj";281;1728;31;1759;NA;238883;312;2020-11-02;4188
2020-11-01;"Trnavský kraj";87;494;27;521;NA;238883;114;2020-11-01;3876
2020-10-31;"Trnavský kraj";259;5024;41;5065;NA;238883;300;2020-10-31;3762
2020-10-30;"Trnavský kraj";198;3784;27;3811;NA;238883;225;2020-10-30;3462
2020-10-29;"Trnavský kraj";273;1461;16;1477;NA;238883;289;2020-10-29;3237
2020-10-28;"Trnavský kraj";319;117;16;133;NA;238883;335;2020-10-28;2948
2020-10-27;"Trnavský kraj";199;461;36;497;NA;238883;235;2020-10-27;2613
2020-10-26;"Trnavský kraj";153;29;2;31;NA;238883;155;2020-10-26;2378
2020-10-25;"Trnavský kraj";95;19;1;20;NA;238883;96;2020-10-25;2223
2020-10-24;"Trnavský kraj";158;109;2;111;NA;238883;160;2020-10-24;2127
2020-10-23;"Trnavský kraj";201;89;4;93;NA;238883;205;2020-10-23;1967
2020-10-22;"Trnavský kraj";195;55;2;57;NA;238883;197;2020-10-22;1762
2020-10-21;"Trnavský kraj";134;73;3;76;NA;238883;137;2020-10-21;1565
2020-10-20;"Trnavský kraj";202;82;3;85;NA;238883;205;2020-10-20;1428
2020-10-19;"Trnavský kraj";67;55;0;55;NA;238883;67;2020-10-19;1223
2020-10-18;"Trnavský kraj";84;0;0;0;NA;238883;84;2020-10-18;1156
2020-10-17;"Trnavský kraj";123;0;0;0;NA;238883;123;2020-10-17;1072
2020-10-16;"Trnavský kraj";86;45;2;47;NA;238883;88;2020-10-16;949
2020-10-15;"Trnavský kraj";155;66;2;68;NA;238883;157;2020-10-15;861
2020-10-14;"Trnavský kraj";236;468;3;471;NA;238883;239;2020-10-14;704
2020-10-13;"Trnavský kraj";138;16;2;18;NA;238883;140;2020-10-13;465
2020-10-12;"Trnavský kraj";33;41;1;42;NA;238883;34;2020-10-12;325
2020-10-11;"Trnavský kraj";31;0;0;0;NA;238883;31;2020-10-11;291
2020-10-10;"Trnavský kraj";128;0;0;0;NA;238883;128;2020-10-10;260
2020-10-09;"Trnavský kraj";156;0;0;0;NA;238883;156;2020-10-09;132
2020-10-08;"Trnavský kraj";153;0;0;0;NA;238883;153;2020-10-08;-24
2020-10-07;"Trnavský kraj";80;0;0;0;NA;238883;80;2020-10-07;-177
2020-10-06;"Trnavský kraj";112;0;0;0;NA;238883;112;2020-10-06;-257
2020-10-05;"Trnavský kraj";33;0;0;0;NA;238883;33;2020-10-05;-369
2020-10-04;"Trnavský kraj";44;0;0;0;NA;238883;44;2020-10-04;-402
2020-10-03;"Trnavský kraj";60;0;0;0;NA;238883;60;2020-10-03;-446
2020-10-02;"Trnavský kraj";41;0;0;0;NA;238883;41;2020-10-02;-506
2020-10-01;"Trnavský kraj";53;0;0;0;NA;238883;53;2020-10-01;-547
2020-09-30;"Trnavský kraj";91;0;0;0;NA;238883;91;2020-09-30;-600
2020-09-29;"Trnavský kraj";40;0;0;0;NA;238883;40;2020-09-29;-691
2020-09-28;"Trnavský kraj";69;0;0;0;NA;238883;69;2020-09-28;-731
2020-09-27;"Trnavský kraj";30;0;0;0;NA;238883;30;2020-09-27;-800
2020-09-26;"Trnavský kraj";46;0;0;0;NA;238883;46;2020-09-26;-830
2020-09-25;"Trnavský kraj";32;0;0;0;NA;238883;32;2020-09-25;-876
2020-09-24;"Trnavský kraj";42;0;0;0;NA;238883;42;2020-09-24;-908
2020-09-23;"Trnavský kraj";43;0;0;0;NA;238883;43;2020-09-23;-950
2020-09-22;"Trnavský kraj";55;0;0;0;NA;238883;55;2020-09-22;-993
2020-09-21;"Trnavský kraj";41;0;0;0;NA;238883;41;2020-09-21;-1048
2020-09-20;"Trnavský kraj";17;0;0;0;NA;238883;17;2020-09-20;-1089
2020-09-19;"Trnavský kraj";4;0;0;0;NA;238883;4;2020-09-19;-1106
2020-09-18;"Trnavský kraj";33;0;0;0;NA;238883;33;2020-09-18;-1110
2020-09-17;"Trnavský kraj";42;0;0;0;NA;238883;42;2020-09-17;-1143
2020-09-16;"Trnavský kraj";49;0;0;0;NA;238883;49;2020-09-16;-1185
2020-09-15;"Trnavský kraj";5;0;0;0;NA;238883;5;2020-09-15;-1234
2020-09-14;"Trnavský kraj";26;0;0;0;NA;238883;26;2020-09-14;-1239
2020-09-13;"Trnavský kraj";9;0;0;0;NA;238883;9;2020-09-13;-1265
2020-09-12;"Trnavský kraj";12;0;0;0;NA;238883;12;2020-09-12;-1274
2020-09-11;"Trnavský kraj";16;0;0;0;NA;238883;16;2020-09-11;-1286
2020-09-10;"Trnavský kraj";32;0;0;0;NA;238883;32;2020-09-10;-1302
2020-09-09;"Trnavský kraj";14;0;0;0;NA;238883;14;2020-09-09;-1334
2020-09-08;"Trnavský kraj";11;0;0;0;NA;238883;11;2020-09-08;-1348
2020-09-07;"Trnavský kraj";7;0;0;0;NA;238883;7;2020-09-07;-1359
2020-09-06;"Trnavský kraj";5;0;0;0;NA;238883;5;2020-09-06;-1366
2020-09-05;"Trnavský kraj";7;0;0;0;NA;238883;7;2020-09-05;-1371
2020-09-04;"Trnavský kraj";16;0;0;0;NA;238883;16;2020-09-04;-1378
2020-09-03;"Trnavský kraj";8;0;0;0;NA;238883;8;2020-09-03;-1394
2020-09-02;"Trnavský kraj";7;0;0;0;NA;238883;7;2020-09-02;-1402
2020-09-01;"Trnavský kraj";1;0;0;0;NA;238883;1;2020-09-01;-1409
2020-08-31;"Trnavský kraj";6;0;0;0;NA;238883;6;2020-08-31;-1410
2020-08-30;"Trnavský kraj";1;0;0;0;NA;238883;1;2020-08-30;-1416
2020-08-29;"Trnavský kraj";3;0;0;0;NA;238883;3;2020-08-29;-1417
2020-08-28;"Trnavský kraj";14;0;0;0;NA;238883;14;2020-08-28;-1420
2020-08-27;"Trnavský kraj";6;0;0;0;NA;238883;6;2020-08-27;-1434
2020-08-26;"Trnavský kraj";4;0;0;0;NA;238883;4;2020-08-26;-1440
2020-08-25;"Trnavský kraj";7;0;0;0;NA;238883;7;2020-08-25;-1444
2020-08-24;"Trnavský kraj";1;0;0;0;NA;238883;1;2020-08-24;-1451
2020-08-23;"Trnavský kraj";6;0;0;0;NA;238883;6;2020-08-23;-1452
2020-08-22;"Trnavský kraj";3;0;0;0;NA;238883;3;2020-08-22;-1458
2020-08-21;"Trnavský kraj";4;0;0;0;NA;238883;4;2020-08-21;-1461
2020-08-20;"Trnavský kraj";23;0;0;0;NA;238883;23;2020-08-20;-1465
2020-08-19;"Trnavský kraj";13;0;0;0;NA;238883;13;2020-08-19;-1488
2020-08-18;"Trnavský kraj";20;0;0;0;NA;238883;20;2020-08-18;-1501
2020-08-17;"Trnavský kraj";3;0;0;0;NA;238883;3;2020-08-17;-1521
2020-08-16;"Trnavský kraj";0;0;0;0;NA;238883;0;2020-08-16;-1524
2020-08-15;"Trnavský kraj";7;0;0;0;NA;238883;7;2020-08-15;-1524
2020-08-14;"Trnavský kraj";6;0;0;0;NA;238883;6;2020-08-14;-1531
2020-08-13;"Trnavský kraj";10;0;0;0;NA;238883;10;2020-08-13;-1537
2020-08-12;"Trnavský kraj";2;0;0;0;NA;238883;2;2020-08-12;-1547
2020-08-11;"Trnavský kraj";30;0;0;0;NA;238883;30;2020-08-11;-1549
2020-08-10;"Trnavský kraj";0;0;0;0;NA;238883;0;2020-08-10;-1579
2020-08-09;"Trnavský kraj";0;0;0;0;NA;238883;0;2020-08-09;-1579
2020-08-08;"Trnavský kraj";13;0;0;0;NA;238883;13;2020-08-08;-1579
2020-08-07;"Trnavský kraj";4;0;0;0;NA;238883;4;2020-08-07;-1592
2020-08-06;"Trnavský kraj";4;0;0;0;NA;238883;4;2020-08-06;-1596
2020-08-05;"Trnavský kraj";0;0;0;0;NA;238883;0;2020-08-05;-1600
2020-08-04;"Trnavský kraj";1;0;0;0;NA;238883;1;2020-08-04;-1600
2020-08-03;"Trnavský kraj";2;0;0;0;NA;238883;2;2020-08-03;-1601
2020-08-02;"Trnavský kraj";1;0;0;0;NA;238883;1;2020-08-02;-1603
2020-08-01;"Trnavský kraj";0;0;0;0;NA;238883;0;2020-08-01;-1604
2020-07-31;"Trnavský kraj";7;0;0;0;NA;238883;7;2020-07-31;-1604
2020-07-30;"Trnavský kraj";6;0;0;0;NA;238883;6;2020-07-30;-1611
2020-07-29;"Trnavský kraj";0;0;0;0;NA;238883;0;2020-07-29;-1617
2020-07-28;"Trnavský kraj";1;0;0;0;NA;238883;1;2020-07-28;-1617
2020-07-27;"Trnavský kraj";2;0;0;0;NA;238883;2;2020-07-27;-1618
2020-07-26;"Trnavský kraj";0;0;0;0;NA;238883;0;2020-07-26;-1620
2020-07-25;"Trnavský kraj";0;0;0;0;NA;238883;0;2020-07-25;-1620
2020-07-24;"Trnavský kraj";1;0;0;0;NA;238883;1;2020-07-24;-1620
2020-07-23;"Trnavský kraj";2;0;0;0;NA;238883;2;2020-07-23;-1621
2020-07-22;"Trnavský kraj";1;0;0;0;NA;238883;1;2020-07-22;-1623
2020-07-21;"Trnavský kraj";2;0;0;0;NA;238883;2;2020-07-21;-1624
2020-07-20;"Trnavský kraj";0;0;0;0;NA;238883;0;2020-07-20;-1626
2020-07-19;"Trnavský kraj";0;0;0;0;NA;238883;0;2020-07-19;-1626
2020-07-18;"Trnavský kraj";0;0;0;0;NA;238883;0;2020-07-18;-1626
2020-07-17;"Trnavský kraj";0;0;0;0;NA;238883;0;2020-07-17;-1626
2020-07-16;"Trnavský kraj";0;0;0;0;NA;238883;0;2020-07-16;-1626
2020-07-15;"Trnavský kraj";1;0;0;0;NA;238883;1;2020-07-15;-1626
2020-07-14;"Trnavský kraj";0;0;0;0;NA;238883;0;2020-07-14;-1627
2020-07-13;"Trnavský kraj";0;0;0;0;NA;238883;0;2020-07-13;-1627
2020-07-12;"Trnavský kraj";0;0;0;0;NA;238883;0;2020-07-12;-1627
2020-07-11;"Trnavský kraj";0;0;0;0;NA;238883;0;2020-07-11;-1627
2020-07-10;"Trnavský kraj";0;0;0;0;NA;238883;0;2020-07-10;-1627
2020-07-09;"Trnavský kraj";0;0;0;0;NA;238883;0;2020-07-09;-1627
2020-07-08;"Trnavský kraj";3;0;0;0;NA;238883;3;2020-07-08;-1627
2020-07-07;"Trnavský kraj";4;0;0;0;NA;238883;4;2020-07-07;-1630
2020-07-06;"Trnavský kraj";0;0;0;0;NA;238883;0;2020-07-06;-1634
2020-07-05;"Trnavský kraj";0;0;0;0;NA;238883;0;2020-07-05;-1634
2020-07-04;"Trnavský kraj";0;0;0;0;NA;238883;0;2020-07-04;-1634
2020-07-03;"Trnavský kraj";0;0;0;0;NA;238883;0;2020-07-03;-1634
2020-07-02;"Trnavský kraj";3;0;0;0;NA;238883;3;2020-07-02;-1634
2020-07-01;"Trnavský kraj";0;0;0;0;NA;238883;0;2020-07-01;-1637
2020-06-30;"Trnavský kraj";0;0;0;0;NA;238883;0;2020-06-30;-1637
2020-06-29;"Trnavský kraj";0;0;0;0;NA;238883;0;2020-06-29;-1637
2020-06-28;"Trnavský kraj";0;0;0;0;NA;238883;0;2020-06-28;-1637
2020-06-27;"Trnavský kraj";0;0;0;0;NA;238883;0;2020-06-27;-1637
2020-06-26;"Trnavský kraj";0;0;0;0;NA;238883;0;2020-06-26;-1637
2020-06-25;"Trnavský kraj";0;0;0;0;NA;238883;0;2020-06-25;-1637
2020-06-24;"Trnavský kraj";0;0;0;0;NA;238883;0;2020-06-24;-1637
2020-06-23;"Trnavský kraj";0;0;0;0;NA;238883;0;2020-06-23;-1637
2020-06-22;"Trnavský kraj";0;0;0;0;NA;238883;0;2020-06-22;-1637
2020-06-21;"Trnavský kraj";0;0;0;0;NA;238883;0;2020-06-21;-1637
2020-06-20;"Trnavský kraj";0;0;0;0;NA;238883;0;2020-06-20;-1637
2020-06-19;"Trnavský kraj";0;0;0;0;NA;238883;0;2020-06-19;-1637
2020-06-18;"Trnavský kraj";2;0;0;0;NA;238883;2;2020-06-18;-1637
2020-06-17;"Trnavský kraj";0;0;0;0;NA;238883;0;2020-06-17;-1639
2020-06-16;"Trnavský kraj";0;0;0;0;NA;238883;0;2020-06-16;-1639
2020-06-14;"Trnavský kraj";0;0;0;0;NA;238883;0;2020-06-14;-1639
2020-06-13;"Trnavský kraj";0;0;0;0;NA;238883;0;2020-06-13;-1639
2020-06-12;"Trnavský kraj";0;0;0;0;NA;238883;0;2020-06-12;-1639
2020-06-11;"Trnavský kraj";0;0;0;0;NA;238883;0;2020-06-11;-1639
2020-06-10;"Trnavský kraj";0;0;0;0;NA;238883;0;2020-06-10;-1639
2020-06-09;"Trnavský kraj";0;0;0;0;NA;238883;0;2020-06-09;-1639
2020-06-08;"Trnavský kraj";0;0;0;0;NA;238883;0;2020-06-08;-1639
2020-06-07;"Trnavský kraj";0;0;0;0;NA;238883;0;2020-06-07;-1639
2020-06-05;"Trnavský kraj";0;0;0;0;NA;238883;0;2020-06-05;-1639
2020-06-03;"Trnavský kraj";0;0;0;0;NA;238883;0;2020-06-03;-1639
2020-06-02;"Trnavský kraj";0;0;0;0;NA;238883;0;2020-06-02;-1639
2020-05-31;"Trnavský kraj";0;0;0;0;NA;238883;0;2020-05-31;-1639
2020-05-29;"Trnavský kraj";0;0;0;0;NA;238883;0;2020-05-29;-1639
2020-05-27;"Trnavský kraj";0;0;0;0;NA;238883;0;2020-05-27;-1639
2020-05-26;"Trnavský kraj";0;0;0;0;NA;238883;0;2020-05-26;-1639
2020-05-25;"Trnavský kraj";1;0;0;0;NA;238883;1;2020-05-25;-1639
2020-05-24;"Trnavský kraj";0;0;0;0;NA;238883;0;2020-05-24;-1640
2020-05-23;"Trnavský kraj";2;0;0;0;NA;238883;2;2020-05-23;-1640
2020-05-22;"Trnavský kraj";0;0;0;0;NA;238883;0;2020-05-22;-1642
2020-05-21;"Trnavský kraj";0;0;0;0;NA;238883;0;2020-05-21;-1642
2020-05-20;"Trnavský kraj";2;0;0;0;NA;238883;2;2020-05-20;-1642
2020-05-19;"Trnavský kraj";0;0;0;0;NA;238883;0;2020-05-19;-1644
2020-05-17;"Trnavský kraj";0;0;0;0;NA;238883;0;2020-05-17;-1644
2020-05-16;"Trnavský kraj";0;0;0;0;NA;238883;0;2020-05-16;-1644
2020-05-15;"Trnavský kraj";1;0;0;0;NA;238883;1;2020-05-15;-1644
2020-05-14;"Trnavský kraj";0;0;0;0;NA;238883;0;2020-05-14;-1645
2020-05-13;"Trnavský kraj";0;0;0;0;NA;238883;0;2020-05-13;-1645
2020-05-12;"Trnavský kraj";0;0;0;0;NA;238883;0;2020-05-12;-1645
2020-05-11;"Trnavský kraj";2;0;0;0;NA;238883;2;2020-05-11;-1645
2020-05-09;"Trnavský kraj";0;0;0;0;NA;238883;0;2020-05-09;-1647
2020-05-07;"Trnavský kraj";0;0;0;0;NA;238883;0;2020-05-07;-1647
2020-05-06;"Trnavský kraj";0;0;0;0;NA;238883;0;2020-05-06;-1647
2020-05-05;"Trnavský kraj";0;0;0;0;NA;238883;0;2020-05-05;-1647
2020-05-04;"Trnavský kraj";0;0;0;0;NA;238883;0;2020-05-04;-1647
2020-05-03;"Trnavský kraj";0;0;0;0;NA;238883;0;2020-05-03;-1647
2020-05-02;"Trnavský kraj";0;0;0;0;NA;238883;0;2020-05-02;-1647
2020-05-01;"Trnavský kraj";0;0;0;0;NA;238883;0;2020-05-01;-1647
2020-04-30;"Trnavský kraj";0;0;0;0;NA;238883;0;2020-04-30;-1647
2020-04-29;"Trnavský kraj";0;0;0;0;NA;238883;0;2020-04-29;-1647
2020-04-28;"Trnavský kraj";1;0;0;0;NA;238883;1;2020-04-28;-1647
2020-04-27;"Trnavský kraj";0;0;0;0;NA;238883;0;2020-04-27;-1648
2020-04-26;"Trnavský kraj";0;0;0;0;NA;238883;0;2020-04-26;-1648
2020-04-25;"Trnavský kraj";2;0;0;0;NA;238883;2;2020-04-25;-1648
2020-04-24;"Trnavský kraj";4;0;0;0;NA;238883;4;2020-04-24;-1650
2020-04-23;"Trnavský kraj";5;0;0;0;NA;238883;5;2020-04-23;-1654
2020-04-22;"Trnavský kraj";10;0;0;0;NA;238883;10;2020-04-22;-1659
2020-04-21;"Trnavský kraj";5;0;0;0;NA;238883;5;2020-04-21;-1669
2020-04-20;"Trnavský kraj";0;0;0;0;NA;238883;0;2020-04-20;-1674
2020-04-19;"Trnavský kraj";1;0;0;0;NA;238883;1;2020-04-19;-1674
2020-04-18;"Trnavský kraj";4;0;0;0;NA;238883;4;2020-04-18;-1675
2020-04-17;"Trnavský kraj";7;0;0;0;NA;238883;7;2020-04-17;-1679
2020-04-16;"Trnavský kraj";5;0;0;0;NA;238883;5;2020-04-16;-1686
2020-04-15;"Trnavský kraj";5;0;0;0;NA;238883;5;2020-04-15;-1691
2020-04-14;"Trnavský kraj";1;0;0;0;NA;238883;1;2020-04-14;-1696
2020-04-13;"Trnavský kraj";0;0;0;0;NA;238883;0;2020-04-13;-1697
2020-04-12;"Trnavský kraj";0;0;0;0;NA;238883;0;2020-04-12;-1697
2020-04-11;"Trnavský kraj";0;0;0;0;NA;238883;0;2020-04-11;-1697
2020-04-10;"Trnavský kraj";2;0;0;0;NA;238883;2;2020-04-10;-1697
2020-04-09;"Trnavský kraj";3;0;0;0;NA;238883;3;2020-04-09;-1699
2020-04-08;"Trnavský kraj";4;0;0;0;NA;238883;4;2020-04-08;-1702
2020-04-07;"Trnavský kraj";6;0;0;0;NA;238883;6;2020-04-07;-1706
2020-04-06;"Trnavský kraj";6;0;0;0;NA;238883;6;2020-04-06;-1712
2020-04-05;"Trnavský kraj";1;0;0;0;NA;238883;1;2020-04-05;-1718
2020-04-04;"Trnavský kraj";1;0;0;0;NA;238883;1;2020-04-04;-1719
2020-04-03;"Trnavský kraj";3;0;0;0;NA;238883;3;2020-04-03;-1720
2020-04-02;"Trnavský kraj";4;0;0;0;NA;238883;4;2020-04-02;-1723
2020-04-01;"Trnavský kraj";0;0;0;0;NA;238883;0;2020-04-01;-1727
2020-03-31;"Trnavský kraj";3;0;0;0;NA;238883;3;2020-03-31;-1727
2020-03-30;"Trnavský kraj";4;0;0;0;NA;238883;4;2020-03-30;-1730
2020-03-29;"Trnavský kraj";1;0;0;0;NA;238883;1;2020-03-29;-1734
2020-03-28;"Trnavský kraj";3;0;0;0;NA;238883;3;2020-03-28;-1735
2020-03-27;"Trnavský kraj";5;0;0;0;NA;238883;5;2020-03-27;-1738
2020-03-26;"Trnavský kraj";5;0;0;0;NA;238883;5;2020-03-26;-1743
2020-03-25;"Trnavský kraj";1;0;0;0;NA;238883;1;2020-03-25;-1748
2020-03-24;"Trnavský kraj";0;0;0;0;NA;238883;0;2020-03-24;-1749
2020-03-23;"Trnavský kraj";2;0;0;0;NA;238883;2;2020-03-23;-1749
2020-03-22;"Trnavský kraj";1;0;0;0;NA;238883;1;2020-03-22;-1751
2020-03-21;"Trnavský kraj";5;0;0;0;NA;238883;5;2020-03-21;-1752
2020-03-20;"Trnavský kraj";0;0;0;0;NA;238883;0;2020-03-20;-1757
2020-03-19;"Trnavský kraj";0;0;0;0;NA;238883;0;2020-03-19;-1757
2020-03-18;"Trnavský kraj";0;0;0;0;NA;238883;0;2020-03-18;-1757
2020-03-17;"Trnavský kraj";3;0;0;0;NA;238883;3;2020-03-17;-1757
2020-03-16;"Trnavský kraj";1;0;0;0;NA;238883;1;2020-03-16;-1760
2020-03-15;"Trnavský kraj";0;0;0;0;NA;238883;0;2020-03-15;-1761
2020-03-14;"Trnavský kraj";0;0;0;0;NA;238883;0;2020-03-14;-1761
2020-03-13;"Trnavský kraj";1;0;0;0;NA;238883;1;2020-03-13;-1761
2020-03-12;"Trnavský kraj";1;0;0;0;NA;238883;1;2020-03-12;-1762
2020-03-11;"Trnavský kraj";0;0;0;0;NA;238883;0;2020-03-11;-1763
2020-03-09;"Trnavský kraj";0;0;0;0;NA;238883;0;2020-03-09;-1763
2020-03-08;"Trnavský kraj";0;0;0;0;NA;238883;0;2020-03-08;-1763
2020-03-07;"Trnavský kraj";0;0;0;0;NA;238883;0;2020-03-07;-1763
2020-03-06;"Trnavský kraj";0;0;0;0;NA;238883;0;2020-03-06;-1763
2022-03-08;"Žilinský kraj";699;0;0;0;225619;316362;699;2022-03-08;316362
2022-03-07;"Žilinský kraj";1448;6;0;6;NA;316362;1448;2022-03-07;315663
2022-03-06;"Žilinský kraj";323;471;142;613;NA;316362;465;2022-03-06;314215
2022-03-05;"Žilinský kraj";576;545;123;668;NA;316362;699;2022-03-05;313750
2022-03-04;"Žilinský kraj";1194;1716;249;1965;NA;316362;1443;2022-03-04;313051
2022-03-03;"Žilinský kraj";1240;1825;244;2069;NA;316362;1484;2022-03-03;311608
2022-03-02;"Žilinský kraj";1194;1772;244;2016;NA;316362;1438;2022-03-02;310124
2022-03-01;"Žilinský kraj";1710;2948;340;3288;NA;316362;2050;2022-03-01;308686
2022-02-28;"Žilinský kraj";1700;2978;355;3333;NA;316362;2055;2022-02-28;306636
2022-02-27;"Žilinský kraj";224;940;221;1161;NA;316362;445;2022-02-27;304581
2022-02-26;"Žilinský kraj";1184;816;171;987;NA;316362;1355;2022-02-26;304136
2022-02-25;"Žilinský kraj";1371;2421;320;2741;NA;316362;1691;2022-02-25;302781
2022-02-24;"Žilinský kraj";1504;2589;314;2903;NA;316362;1818;2022-02-24;301090
2022-02-23;"Žilinský kraj";1766;3298;333;3631;NA;316362;2099;2022-02-23;299272
2022-02-22;"Žilinský kraj";2419;3369;406;3775;NA;316362;2825;2022-02-22;297173
2022-02-21;"Žilinský kraj";2227;4180;573;4753;NA;316362;2800;2022-02-21;294348
2022-02-20;"Žilinský kraj";541;1473;304;1777;NA;316362;845;2022-02-20;291548
2022-02-19;"Žilinský kraj";1656;944;273;1217;NA;316362;1929;2022-02-19;290703
2022-02-18;"Žilinský kraj";1994;3335;439;3774;NA;316362;2433;2022-02-18;288774
2022-02-17;"Žilinský kraj";2274;3013;424;3437;NA;316362;2698;2022-02-17;286341
2022-02-16;"Žilinský kraj";2676;3573;495;4068;NA;316362;3171;2022-02-16;283643
2022-02-15;"Žilinský kraj";2939;4224;604;4828;NA;316362;3543;2022-02-15;280472
2022-02-14;"Žilinský kraj";2955;4169;777;4946;NA;316362;3732;2022-02-14;276929
2022-02-13;"Žilinský kraj";751;1842;464;2306;NA;316362;1215;2022-02-13;273197
2022-02-12;"Žilinský kraj";1771;1423;319;1742;NA;316362;2090;2022-02-12;271982
2022-02-11;"Žilinský kraj";2856;3332;570;3902;NA;316362;3426;2022-02-11;269892
2022-02-10;"Žilinský kraj";2861;3472;583;4055;NA;316362;3444;2022-02-10;266466
2022-02-09;"Žilinský kraj";3365;3856;618;4474;NA;316362;3983;2022-02-09;263022
2022-02-08;"Žilinský kraj";3367;4866;780;5646;NA;316362;4147;2022-02-08;259039
2022-02-07;"Žilinský kraj";3242;5569;913;6482;NA;316362;4155;2022-02-07;254892
2022-02-06;"Žilinský kraj";1389;2587;529;3116;NA;316362;1918;2022-02-06;250737
2022-02-05;"Žilinský kraj";2107;1840;425;2265;NA;316362;2532;2022-02-05;248819
2022-02-04;"Žilinský kraj";3099;4382;631;5013;NA;316362;3730;2022-02-04;246287
2022-02-03;"Žilinský kraj";3201;4122;613;4735;NA;316362;3814;2022-02-03;242557
2022-02-02;"Žilinský kraj";3168;4616;666;5282;NA;316362;3834;2022-02-02;238743
2022-02-01;"Žilinský kraj";3593;5240;694;5934;NA;316362;4287;2022-02-01;234909
2022-01-31;"Žilinský kraj";2145;7490;931;8421;NA;316362;3076;2022-01-31;230622
2022-01-30;"Žilinský kraj";1487;2898;431;3329;NA;316362;1918;2022-01-30;227546
2022-01-29;"Žilinský kraj";2055;2033;365;2398;NA;316362;2420;2022-01-29;225628
2022-01-28;"Žilinský kraj";2572;4800;546;5346;NA;316362;3118;2022-01-28;223208
2022-01-27;"Žilinský kraj";2406;4038;537;4575;NA;316362;2943;2022-01-27;220090
2022-01-26;"Žilinský kraj";2693;5009;516;5525;NA;316362;3209;2022-01-26;217147
2022-01-25;"Žilinský kraj";2595;5626;416;6042;NA;316362;3011;2022-01-25;213938
2022-01-24;"Žilinský kraj";1401;7096;522;7618;NA;316362;1923;2022-01-24;210927
2022-01-23;"Žilinský kraj";654;2923;276;3199;NA;316362;930;2022-01-23;209004
2022-01-22;"Žilinský kraj";1256;1706;206;1912;NA;316362;1462;2022-01-22;208074
2022-01-21;"Žilinský kraj";1188;4187;265;4452;NA;316362;1453;2022-01-21;206612
2022-01-20;"Žilinský kraj";1288;3654;205;3859;NA;316362;1493;2022-01-20;205159
2022-01-19;"Žilinský kraj";1215;4086;206;4292;NA;316362;1421;2022-01-19;203666
2022-01-18;"Žilinský kraj";1191;4213;168;4381;NA;316362;1359;2022-01-18;202245
2022-01-17;"Žilinský kraj";675;6884;256;7140;NA;316362;931;2022-01-17;200886
2022-01-16;"Žilinský kraj";175;2418;106;2524;NA;316362;281;2022-01-16;199955
2022-01-15;"Žilinský kraj";398;1410;70;1480;NA;316362;468;2022-01-15;199674
2022-01-14;"Žilinský kraj";446;3716;106;3822;NA;316362;552;2022-01-14;199206
2022-01-13;"Žilinský kraj";295;2912;78;2990;NA;316362;373;2022-01-13;198654
2022-01-12;"Žilinský kraj";422;3168;72;3240;NA;316362;494;2022-01-12;198281
2022-01-11;"Žilinský kraj";622;4216;57;4273;NA;316362;679;2022-01-11;197787
2022-01-10;"Žilinský kraj";436;6342;102;6444;NA;316362;538;2022-01-10;197108
2022-01-09;"Žilinský kraj";95;2934;54;2988;NA;316362;149;2022-01-09;196570
2022-01-08;"Žilinský kraj";345;1650;45;1695;NA;316362;390;2022-01-08;196421
2022-01-07;"Žilinský kraj";525;4566;75;4641;NA;316362;600;2022-01-07;196031
2022-01-06;"Žilinský kraj";167;1214;40;1254;NA;316362;207;2022-01-06;195431
2022-01-05;"Žilinský kraj";471;3492;75;3567;NA;316362;546;2022-01-05;195224
2022-01-04;"Žilinský kraj";606;3762;87;3849;NA;316362;693;2022-01-04;194678
2022-01-03;"Žilinský kraj";601;6082;116;6198;NA;316362;717;2022-01-03;193985
2022-01-02;"Žilinský kraj";288;2596;85;2681;NA;316362;373;2022-01-02;193268
2022-01-01;"Žilinský kraj";14;439;15;454;NA;316362;29;2022-01-01;192895
2021-12-31;"Žilinský kraj";323;1608;70;1678;NA;316362;393;2021-12-31;192866
2021-12-30;"Žilinský kraj";492;2213;95;2308;NA;316362;587;2021-12-30;192473
2021-12-29;"Žilinský kraj";543;6864;83;6947;NA;316362;626;2021-12-29;191886
2021-12-28;"Žilinský kraj";641;3408;106;3514;NA;316362;747;2021-12-28;191260
2021-12-27;"Žilinský kraj";691;3960;145;4105;NA;316362;836;2021-12-27;190513
2021-12-26;"Žilinský kraj";242;1167;58;1225;NA;316362;300;2021-12-26;189677
2021-12-25;"Žilinský kraj";22;442;45;487;NA;316362;67;2021-12-25;189377
2021-12-24;"Žilinský kraj";98;518;21;539;NA;316362;119;2021-12-24;189310
2021-12-23;"Žilinský kraj";731;2678;105;2783;NA;316362;836;2021-12-23;189191
2021-12-22;"Žilinský kraj";510;2428;77;2505;NA;316362;587;2021-12-22;188355
2021-12-21;"Žilinský kraj";755;3641;102;3743;NA;316362;857;2021-12-21;187768
2021-12-20;"Žilinský kraj";563;4543;125;4668;NA;316362;688;2021-12-20;186911
2021-12-19;"Žilinský kraj";133;2215;90;2305;NA;316362;223;2021-12-19;186223
2021-12-18;"Žilinský kraj";417;1321;70;1391;NA;316362;487;2021-12-18;186000
2021-12-17;"Žilinský kraj";604;3895;127;4022;NA;316362;731;2021-12-17;185513
2021-12-16;"Žilinský kraj";660;3931;109;4040;NA;316362;769;2021-12-16;184782
2021-12-15;"Žilinský kraj";802;3489;122;3611;NA;316362;924;2021-12-15;184013
2021-12-14;"Žilinský kraj";798;4587;129;4716;NA;316362;927;2021-12-14;183089
2021-12-13;"Žilinský kraj";759;7755;212;7967;NA;316362;971;2021-12-13;182162
2021-12-12;"Žilinský kraj";340;2836;114;2950;NA;316362;454;2021-12-12;181191
2021-12-11;"Žilinský kraj";761;1849;112;1961;NA;316362;873;2021-12-11;180737
2021-12-10;"Žilinský kraj";638;4041;136;4177;NA;316362;774;2021-12-10;179864
2021-12-09;"Žilinský kraj";870;5842;161;6003;NA;316362;1031;2021-12-09;179090
2021-12-08;"Žilinský kraj";1018;3214;158;3372;NA;316362;1176;2021-12-08;178059
2021-12-07;"Žilinský kraj";1356;5147;160;5307;NA;316362;1516;2021-12-07;176883
2021-12-06;"Žilinský kraj";919;7441;226;7667;NA;316362;1145;2021-12-06;175367
2021-12-05;"Žilinský kraj";505;3306;134;3440;NA;316362;639;2021-12-05;174222
2021-12-04;"Žilinský kraj";704;1892;153;2045;NA;316362;857;2021-12-04;173583
2021-12-03;"Žilinský kraj";1204;4864;215;5079;NA;316362;1419;2021-12-03;172726
2021-12-02;"Žilinský kraj";1847;4131;199;4330;NA;316362;2046;2021-12-02;171307
2021-12-01;"Žilinský kraj";1183;4073;195;4268;NA;316362;1378;2021-12-01;169261
2021-11-30;"Žilinský kraj";1575;5467;252;5719;NA;316362;1827;2021-11-30;167883
2021-11-29;"Žilinský kraj";1395;9067;358;9425;NA;316362;1753;2021-11-29;166056
2021-11-28;"Žilinský kraj";625;4581;235;4816;NA;316362;860;2021-11-28;164303
2021-11-27;"Žilinský kraj";909;2557;192;2749;NA;316362;1101;2021-11-27;163443
2021-11-26;"Žilinský kraj";1195;6599;344;6943;NA;316362;1539;2021-11-26;162342
2021-11-25;"Žilinský kraj";1281;4701;331;5032;NA;316362;1612;2021-11-25;160803
2021-11-24;"Žilinský kraj";1792;4660;324;4984;NA;316362;2116;2021-11-24;159191
2021-11-23;"Žilinský kraj";1630;4654;353;5007;NA;316362;1983;2021-11-23;157075
2021-11-22;"Žilinský kraj";1126;6699;452;7151;NA;316362;1578;2021-11-22;155092
2021-11-21;"Žilinský kraj";443;2865;260;3125;NA;316362;703;2021-11-21;153514
2021-11-20;"Žilinský kraj";963;2104;241;2345;NA;316362;1204;2021-11-20;152811
2021-11-19;"Žilinský kraj";1281;4622;434;5056;NA;316362;1715;2021-11-19;151607
2021-11-18;"Žilinský kraj";1220;4432;376;4808;NA;316362;1596;2021-11-18;149892
2021-11-17;"Žilinský kraj";1001;1434;149;1583;NA;316362;1150;2021-11-17;148296
2021-11-16;"Žilinský kraj";1197;4058;323;4381;NA;316362;1520;2021-11-16;147146
2021-11-15;"Žilinský kraj";977;5050;476;5526;NA;316362;1453;2021-11-15;145626
2021-11-14;"Žilinský kraj";356;2287;262;2549;NA;316362;618;2021-11-14;144173
2021-11-13;"Žilinský kraj";652;1882;220;2102;NA;316362;872;2021-11-13;143555
2021-11-12;"Žilinský kraj";1027;4291;340;4631;NA;316362;1367;2021-11-12;142683
2021-11-11;"Žilinský kraj";924;4192;272;4464;NA;316362;1196;2021-11-11;141316
2021-11-10;"Žilinský kraj";897;4509;305;4814;NA;316362;1202;2021-11-10;140120
2021-11-09;"Žilinský kraj";1440;4619;256;4875;NA;316362;1696;2021-11-09;138918
2021-11-08;"Žilinský kraj";781;4438;425;4863;NA;316362;1206;2021-11-08;137222
2021-11-07;"Žilinský kraj";304;2130;231;2361;NA;316362;535;2021-11-07;136016
2021-11-06;"Žilinský kraj";741;2150;201;2351;NA;316362;942;2021-11-06;135481
2021-11-05;"Žilinský kraj";1064;4067;235;4302;NA;316362;1299;2021-11-05;134539
2021-11-04;"Žilinský kraj";776;3709;232;3941;NA;316362;1008;2021-11-04;133240
2021-11-03;"Žilinský kraj";1106;5550;338;5888;NA;316362;1444;2021-11-03;132232
2021-11-02;"Žilinský kraj";1136;4451;333;4784;NA;316362;1469;2021-11-02;130788
2021-11-01;"Žilinský kraj";399;1456;137;1593;NA;316362;536;2021-11-01;129319
2021-10-31;"Žilinský kraj";344;1387;145;1532;NA;316362;489;2021-10-31;128783
2021-10-30;"Žilinský kraj";571;1944;161;2105;NA;316362;732;2021-10-30;128294
2021-10-29;"Žilinský kraj";733;3339;194;3533;NA;316362;927;2021-10-29;127562
2021-10-28;"Žilinský kraj";639;4953;247;5200;NA;316362;886;2021-10-28;126635
2021-10-27;"Žilinský kraj";739;3446;173;3619;NA;316362;912;2021-10-27;125749
2021-10-26;"Žilinský kraj";945;4748;216;4964;NA;316362;1161;2021-10-26;124837
2021-10-25;"Žilinský kraj";649;5736;271;6007;NA;316362;920;2021-10-25;123676
2021-10-24;"Žilinský kraj";248;1679;107;1786;NA;316362;355;2021-10-24;122756
2021-10-23;"Žilinský kraj";399;2415;149;2564;NA;316362;548;2021-10-23;122401
2021-10-22;"Žilinský kraj";587;3898;151;4049;NA;316362;738;2021-10-22;121853
2021-10-21;"Žilinský kraj";591;3367;162;3529;NA;316362;753;2021-10-21;121115
2021-10-20;"Žilinský kraj";479;3864;154;4018;NA;316362;633;2021-10-20;120362
2021-10-19;"Žilinský kraj";675;3763;161;3924;NA;316362;836;2021-10-19;119729
2021-10-18;"Žilinský kraj";432;5160;271;5431;NA;316362;703;2021-10-18;118893
2021-10-17;"Žilinský kraj";135;1769;101;1870;NA;316362;236;2021-10-17;118190
2021-10-16;"Žilinský kraj";273;2341;100;2441;NA;316362;373;2021-10-16;117954
2021-10-15;"Žilinský kraj";347;3859;146;4005;NA;316362;493;2021-10-15;117581
2021-10-14;"Žilinský kraj";419;3035;110;3145;NA;316362;529;2021-10-14;117088
2021-10-13;"Žilinský kraj";404;3427;112;3539;NA;316362;516;2021-10-13;116559
2021-10-12;"Žilinský kraj";589;4000;141;4141;NA;316362;730;2021-10-12;116043
2021-10-11;"Žilinský kraj";323;4501;154;4655;NA;316362;477;2021-10-11;115313
2021-10-10;"Žilinský kraj";113;1577;77;1654;NA;316362;190;2021-10-10;114836
2021-10-09;"Žilinský kraj";201;1565;57;1622;NA;316362;258;2021-10-09;114646
2021-10-08;"Žilinský kraj";265;4227;99;4326;NA;316362;364;2021-10-08;114388
2021-10-07;"Žilinský kraj";338;3384;113;3497;NA;316362;451;2021-10-07;114024
2021-10-06;"Žilinský kraj";313;3901;89;3990;NA;316362;402;2021-10-06;113573
2021-10-05;"Žilinský kraj";387;4031;122;4153;NA;316362;509;2021-10-05;113171
2021-10-04;"Žilinský kraj";297;4449;121;4570;NA;316362;418;2021-10-04;112662
2021-10-03;"Žilinský kraj";22;1596;63;1659;NA;316362;85;2021-10-03;112244
2021-10-02;"Žilinský kraj";209;1990;45;2035;NA;316362;254;2021-10-02;112159
2021-10-01;"Žilinský kraj";263;4047;104;4151;NA;316362;367;2021-10-01;111905
2021-09-30;"Žilinský kraj";248;3531;71;3602;NA;316362;319;2021-09-30;111538
2021-09-29;"Žilinský kraj";285;3577;82;3659;NA;316362;367;2021-09-29;111219
2021-09-28;"Žilinský kraj";272;3656;73;3729;NA;316362;345;2021-09-28;110852
2021-09-27;"Žilinský kraj";239;4418;152;4570;NA;316362;391;2021-09-27;110507
2021-09-26;"Žilinský kraj";17;1665;42;1707;NA;316362;59;2021-09-26;110116
2021-09-25;"Žilinský kraj";111;1711;50;1761;NA;316362;161;2021-09-25;110057
2021-09-24;"Žilinský kraj";199;6127;98;6225;NA;316362;297;2021-09-24;109896
2021-09-23;"Žilinský kraj";176;2629;74;2703;NA;316362;250;2021-09-23;109599
2021-09-22;"Žilinský kraj";185;2728;77;2805;NA;316362;262;2021-09-22;109349
2021-09-21;"Žilinský kraj";250;3123;78;3201;NA;316362;328;2021-09-21;109087
2021-09-20;"Žilinský kraj";244;3231;95;3326;NA;316362;339;2021-09-20;108759
2021-09-19;"Žilinský kraj";26;1579;37;1616;NA;316362;63;2021-09-19;108420
2021-09-18;"Žilinský kraj";87;1441;45;1486;NA;316362;132;2021-09-18;108357
2021-09-17;"Žilinský kraj";192;3351;56;3407;NA;316362;248;2021-09-17;108225
2021-09-16;"Žilinský kraj";164;2744;87;2831;NA;316362;251;2021-09-16;107977
2021-09-15;"Žilinský kraj";31;555;11;566;NA;316362;42;2021-09-15;107726
2021-09-14;"Žilinský kraj";155;3268;61;3329;NA;316362;216;2021-09-14;107684
2021-09-13;"Žilinský kraj";81;3250;75;3325;NA;316362;156;2021-09-13;107468
2021-09-12;"Žilinský kraj";9;1138;24;1162;NA;316362;33;2021-09-12;107312
2021-09-11;"Žilinský kraj";47;1322;21;1343;NA;316362;68;2021-09-11;107279
2021-09-10;"Žilinský kraj";66;2439;34;2473;NA;316362;100;2021-09-10;107211
2021-09-09;"Žilinský kraj";56;2352;18;2370;NA;316362;74;2021-09-09;107111
2021-09-08;"Žilinský kraj";68;1560;24;1584;NA;316362;92;2021-09-08;107037
2021-09-07;"Žilinský kraj";72;1806;27;1833;NA;316362;99;2021-09-07;106945
2021-09-06;"Žilinský kraj";31;2381;45;2426;NA;316362;76;2021-09-06;106846
2021-09-05;"Žilinský kraj";11;785;8;793;NA;316362;19;2021-09-05;106770
2021-09-04;"Žilinský kraj";24;1080;5;1085;NA;316362;29;2021-09-04;106751
2021-09-03;"Žilinský kraj";52;2047;28;2075;NA;316362;80;2021-09-03;106722
2021-09-02;"Žilinský kraj";30;1432;22;1454;NA;316362;52;2021-09-02;106642
2021-09-01;"Žilinský kraj";5;461;6;467;NA;316362;11;2021-09-01;106590
2021-08-31;"Žilinský kraj";32;1710;15;1725;NA;316362;47;2021-08-31;106579
2021-08-30;"Žilinský kraj";7;1801;4;1805;NA;316362;11;2021-08-30;106532
2021-08-29;"Žilinský kraj";8;631;5;636;NA;316362;13;2021-08-29;106521
2021-08-28;"Žilinský kraj";2;1005;1;1006;NA;316362;3;2021-08-28;106508
2021-08-27;"Žilinský kraj";13;1765;12;1777;NA;316362;25;2021-08-27;106505
2021-08-26;"Žilinský kraj";17;1636;7;1643;NA;316362;24;2021-08-26;106480
2021-08-25;"Žilinský kraj";9;1203;11;1214;NA;316362;20;2021-08-25;106456
2021-08-24;"Žilinský kraj";6;1395;9;1404;NA;316362;15;2021-08-24;106436
2021-08-23;"Žilinský kraj";11;1877;7;1884;NA;316362;18;2021-08-23;106421
2021-08-22;"Žilinský kraj";2;733;3;736;NA;316362;5;2021-08-22;106403
2021-08-21;"Žilinský kraj";6;1183;2;1185;NA;316362;8;2021-08-21;106398
2021-08-20;"Žilinský kraj";7;2284;5;2289;NA;316362;12;2021-08-20;106390
2021-08-19;"Žilinský kraj";6;1281;3;1284;NA;316362;9;2021-08-19;106378
2021-08-18;"Žilinský kraj";4;1331;7;1338;NA;316362;11;2021-08-18;106369
2021-08-17;"Žilinský kraj";9;1219;3;1222;NA;316362;12;2021-08-17;106358
2021-08-16;"Žilinský kraj";14;1696;5;1701;NA;316362;19;2021-08-16;106346
2021-08-15;"Žilinský kraj";1;880;2;882;NA;316362;3;2021-08-15;106327
2021-08-14;"Žilinský kraj";5;1197;0;1197;NA;316362;5;2021-08-14;106324
2021-08-13;"Žilinský kraj";6;1685;0;1685;NA;316362;6;2021-08-13;106319
2021-08-12;"Žilinský kraj";4;1105;1;1106;NA;316362;5;2021-08-12;106313
2021-08-11;"Žilinský kraj";13;1250;3;1253;NA;316362;16;2021-08-11;106308
2021-08-10;"Žilinský kraj";12;1292;3;1295;NA;316362;15;2021-08-10;106292
2021-08-09;"Žilinský kraj";9;1142;1;1143;NA;316362;10;2021-08-09;106277
2021-08-08;"Žilinský kraj";1;748;5;753;NA;316362;6;2021-08-08;106267
2021-08-07;"Žilinský kraj";7;1192;1;1193;NA;316362;8;2021-08-07;106261
2021-08-06;"Žilinský kraj";1;1347;0;1347;NA;316362;1;2021-08-06;106253
2021-08-05;"Žilinský kraj";7;1148;3;1151;NA;316362;10;2021-08-05;106252
2021-08-04;"Žilinský kraj";12;895;0;895;NA;316362;12;2021-08-04;106242
2021-08-03;"Žilinský kraj";11;918;0;918;NA;316362;11;2021-08-03;106230
2021-08-02;"Žilinský kraj";5;1513;1;1514;NA;316362;6;2021-08-02;106219
2021-08-01;"Žilinský kraj";0;679;2;681;NA;316362;2;2021-08-01;106213
2021-07-31;"Žilinský kraj";4;1114;0;1114;NA;316362;4;2021-07-31;106211
2021-07-30;"Žilinský kraj";3;1671;0;1671;NA;316362;3;2021-07-30;106207
2021-07-29;"Žilinský kraj";1;1299;0;1299;NA;316362;1;2021-07-29;106204
2021-07-28;"Žilinský kraj";4;901;0;901;NA;316362;4;2021-07-28;106203
2021-07-27;"Žilinský kraj";11;1378;0;1378;NA;316362;11;2021-07-27;106199
2021-07-26;"Žilinský kraj";1;1301;1;1302;NA;316362;2;2021-07-26;106188
2021-07-25;"Žilinský kraj";2;828;2;830;NA;316362;4;2021-07-25;106186
2021-07-24;"Žilinský kraj";2;1338;2;1340;NA;316362;4;2021-07-24;106182
2021-07-23;"Žilinský kraj";4;1750;0;1750;NA;316362;4;2021-07-23;106178
2021-07-22;"Žilinský kraj";2;1207;0;1207;NA;316362;2;2021-07-22;106174
2021-07-21;"Žilinský kraj";2;1021;0;1021;NA;316362;2;2021-07-21;106172
2021-07-20;"Žilinský kraj";4;1439;0;1439;NA;316362;4;2021-07-20;106170
2021-07-19;"Žilinský kraj";4;1763;1;1764;NA;316362;5;2021-07-19;106166
2021-07-18;"Žilinský kraj";0;854;1;855;NA;316362;1;2021-07-18;106161
2021-07-17;"Žilinský kraj";0;1350;0;1350;NA;316362;0;2021-07-17;106160
2021-07-16;"Žilinský kraj";2;1767;0;1767;NA;316362;2;2021-07-16;106160
2021-07-15;"Žilinský kraj";2;1577;0;1577;NA;316362;2;2021-07-15;106158
2021-07-14;"Žilinský kraj";5;1042;1;1043;NA;316362;6;2021-07-14;106156
2021-07-13;"Žilinský kraj";3;1709;1;1710;NA;316362;4;2021-07-13;106150
2021-07-12;"Žilinský kraj";3;1325;1;1326;NA;316362;4;2021-07-12;106146
2021-07-11;"Žilinský kraj";2;989;0;989;NA;316362;2;2021-07-11;106142
2021-07-10;"Žilinský kraj";1;1511;4;1515;NA;316362;5;2021-07-10;106140
2021-07-09;"Žilinský kraj";1;2208;1;2209;NA;316362;2;2021-07-09;106135
2021-07-08;"Žilinský kraj";6;1776;3;1779;NA;316362;9;2021-07-08;106133
2021-07-07;"Žilinský kraj";1;1585;3;1588;NA;316362;4;2021-07-07;106124
2021-07-06;"Žilinský kraj";4;1956;0;1956;NA;316362;4;2021-07-06;106120
2021-07-05;"Žilinský kraj";2;1031;1;1032;NA;316362;3;2021-07-05;106116
2021-07-04;"Žilinský kraj";0;1003;0;1003;NA;316362;0;2021-07-04;106113
2021-07-03;"Žilinský kraj";1;1696;2;1698;NA;316362;3;2021-07-03;106113
2021-07-02;"Žilinský kraj";0;3356;2;3358;NA;316362;2;2021-07-02;106110
2021-07-01;"Žilinský kraj";1;1118;0;1118;NA;316362;1;2021-07-01;106108
2021-06-30;"Žilinský kraj";1;10464;6;10470;NA;316362;7;2021-06-30;106107
2021-06-29;"Žilinský kraj";10;5946;0;5946;NA;316362;10;2021-06-29;106100
2021-06-28;"Žilinský kraj";4;6245;2;6247;NA;316362;6;2021-06-28;106090
2021-06-27;"Žilinský kraj";3;4702;1;4703;NA;316362;4;2021-06-27;106084
2021-06-26;"Žilinský kraj";4;5919;0;5919;NA;316362;4;2021-06-26;106080
2021-06-25;"Žilinský kraj";8;9756;5;9761;NA;316362;13;2021-06-25;106076
2021-06-24;"Žilinský kraj";6;5657;3;5660;NA;316362;9;2021-06-24;106063
2021-06-23;"Žilinský kraj";7;5955;10;5965;NA;316362;17;2021-06-23;106054
2021-06-22;"Žilinský kraj";6;5214;8;5222;NA;316362;14;2021-06-22;106037
2021-06-21;"Žilinský kraj";6;6287;8;6295;NA;316362;14;2021-06-21;106023
2021-06-20;"Žilinský kraj";1;5531;8;5539;NA;316362;9;2021-06-20;106009
2021-06-19;"Žilinský kraj";9;8353;2;8355;NA;316362;11;2021-06-19;106000
2021-06-18;"Žilinský kraj";11;10624;12;10636;NA;316362;23;2021-06-18;105989
2021-06-17;"Žilinský kraj";10;6092;12;6104;NA;316362;22;2021-06-17;105966
2021-06-16;"Žilinský kraj";17;5786;11;5797;NA;316362;28;2021-06-16;105944
2021-06-15;"Žilinský kraj";13;5996;13;6009;NA;316362;26;2021-06-15;105916
2021-06-14;"Žilinský kraj";10;7596;21;7617;NA;316362;31;2021-06-14;105890
2021-06-13;"Žilinský kraj";2;6682;9;6691;NA;316362;11;2021-06-13;105859
2021-06-12;"Žilinský kraj";9;8634;11;8645;NA;316362;20;2021-06-12;105848
2021-06-11;"Žilinský kraj";11;11566;14;11580;NA;316362;25;2021-06-11;105828
2021-06-10;"Žilinský kraj";14;6788;14;6802;NA;316362;28;2021-06-10;105803
2021-06-09;"Žilinský kraj";23;5925;14;5939;NA;316362;37;2021-06-09;105775
2021-06-08;"Žilinský kraj";18;6615;16;6631;NA;316362;34;2021-06-08;105738
2021-06-07;"Žilinský kraj";25;8534;21;8555;NA;316362;46;2021-06-07;105704
2021-06-06;"Žilinský kraj";10;8056;27;8083;NA;316362;37;2021-06-06;105658
2021-06-05;"Žilinský kraj";8;9175;10;9185;NA;316362;18;2021-06-05;105621
2021-06-04;"Žilinský kraj";19;12260;34;12294;NA;316362;53;2021-06-04;105603
2021-06-03;"Žilinský kraj";12;7033;33;7066;NA;316362;45;2021-06-03;105550
2021-06-02;"Žilinský kraj";17;7090;28;7118;NA;316362;45;2021-06-02;105505
2021-06-01;"Žilinský kraj";38;8285;46;8331;NA;316362;84;2021-06-01;105460
2021-05-31;"Žilinský kraj";31;9616;59;9675;NA;316362;90;2021-05-31;105376
2021-05-30;"Žilinský kraj";21;9025;35;9060;NA;316362;56;2021-05-30;105286
2021-05-29;"Žilinský kraj";13;11195;23;11218;NA;316362;36;2021-05-29;105230
2021-05-28;"Žilinský kraj";28;13277;30;13307;NA;316362;58;2021-05-28;105194
2021-05-27;"Žilinský kraj";17;8267;39;8306;NA;316362;56;2021-05-27;105136
2021-05-26;"Žilinský kraj";20;8329;25;8354;NA;316362;45;2021-05-26;105080
2021-05-25;"Žilinský kraj";21;9624;38;9662;NA;316362;59;2021-05-25;105035
2021-05-24;"Žilinský kraj";36;11487;57;11544;NA;316362;93;2021-05-24;104976
2021-05-23;"Žilinský kraj";4;10923;56;10979;NA;316362;60;2021-05-23;104883
2021-05-22;"Žilinský kraj";21;11893;28;11921;NA;316362;49;2021-05-22;104823
2021-05-21;"Žilinský kraj";28;15654;50;15704;NA;316362;78;2021-05-21;104774
2021-05-20;"Žilinský kraj";30;9616;30;9646;NA;316362;60;2021-05-20;104696
2021-05-19;"Žilinský kraj";46;8693;41;8734;NA;316362;87;2021-05-19;104636
2021-05-18;"Žilinský kraj";52;10609;44;10653;NA;316362;96;2021-05-18;104549
2021-05-17;"Žilinský kraj";51;12676;84;12760;NA;316362;135;2021-05-17;104453
2021-05-16;"Žilinský kraj";13;14114;42;14156;NA;316362;55;2021-05-16;104318
2021-05-15;"Žilinský kraj";30;18404;35;18439;NA;316362;65;2021-05-15;104263
2021-05-14;"Žilinský kraj";34;21205;82;21287;NA;316362;116;2021-05-14;104198
2021-05-13;"Žilinský kraj";64;11865;51;11916;NA;316362;115;2021-05-13;104082
2021-05-12;"Žilinský kraj";57;10337;51;10388;NA;316362;108;2021-05-12;103967
2021-05-11;"Žilinský kraj";70;12174;51;12225;NA;316362;121;2021-05-11;103859
2021-05-10;"Žilinský kraj";69;16182;72;16254;NA;316362;141;2021-05-10;103738
2021-05-09;"Žilinský kraj";58;20385;77;20462;NA;316362;135;2021-05-09;103597
2021-05-08;"Žilinský kraj";0;24133;63;24196;NA;316362;63;2021-05-08;103462
2021-05-07;"Žilinský kraj";65;26522;87;26609;NA;316362;152;2021-05-07;103399
2021-05-06;"Žilinský kraj";67;16605;72;16677;NA;316362;139;2021-05-06;103247
2021-05-05;"Žilinský kraj";71;13096;73;13169;NA;316362;144;2021-05-05;103108
2021-05-04;"Žilinský kraj";81;16749;80;16829;NA;316362;161;2021-05-04;102964
2021-05-03;"Žilinský kraj";97;20391;111;20502;NA;316362;208;2021-05-03;102803
2021-05-02;"Žilinský kraj";8;28886;64;28950;NA;316362;72;2021-05-02;102595
2021-05-01;"Žilinský kraj";65;55053;105;55158;NA;316362;170;2021-05-01;102523
2021-04-30;"Žilinský kraj";84;44000;117;44117;NA;316362;201;2021-04-30;102353
2021-04-29;"Žilinský kraj";77;24566;101;24667;NA;316362;178;2021-04-29;102152
2021-04-28;"Žilinský kraj";76;19214;91;19305;NA;316362;167;2021-04-28;101974
2021-04-27;"Žilinský kraj";97;21805;110;21915;NA;316362;207;2021-04-27;101807
2021-04-26;"Žilinský kraj";114;27412;136;27548;NA;316362;250;2021-04-26;101600
2021-04-25;"Žilinský kraj";38;35750;82;35832;NA;316362;120;2021-04-25;101350
2021-04-24;"Žilinský kraj";93;78854;157;79011;NA;316362;250;2021-04-24;101230
2021-04-23;"Žilinský kraj";144;49440;153;49593;NA;316362;297;2021-04-23;100980
2021-04-22;"Žilinský kraj";110;25224;132;25356;NA;316362;242;2021-04-22;100683
2021-04-21;"Žilinský kraj";118;20616;145;20761;NA;316362;263;2021-04-21;100441
2021-04-20;"Žilinský kraj";128;23873;136;24009;NA;316362;264;2021-04-20;100178
2021-04-19;"Žilinský kraj";164;32773;210;32983;NA;316362;374;2021-04-19;99914
2021-04-18;"Žilinský kraj";18;36767;91;36858;NA;316362;109;2021-04-18;99540
2021-04-17;"Žilinský kraj";108;89377;156;89533;NA;316362;264;2021-04-17;99431
2021-04-16;"Žilinský kraj";185;47847;208;48055;NA;316362;393;2021-04-16;99167
2021-04-15;"Žilinský kraj";108;24830;130;24960;NA;316362;238;2021-04-15;98774
2021-04-14;"Žilinský kraj";135;23145;145;23290;NA;316362;280;2021-04-14;98536
2021-04-13;"Žilinský kraj";171;25050;135;25185;NA;316362;306;2021-04-13;98256
2021-04-12;"Žilinský kraj";266;30794;189;30983;NA;316362;455;2021-04-12;97950
2021-04-11;"Žilinský kraj";19;37126;107;37233;NA;316362;126;2021-04-11;97495
2021-04-10;"Žilinský kraj";111;86284;237;86521;NA;316362;348;2021-04-10;97369
2021-04-09;"Žilinský kraj";195;41973;206;42179;NA;316362;401;2021-04-09;97021
2021-04-08;"Žilinský kraj";179;24404;141;24545;NA;316362;320;2021-04-08;96620
2021-04-07;"Žilinský kraj";309;28651;174;28825;NA;316362;483;2021-04-07;96300
2021-04-06;"Žilinský kraj";308;40107;301;40408;NA;316362;609;2021-04-06;95817
2021-04-05;"Žilinský kraj";17;14747;140;14887;NA;316362;157;2021-04-05;95208
2021-04-04;"Žilinský kraj";17;16284;69;16353;NA;316362;86;2021-04-04;95051
2021-04-03;"Žilinský kraj";180;100699;403;101102;NA;316362;583;2021-04-03;94965
2021-04-02;"Žilinský kraj";73;22411;83;22494;NA;316362;156;2021-04-02;94382
2021-04-01;"Žilinský kraj";334;43264;240;43504;NA;316362;574;2021-04-01;94226
2021-03-31;"Žilinský kraj";170;31635;247;31882;NA;316362;417;2021-03-31;93652
2021-03-30;"Žilinský kraj";406;26323;243;26566;NA;316362;649;2021-03-30;93235
2021-03-29;"Žilinský kraj";297;28029;268;28297;NA;316362;565;2021-03-29;92586
2021-03-28;"Žilinský kraj";21;36206;239;36445;NA;316362;260;2021-03-28;92021
2021-03-27;"Žilinský kraj";151;89107;353;89460;NA;316362;504;2021-03-27;91761
2021-03-26;"Žilinský kraj";312;51757;330;52087;NA;316362;642;2021-03-26;91257
2021-03-25;"Žilinský kraj";281;27619;214;27833;NA;316362;495;2021-03-25;90615
2021-03-24;"Žilinský kraj";280;21268;260;21528;NA;316362;540;2021-03-24;90120
2021-03-23;"Žilinský kraj";418;23193;278;23471;NA;316362;696;2021-03-23;89580
2021-03-22;"Žilinský kraj";293;29289;314;29603;NA;316362;607;2021-03-22;88884
2021-03-21;"Žilinský kraj";32;33705;227;33932;NA;316362;259;2021-03-21;88277
2021-03-20;"Žilinský kraj";165;93015;497;93512;NA;316362;662;2021-03-20;88018
2021-03-19;"Žilinský kraj";357;51988;414;52402;NA;316362;771;2021-03-19;87356
2021-03-18;"Žilinský kraj";329;28459;294;28753;NA;316362;623;2021-03-18;86585
2021-03-17;"Žilinský kraj";395;21919;269;22188;NA;316362;664;2021-03-17;85962
2021-03-16;"Žilinský kraj";514;24341;317;24658;NA;316362;831;2021-03-16;85298
2021-03-15;"Žilinský kraj";341;29613;419;30032;NA;316362;760;2021-03-15;84467
2021-03-14;"Žilinský kraj";87;34121;267;34388;NA;316362;354;2021-03-14;83707
2021-03-13;"Žilinský kraj";113;93386;581;93967;NA;316362;694;2021-03-13;83353
2021-03-12;"Žilinský kraj";520;52329;411;52740;NA;316362;931;2021-03-12;82659
2021-03-11;"Žilinský kraj";399;28189;302;28491;NA;316362;701;2021-03-11;81728
2021-03-10;"Žilinský kraj";368;22414;378;22792;NA;316362;746;2021-03-10;81027
2021-03-09;"Žilinský kraj";537;24857;316;25173;NA;316362;853;2021-03-09;80281
2021-03-08;"Žilinský kraj";387;30873;458;31331;NA;316362;845;2021-03-08;79428
2021-03-07;"Žilinský kraj";48;33469;290;33759;NA;316362;338;2021-03-07;78583
2021-03-06;"Žilinský kraj";173;92410;589;92999;NA;316362;762;2021-03-06;78245
2021-03-05;"Žilinský kraj";369;51987;484;52471;NA;316362;853;2021-03-05;77483
2021-03-04;"Žilinský kraj";467;30037;377;30414;NA;316362;844;2021-03-04;76630
2021-03-03;"Žilinský kraj";448;26261;394;26655;NA;316362;842;2021-03-03;75786
2021-03-02;"Žilinský kraj";551;25913;378;26291;NA;316362;929;2021-03-02;74944
2021-03-01;"Žilinský kraj";375;30498;441;30939;NA;316362;816;2021-03-01;74015
2021-02-28;"Žilinský kraj";61;34802;327;35129;NA;316362;388;2021-02-28;73199
2021-02-27;"Žilinský kraj";159;83781;639;84420;NA;316362;798;2021-02-27;72811
2021-02-26;"Žilinský kraj";459;47500;508;48008;NA;316362;967;2021-02-26;72013
2021-02-25;"Žilinský kraj";347;30879;393;31272;NA;316362;740;2021-02-25;71046
2021-02-24;"Žilinský kraj";339;18760;395;19155;NA;316362;734;2021-02-24;70306
2021-02-23;"Žilinský kraj";437;22172;418;22590;NA;316362;855;2021-02-23;69572
2021-02-22;"Žilinský kraj";345;29270;438;29708;NA;316362;783;2021-02-22;68717
2021-02-21;"Žilinský kraj";36;28686;322;29008;NA;316362;358;2021-02-21;67934
2021-02-20;"Žilinský kraj";152;89944;671;90615;NA;316362;823;2021-02-20;67576
2021-02-19;"Žilinský kraj";337;45541;417;45958;NA;316362;754;2021-02-19;66753
2021-02-18;"Žilinský kraj";263;24662;337;24999;NA;316362;600;2021-02-18;65999
2021-02-17;"Žilinský kraj";269;17932;355;18287;NA;316362;624;2021-02-17;65399
2021-02-16;"Žilinský kraj";321;24298;325;24623;NA;316362;646;2021-02-16;64775
2021-02-15;"Žilinský kraj";230;30420;311;30731;NA;316362;541;2021-02-15;64129
2021-02-14;"Žilinský kraj";30;28574;231;28805;NA;316362;261;2021-02-14;63588
2021-02-13;"Žilinský kraj";91;69638;453;70091;NA;316362;544;2021-02-13;63327
2021-02-12;"Žilinský kraj";242;43338;336;43674;NA;316362;578;2021-02-12;62783
2021-02-11;"Žilinský kraj";228;23521;300;23821;NA;316362;528;2021-02-11;62205
2021-02-10;"Žilinský kraj";259;17894;267;18161;NA;316362;526;2021-02-10;61677
2021-02-09;"Žilinský kraj";377;24784;274;25058;NA;316362;651;2021-02-09;61151
2021-02-08;"Žilinský kraj";160;41375;390;41765;NA;316362;550;2021-02-08;60500
2021-02-07;"Žilinský kraj";24;46446;252;46698;NA;316362;276;2021-02-07;59950
2021-02-06;"Žilinský kraj";71;72880;367;73247;NA;316362;438;2021-02-06;59674
2021-02-05;"Žilinský kraj";248;31869;323;32192;NA;316362;571;2021-02-05;59236
2021-02-04;"Žilinský kraj";238;13240;258;13498;NA;316362;496;2021-02-04;58665
2021-02-03;"Žilinský kraj";194;9186;255;9441;NA;316362;449;2021-02-03;58169
2021-02-02;"Žilinský kraj";216;9280;272;9552;NA;316362;488;2021-02-02;57720
2021-02-01;"Žilinský kraj";220;19690;370;20060;NA;316362;590;2021-02-01;57232
2021-01-31;"Žilinský kraj";11;2652;27;2679;NA;316362;38;2021-01-31;56642
2021-01-30;"Žilinský kraj";85;18447;187;18634;NA;316362;272;2021-01-30;56604
2021-01-29;"Žilinský kraj";209;22891;304;23195;NA;316362;513;2021-01-29;56332
2021-01-28;"Žilinský kraj";240;5533;172;5705;NA;316362;412;2021-01-28;55819
2021-01-27;"Žilinský kraj";256;6725;119;6844;NA;316362;375;2021-01-27;55407
2021-01-26;"Žilinský kraj";245;49781;348;50129;NA;316362;593;2021-01-26;55032
2021-01-25;"Žilinský kraj";159;21245;150;21395;NA;316362;309;2021-01-25;54439
2021-01-24;"Žilinský kraj";22;55835;268;56103;NA;316362;290;2021-01-24;54130
2021-01-23;"Žilinský kraj";91;101730;444;102174;NA;316362;535;2021-01-23;53840
2021-01-22;"Žilinský kraj";163;32160;237;32397;NA;316362;400;2021-01-22;53305
2021-01-21;"Žilinský kraj";116;19828;181;20009;NA;316362;297;2021-01-21;52905
2021-01-20;"Žilinský kraj";236;17126;159;17285;NA;316362;395;2021-01-20;52608
2021-01-19;"Žilinský kraj";245;15730;285;16015;NA;316362;530;2021-01-19;52213
2021-01-18;"Žilinský kraj";236;12685;326;13011;NA;316362;562;2021-01-18;51683
2021-01-17;"Žilinský kraj";95;147;8;155;NA;316362;103;2021-01-17;51121
2021-01-16;"Žilinský kraj";14;516;31;547;NA;316362;45;2021-01-16;51018
2021-01-15;"Žilinský kraj";248;7486;209;7695;NA;316362;457;2021-01-15;50973
2021-01-14;"Žilinský kraj";166;5319;239;5558;NA;316362;405;2021-01-14;50516
2021-01-13;"Žilinský kraj";247;11263;557;11820;NA;316362;804;2021-01-13;50111
2021-01-12;"Žilinský kraj";376;8410;385;8795;NA;316362;761;2021-01-12;49307
2021-01-11;"Žilinský kraj";351;10058;465;10523;NA;316362;816;2021-01-11;48546
2021-01-10;"Žilinský kraj";38;229;6;235;NA;316362;44;2021-01-10;47730
2021-01-09;"Žilinský kraj";192;1282;60;1342;NA;316362;252;2021-01-09;47686
2021-01-08;"Žilinský kraj";413;8721;462;9183;NA;316362;875;2021-01-08;47434
2021-01-07;"Žilinský kraj";438;23407;1872;25279;NA;316362;2310;2021-01-07;46559
2021-01-06;"Žilinský kraj";145;1076;67;1143;NA;316362;212;2021-01-06;44249
2021-01-05;"Žilinský kraj";717;10227;796;11023;NA;316362;1513;2021-01-05;44037
2021-01-04;"Žilinský kraj";479;9313;893;10206;NA;316362;1372;2021-01-04;42524
2021-01-03;"Žilinský kraj";13;1006;107;1113;NA;316362;120;2021-01-03;41152
2021-01-02;"Žilinský kraj";98;789;91;880;NA;316362;189;2021-01-02;41032
2021-01-01;"Žilinský kraj";118;241;13;254;NA;316362;131;2021-01-01;40843
2020-12-31;"Žilinský kraj";395;9626;784;10410;NA;316362;1179;2020-12-31;40712
2020-12-30;"Žilinský kraj";1038;11781;823;12604;NA;316362;1861;2020-12-30;39533
2020-12-29;"Žilinský kraj";256;10159;979;11138;NA;316362;1235;2020-12-29;37672
2020-12-28;"Žilinský kraj";406;10704;976;11680;NA;316362;1382;2020-12-28;36437
2020-12-27;"Žilinský kraj";40;684;94;778;NA;316362;134;2020-12-27;35055
2020-12-26;"Žilinský kraj";135;593;48;641;NA;316362;183;2020-12-26;34921
2020-12-25;"Žilinský kraj";66;83;9;92;NA;316362;75;2020-12-25;34738
2020-12-24;"Žilinský kraj";643;667;55;722;NA;316362;698;2020-12-24;34663
2020-12-23;"Žilinský kraj";228;16229;975;17204;NA;316362;1203;2020-12-23;33965
2020-12-22;"Žilinský kraj";519;13483;988;14471;NA;316362;1507;2020-12-22;32762
2020-12-21;"Žilinský kraj";444;12429;1078;13507;NA;316362;1522;2020-12-21;31255
2020-12-20;"Žilinský kraj";36;598;80;678;NA;316362;116;2020-12-20;29733
2020-12-19;"Žilinský kraj";208;1678;127;1805;NA;316362;335;2020-12-19;29617
2020-12-18;"Žilinský kraj";333;6553;370;6923;NA;316362;703;2020-12-18;29282
2020-12-17;"Žilinský kraj";500;3922;262;4184;NA;316362;762;2020-12-17;28579
2020-12-16;"Žilinský kraj";333;3815;267;4082;NA;316362;600;2020-12-16;27817
2020-12-15;"Žilinský kraj";528;3729;340;4069;NA;316362;868;2020-12-15;27217
2020-12-14;"Žilinský kraj";321;3884;309;4193;NA;316362;630;2020-12-14;26349
2020-12-13;"Žilinský kraj";26;494;66;560;NA;316362;92;2020-12-13;25719
2020-12-12;"Žilinský kraj";95;767;46;813;NA;316362;141;2020-12-12;25627
2020-12-11;"Žilinský kraj";455;3938;227;4165;NA;316362;682;2020-12-11;25486
2020-12-10;"Žilinský kraj";166;9129;838;9967;NA;316362;1004;2020-12-10;24804
2020-12-09;"Žilinský kraj";392;2169;132;2301;NA;316362;524;2020-12-09;23800
2020-12-08;"Žilinský kraj";331;3127;101;3228;NA;316362;432;2020-12-08;23276
2020-12-07;"Žilinský kraj";348;2746;162;2908;NA;316362;510;2020-12-07;22844
2020-12-06;"Žilinský kraj";15;128;6;134;NA;316362;21;2020-12-06;22334
2020-12-05;"Žilinský kraj";98;781;41;822;NA;316362;139;2020-12-05;22313
2020-12-04;"Žilinský kraj";228;3091;107;3198;NA;316362;335;2020-12-04;22174
2020-12-03;"Žilinský kraj";237;1609;115;1724;NA;316362;352;2020-12-03;21839
2020-12-02;"Žilinský kraj";181;1710;94;1804;NA;316362;275;2020-12-02;21487
2020-12-01;"Žilinský kraj";209;6239;284;6523;NA;316362;493;2020-12-01;21212
2020-11-30;"Žilinský kraj";203;5326;305;5631;NA;316362;508;2020-11-30;20719
2020-11-29;"Žilinský kraj";18;81;7;88;NA;316362;25;2020-11-29;20211
2020-11-28;"Žilinský kraj";99;349;15;364;NA;316362;114;2020-11-28;20186
2020-11-27;"Žilinský kraj";218;904;46;950;NA;316362;264;2020-11-27;20072
2020-11-26;"Žilinský kraj";190;1041;54;1095;NA;316362;244;2020-11-26;19808
2020-11-25;"Žilinský kraj";225;1217;49;1266;NA;316362;274;2020-11-25;19564
2020-11-24;"Žilinský kraj";213;2139;67;2206;NA;316362;280;2020-11-24;19290
2020-11-23;"Žilinský kraj";170;759;44;803;NA;316362;214;2020-11-23;19010
2020-11-22;"Žilinský kraj";11;67;2;69;NA;316362;13;2020-11-22;18796
2020-11-21;"Žilinský kraj";61;505;20;525;NA;316362;81;2020-11-21;18783
2020-11-20;"Žilinský kraj";251;1074;45;1119;NA;316362;296;2020-11-20;18702
2020-11-19;"Žilinský kraj";252;752;61;813;NA;316362;313;2020-11-19;18406
2020-11-18;"Žilinský kraj";346;348;15;363;NA;316362;361;2020-11-18;18093
2020-11-17;"Žilinský kraj";123;490;15;505;NA;316362;138;2020-11-17;17732
2020-11-16;"Žilinský kraj";227;247;15;262;NA;316362;242;2020-11-16;17594
2020-11-15;"Žilinský kraj";63;13;0;13;NA;316362;63;2020-11-15;17352
2020-11-14;"Žilinský kraj";189;1038;11;1049;NA;316362;200;2020-11-14;17289
2020-11-13;"Žilinský kraj";181;125;9;134;NA;316362;190;2020-11-13;17089
2020-11-12;"Žilinský kraj";334;79;2;81;NA;316362;336;2020-11-12;16899
2020-11-11;"Žilinský kraj";489;147;10;157;NA;316362;499;2020-11-11;16563
2020-11-10;"Žilinský kraj";374;519;9;528;NA;316362;383;2020-11-10;16064
2020-11-09;"Žilinský kraj";143;2335;30;2365;NA;316362;173;2020-11-09;15681
2020-11-08;"Žilinský kraj";59;2538;37;2575;NA;316362;96;2020-11-08;15508
2020-11-07;"Žilinský kraj";312;8175;88;8263;NA;316362;400;2020-11-07;15412
2020-11-06;"Žilinský kraj";503;4090;38;4128;NA;316362;541;2020-11-06;15012
2020-11-05;"Žilinský kraj";473;64;4;68;NA;316362;477;2020-11-05;14471
2020-11-04;"Žilinský kraj";423;178;10;188;NA;316362;433;2020-11-04;13994
2020-11-03;"Žilinský kraj";688;889;16;905;NA;316362;704;2020-11-03;13561
2020-11-02;"Žilinský kraj";472;1043;39;1082;NA;316362;511;2020-11-02;12857
2020-11-01;"Žilinský kraj";349;5096;130;5226;NA;316362;479;2020-11-01;12346
2020-10-31;"Žilinský kraj";661;7963;203;8166;NA;316362;864;2020-10-31;11867
2020-10-30;"Žilinský kraj";529;2575;61;2636;NA;316362;590;2020-10-30;11003
2020-10-29;"Žilinský kraj";740;503;17;520;NA;316362;757;2020-10-29;10413
2020-10-28;"Žilinský kraj";635;105;11;116;NA;316362;646;2020-10-28;9656
2020-10-27;"Žilinský kraj";355;154;24;178;NA;316362;379;2020-10-27;9010
2020-10-26;"Žilinský kraj";148;117;28;145;NA;316362;176;2020-10-26;8631
2020-10-25;"Žilinský kraj";436;0;0;0;NA;316362;436;2020-10-25;8455
2020-10-24;"Žilinský kraj";803;0;0;0;NA;316362;803;2020-10-24;8019
2020-10-23;"Žilinský kraj";659;102;13;115;NA;316362;672;2020-10-23;7216
2020-10-22;"Žilinský kraj";525;33;3;36;NA;316362;528;2020-10-22;6544
2020-10-21;"Žilinský kraj";478;74;14;88;NA;316362;492;2020-10-21;6016
2020-10-20;"Žilinský kraj";524;127;8;135;NA;316362;532;2020-10-20;5524
2020-10-19;"Žilinský kraj";70;80;12;92;NA;316362;82;2020-10-19;4992
2020-10-18;"Žilinský kraj";159;0;0;0;NA;316362;159;2020-10-18;4910
2020-10-17;"Žilinský kraj";509;0;0;0;NA;316362;509;2020-10-17;4751
2020-10-16;"Žilinský kraj";603;51;9;60;NA;316362;612;2020-10-16;4242
2020-10-15;"Žilinský kraj";679;61;3;64;NA;316362;682;2020-10-15;3630
2020-10-14;"Žilinský kraj";523;269;6;275;NA;316362;529;2020-10-14;2948
2020-10-13;"Žilinský kraj";367;458;40;498;NA;316362;407;2020-10-13;2419
2020-10-12;"Žilinský kraj";62;0;0;0;NA;316362;62;2020-10-12;2012
2020-10-11;"Žilinský kraj";50;0;0;0;NA;316362;50;2020-10-11;1950
2020-10-10;"Žilinský kraj";213;0;0;0;NA;316362;213;2020-10-10;1900
2020-10-09;"Žilinský kraj";543;0;0;0;NA;316362;543;2020-10-09;1687
2020-10-08;"Žilinský kraj";238;0;0;0;NA;316362;238;2020-10-08;1144
2020-10-07;"Žilinský kraj";168;0;0;0;NA;316362;168;2020-10-07;906
2020-10-06;"Žilinský kraj";233;0;0;0;NA;316362;233;2020-10-06;738
2020-10-05;"Žilinský kraj";33;0;0;0;NA;316362;33;2020-10-05;505
2020-10-04;"Žilinský kraj";35;0;0;0;NA;316362;35;2020-10-04;472
2020-10-03;"Žilinský kraj";155;0;0;0;NA;316362;155;2020-10-03;437
2020-10-02;"Žilinský kraj";105;0;0;0;NA;316362;105;2020-10-02;282
2020-10-01;"Žilinský kraj";147;0;0;0;NA;316362;147;2020-10-01;177
2020-09-30;"Žilinský kraj";163;0;0;0;NA;316362;163;2020-09-30;30
2020-09-29;"Žilinský kraj";105;0;0;0;NA;316362;105;2020-09-29;-133
2020-09-28;"Žilinský kraj";34;0;0;0;NA;316362;34;2020-09-28;-238
2020-09-27;"Žilinský kraj";108;0;0;0;NA;316362;108;2020-09-27;-272
2020-09-26;"Žilinský kraj";96;0;0;0;NA;316362;96;2020-09-26;-380
2020-09-25;"Žilinský kraj";69;0;0;0;NA;316362;69;2020-09-25;-476
2020-09-24;"Žilinský kraj";100;0;0;0;NA;316362;100;2020-09-24;-545
2020-09-23;"Žilinský kraj";65;0;0;0;NA;316362;65;2020-09-23;-645
2020-09-22;"Žilinský kraj";65;0;0;0;NA;316362;65;2020-09-22;-710
2020-09-21;"Žilinský kraj";47;0;0;0;NA;316362;47;2020-09-21;-775
2020-09-20;"Žilinský kraj";4;0;0;0;NA;316362;4;2020-09-20;-822
2020-09-19;"Žilinský kraj";6;0;0;0;NA;316362;6;2020-09-19;-826
2020-09-18;"Žilinský kraj";82;0;0;0;NA;316362;82;2020-09-18;-832
2020-09-17;"Žilinský kraj";30;0;0;0;NA;316362;30;2020-09-17;-914
2020-09-16;"Žilinský kraj";34;0;0;0;NA;316362;34;2020-09-16;-944
2020-09-15;"Žilinský kraj";12;0;0;0;NA;316362;12;2020-09-15;-978
2020-09-14;"Žilinský kraj";39;0;0;0;NA;316362;39;2020-09-14;-990
2020-09-13;"Žilinský kraj";6;0;0;0;NA;316362;6;2020-09-13;-1029
2020-09-12;"Žilinský kraj";4;0;0;0;NA;316362;4;2020-09-12;-1035
2020-09-11;"Žilinský kraj";31;0;0;0;NA;316362;31;2020-09-11;-1039
2020-09-10;"Žilinský kraj";31;12;0;12;NA;316362;31;2020-09-10;-1070
2020-09-09;"Žilinský kraj";23;0;0;0;NA;316362;23;2020-09-09;-1101
2020-09-08;"Žilinský kraj";25;0;0;0;NA;316362;25;2020-09-08;-1124
2020-09-07;"Žilinský kraj";11;0;0;0;NA;316362;11;2020-09-07;-1149
2020-09-06;"Žilinský kraj";0;0;0;0;NA;316362;0;2020-09-06;-1160
2020-09-05;"Žilinský kraj";2;0;0;0;NA;316362;2;2020-09-05;-1160
2020-09-04;"Žilinský kraj";33;0;0;0;NA;316362;33;2020-09-04;-1162
2020-09-03;"Žilinský kraj";18;0;0;0;NA;316362;18;2020-09-03;-1195
2020-09-02;"Žilinský kraj";16;0;0;0;NA;316362;16;2020-09-02;-1213
2020-09-01;"Žilinský kraj";4;0;0;0;NA;316362;4;2020-09-01;-1229
2020-08-31;"Žilinský kraj";5;0;0;0;NA;316362;5;2020-08-31;-1233
2020-08-30;"Žilinský kraj";3;0;0;0;NA;316362;3;2020-08-30;-1238
2020-08-29;"Žilinský kraj";5;0;0;0;NA;316362;5;2020-08-29;-1241
2020-08-28;"Žilinský kraj";13;0;0;0;NA;316362;13;2020-08-28;-1246
2020-08-27;"Žilinský kraj";18;0;0;0;NA;316362;18;2020-08-27;-1259
2020-08-26;"Žilinský kraj";8;0;0;0;NA;316362;8;2020-08-26;-1277
2020-08-25;"Žilinský kraj";2;0;0;0;NA;316362;2;2020-08-25;-1285
2020-08-24;"Žilinský kraj";5;0;0;0;NA;316362;5;2020-08-24;-1287
2020-08-23;"Žilinský kraj";0;0;0;0;NA;316362;0;2020-08-23;-1292
2020-08-22;"Žilinský kraj";0;0;0;0;NA;316362;0;2020-08-22;-1292
2020-08-21;"Žilinský kraj";10;0;0;0;NA;316362;10;2020-08-21;-1292
2020-08-20;"Žilinský kraj";13;0;0;0;NA;316362;13;2020-08-20;-1302
2020-08-19;"Žilinský kraj";7;0;0;0;NA;316362;7;2020-08-19;-1315
2020-08-18;"Žilinský kraj";9;0;0;0;NA;316362;9;2020-08-18;-1322
2020-08-17;"Žilinský kraj";1;0;0;0;NA;316362;1;2020-08-17;-1331
2020-08-16;"Žilinský kraj";0;0;0;0;NA;316362;0;2020-08-16;-1332
2020-08-15;"Žilinský kraj";0;0;0;0;NA;316362;0;2020-08-15;-1332
2020-08-14;"Žilinský kraj";4;0;0;0;NA;316362;4;2020-08-14;-1332
2020-08-13;"Žilinský kraj";2;0;0;0;NA;316362;2;2020-08-13;-1336
2020-08-12;"Žilinský kraj";0;0;0;0;NA;316362;0;2020-08-12;-1338
2020-08-11;"Žilinský kraj";4;0;0;0;NA;316362;4;2020-08-11;-1338
2020-08-10;"Žilinský kraj";1;0;0;0;NA;316362;1;2020-08-10;-1342
2020-08-09;"Žilinský kraj";0;0;0;0;NA;316362;0;2020-08-09;-1343
2020-08-08;"Žilinský kraj";3;0;0;0;NA;316362;3;2020-08-08;-1343
2020-08-07;"Žilinský kraj";8;0;0;0;NA;316362;8;2020-08-07;-1346
2020-08-06;"Žilinský kraj";1;0;0;0;NA;316362;1;2020-08-06;-1354
2020-08-05;"Žilinský kraj";1;0;0;0;NA;316362;1;2020-08-05;-1355
2020-08-04;"Žilinský kraj";2;0;0;0;NA;316362;2;2020-08-04;-1356
2020-08-03;"Žilinský kraj";0;0;0;0;NA;316362;0;2020-08-03;-1358
2020-08-02;"Žilinský kraj";1;0;0;0;NA;316362;1;2020-08-02;-1358
2020-08-01;"Žilinský kraj";0;0;0;0;NA;316362;0;2020-08-01;-1359
2020-07-31;"Žilinský kraj";4;0;0;0;NA;316362;4;2020-07-31;-1359
2020-07-30;"Žilinský kraj";2;0;0;0;NA;316362;2;2020-07-30;-1363
2020-07-29;"Žilinský kraj";2;0;0;0;NA;316362;2;2020-07-29;-1365
2020-07-28;"Žilinský kraj";4;0;0;0;NA;316362;4;2020-07-28;-1367
2020-07-27;"Žilinský kraj";6;0;0;0;NA;316362;6;2020-07-27;-1371
2020-07-26;"Žilinský kraj";0;0;0;0;NA;316362;0;2020-07-26;-1377
2020-07-25;"Žilinský kraj";0;0;0;0;NA;316362;0;2020-07-25;-1377
2020-07-24;"Žilinský kraj";2;0;0;0;NA;316362;2;2020-07-24;-1377
2020-07-23;"Žilinský kraj";0;0;0;0;NA;316362;0;2020-07-23;-1379
2020-07-22;"Žilinský kraj";1;0;0;0;NA;316362;1;2020-07-22;-1379
2020-07-21;"Žilinský kraj";2;0;0;0;NA;316362;2;2020-07-21;-1380
2020-07-20;"Žilinský kraj";3;0;0;0;NA;316362;3;2020-07-20;-1382
2020-07-19;"Žilinský kraj";0;0;0;0;NA;316362;0;2020-07-19;-1385
2020-07-18;"Žilinský kraj";0;0;0;0;NA;316362;0;2020-07-18;-1385
2020-07-17;"Žilinský kraj";2;0;0;0;NA;316362;2;2020-07-17;-1385
2020-07-16;"Žilinský kraj";2;0;0;0;NA;316362;2;2020-07-16;-1387
2020-07-15;"Žilinský kraj";2;0;0;0;NA;316362;2;2020-07-15;-1389
2020-07-14;"Žilinský kraj";1;0;0;0;NA;316362;1;2020-07-14;-1391
2020-07-13;"Žilinský kraj";0;0;0;0;NA;316362;0;2020-07-13;-1392
2020-07-12;"Žilinský kraj";0;0;0;0;NA;316362;0;2020-07-12;-1392
2020-07-11;"Žilinský kraj";2;0;0;0;NA;316362;2;2020-07-11;-1392
2020-07-10;"Žilinský kraj";3;0;0;0;NA;316362;3;2020-07-10;-1394
2020-07-09;"Žilinský kraj";2;0;0;0;NA;316362;2;2020-07-09;-1397
2020-07-08;"Žilinský kraj";10;0;0;0;NA;316362;10;2020-07-08;-1399
2020-07-07;"Žilinský kraj";7;0;0;0;NA;316362;7;2020-07-07;-1409
2020-07-06;"Žilinský kraj";0;0;0;0;NA;316362;0;2020-07-06;-1416
2020-07-05;"Žilinský kraj";0;0;0;0;NA;316362;0;2020-07-05;-1416
2020-07-04;"Žilinský kraj";10;0;0;0;NA;316362;10;2020-07-04;-1416
2020-07-03;"Žilinský kraj";18;0;0;0;NA;316362;18;2020-07-03;-1426
2020-07-02;"Žilinský kraj";7;0;0;0;NA;316362;7;2020-07-02;-1444
2020-07-01;"Žilinský kraj";0;0;0;0;NA;316362;0;2020-07-01;-1451
2020-06-30;"Žilinský kraj";4;0;0;0;NA;316362;4;2020-06-30;-1451
2020-06-29;"Žilinský kraj";0;0;0;0;NA;316362;0;2020-06-29;-1455
2020-06-28;"Žilinský kraj";1;0;0;0;NA;316362;1;2020-06-28;-1455
2020-06-27;"Žilinský kraj";3;0;0;0;NA;316362;3;2020-06-27;-1456
2020-06-26;"Žilinský kraj";5;0;0;0;NA;316362;5;2020-06-26;-1459
2020-06-25;"Žilinský kraj";7;0;0;0;NA;316362;7;2020-06-25;-1464
2020-06-24;"Žilinský kraj";11;0;0;0;NA;316362;11;2020-06-24;-1471
2020-06-23;"Žilinský kraj";9;0;0;0;NA;316362;9;2020-06-23;-1482
2020-06-22;"Žilinský kraj";0;0;0;0;NA;316362;0;2020-06-22;-1491
2020-06-21;"Žilinský kraj";1;0;0;0;NA;316362;1;2020-06-21;-1491
2020-06-20;"Žilinský kraj";1;0;0;0;NA;316362;1;2020-06-20;-1492
2020-06-19;"Žilinský kraj";4;0;0;0;NA;316362;4;2020-06-19;-1493
2020-06-18;"Žilinský kraj";1;0;0;0;NA;316362;1;2020-06-18;-1497
2020-06-17;"Žilinský kraj";0;0;0;0;NA;316362;0;2020-06-17;-1498
2020-06-16;"Žilinský kraj";1;0;0;0;NA;316362;1;2020-06-16;-1498
2020-06-14;"Žilinský kraj";0;0;0;0;NA;316362;0;2020-06-14;-1499
2020-06-13;"Žilinský kraj";0;0;0;0;NA;316362;0;2020-06-13;-1499
2020-06-12;"Žilinský kraj";0;0;0;0;NA;316362;0;2020-06-12;-1499
2020-06-11;"Žilinský kraj";0;0;0;0;NA;316362;0;2020-06-11;-1499
2020-06-10;"Žilinský kraj";0;0;0;0;NA;316362;0;2020-06-10;-1499
2020-06-09;"Žilinský kraj";1;0;0;0;NA;316362;1;2020-06-09;-1499
2020-06-08;"Žilinský kraj";0;0;0;0;NA;316362;0;2020-06-08;-1500
2020-06-07;"Žilinský kraj";0;0;0;0;NA;316362;0;2020-06-07;-1500
2020-06-05;"Žilinský kraj";0;0;0;0;NA;316362;0;2020-06-05;-1500
2020-06-03;"Žilinský kraj";0;0;0;0;NA;316362;0;2020-06-03;-1500
2020-06-02;"Žilinský kraj";0;0;0;0;NA;316362;0;2020-06-02;-1500
2020-05-31;"Žilinský kraj";0;0;0;0;NA;316362;0;2020-05-31;-1500
2020-05-29;"Žilinský kraj";0;0;0;0;NA;316362;0;2020-05-29;-1500
2020-05-27;"Žilinský kraj";1;0;0;0;NA;316362;1;2020-05-27;-1500
2020-05-26;"Žilinský kraj";1;0;0;0;NA;316362;1;2020-05-26;-1501
2020-05-25;"Žilinský kraj";0;0;0;0;NA;316362;0;2020-05-25;-1502
2020-05-24;"Žilinský kraj";0;0;0;0;NA;316362;0;2020-05-24;-1502
2020-05-23;"Žilinský kraj";0;0;0;0;NA;316362;0;2020-05-23;-1502
2020-05-22;"Žilinský kraj";0;0;0;0;NA;316362;0;2020-05-22;-1502
2020-05-21;"Žilinský kraj";0;0;0;0;NA;316362;0;2020-05-21;-1502
2020-05-20;"Žilinský kraj";0;0;0;0;NA;316362;0;2020-05-20;-1502
2020-05-19;"Žilinský kraj";1;0;0;0;NA;316362;1;2020-05-19;-1502
2020-05-17;"Žilinský kraj";0;0;0;0;NA;316362;0;2020-05-17;-1503
2020-05-16;"Žilinský kraj";0;0;0;0;NA;316362;0;2020-05-16;-1503
2020-05-15;"Žilinský kraj";0;0;0;0;NA;316362;0;2020-05-15;-1503
2020-05-14;"Žilinský kraj";0;0;0;0;NA;316362;0;2020-05-14;-1503
2020-05-13;"Žilinský kraj";0;0;0;0;NA;316362;0;2020-05-13;-1503
2020-05-12;"Žilinský kraj";0;0;0;0;NA;316362;0;2020-05-12;-1503
2020-05-11;"Žilinský kraj";0;0;0;0;NA;316362;0;2020-05-11;-1503
2020-05-09;"Žilinský kraj";0;0;0;0;NA;316362;0;2020-05-09;-1503
2020-05-07;"Žilinský kraj";0;0;0;0;NA;316362;0;2020-05-07;-1503
2020-05-06;"Žilinský kraj";2;0;0;0;NA;316362;2;2020-05-06;-1503
2020-05-05;"Žilinský kraj";3;0;0;0;NA;316362;3;2020-05-05;-1505
2020-05-04;"Žilinský kraj";3;0;0;0;NA;316362;3;2020-05-04;-1508
2020-05-03;"Žilinský kraj";1;0;0;0;NA;316362;1;2020-05-03;-1511
2020-05-02;"Žilinský kraj";0;0;0;0;NA;316362;0;2020-05-02;-1512
2020-05-01;"Žilinský kraj";1;0;0;0;NA;316362;1;2020-05-01;-1512
2020-04-30;"Žilinský kraj";0;0;0;0;NA;316362;0;2020-04-30;-1513
2020-04-29;"Žilinský kraj";0;0;0;0;NA;316362;0;2020-04-29;-1513
2020-04-28;"Žilinský kraj";0;0;0;0;NA;316362;0;2020-04-28;-1513
2020-04-27;"Žilinský kraj";0;0;0;0;NA;316362;0;2020-04-27;-1513
2020-04-26;"Žilinský kraj";0;0;0;0;NA;316362;0;2020-04-26;-1513
2020-04-25;"Žilinský kraj";2;0;0;0;NA;316362;2;2020-04-25;-1513
2020-04-24;"Žilinský kraj";1;0;0;0;NA;316362;1;2020-04-24;-1515
2020-04-23;"Žilinský kraj";2;0;0;0;NA;316362;2;2020-04-23;-1516
2020-04-22;"Žilinský kraj";9;0;0;0;NA;316362;9;2020-04-22;-1518
2020-04-21;"Žilinský kraj";1;0;0;0;NA;316362;1;2020-04-21;-1527
2020-04-20;"Žilinský kraj";4;0;0;0;NA;316362;4;2020-04-20;-1528
2020-04-19;"Žilinský kraj";0;0;0;0;NA;316362;0;2020-04-19;-1532
2020-04-18;"Žilinský kraj";49;0;0;0;NA;316362;49;2020-04-18;-1532
2020-04-17;"Žilinský kraj";3;0;0;0;NA;316362;3;2020-04-17;-1581
2020-04-16;"Žilinský kraj";4;0;0;0;NA;316362;4;2020-04-16;-1584
2020-04-15;"Žilinský kraj";7;0;0;0;NA;316362;7;2020-04-15;-1588
2020-04-14;"Žilinský kraj";1;0;0;0;NA;316362;1;2020-04-14;-1595
2020-04-13;"Žilinský kraj";2;0;0;0;NA;316362;2;2020-04-13;-1596
2020-04-12;"Žilinský kraj";5;0;0;0;NA;316362;5;2020-04-12;-1598
2020-04-11;"Žilinský kraj";2;0;0;0;NA;316362;2;2020-04-11;-1603
2020-04-10;"Žilinský kraj";1;0;0;0;NA;316362;1;2020-04-10;-1605
2020-04-09;"Žilinský kraj";1;0;0;0;NA;316362;1;2020-04-09;-1606
2020-04-08;"Žilinský kraj";3;0;0;0;NA;316362;3;2020-04-08;-1607
2020-04-07;"Žilinský kraj";5;0;0;0;NA;316362;5;2020-04-07;-1610
2020-04-06;"Žilinský kraj";6;0;0;0;NA;316362;6;2020-04-06;-1615
2020-04-05;"Žilinský kraj";8;0;0;0;NA;316362;8;2020-04-05;-1621
2020-04-04;"Žilinský kraj";0;0;0;0;NA;316362;0;2020-04-04;-1629
2020-04-03;"Žilinský kraj";3;0;0;0;NA;316362;3;2020-04-03;-1629
2020-04-02;"Žilinský kraj";5;0;0;0;NA;316362;5;2020-04-02;-1632
2020-04-01;"Žilinský kraj";4;0;0;0;NA;316362;4;2020-04-01;-1637
2020-03-31;"Žilinský kraj";1;0;0;0;NA;316362;1;2020-03-31;-1641
2020-03-30;"Žilinský kraj";3;0;0;0;NA;316362;3;2020-03-30;-1642
2020-03-29;"Žilinský kraj";0;0;0;0;NA;316362;0;2020-03-29;-1645
2020-03-28;"Žilinský kraj";1;0;0;0;NA;316362;1;2020-03-28;-1645
2020-03-27;"Žilinský kraj";9;0;0;0;NA;316362;9;2020-03-27;-1646
2020-03-26;"Žilinský kraj";4;0;0;0;NA;316362;4;2020-03-26;-1655
2020-03-25;"Žilinský kraj";1;0;0;0;NA;316362;1;2020-03-25;-1659
2020-03-24;"Žilinský kraj";2;0;0;0;NA;316362;2;2020-03-24;-1660
2020-03-23;"Žilinský kraj";3;0;0;0;NA;316362;3;2020-03-23;-1662
2020-03-22;"Žilinský kraj";1;0;0;0;NA;316362;1;2020-03-22;-1665
2020-03-21;"Žilinský kraj";2;0;0;0;NA;316362;2;2020-03-21;-1666
2020-03-20;"Žilinský kraj";4;0;0;0;NA;316362;4;2020-03-20;-1668
2020-03-19;"Žilinský kraj";2;0;0;0;NA;316362;2;2020-03-19;-1672
2020-03-18;"Žilinský kraj";1;0;0;0;NA;316362;1;2020-03-18;-1674
2020-03-17;"Žilinský kraj";5;0;0;0;NA;316362;5;2020-03-17;-1675
2020-03-16;"Žilinský kraj";1;0;0;0;NA;316362;1;2020-03-16;-1680
2020-03-15;"Žilinský kraj";2;0;0;0;NA;316362;2;2020-03-15;-1681
2020-03-14;"Žilinský kraj";1;0;0;0;NA;316362;1;2020-03-14;-1683
2020-03-13;"Žilinský kraj";5;0;0;0;NA;316362;5;2020-03-13;-1684
2020-03-12;"Žilinský kraj";1;0;0;0;NA;316362;1;2020-03-12;-1689
2020-03-11;"Žilinský kraj";0;0;0;0;NA;316362;0;2020-03-11;-1690
2020-03-09;"Žilinský kraj";1;0;0;0;NA;316362;1;2020-03-09;-1690
2020-03-08;"Žilinský kraj";0;0;0;0;NA;316362;0;2020-03-08;-1691
2020-03-07;"Žilinský kraj";0;0;0;0;NA;316362;0;2020-03-07;-1691
2020-03-06;"Žilinský kraj";0;0;0;0;NA;316362;0;2020-03-06;-1691
