"Datum";"Region";"PCR_Pos";"Ag_Neg";"Ag_Pos";"Total";"Pocet.potvrdenych";"Potvrdenych";"newcases";"date";"positive"
2022-04-03;"Banskobystrický kraj";66;328;70;398;177667;267192;136;2022-04-03;267192
2022-04-02;"Banskobystrický kraj";208;114;32;146;NA;267192;240;2022-04-02;267056
2022-04-01;"Banskobystrický kraj";529;1186;137;1323;NA;267192;666;2022-04-01;266816
2022-03-31;"Banskobystrický kraj";516;1775;102;1877;NA;267192;618;2022-03-31;266150
2022-03-30;"Banskobystrický kraj";734;1541;125;1666;NA;267192;859;2022-03-30;265532
2022-03-29;"Banskobystrický kraj";666;1380;161;1541;NA;267192;827;2022-03-29;264673
2022-03-28;"Banskobystrický kraj";618;2523;318;2841;NA;267192;936;2022-03-28;263846
2022-03-27;"Banskobystrický kraj";147;686;114;800;NA;267192;261;2022-03-27;262910
2022-03-26;"Banskobystrický kraj";343;150;53;203;NA;267192;396;2022-03-26;262649
2022-03-25;"Banskobystrický kraj";721;1378;192;1570;NA;267192;913;2022-03-25;262253
2022-03-24;"Banskobystrický kraj";769;1789;162;1951;NA;267192;931;2022-03-24;261340
2022-03-23;"Banskobystrický kraj";823;1643;201;1844;NA;267192;1024;2022-03-23;260409
2022-03-22;"Banskobystrický kraj";1148;1703;220;1923;NA;267192;1368;2022-03-22;259385
2022-03-21;"Banskobystrický kraj";879;2711;356;3067;NA;267192;1235;2022-03-21;258017
2022-03-20;"Banskobystrický kraj";172;604;174;778;NA;267192;346;2022-03-20;256782
2022-03-19;"Banskobystrický kraj";529;218;89;307;NA;267192;618;2022-03-19;256436
2022-03-18;"Banskobystrický kraj";819;2081;200;2281;NA;267192;1019;2022-03-18;255818
2022-03-17;"Banskobystrický kraj";981;3476;224;3700;NA;267192;1205;2022-03-17;254799
2022-03-16;"Banskobystrický kraj";1189;1396;235;1631;NA;267192;1424;2022-03-16;253594
2022-03-15;"Banskobystrický kraj";1420;1730;231;1961;NA;267192;1651;2022-03-15;252170
2022-03-14;"Banskobystrický kraj";948;3220;426;3646;NA;267192;1374;2022-03-14;250519
2022-03-13;"Banskobystrický kraj";224;576;216;792;NA;267192;440;2022-03-13;249145
2022-03-12;"Banskobystrický kraj";625;262;94;356;NA;267192;719;2022-03-12;248705
2022-03-11;"Banskobystrický kraj";1144;1817;287;2104;NA;267192;1431;2022-03-11;247986
2022-03-10;"Banskobystrický kraj";1325;2126;311;2437;NA;267192;1636;2022-03-10;246555
2022-03-09;"Banskobystrický kraj";1370;2033;333;2366;NA;267192;1703;2022-03-09;244919
2022-03-08;"Banskobystrický kraj";1738;2327;376;2703;NA;267192;2114;2022-03-08;243216
2022-03-07;"Banskobystrický kraj";1048;4974;604;5578;NA;267192;1652;2022-03-07;241102
2022-03-06;"Banskobystrický kraj";356;1264;278;1542;NA;267192;634;2022-03-06;239450
2022-03-05;"Banskobystrický kraj";745;494;180;674;NA;267192;925;2022-03-05;238816
2022-03-04;"Banskobystrický kraj";1302;2574;391;2965;NA;267192;1693;2022-03-04;237891
2022-03-03;"Banskobystrický kraj";1766;3465;386;3851;NA;267192;2152;2022-03-03;236198
2022-03-02;"Banskobystrický kraj";1515;5604;415;6019;NA;267192;1930;2022-03-02;234046
2022-03-01;"Banskobystrický kraj";1842;3325;396;3721;NA;267192;2238;2022-03-01;232116
2022-02-28;"Banskobystrický kraj";1050;4913;708;5621;NA;267192;1758;2022-02-28;229878
2022-02-27;"Banskobystrický kraj";604;1162;303;1465;NA;267192;907;2022-02-27;228120
2022-02-26;"Banskobystrický kraj";909;528;154;682;NA;267192;1063;2022-02-26;227213
2022-02-25;"Banskobystrický kraj";1591;2518;430;2948;NA;267192;2021;2022-02-25;226150
2022-02-24;"Banskobystrický kraj";1781;3858;404;4262;NA;267192;2185;2022-02-24;224129
2022-02-23;"Banskobystrický kraj";2094;2869;454;3323;NA;267192;2548;2022-02-23;221944
2022-02-22;"Banskobystrický kraj";2195;3736;469;4205;NA;267192;2664;2022-02-22;219396
2022-02-21;"Banskobystrický kraj";1409;5732;806;6538;NA;267192;2215;2022-02-21;216732
2022-02-20;"Banskobystrický kraj";484;1717;423;2140;NA;267192;907;2022-02-20;214517
2022-02-19;"Banskobystrický kraj";1180;774;242;1016;NA;267192;1422;2022-02-19;213610
2022-02-18;"Banskobystrický kraj";2473;3620;541;4161;NA;267192;3014;2022-02-18;212188
2022-02-17;"Banskobystrický kraj";1924;4239;460;4699;NA;267192;2384;2022-02-17;209174
2022-02-16;"Banskobystrický kraj";1856;3635;543;4178;NA;267192;2399;2022-02-16;206790
2022-02-15;"Banskobystrický kraj";2287;4459;584;5043;NA;267192;2871;2022-02-15;204391
2022-02-14;"Banskobystrický kraj";2071;6848;891;7739;NA;267192;2962;2022-02-14;201520
2022-02-13;"Banskobystrický kraj";577;2247;471;2718;NA;267192;1048;2022-02-13;198558
2022-02-12;"Banskobystrický kraj";1308;906;308;1214;NA;267192;1616;2022-02-12;197510
2022-02-11;"Banskobystrický kraj";2684;3818;555;4373;NA;267192;3239;2022-02-11;195894
2022-02-10;"Banskobystrický kraj";1765;5733;567;6300;NA;267192;2332;2022-02-10;192655
2022-02-09;"Banskobystrický kraj";2544;3794;569;4363;NA;267192;3113;2022-02-09;190323
2022-02-08;"Banskobystrický kraj";1806;4418;538;4956;NA;267192;2344;2022-02-08;187210
2022-02-07;"Banskobystrický kraj";1683;7388;728;8116;NA;267192;2411;2022-02-07;184866
2022-02-06;"Banskobystrický kraj";604;2244;392;2636;NA;267192;996;2022-02-06;182455
2022-02-05;"Banskobystrický kraj";1032;1434;233;1667;NA;267192;1265;2022-02-05;181459
2022-02-04;"Banskobystrický kraj";1866;3745;438;4183;NA;267192;2304;2022-02-04;180194
2022-02-03;"Banskobystrický kraj";1561;5433;359;5792;NA;267192;1920;2022-02-03;177890
2022-02-02;"Banskobystrický kraj";1716;4780;395;5175;NA;267192;2111;2022-02-02;175970
2022-02-01;"Banskobystrický kraj";1918;4558;410;4968;NA;267192;2328;2022-02-01;173859
2022-01-31;"Banskobystrický kraj";779;9006;553;9559;NA;267192;1332;2022-01-31;171531
2022-01-30;"Banskobystrický kraj";412;3055;267;3322;NA;267192;679;2022-01-30;170199
2022-01-29;"Banskobystrický kraj";981;1155;174;1329;NA;267192;1155;2022-01-29;169520
2022-01-28;"Banskobystrický kraj";1040;3814;313;4127;NA;267192;1353;2022-01-28;168365
2022-01-27;"Banskobystrický kraj";1035;4955;225;5180;NA;267192;1260;2022-01-27;167012
2022-01-26;"Banskobystrický kraj";1060;4035;213;4248;NA;267192;1273;2022-01-26;165752
2022-01-25;"Banskobystrický kraj";1001;6119;257;6376;NA;267192;1258;2022-01-25;164479
2022-01-24;"Banskobystrický kraj";557;10186;257;10443;NA;267192;814;2022-01-24;163221
2022-01-23;"Banskobystrický kraj";246;3710;129;3839;NA;267192;375;2022-01-23;162407
2022-01-22;"Banskobystrický kraj";411;1077;64;1141;NA;267192;475;2022-01-22;162032
2022-01-21;"Banskobystrický kraj";578;3491;113;3604;NA;267192;691;2022-01-21;161557
2022-01-20;"Banskobystrický kraj";490;3810;91;3901;NA;267192;581;2022-01-20;160866
2022-01-19;"Banskobystrický kraj";421;4173;98;4271;NA;267192;519;2022-01-19;160285
2022-01-18;"Banskobystrický kraj";517;4737;95;4832;NA;267192;612;2022-01-18;159766
2022-01-17;"Banskobystrický kraj";269;8102;114;8216;NA;267192;383;2022-01-17;159154
2022-01-16;"Banskobystrický kraj";63;2746;84;2830;NA;267192;147;2022-01-16;158771
2022-01-15;"Banskobystrický kraj";287;858;16;874;NA;267192;303;2022-01-15;158624
2022-01-14;"Banskobystrický kraj";165;2758;67;2825;NA;267192;232;2022-01-14;158321
2022-01-13;"Banskobystrický kraj";182;3411;57;3468;NA;267192;239;2022-01-13;158089
2022-01-12;"Banskobystrický kraj";241;3787;67;3854;NA;267192;308;2022-01-12;157850
2022-01-11;"Banskobystrický kraj";327;4970;74;5044;NA;267192;401;2022-01-11;157542
2022-01-10;"Banskobystrický kraj";219;8173;113;8286;NA;267192;332;2022-01-10;157141
2022-01-09;"Banskobystrický kraj";54;3514;38;3552;NA;267192;92;2022-01-09;156809
2022-01-08;"Banskobystrický kraj";177;1054;40;1094;NA;267192;217;2022-01-08;156717
2022-01-07;"Banskobystrický kraj";320;3087;86;3173;NA;267192;406;2022-01-07;156500
2022-01-06;"Banskobystrický kraj";101;985;21;1006;NA;267192;122;2022-01-06;156094
2022-01-05;"Banskobystrický kraj";376;2852;67;2919;NA;267192;443;2022-01-05;155972
2022-01-04;"Banskobystrický kraj";458;4197;72;4269;NA;267192;530;2022-01-04;155529
2022-01-03;"Banskobystrický kraj";420;8216;115;8331;NA;267192;535;2022-01-03;154999
2022-01-02;"Banskobystrický kraj";117;2239;95;2334;NA;267192;212;2022-01-02;154464
2022-01-01;"Banskobystrický kraj";33;80;4;84;NA;267192;37;2022-01-01;154252
2021-12-31;"Banskobystrický kraj";314;1803;68;1871;NA;267192;382;2021-12-31;154215
2021-12-30;"Banskobystrický kraj";308;2833;88;2921;NA;267192;396;2021-12-30;153833
2021-12-29;"Banskobystrický kraj";390;2448;83;2531;NA;267192;473;2021-12-29;153437
2021-12-28;"Banskobystrický kraj";492;2902;95;2997;NA;267192;587;2021-12-28;152964
2021-12-27;"Banskobystrický kraj";397;5029;203;5232;NA;267192;600;2021-12-27;152377
2021-12-26;"Banskobystrický kraj";76;1245;62;1307;NA;267192;138;2021-12-26;151777
2021-12-25;"Banskobystrický kraj";107;373;45;418;NA;267192;152;2021-12-25;151639
2021-12-24;"Banskobystrický kraj";116;213;10;223;NA;267192;126;2021-12-24;151487
2021-12-23;"Banskobystrický kraj";429;3501;107;3608;NA;267192;536;2021-12-23;151361
2021-12-22;"Banskobystrický kraj";393;3394;106;3500;NA;267192;499;2021-12-22;150825
2021-12-21;"Banskobystrický kraj";508;4173;88;4261;NA;267192;596;2021-12-21;150326
2021-12-20;"Banskobystrický kraj";424;7610;186;7796;NA;267192;610;2021-12-20;149730
2021-12-19;"Banskobystrický kraj";39;2681;87;2768;NA;267192;126;2021-12-19;149120
2021-12-18;"Banskobystrický kraj";333;1036;67;1103;NA;267192;400;2021-12-18;148994
2021-12-17;"Banskobystrický kraj";465;3805;102;3907;NA;267192;567;2021-12-17;148594
2021-12-16;"Banskobystrický kraj";499;4278;116;4394;NA;267192;615;2021-12-16;148027
2021-12-15;"Banskobystrický kraj";554;4772;102;4874;NA;267192;656;2021-12-15;147412
2021-12-14;"Banskobystrický kraj";729;4614;108;4722;NA;267192;837;2021-12-14;146756
2021-12-13;"Banskobystrický kraj";470;8201;222;8423;NA;267192;692;2021-12-13;145919
2021-12-12;"Banskobystrický kraj";161;3332;101;3433;NA;267192;262;2021-12-12;145227
2021-12-11;"Banskobystrický kraj";568;1166;82;1248;NA;267192;650;2021-12-11;144965
2021-12-10;"Banskobystrický kraj";731;4033;185;4218;NA;267192;916;2021-12-10;144315
2021-12-09;"Banskobystrický kraj";652;4381;139;4520;NA;267192;791;2021-12-09;143399
2021-12-08;"Banskobystrický kraj";1087;4100;169;4269;NA;267192;1256;2021-12-08;142608
2021-12-07;"Banskobystrický kraj";1104;5410;201;5611;NA;267192;1305;2021-12-07;141352
2021-12-06;"Banskobystrický kraj";647;9113;324;9437;NA;267192;971;2021-12-06;140047
2021-12-05;"Banskobystrický kraj";217;3425;155;3580;NA;267192;372;2021-12-05;139076
2021-12-04;"Banskobystrický kraj";654;1334;131;1465;NA;267192;785;2021-12-04;138704
2021-12-03;"Banskobystrický kraj";1117;5057;246;5303;NA;267192;1363;2021-12-03;137919
2021-12-02;"Banskobystrický kraj";1710;5259;258;5517;NA;267192;1968;2021-12-02;136556
2021-12-01;"Banskobystrický kraj";947;4753;264;5017;NA;267192;1211;2021-12-01;134588
2021-11-30;"Banskobystrický kraj";1266;6543;245;6788;NA;267192;1511;2021-11-30;133377
2021-11-29;"Banskobystrický kraj";591;10653;468;11121;NA;267192;1059;2021-11-29;131866
2021-11-28;"Banskobystrický kraj";418;4289;216;4505;NA;267192;634;2021-11-28;130807
2021-11-27;"Banskobystrický kraj";827;1781;208;1989;NA;267192;1035;2021-11-27;130173
2021-11-26;"Banskobystrický kraj";963;4771;354;5125;NA;267192;1317;2021-11-26;129138
2021-11-25;"Banskobystrický kraj";1110;5911;350;6261;NA;267192;1460;2021-11-25;127821
2021-11-24;"Banskobystrický kraj";1387;5956;330;6286;NA;267192;1717;2021-11-24;126361
2021-11-23;"Banskobystrický kraj";1436;6082;377;6459;NA;267192;1813;2021-11-23;124644
2021-11-22;"Banskobystrický kraj";489;8727;579;9306;NA;267192;1068;2021-11-22;122831
2021-11-21;"Banskobystrický kraj";408;4109;307;4416;NA;267192;715;2021-11-21;121763
2021-11-20;"Banskobystrický kraj";985;1758;199;1957;NA;267192;1184;2021-11-20;121048
2021-11-19;"Banskobystrický kraj";1006;4886;470;5356;NA;267192;1476;2021-11-19;119864
2021-11-18;"Banskobystrický kraj";979;8037;620;8657;NA;267192;1599;2021-11-18;118388
2021-11-17;"Banskobystrický kraj";772;1051;147;1198;NA;267192;919;2021-11-17;116789
2021-11-16;"Banskobystrický kraj";1130;5473;453;5926;NA;267192;1583;2021-11-16;115870
2021-11-15;"Banskobystrický kraj";749;7884;588;8472;NA;267192;1337;2021-11-15;114287
2021-11-14;"Banskobystrický kraj";311;2629;302;2931;NA;267192;613;2021-11-14;112950
2021-11-13;"Banskobystrický kraj";761;1471;214;1685;NA;267192;975;2021-11-13;112337
2021-11-12;"Banskobystrický kraj";972;5019;434;5453;NA;267192;1406;2021-11-12;111362
2021-11-11;"Banskobystrický kraj";1023;5584;345;5929;NA;267192;1368;2021-11-11;109956
2021-11-10;"Banskobystrický kraj";950;4713;333;5046;NA;267192;1283;2021-11-10;108588
2021-11-09;"Banskobystrický kraj";921;4616;283;4899;NA;267192;1204;2021-11-09;107305
2021-11-08;"Banskobystrický kraj";519;7249;488;7737;NA;267192;1007;2021-11-08;106101
2021-11-07;"Banskobystrický kraj";460;2479;258;2737;NA;267192;718;2021-11-07;105094
2021-11-06;"Banskobystrický kraj";505;1344;170;1514;NA;267192;675;2021-11-06;104376
2021-11-05;"Banskobystrický kraj";997;4773;342;5115;NA;267192;1339;2021-11-05;103701
2021-11-04;"Banskobystrický kraj";1086;4811;248;5059;NA;267192;1334;2021-11-04;102362
2021-11-03;"Banskobystrický kraj";976;4825;330;5155;NA;267192;1306;2021-11-03;101028
2021-11-02;"Banskobystrický kraj";538;5709;492;6201;NA;267192;1030;2021-11-02;99722
2021-11-01;"Banskobystrický kraj";390;1178;132;1310;NA;267192;522;2021-11-01;98692
2021-10-31;"Banskobystrický kraj";150;1700;210;1910;NA;267192;360;2021-10-31;98170
2021-10-30;"Banskobystrický kraj";449;1508;140;1648;NA;267192;589;2021-10-30;97810
2021-10-29;"Banskobystrický kraj";780;4178;286;4464;NA;267192;1066;2021-10-29;97221
2021-10-28;"Banskobystrický kraj";744;4182;247;4429;NA;267192;991;2021-10-28;96155
2021-10-27;"Banskobystrický kraj";664;4577;233;4810;NA;267192;897;2021-10-27;95164
2021-10-26;"Banskobystrický kraj";700;3673;187;3860;NA;267192;887;2021-10-26;94267
2021-10-25;"Banskobystrický kraj";376;5478;257;5735;NA;267192;633;2021-10-25;93380
2021-10-24;"Banskobystrický kraj";161;1707;143;1850;NA;267192;304;2021-10-24;92747
2021-10-23;"Banskobystrický kraj";238;1286;79;1365;NA;267192;317;2021-10-23;92443
2021-10-22;"Banskobystrický kraj";530;3816;185;4001;NA;267192;715;2021-10-22;92126
2021-10-21;"Banskobystrický kraj";416;4128;140;4268;NA;267192;556;2021-10-21;91411
2021-10-20;"Banskobystrický kraj";387;3615;123;3738;NA;267192;510;2021-10-20;90855
2021-10-19;"Banskobystrický kraj";419;4094;103;4197;NA;267192;522;2021-10-19;90345
2021-10-18;"Banskobystrický kraj";162;5286;175;5461;NA;267192;337;2021-10-18;89823
2021-10-17;"Banskobystrický kraj";26;1555;71;1626;NA;267192;97;2021-10-17;89486
2021-10-16;"Banskobystrický kraj";162;1387;50;1437;NA;267192;212;2021-10-16;89389
2021-10-15;"Banskobystrický kraj";187;3693;81;3774;NA;267192;268;2021-10-15;89177
2021-10-14;"Banskobystrický kraj";198;3705;47;3752;NA;267192;245;2021-10-14;88909
2021-10-13;"Banskobystrický kraj";217;3068;55;3123;NA;267192;272;2021-10-13;88664
2021-10-12;"Banskobystrický kraj";301;3743;59;3802;NA;267192;360;2021-10-12;88392
2021-10-11;"Banskobystrický kraj";128;4734;96;4830;NA;267192;224;2021-10-11;88032
2021-10-10;"Banskobystrický kraj";26;1815;53;1868;NA;267192;79;2021-10-10;87808
2021-10-09;"Banskobystrický kraj";73;1122;27;1149;NA;267192;100;2021-10-09;87729
2021-10-08;"Banskobystrický kraj";239;3027;61;3088;NA;267192;300;2021-10-08;87629
2021-10-07;"Banskobystrický kraj";179;3437;42;3479;NA;267192;221;2021-10-07;87329
2021-10-06;"Banskobystrický kraj";136;3862;48;3910;NA;267192;184;2021-10-06;87108
2021-10-05;"Banskobystrický kraj";209;2979;54;3033;NA;267192;263;2021-10-05;86924
2021-10-04;"Banskobystrický kraj";126;3725;64;3789;NA;267192;190;2021-10-04;86661
2021-10-03;"Banskobystrický kraj";11;1407;34;1441;NA;267192;45;2021-10-03;86471
2021-10-02;"Banskobystrický kraj";66;1042;26;1068;NA;267192;92;2021-10-02;86426
2021-10-01;"Banskobystrický kraj";158;3228;51;3279;NA;267192;209;2021-10-01;86334
2021-09-30;"Banskobystrický kraj";120;3362;30;3392;NA;267192;150;2021-09-30;86125
2021-09-29;"Banskobystrický kraj";118;2626;40;2666;NA;267192;158;2021-09-29;85975
2021-09-28;"Banskobystrický kraj";112;3061;45;3106;NA;267192;157;2021-09-28;85817
2021-09-27;"Banskobystrický kraj";90;4456;72;4528;NA;267192;162;2021-09-27;85660
2021-09-26;"Banskobystrický kraj";17;1498;31;1529;NA;267192;48;2021-09-26;85498
2021-09-25;"Banskobystrický kraj";17;1481;7;1488;NA;267192;24;2021-09-25;85450
2021-09-24;"Banskobystrický kraj";98;4254;32;4286;NA;267192;130;2021-09-24;85426
2021-09-23;"Banskobystrický kraj";63;3019;13;3032;NA;267192;76;2021-09-23;85296
2021-09-22;"Banskobystrický kraj";75;2442;19;2461;NA;267192;94;2021-09-22;85220
2021-09-21;"Banskobystrický kraj";125;2976;20;2996;NA;267192;145;2021-09-21;85126
2021-09-20;"Banskobystrický kraj";45;3951;30;3981;NA;267192;75;2021-09-20;84981
2021-09-19;"Banskobystrický kraj";6;1456;24;1480;NA;267192;30;2021-09-19;84906
2021-09-18;"Banskobystrický kraj";44;1318;15;1333;NA;267192;59;2021-09-18;84876
2021-09-17;"Banskobystrický kraj";73;3485;32;3517;NA;267192;105;2021-09-17;84817
2021-09-16;"Banskobystrický kraj";95;3019;29;3048;NA;267192;124;2021-09-16;84712
2021-09-15;"Banskobystrický kraj";22;394;1;395;NA;267192;23;2021-09-15;84588
2021-09-14;"Banskobystrický kraj";95;2508;28;2536;NA;267192;123;2021-09-14;84565
2021-09-13;"Banskobystrický kraj";29;3206;28;3234;NA;267192;57;2021-09-13;84442
2021-09-12;"Banskobystrický kraj";7;958;15;973;NA;267192;22;2021-09-12;84385
2021-09-11;"Banskobystrický kraj";31;865;11;876;NA;267192;42;2021-09-11;84363
2021-09-10;"Banskobystrický kraj";59;2250;24;2274;NA;267192;83;2021-09-10;84321
2021-09-09;"Banskobystrický kraj";46;2011;17;2028;NA;267192;63;2021-09-09;84238
2021-09-08;"Banskobystrický kraj";46;1713;27;1740;NA;267192;73;2021-09-08;84175
2021-09-07;"Banskobystrický kraj";27;1422;21;1443;NA;267192;48;2021-09-07;84102
2021-09-06;"Banskobystrický kraj";26;2570;13;2583;NA;267192;39;2021-09-06;84054
2021-09-05;"Banskobystrický kraj";9;742;2;744;NA;267192;11;2021-09-05;84015
2021-09-04;"Banskobystrický kraj";14;745;10;755;NA;267192;24;2021-09-04;84004
2021-09-03;"Banskobystrický kraj";49;2116;22;2138;NA;267192;71;2021-09-03;83980
2021-09-02;"Banskobystrický kraj";19;1730;25;1755;NA;267192;44;2021-09-02;83909
2021-09-01;"Banskobystrický kraj";6;230;6;236;NA;267192;12;2021-09-01;83865
2021-08-31;"Banskobystrický kraj";18;1406;13;1419;NA;267192;31;2021-08-31;83853
2021-08-30;"Banskobystrický kraj";23;1867;10;1877;NA;267192;33;2021-08-30;83822
2021-08-29;"Banskobystrický kraj";0;351;5;356;NA;267192;5;2021-08-29;83789
2021-08-28;"Banskobystrický kraj";9;827;5;832;NA;267192;14;2021-08-28;83784
2021-08-27;"Banskobystrický kraj";7;1608;12;1620;NA;267192;19;2021-08-27;83770
2021-08-26;"Banskobystrický kraj";7;1161;2;1163;NA;267192;9;2021-08-26;83751
2021-08-25;"Banskobystrický kraj";6;1052;1;1053;NA;267192;7;2021-08-25;83742
2021-08-24;"Banskobystrický kraj";12;1117;1;1118;NA;267192;13;2021-08-24;83735
2021-08-23;"Banskobystrický kraj";7;1368;5;1373;NA;267192;12;2021-08-23;83722
2021-08-22;"Banskobystrický kraj";0;773;2;775;NA;267192;2;2021-08-22;83710
2021-08-21;"Banskobystrický kraj";3;793;1;794;NA;267192;4;2021-08-21;83708
2021-08-20;"Banskobystrický kraj";5;1616;4;1620;NA;267192;9;2021-08-20;83704
2021-08-19;"Banskobystrický kraj";4;1092;3;1095;NA;267192;7;2021-08-19;83695
2021-08-18;"Banskobystrický kraj";1;1044;1;1045;NA;267192;2;2021-08-18;83688
2021-08-17;"Banskobystrický kraj";12;890;0;890;NA;267192;12;2021-08-17;83686
2021-08-16;"Banskobystrický kraj";7;1321;3;1324;NA;267192;10;2021-08-16;83674
2021-08-15;"Banskobystrický kraj";0;366;3;369;NA;267192;3;2021-08-15;83664
2021-08-14;"Banskobystrický kraj";6;435;1;436;NA;267192;7;2021-08-14;83661
2021-08-13;"Banskobystrický kraj";11;898;0;898;NA;267192;11;2021-08-13;83654
2021-08-12;"Banskobystrický kraj";10;951;1;952;NA;267192;11;2021-08-12;83643
2021-08-11;"Banskobystrický kraj";7;575;3;578;NA;267192;10;2021-08-11;83632
2021-08-10;"Banskobystrický kraj";7;678;2;680;NA;267192;9;2021-08-10;83622
2021-08-09;"Banskobystrický kraj";9;1064;0;1064;NA;267192;9;2021-08-09;83613
2021-08-08;"Banskobystrický kraj";4;335;1;336;NA;267192;5;2021-08-08;83604
2021-08-07;"Banskobystrický kraj";0;308;4;312;NA;267192;4;2021-08-07;83599
2021-08-06;"Banskobystrický kraj";5;929;2;931;NA;267192;7;2021-08-06;83595
2021-08-05;"Banskobystrický kraj";2;838;1;839;NA;267192;3;2021-08-05;83588
2021-08-04;"Banskobystrický kraj";2;579;1;580;NA;267192;3;2021-08-04;83585
2021-08-03;"Banskobystrický kraj";4;743;0;743;NA;267192;4;2021-08-03;83582
2021-08-02;"Banskobystrický kraj";6;934;0;934;NA;267192;6;2021-08-02;83578
2021-08-01;"Banskobystrický kraj";0;271;0;271;NA;267192;0;2021-08-01;83572
2021-07-31;"Banskobystrický kraj";1;370;4;374;NA;267192;5;2021-07-31;83572
2021-07-30;"Banskobystrický kraj";27;928;2;930;NA;267192;29;2021-07-30;83567
2021-07-29;"Banskobystrický kraj";2;890;1;891;NA;267192;3;2021-07-29;83538
2021-07-28;"Banskobystrický kraj";4;520;1;521;NA;267192;5;2021-07-28;83535
2021-07-27;"Banskobystrický kraj";15;1092;0;1092;NA;267192;15;2021-07-27;83530
2021-07-26;"Banskobystrický kraj";2;911;1;912;NA;267192;3;2021-07-26;83515
2021-07-25;"Banskobystrický kraj";0;367;1;368;NA;267192;1;2021-07-25;83512
2021-07-24;"Banskobystrický kraj";2;298;0;298;NA;267192;2;2021-07-24;83511
2021-07-23;"Banskobystrický kraj";7;840;0;840;NA;267192;7;2021-07-23;83509
2021-07-22;"Banskobystrický kraj";5;727;3;730;NA;267192;8;2021-07-22;83502
2021-07-21;"Banskobystrický kraj";2;560;0;560;NA;267192;2;2021-07-21;83494
2021-07-20;"Banskobystrický kraj";6;885;2;887;NA;267192;8;2021-07-20;83492
2021-07-19;"Banskobystrický kraj";1;854;3;857;NA;267192;4;2021-07-19;83484
2021-07-18;"Banskobystrický kraj";0;377;1;378;NA;267192;1;2021-07-18;83480
2021-07-17;"Banskobystrický kraj";1;324;0;324;NA;267192;1;2021-07-17;83479
2021-07-16;"Banskobystrický kraj";3;974;1;975;NA;267192;4;2021-07-16;83478
2021-07-15;"Banskobystrický kraj";1;1038;0;1038;NA;267192;1;2021-07-15;83474
2021-07-14;"Banskobystrický kraj";3;765;0;765;NA;267192;3;2021-07-14;83473
2021-07-13;"Banskobystrický kraj";2;695;0;695;NA;267192;2;2021-07-13;83470
2021-07-12;"Banskobystrický kraj";1;1057;0;1057;NA;267192;1;2021-07-12;83468
2021-07-11;"Banskobystrický kraj";0;446;0;446;NA;267192;0;2021-07-11;83467
2021-07-10;"Banskobystrický kraj";2;368;0;368;NA;267192;2;2021-07-10;83467
2021-07-09;"Banskobystrický kraj";3;1209;0;1209;NA;267192;3;2021-07-09;83465
2021-07-08;"Banskobystrický kraj";0;1083;1;1084;NA;267192;1;2021-07-08;83462
2021-07-07;"Banskobystrický kraj";1;798;0;798;NA;267192;1;2021-07-07;83461
2021-07-06;"Banskobystrický kraj";6;1365;0;1365;NA;267192;6;2021-07-06;83460
2021-07-05;"Banskobystrický kraj";2;392;1;393;NA;267192;3;2021-07-05;83454
2021-07-04;"Banskobystrický kraj";0;318;0;318;NA;267192;0;2021-07-04;83451
2021-07-03;"Banskobystrický kraj";1;413;1;414;NA;267192;2;2021-07-03;83451
2021-07-02;"Banskobystrický kraj";3;1045;0;1045;NA;267192;3;2021-07-02;83449
2021-07-01;"Banskobystrický kraj";0;705;1;706;NA;267192;1;2021-07-01;83446
2021-06-30;"Banskobystrický kraj";3;7607;1;7608;NA;267192;4;2021-06-30;83445
2021-06-29;"Banskobystrický kraj";2;4642;1;4643;NA;267192;3;2021-06-29;83441
2021-06-28;"Banskobystrický kraj";3;5695;1;5696;NA;267192;4;2021-06-28;83438
2021-06-27;"Banskobystrický kraj";0;4369;5;4374;NA;267192;5;2021-06-27;83434
2021-06-26;"Banskobystrický kraj";0;4289;4;4293;NA;267192;4;2021-06-26;83429
2021-06-25;"Banskobystrický kraj";2;6717;2;6719;NA;267192;4;2021-06-25;83425
2021-06-24;"Banskobystrický kraj";6;4585;2;4587;NA;267192;8;2021-06-24;83421
2021-06-23;"Banskobystrický kraj";4;4947;0;4947;NA;267192;4;2021-06-23;83413
2021-06-22;"Banskobystrický kraj";7;4527;0;4527;NA;267192;7;2021-06-22;83409
2021-06-21;"Banskobystrický kraj";6;5836;8;5844;NA;267192;14;2021-06-21;83402
2021-06-20;"Banskobystrický kraj";0;5055;7;5062;NA;267192;7;2021-06-20;83388
2021-06-19;"Banskobystrický kraj";0;5639;4;5643;NA;267192;4;2021-06-19;83381
2021-06-18;"Banskobystrický kraj";4;7642;1;7643;NA;267192;5;2021-06-18;83377
2021-06-17;"Banskobystrický kraj";2;5245;3;5248;NA;267192;5;2021-06-17;83372
2021-06-16;"Banskobystrický kraj";10;5951;5;5956;NA;267192;15;2021-06-16;83367
2021-06-15;"Banskobystrický kraj";9;5576;6;5582;NA;267192;15;2021-06-15;83352
2021-06-14;"Banskobystrický kraj";8;6922;7;6929;NA;267192;15;2021-06-14;83337
2021-06-13;"Banskobystrický kraj";0;6407;7;6414;NA;267192;7;2021-06-13;83322
2021-06-12;"Banskobystrický kraj";3;6338;6;6344;NA;267192;9;2021-06-12;83315
2021-06-11;"Banskobystrický kraj";5;9693;15;9708;NA;267192;20;2021-06-11;83306
2021-06-10;"Banskobystrický kraj";10;5726;8;5734;NA;267192;18;2021-06-10;83286
2021-06-09;"Banskobystrický kraj";9;5720;4;5724;NA;267192;13;2021-06-09;83268
2021-06-08;"Banskobystrický kraj";15;5645;10;5655;NA;267192;25;2021-06-08;83255
2021-06-07;"Banskobystrický kraj";4;7582;21;7603;NA;267192;25;2021-06-07;83230
2021-06-06;"Banskobystrický kraj";1;7497;12;7509;NA;267192;13;2021-06-06;83205
2021-06-05;"Banskobystrický kraj";15;7531;9;7540;NA;267192;24;2021-06-05;83192
2021-06-04;"Banskobystrický kraj";2;9352;14;9366;NA;267192;16;2021-06-04;83168
2021-06-03;"Banskobystrický kraj";8;6507;24;6531;NA;267192;32;2021-06-03;83152
2021-06-02;"Banskobystrický kraj";7;6837;6;6843;NA;267192;13;2021-06-02;83120
2021-06-01;"Banskobystrický kraj";12;7146;14;7160;NA;267192;26;2021-06-01;83107
2021-05-31;"Banskobystrický kraj";4;9546;31;9577;NA;267192;35;2021-05-31;83081
2021-05-30;"Banskobystrický kraj";3;8959;19;8978;NA;267192;22;2021-05-30;83046
2021-05-29;"Banskobystrický kraj";11;9763;18;9781;NA;267192;29;2021-05-29;83024
2021-05-28;"Banskobystrický kraj";13;11905;27;11932;NA;267192;40;2021-05-28;82995
2021-05-27;"Banskobystrický kraj";7;8760;12;8772;NA;267192;19;2021-05-27;82955
2021-05-26;"Banskobystrický kraj";18;7905;17;7922;NA;267192;35;2021-05-26;82936
2021-05-25;"Banskobystrický kraj";27;8951;30;8981;NA;267192;57;2021-05-25;82901
2021-05-24;"Banskobystrický kraj";9;12469;44;12513;NA;267192;53;2021-05-24;82844
2021-05-23;"Banskobystrický kraj";0;9798;27;9825;NA;267192;27;2021-05-23;82791
2021-05-22;"Banskobystrický kraj";20;9608;26;9634;NA;267192;46;2021-05-22;82764
2021-05-21;"Banskobystrický kraj";22;12796;25;12821;NA;267192;47;2021-05-21;82718
2021-05-20;"Banskobystrický kraj";14;8994;25;9019;NA;267192;39;2021-05-20;82671
2021-05-19;"Banskobystrický kraj";42;8608;21;8629;NA;267192;63;2021-05-19;82632
2021-05-18;"Banskobystrický kraj";27;9450;25;9475;NA;267192;52;2021-05-18;82569
2021-05-17;"Banskobystrický kraj";11;13399;33;13432;NA;267192;44;2021-05-17;82517
2021-05-16;"Banskobystrický kraj";15;14072;26;14098;NA;267192;41;2021-05-16;82473
2021-05-15;"Banskobystrický kraj";11;15356;29;15385;NA;267192;40;2021-05-15;82432
2021-05-14;"Banskobystrický kraj";35;18939;45;18984;NA;267192;80;2021-05-14;82392
2021-05-13;"Banskobystrický kraj";37;10605;40;10645;NA;267192;77;2021-05-13;82312
2021-05-12;"Banskobystrický kraj";31;10857;45;10902;NA;267192;76;2021-05-12;82235
2021-05-11;"Banskobystrický kraj";42;11325;48;11373;NA;267192;90;2021-05-11;82159
2021-05-10;"Banskobystrický kraj";28;17621;68;17689;NA;267192;96;2021-05-10;82069
2021-05-09;"Banskobystrický kraj";25;21902;68;21970;NA;267192;93;2021-05-09;81973
2021-05-08;"Banskobystrický kraj";11;14285;26;14311;NA;267192;37;2021-05-08;81880
2021-05-07;"Banskobystrický kraj";41;21806;78;21884;NA;267192;119;2021-05-07;81843
2021-05-06;"Banskobystrický kraj";36;12251;70;12321;NA;267192;106;2021-05-06;81724
2021-05-05;"Banskobystrický kraj";34;12592;63;12655;NA;267192;97;2021-05-05;81618
2021-05-04;"Banskobystrický kraj";83;13888;47;13935;NA;267192;130;2021-05-04;81521
2021-05-03;"Banskobystrický kraj";30;20872;80;20952;NA;267192;110;2021-05-03;81391
2021-05-02;"Banskobystrický kraj";6;33040;60;33100;NA;267192;66;2021-05-02;81281
2021-05-01;"Banskobystrický kraj";54;36900;67;36967;NA;267192;121;2021-05-01;81215
2021-04-30;"Banskobystrický kraj";38;34957;86;35043;NA;267192;124;2021-04-30;81094
2021-04-29;"Banskobystrický kraj";55;16839;68;16907;NA;267192;123;2021-04-29;80970
2021-04-28;"Banskobystrický kraj";66;17959;67;18026;NA;267192;133;2021-04-28;80847
2021-04-27;"Banskobystrický kraj";70;19152;73;19225;NA;267192;143;2021-04-27;80714
2021-04-26;"Banskobystrický kraj";34;28517;101;28618;NA;267192;135;2021-04-26;80571
2021-04-25;"Banskobystrický kraj";14;40601;106;40707;NA;267192;120;2021-04-25;80436
2021-04-24;"Banskobystrický kraj";40;51944;98;52042;NA;267192;138;2021-04-24;80316
2021-04-23;"Banskobystrický kraj";78;37922;88;38010;NA;267192;166;2021-04-23;80178
2021-04-22;"Banskobystrický kraj";51;17415;57;17472;NA;267192;108;2021-04-22;80012
2021-04-21;"Banskobystrický kraj";76;19218;94;19312;NA;267192;170;2021-04-21;79904
2021-04-20;"Banskobystrický kraj";116;21234;98;21332;NA;267192;214;2021-04-20;79734
2021-04-19;"Banskobystrický kraj";48;31408;105;31513;NA;267192;153;2021-04-19;79520
2021-04-18;"Banskobystrický kraj";16;43375;90;43465;NA;267192;106;2021-04-18;79367
2021-04-17;"Banskobystrický kraj";42;64939;92;65031;NA;267192;134;2021-04-17;79261
2021-04-16;"Banskobystrický kraj";72;37307;100;37407;NA;267192;172;2021-04-16;79127
2021-04-15;"Banskobystrický kraj";67;20127;83;20210;NA;267192;150;2021-04-15;78955
2021-04-14;"Banskobystrický kraj";69;21260;86;21346;NA;267192;155;2021-04-14;78805
2021-04-13;"Banskobystrický kraj";130;23076;77;23153;NA;267192;207;2021-04-13;78650
2021-04-12;"Banskobystrický kraj";60;32272;130;32402;NA;267192;190;2021-04-12;78443
2021-04-11;"Banskobystrický kraj";0;41367;88;41455;NA;267192;88;2021-04-11;78253
2021-04-10;"Banskobystrický kraj";56;64728;141;64869;NA;267192;197;2021-04-10;78165
2021-04-09;"Banskobystrický kraj";106;31570;118;31688;NA;267192;224;2021-04-09;77968
2021-04-08;"Banskobystrický kraj";132;19000;148;19148;NA;267192;280;2021-04-08;77744
2021-04-07;"Banskobystrický kraj";226;25121;94;25215;NA;267192;320;2021-04-07;77464
2021-04-06;"Banskobystrický kraj";93;42496;187;42683;NA;267192;280;2021-04-06;77144
2021-04-05;"Banskobystrický kraj";15;11797;87;11884;NA;267192;102;2021-04-05;76864
2021-04-04;"Banskobystrický kraj";24;19683;79;19762;NA;267192;103;2021-04-04;76762
2021-04-03;"Banskobystrický kraj";5;72553;211;72764;NA;267192;216;2021-04-03;76659
2021-04-02;"Banskobystrický kraj";71;13455;66;13521;NA;267192;137;2021-04-02;76443
2021-04-01;"Banskobystrický kraj";171;39407;200;39607;NA;267192;371;2021-04-01;76306
2021-03-31;"Banskobystrický kraj";147;25543;161;25704;NA;267192;308;2021-03-31;75935
2021-03-30;"Banskobystrický kraj";167;21442;159;21601;NA;267192;326;2021-03-30;75627
2021-03-29;"Banskobystrický kraj";119;29492;218;29710;NA;267192;337;2021-03-29;75301
2021-03-28;"Banskobystrický kraj";25;40610;189;40799;NA;267192;214;2021-03-28;74964
2021-03-27;"Banskobystrický kraj";85;63414;260;63674;NA;267192;345;2021-03-27;74750
2021-03-26;"Banskobystrický kraj";122;43671;240;43911;NA;267192;362;2021-03-26;74405
2021-03-25;"Banskobystrický kraj";120;21598;240;21838;NA;267192;360;2021-03-25;74043
2021-03-24;"Banskobystrický kraj";200;19337;227;19564;NA;267192;427;2021-03-24;73683
2021-03-23;"Banskobystrický kraj";241;21541;257;21798;NA;267192;498;2021-03-23;73256
2021-03-22;"Banskobystrický kraj";65;30480;274;30754;NA;267192;339;2021-03-22;72758
2021-03-21;"Banskobystrický kraj";31;40039;280;40319;NA;267192;311;2021-03-21;72419
2021-03-20;"Banskobystrický kraj";119;67926;383;68309;NA;267192;502;2021-03-20;72108
2021-03-19;"Banskobystrický kraj";240;44038;306;44344;NA;267192;546;2021-03-19;71606
2021-03-18;"Banskobystrický kraj";160;22469;273;22742;NA;267192;433;2021-03-18;71060
2021-03-17;"Banskobystrický kraj";262;21573;245;21818;NA;267192;507;2021-03-17;70627
2021-03-16;"Banskobystrický kraj";340;23349;224;23573;NA;267192;564;2021-03-16;70120
2021-03-15;"Banskobystrický kraj";95;32306;366;32672;NA;267192;461;2021-03-15;69556
2021-03-14;"Banskobystrický kraj";39;39212;218;39430;NA;267192;257;2021-03-14;69095
2021-03-13;"Banskobystrický kraj";209;67463;395;67858;NA;267192;604;2021-03-13;68838
2021-03-12;"Banskobystrický kraj";206;41444;330;41774;NA;267192;536;2021-03-12;68234
2021-03-11;"Banskobystrický kraj";228;21338;274;21612;NA;267192;502;2021-03-11;67698
2021-03-10;"Banskobystrický kraj";260;20408;241;20649;NA;267192;501;2021-03-10;67196
2021-03-09;"Banskobystrický kraj";352;21790;284;22074;NA;267192;636;2021-03-09;66695
2021-03-08;"Banskobystrický kraj";191;31471;427;31898;NA;267192;618;2021-03-08;66059
2021-03-07;"Banskobystrický kraj";60;39191;295;39486;NA;267192;355;2021-03-07;65441
2021-03-06;"Banskobystrický kraj";164;70897;410;71307;NA;267192;574;2021-03-06;65086
2021-03-05;"Banskobystrický kraj";221;42336;389;42725;NA;267192;610;2021-03-05;64512
2021-03-04;"Banskobystrický kraj";226;22009;334;22343;NA;267192;560;2021-03-04;63902
2021-03-03;"Banskobystrický kraj";317;21949;331;22280;NA;267192;648;2021-03-03;63342
2021-03-02;"Banskobystrický kraj";291;23160;354;23514;NA;267192;645;2021-03-02;62694
2021-03-01;"Banskobystrický kraj";151;31773;434;32207;NA;267192;585;2021-03-01;62049
2021-02-28;"Banskobystrický kraj";45;38665;336;39001;NA;267192;381;2021-02-28;61464
2021-02-27;"Banskobystrický kraj";289;66667;529;67196;NA;267192;818;2021-02-27;61083
2021-02-26;"Banskobystrický kraj";326;39674;468;40142;NA;267192;794;2021-02-26;60265
2021-02-25;"Banskobystrický kraj";375;18081;366;18447;NA;267192;741;2021-02-25;59471
2021-02-24;"Banskobystrický kraj";332;16735;373;17108;NA;267192;705;2021-02-24;58730
2021-02-23;"Banskobystrický kraj";462;19932;439;20371;NA;267192;901;2021-02-23;58025
2021-02-22;"Banskobystrický kraj";67;28643;598;29241;NA;267192;665;2021-02-22;57124
2021-02-21;"Banskobystrický kraj";68;37619;444;38063;NA;267192;512;2021-02-21;56459
2021-02-20;"Banskobystrický kraj";280;68851;598;69449;NA;267192;878;2021-02-20;55947
2021-02-19;"Banskobystrický kraj";420;39888;511;40399;NA;267192;931;2021-02-19;55069
2021-02-18;"Banskobystrický kraj";241;18618;396;19014;NA;267192;637;2021-02-18;54138
2021-02-17;"Banskobystrický kraj";415;16740;389;17129;NA;267192;804;2021-02-17;53501
2021-02-16;"Banskobystrický kraj";338;19731;368;20099;NA;267192;706;2021-02-16;52697
2021-02-15;"Banskobystrický kraj";118;35835;591;36426;NA;267192;709;2021-02-15;51991
2021-02-14;"Banskobystrický kraj";60;31894;386;32280;NA;267192;446;2021-02-14;51282
2021-02-13;"Banskobystrický kraj";202;53889;492;54381;NA;267192;694;2021-02-13;50836
2021-02-12;"Banskobystrický kraj";312;37270;533;37803;NA;267192;845;2021-02-12;50142
2021-02-11;"Banskobystrický kraj";305;21196;386;21582;NA;267192;691;2021-02-11;49297
2021-02-10;"Banskobystrický kraj";333;14790;344;15134;NA;267192;677;2021-02-10;48606
2021-02-09;"Banskobystrický kraj";329;18504;362;18866;NA;267192;691;2021-02-09;47929
2021-02-08;"Banskobystrický kraj";103;49716;695;50411;NA;267192;798;2021-02-08;47238
2021-02-07;"Banskobystrický kraj";70;37659;335;37994;NA;267192;405;2021-02-07;46440
2021-02-06;"Banskobystrický kraj";178;69388;570;69958;NA;267192;748;2021-02-06;46035
2021-02-05;"Banskobystrický kraj";282;24577;363;24940;NA;267192;645;2021-02-05;45287
2021-02-04;"Banskobystrický kraj";240;14367;430;14797;NA;267192;670;2021-02-04;44642
2021-02-03;"Banskobystrický kraj";350;9459;255;9714;NA;267192;605;2021-02-03;43972
2021-02-02;"Banskobystrický kraj";277;15741;334;16075;NA;267192;611;2021-02-02;43367
2021-02-01;"Banskobystrický kraj";75;24346;489;24835;NA;267192;564;2021-02-01;42756
2021-01-31;"Banskobystrický kraj";34;19983;201;20184;NA;267192;235;2021-01-31;42192
2021-01-30;"Banskobystrický kraj";163;63896;525;64421;NA;267192;688;2021-01-30;41957
2021-01-29;"Banskobystrický kraj";196;17368;274;17642;NA;267192;470;2021-01-29;41269
2021-01-28;"Banskobystrický kraj";218;15613;382;15995;NA;267192;600;2021-01-28;40799
2021-01-27;"Banskobystrický kraj";191;8132;200;8332;NA;267192;391;2021-01-27;40199
2021-01-26;"Banskobystrický kraj";238;19795;283;20078;NA;267192;521;2021-01-26;39808
2021-01-25;"Banskobystrický kraj";82;33666;412;34078;NA;267192;494;2021-01-25;39287
2021-01-24;"Banskobystrický kraj";38;35587;278;35865;NA;267192;316;2021-01-24;38793
2021-01-23;"Banskobystrický kraj";142;89058;523;89581;NA;267192;665;2021-01-23;38477
2021-01-22;"Banskobystrický kraj";175;25887;355;26242;NA;267192;530;2021-01-22;37812
2021-01-21;"Banskobystrický kraj";194;17063;279;17342;NA;267192;473;2021-01-21;37282
2021-01-20;"Banskobystrický kraj";231;9142;186;9328;NA;267192;417;2021-01-20;36809
2021-01-19;"Banskobystrický kraj";213;10708;311;11019;NA;267192;524;2021-01-19;36392
2021-01-18;"Banskobystrický kraj";94;7402;401;7803;NA;267192;495;2021-01-18;35868
2021-01-17;"Banskobystrický kraj";110;8154;77;8231;NA;267192;187;2021-01-17;35373
2021-01-16;"Banskobystrický kraj";58;2274;57;2331;NA;267192;115;2021-01-16;35186
2021-01-15;"Banskobystrický kraj";164;7673;217;7890;NA;267192;381;2021-01-15;35071
2021-01-14;"Banskobystrický kraj";220;5760;325;6085;NA;267192;545;2021-01-14;34690
2021-01-13;"Banskobystrický kraj";235;5974;217;6191;NA;267192;452;2021-01-13;34145
2021-01-12;"Banskobystrický kraj";194;6600;290;6890;NA;267192;484;2021-01-12;33693
2021-01-11;"Banskobystrický kraj";76;8231;481;8712;NA;267192;557;2021-01-11;33209
2021-01-10;"Banskobystrický kraj";110;433;4;437;NA;267192;114;2021-01-10;32652
2021-01-09;"Banskobystrický kraj";297;2378;81;2459;NA;267192;378;2021-01-09;32538
2021-01-08;"Banskobystrický kraj";435;9805;443;10248;NA;267192;878;2021-01-08;32160
2021-01-07;"Banskobystrický kraj";127;6322;366;6688;NA;267192;493;2021-01-07;31282
2021-01-06;"Banskobystrický kraj";305;3374;185;3559;NA;267192;490;2021-01-06;30789
2021-01-05;"Banskobystrický kraj";372;7349;533;7882;NA;267192;905;2021-01-05;30299
2021-01-04;"Banskobystrický kraj";130;7087;700;7787;NA;267192;830;2021-01-04;29394
2021-01-03;"Banskobystrický kraj";199;320;19;339;NA;267192;218;2021-01-03;28564
2021-01-02;"Banskobystrický kraj";123;702;85;787;NA;267192;208;2021-01-02;28346
2021-01-01;"Banskobystrický kraj";220;1958;132;2090;NA;267192;352;2021-01-01;28138
2020-12-31;"Banskobystrický kraj";499;7679;633;8312;NA;267192;1132;2020-12-31;27786
2020-12-30;"Banskobystrický kraj";593;7407;541;7948;NA;267192;1134;2020-12-30;26654
2020-12-29;"Banskobystrický kraj";240;7876;660;8536;NA;267192;900;2020-12-29;25520
2020-12-28;"Banskobystrický kraj";131;6120;720;6840;NA;267192;851;2020-12-28;24620
2020-12-27;"Banskobystrický kraj";116;541;25;566;NA;267192;141;2020-12-27;23769
2020-12-26;"Banskobystrický kraj";61;295;35;330;NA;267192;96;2020-12-26;23628
2020-12-25;"Banskobystrický kraj";65;888;10;898;NA;267192;75;2020-12-25;23532
2020-12-24;"Banskobystrický kraj";452;3685;135;3820;NA;267192;587;2020-12-24;23457
2020-12-23;"Banskobystrický kraj";368;9892;473;10365;NA;267192;841;2020-12-23;22870
2020-12-22;"Banskobystrický kraj";307;8468;619;9087;NA;267192;926;2020-12-22;22029
2020-12-21;"Banskobystrický kraj";286;4922;455;5377;NA;267192;741;2020-12-21;21103
2020-12-20;"Banskobystrický kraj";155;250;14;264;NA;267192;169;2020-12-20;20362
2020-12-19;"Banskobystrický kraj";170;3084;138;3222;NA;267192;308;2020-12-19;20193
2020-12-18;"Banskobystrický kraj";432;5959;331;6290;NA;267192;763;2020-12-18;19885
2020-12-17;"Banskobystrický kraj";468;8753;653;9406;NA;267192;1121;2020-12-17;19122
2020-12-16;"Banskobystrický kraj";379;10184;567;10751;NA;267192;946;2020-12-16;18001
2020-12-15;"Banskobystrický kraj";336;5281;425;5706;NA;267192;761;2020-12-15;17055
2020-12-14;"Banskobystrický kraj";148;4012;259;4271;NA;267192;407;2020-12-14;16294
2020-12-13;"Banskobystrický kraj";122;142;1;143;NA;267192;123;2020-12-13;15887
2020-12-12;"Banskobystrický kraj";137;2714;138;2852;NA;267192;275;2020-12-12;15764
2020-12-11;"Banskobystrický kraj";468;6633;362;6995;NA;267192;830;2020-12-11;15489
2020-12-10;"Banskobystrický kraj";280;5501;369;5870;NA;267192;649;2020-12-10;14659
2020-12-09;"Banskobystrický kraj";323;3941;205;4146;NA;267192;528;2020-12-09;14010
2020-12-08;"Banskobystrický kraj";256;3782;272;4054;NA;267192;528;2020-12-08;13482
2020-12-07;"Banskobystrický kraj";175;2633;177;2810;NA;267192;352;2020-12-07;12954
2020-12-06;"Banskobystrický kraj";121;507;11;518;NA;267192;132;2020-12-06;12602
2020-12-05;"Banskobystrický kraj";109;1099;34;1133;NA;267192;143;2020-12-05;12470
2020-12-04;"Banskobystrický kraj";339;3828;174;4002;NA;267192;513;2020-12-04;12327
2020-12-03;"Banskobystrický kraj";240;3193;234;3427;NA;267192;474;2020-12-03;11814
2020-12-02;"Banskobystrický kraj";217;4442;186;4628;NA;267192;403;2020-12-02;11340
2020-12-01;"Banskobystrický kraj";215;2702;134;2836;NA;267192;349;2020-12-01;10937
2020-11-30;"Banskobystrický kraj";74;4314;241;4555;NA;267192;315;2020-11-30;10588
2020-11-29;"Banskobystrický kraj";19;208;7;215;NA;267192;26;2020-11-29;10273
2020-11-28;"Banskobystrický kraj";81;1408;55;1463;NA;267192;136;2020-11-28;10247
2020-11-27;"Banskobystrický kraj";219;2566;123;2689;NA;267192;342;2020-11-27;10111
2020-11-26;"Banskobystrický kraj";208;2124;93;2217;NA;267192;301;2020-11-26;9769
2020-11-25;"Banskobystrický kraj";170;1952;86;2038;NA;267192;256;2020-11-25;9468
2020-11-24;"Banskobystrický kraj";166;2566;69;2635;NA;267192;235;2020-11-24;9212
2020-11-23;"Banskobystrický kraj";66;10147;193;10340;NA;267192;259;2020-11-23;8977
2020-11-22;"Banskobystrický kraj";38;104;1;105;NA;267192;39;2020-11-22;8718
2020-11-21;"Banskobystrický kraj";52;904;14;918;NA;267192;66;2020-11-21;8679
2020-11-20;"Banskobystrický kraj";127;2005;107;2112;NA;267192;234;2020-11-20;8613
2020-11-19;"Banskobystrický kraj";170;1218;82;1300;NA;267192;252;2020-11-19;8379
2020-11-18;"Banskobystrický kraj";153;698;65;763;NA;267192;218;2020-11-18;8127
2020-11-17;"Banskobystrický kraj";52;578;35;613;NA;267192;87;2020-11-17;7909
2020-11-16;"Banskobystrický kraj";106;470;25;495;NA;267192;131;2020-11-16;7822
2020-11-15;"Banskobystrický kraj";52;301;4;305;NA;267192;56;2020-11-15;7691
2020-11-14;"Banskobystrický kraj";73;305;2;307;NA;267192;75;2020-11-14;7635
2020-11-13;"Banskobystrický kraj";157;552;11;563;NA;267192;168;2020-11-13;7560
2020-11-12;"Banskobystrický kraj";218;952;44;996;NA;267192;262;2020-11-12;7392
2020-11-11;"Banskobystrický kraj";224;437;9;446;NA;267192;233;2020-11-11;7130
2020-11-10;"Banskobystrický kraj";263;463;18;481;NA;267192;281;2020-11-10;6897
2020-11-09;"Banskobystrický kraj";80;2678;31;2709;NA;267192;111;2020-11-09;6616
2020-11-08;"Banskobystrický kraj";82;981;16;997;NA;267192;98;2020-11-08;6505
2020-11-07;"Banskobystrický kraj";164;8828;94;8922;NA;267192;258;2020-11-07;6407
2020-11-06;"Banskobystrický kraj";227;2496;16;2512;NA;267192;243;2020-11-06;6149
2020-11-05;"Banskobystrický kraj";240;290;33;323;NA;267192;273;2020-11-05;5906
2020-11-04;"Banskobystrický kraj";254;1366;13;1379;NA;267192;267;2020-11-04;5633
2020-11-03;"Banskobystrický kraj";246;1332;4;1336;NA;267192;250;2020-11-03;5366
2020-11-02;"Banskobystrický kraj";90;2909;65;2974;NA;267192;155;2020-11-02;5116
2020-11-01;"Banskobystrický kraj";29;2671;42;2713;NA;267192;71;2020-11-01;4961
2022-04-03;"Bratislavský kraj";589;708;65;773;238291;329193;654;2022-04-03;329193
2022-04-02;"Bratislavský kraj";863;790;67;857;NA;329193;930;2022-04-02;328539
2022-04-01;"Bratislavský kraj";1381;1838;121;1959;NA;329193;1502;2022-04-01;327609
2022-03-31;"Bratislavský kraj";1305;2685;150;2835;NA;329193;1455;2022-03-31;326107
2022-03-30;"Bratislavský kraj";1516;2102;154;2256;NA;329193;1670;2022-03-30;324652
2022-03-29;"Bratislavský kraj";1327;2536;215;2751;NA;329193;1542;2022-03-29;322982
2022-03-28;"Bratislavský kraj";1275;4142;260;4402;NA;329193;1535;2022-03-28;321440
2022-03-27;"Bratislavský kraj";962;1215;146;1361;NA;329193;1108;2022-03-27;319905
2022-03-26;"Bratislavský kraj";1391;1166;104;1270;NA;329193;1495;2022-03-26;318797
2022-03-25;"Bratislavský kraj";1793;2509;170;2679;NA;329193;1963;2022-03-25;317302
2022-03-24;"Bratislavský kraj";1708;2833;194;3027;NA;329193;1902;2022-03-24;315339
2022-03-23;"Bratislavský kraj";2093;2812;192;3004;NA;329193;2285;2022-03-23;313437
2022-03-22;"Bratislavský kraj";1857;2864;229;3093;NA;329193;2086;2022-03-22;311152
2022-03-21;"Bratislavský kraj";1469;4326;371;4697;NA;329193;1840;2022-03-21;309066
2022-03-20;"Bratislavský kraj";935;1344;175;1519;NA;329193;1110;2022-03-20;307226
2022-03-19;"Bratislavský kraj";1672;1481;136;1617;NA;329193;1808;2022-03-19;306116
2022-03-18;"Bratislavský kraj";1977;2930;208;3138;NA;329193;2185;2022-03-18;304308
2022-03-17;"Bratislavský kraj";2024;3477;245;3722;NA;329193;2269;2022-03-17;302123
2022-03-16;"Bratislavský kraj";1895;2748;257;3005;NA;329193;2152;2022-03-16;299854
2022-03-15;"Bratislavský kraj";1982;3779;338;4117;NA;329193;2320;2022-03-15;297702
2022-03-14;"Bratislavský kraj";1557;4095;342;4437;NA;329193;1899;2022-03-14;295382
2022-03-13;"Bratislavský kraj";738;1311;161;1472;NA;329193;899;2022-03-13;293483
2022-03-12;"Bratislavský kraj";1632;1250;110;1360;NA;329193;1742;2022-03-12;292584
2022-03-11;"Bratislavský kraj";1184;3141;316;3457;NA;329193;1500;2022-03-11;290842
2022-03-10;"Bratislavský kraj";1706;3576;347;3923;NA;329193;2053;2022-03-10;289342
2022-03-09;"Bratislavský kraj";1723;2810;276;3086;NA;329193;1999;2022-03-09;287289
2022-03-08;"Bratislavský kraj";1925;3821;342;4163;NA;329193;2267;2022-03-08;285290
2022-03-07;"Bratislavský kraj";1451;4273;478;4751;NA;329193;1929;2022-03-07;283023
2022-03-06;"Bratislavský kraj";850;1541;213;1754;NA;329193;1063;2022-03-06;281094
2022-03-05;"Bratislavský kraj";1203;1331;178;1509;NA;329193;1381;2022-03-05;280031
2022-03-04;"Bratislavský kraj";1443;2994;307;3301;NA;329193;1750;2022-03-04;278650
2022-03-03;"Bratislavský kraj";1599;3281;328;3609;NA;329193;1927;2022-03-03;276900
2022-03-02;"Bratislavský kraj";1677;2536;309;2845;NA;329193;1986;2022-03-02;274973
2022-03-01;"Bratislavský kraj";1560;3651;341;3992;NA;329193;1901;2022-03-01;272987
2022-02-28;"Bratislavský kraj";1593;4052;472;4524;NA;329193;2065;2022-02-28;271086
2022-02-27;"Bratislavský kraj";1156;1746;227;1973;NA;329193;1383;2022-02-27;269021
2022-02-26;"Bratislavský kraj";1228;1749;209;1958;NA;329193;1437;2022-02-26;267638
2022-02-25;"Bratislavský kraj";1692;3604;323;3927;NA;329193;2015;2022-02-25;266201
2022-02-24;"Bratislavský kraj";1760;3992;324;4316;NA;329193;2084;2022-02-24;264186
2022-02-23;"Bratislavský kraj";2105;3450;393;3843;NA;329193;2498;2022-02-23;262102
2022-02-22;"Bratislavský kraj";2951;4213;384;4597;NA;329193;3335;2022-02-22;259604
2022-02-21;"Bratislavský kraj";781;5116;517;5633;NA;329193;1298;2022-02-21;256269
2022-02-20;"Bratislavský kraj";1314;2005;294;2299;NA;329193;1608;2022-02-20;254971
2022-02-19;"Bratislavský kraj";1510;1929;235;2164;NA;329193;1745;2022-02-19;253363
2022-02-18;"Bratislavský kraj";2315;3835;378;4213;NA;329193;2693;2022-02-18;251618
2022-02-17;"Bratislavský kraj";2279;4412;416;4828;NA;329193;2695;2022-02-17;248925
2022-02-16;"Bratislavský kraj";2137;3749;419;4168;NA;329193;2556;2022-02-16;246230
2022-02-15;"Bratislavský kraj";2276;4894;475;5369;NA;329193;2751;2022-02-15;243674
2022-02-14;"Bratislavský kraj";2700;6170;601;6771;NA;329193;3301;2022-02-14;240923
2022-02-13;"Bratislavský kraj";1343;2248;395;2643;NA;329193;1738;2022-02-13;237622
2022-02-12;"Bratislavský kraj";1872;2273;336;2609;NA;329193;2208;2022-02-12;235884
2022-02-11;"Bratislavský kraj";2431;5054;419;5473;NA;329193;2850;2022-02-11;233676
2022-02-10;"Bratislavský kraj";2595;4563;427;4990;NA;329193;3022;2022-02-10;230826
2022-02-09;"Bratislavský kraj";2414;4706;477;5183;NA;329193;2891;2022-02-09;227804
2022-02-08;"Bratislavský kraj";2878;5134;512;5646;NA;329193;3390;2022-02-08;224913
2022-02-07;"Bratislavský kraj";2636;6970;668;7638;NA;329193;3304;2022-02-07;221523
2022-02-06;"Bratislavský kraj";1680;3005;382;3387;NA;329193;2062;2022-02-06;218219
2022-02-05;"Bratislavský kraj";2156;2456;315;2771;NA;329193;2471;2022-02-05;216157
2022-02-04;"Bratislavský kraj";2586;4679;408;5087;NA;329193;2994;2022-02-04;213686
2022-02-03;"Bratislavský kraj";2540;6005;435;6440;NA;329193;2975;2022-02-03;210692
2022-02-02;"Bratislavský kraj";2655;5035;465;5500;NA;329193;3120;2022-02-02;207717
2022-02-01;"Bratislavský kraj";2758;6001;469;6470;NA;329193;3227;2022-02-01;204597
2022-01-31;"Bratislavský kraj";2172;8357;712;9069;NA;329193;2884;2022-01-31;201370
2022-01-30;"Bratislavský kraj";1418;3314;362;3676;NA;329193;1780;2022-01-30;198486
2022-01-29;"Bratislavský kraj";1762;3138;326;3464;NA;329193;2088;2022-01-29;196706
2022-01-28;"Bratislavský kraj";2237;5047;389;5436;NA;329193;2626;2022-01-28;194618
2022-01-27;"Bratislavský kraj";2014;5975;334;6309;NA;329193;2348;2022-01-27;191992
2022-01-26;"Bratislavský kraj";1792;4895;367;5262;NA;329193;2159;2022-01-26;189644
2022-01-25;"Bratislavský kraj";1933;5551;385;5936;NA;329193;2318;2022-01-25;187485
2022-01-24;"Bratislavský kraj";1173;7911;315;8226;NA;329193;1488;2022-01-24;185167
2022-01-23;"Bratislavský kraj";862;3289;151;3440;NA;329193;1013;2022-01-23;183679
2022-01-22;"Bratislavský kraj";1130;2802;125;2927;NA;329193;1255;2022-01-22;182666
2022-01-21;"Bratislavský kraj";1057;4656;166;4822;NA;329193;1223;2022-01-21;181411
2022-01-20;"Bratislavský kraj";940;4893;146;5039;NA;329193;1086;2022-01-20;180188
2022-01-19;"Bratislavský kraj";857;4618;169;4787;NA;329193;1026;2022-01-19;179102
2022-01-18;"Bratislavský kraj";794;5002;163;5165;NA;329193;957;2022-01-18;178076
2022-01-17;"Bratislavský kraj";534;7242;150;7392;NA;329193;684;2022-01-17;177119
2022-01-16;"Bratislavský kraj";300;2854;77;2931;NA;329193;377;2022-01-16;176435
2022-01-15;"Bratislavský kraj";543;2139;71;2210;NA;329193;614;2022-01-15;176058
2022-01-14;"Bratislavský kraj";356;3692;70;3762;NA;329193;426;2022-01-14;175444
2022-01-13;"Bratislavský kraj";382;4579;82;4661;NA;329193;464;2022-01-13;175018
2022-01-12;"Bratislavský kraj";415;4014;71;4085;NA;329193;486;2022-01-12;174554
2022-01-11;"Bratislavský kraj";407;4910;110;5020;NA;329193;517;2022-01-11;174068
2022-01-10;"Bratislavský kraj";413;6380;101;6481;NA;329193;514;2022-01-10;173551
2022-01-09;"Bratislavský kraj";187;3080;71;3151;NA;329193;258;2022-01-09;173037
2022-01-08;"Bratislavský kraj";323;1951;58;2009;NA;329193;381;2022-01-08;172779
2022-01-07;"Bratislavský kraj";436;3809;100;3909;NA;329193;536;2022-01-07;172398
2022-01-06;"Bratislavský kraj";192;2163;51;2214;NA;329193;243;2022-01-06;171862
2022-01-05;"Bratislavský kraj";426;4047;69;4116;NA;329193;495;2022-01-05;171619
2022-01-04;"Bratislavský kraj";446;4467;101;4568;NA;329193;547;2022-01-04;171124
2022-01-03;"Bratislavský kraj";578;5672;129;5801;NA;329193;707;2022-01-03;170577
2022-01-02;"Bratislavský kraj";198;3137;80;3217;NA;329193;278;2022-01-02;169870
2022-01-01;"Bratislavský kraj";7;1103;36;1139;NA;329193;43;2022-01-01;169592
2021-12-31;"Bratislavský kraj";371;3443;92;3535;NA;329193;463;2021-12-31;169549
2021-12-30;"Bratislavský kraj";468;3619;119;3738;NA;329193;587;2021-12-30;169086
2021-12-29;"Bratislavský kraj";404;3598;85;3683;NA;329193;489;2021-12-29;168499
2021-12-28;"Bratislavský kraj";578;4329;121;4450;NA;329193;699;2021-12-28;168010
2021-12-27;"Bratislavský kraj";656;4693;108;4801;NA;329193;764;2021-12-27;167311
2021-12-26;"Bratislavský kraj";198;2549;83;2632;NA;329193;281;2021-12-26;166547
2021-12-25;"Bratislavský kraj";34;1160;53;1213;NA;329193;87;2021-12-25;166266
2021-12-24;"Bratislavský kraj";171;2214;55;2269;NA;329193;226;2021-12-24;166179
2021-12-23;"Bratislavský kraj";678;4134;115;4249;NA;329193;793;2021-12-23;165953
2021-12-22;"Bratislavský kraj";575;4919;118;5037;NA;329193;693;2021-12-22;165160
2021-12-21;"Bratislavský kraj";625;5628;167;5795;NA;329193;792;2021-12-21;164467
2021-12-20;"Bratislavský kraj";528;6163;158;6321;NA;329193;686;2021-12-20;163675
2021-12-19;"Bratislavský kraj";250;3042;98;3140;NA;329193;348;2021-12-19;162989
2021-12-18;"Bratislavský kraj";528;2654;103;2757;NA;329193;631;2021-12-18;162641
2021-12-17;"Bratislavský kraj";683;4917;145;5062;NA;329193;828;2021-12-17;162010
2021-12-16;"Bratislavský kraj";730;5576;162;5738;NA;329193;892;2021-12-16;161182
2021-12-15;"Bratislavský kraj";881;4884;158;5042;NA;329193;1039;2021-12-15;160290
2021-12-14;"Bratislavský kraj";869;5397;179;5576;NA;329193;1048;2021-12-14;159251
2021-12-13;"Bratislavský kraj";648;7614;239;7853;NA;329193;887;2021-12-13;158203
2021-12-12;"Bratislavský kraj";534;3474;129;3603;NA;329193;663;2021-12-12;157316
2021-12-11;"Bratislavský kraj";698;2377;153;2530;NA;329193;851;2021-12-11;156653
2021-12-10;"Bratislavský kraj";796;4728;186;4914;NA;329193;982;2021-12-10;155802
2021-12-09;"Bratislavský kraj";1040;4152;174;4326;NA;329193;1214;2021-12-09;154820
2021-12-08;"Bratislavský kraj";1172;4602;196;4798;NA;329193;1368;2021-12-08;153606
2021-12-07;"Bratislavský kraj";1236;5173;257;5430;NA;329193;1493;2021-12-07;152238
2021-12-06;"Bratislavský kraj";1434;8714;312;9026;NA;329193;1746;2021-12-06;150745
2021-12-05;"Bratislavský kraj";633;3874;197;4071;NA;329193;830;2021-12-05;148999
2021-12-04;"Bratislavský kraj";936;4332;195;4527;NA;329193;1131;2021-12-04;148169
2021-12-03;"Bratislavský kraj";1222;4351;269;4620;NA;329193;1491;2021-12-03;147038
2021-12-02;"Bratislavský kraj";2053;5097;311;5408;NA;329193;2364;2021-12-02;145547
2021-12-01;"Bratislavský kraj";1161;9058;295;9353;NA;329193;1456;2021-12-01;143183
2021-11-30;"Bratislavský kraj";1442;6508;355;6863;NA;329193;1797;2021-11-30;141727
2021-11-29;"Bratislavský kraj";863;8823;452;9275;NA;329193;1315;2021-11-29;139930
2021-11-28;"Bratislavský kraj";617;5102;295;5397;NA;329193;912;2021-11-28;138615
2021-11-27;"Bratislavský kraj";1026;3497;329;3826;NA;329193;1355;2021-11-27;137703
2021-11-26;"Bratislavský kraj";1346;5483;422;5905;NA;329193;1768;2021-11-26;136348
2021-11-25;"Bratislavský kraj";1415;6383;451;6834;NA;329193;1866;2021-11-25;134580
2021-11-24;"Bratislavský kraj";1286;6849;467;7316;NA;329193;1753;2021-11-24;132714
2021-11-23;"Bratislavský kraj";1651;6351;433;6784;NA;329193;2084;2021-11-23;130961
2021-11-22;"Bratislavský kraj";1197;8722;584;9306;NA;329193;1781;2021-11-22;128877
2021-11-21;"Bratislavský kraj";702;4324;320;4644;NA;329193;1022;2021-11-21;127096
2021-11-20;"Bratislavský kraj";1005;3514;360;3874;NA;329193;1365;2021-11-20;126074
2021-11-19;"Bratislavský kraj";1444;5927;549;6476;NA;329193;1993;2021-11-19;124709
2021-11-18;"Bratislavský kraj";1052;6358;548;6906;NA;329193;1600;2021-11-18;122716
2021-11-17;"Bratislavský kraj";832;2439;308;2747;NA;329193;1140;2021-11-17;121116
2021-11-16;"Bratislavský kraj";1067;5792;443;6235;NA;329193;1510;2021-11-16;119976
2021-11-15;"Bratislavský kraj";1014;6330;519;6849;NA;329193;1533;2021-11-15;118466
2021-11-14;"Bratislavský kraj";448;3202;335;3537;NA;329193;783;2021-11-14;116933
2021-11-13;"Bratislavský kraj";587;3251;313;3564;NA;329193;900;2021-11-13;116150
2021-11-12;"Bratislavský kraj";856;5723;357;6080;NA;329193;1213;2021-11-12;115250
2021-11-11;"Bratislavský kraj";787;6028;355;6383;NA;329193;1142;2021-11-11;114037
2021-11-10;"Bratislavský kraj";840;5903;385;6288;NA;329193;1225;2021-11-10;112895
2021-11-09;"Bratislavský kraj";939;5733;350;6083;NA;329193;1289;2021-11-09;111670
2021-11-08;"Bratislavský kraj";579;5641;404;6045;NA;329193;983;2021-11-08;110381
2021-11-07;"Bratislavský kraj";363;2836;244;3080;NA;329193;607;2021-11-07;109398
2021-11-06;"Bratislavský kraj";538;2901;243;3144;NA;329193;781;2021-11-06;108791
2021-11-05;"Bratislavský kraj";801;5640;318;5958;NA;329193;1119;2021-11-05;108010
2021-11-04;"Bratislavský kraj";768;5233;273;5506;NA;329193;1041;2021-11-04;106891
2021-11-03;"Bratislavský kraj";690;5120;290;5410;NA;329193;980;2021-11-03;105850
2021-11-02;"Bratislavský kraj";422;6356;327;6683;NA;329193;749;2021-11-02;104870
2021-11-01;"Bratislavský kraj";395;1733;136;1869;NA;329193;531;2021-11-01;104121
2021-10-31;"Bratislavský kraj";209;2280;163;2443;NA;329193;372;2021-10-31;103590
2021-10-30;"Bratislavský kraj";429;2138;118;2256;NA;329193;547;2021-10-30;103218
2021-10-29;"Bratislavský kraj";445;4757;219;4976;NA;329193;664;2021-10-29;102671
2021-10-28;"Bratislavský kraj";372;4777;179;4956;NA;329193;551;2021-10-28;102007
2021-10-27;"Bratislavský kraj";376;4522;164;4686;NA;329193;540;2021-10-27;101456
2021-10-26;"Bratislavský kraj";461;4492;188;4680;NA;329193;649;2021-10-26;100916
2021-10-25;"Bratislavský kraj";379;5347;192;5539;NA;329193;571;2021-10-25;100267
2021-10-24;"Bratislavský kraj";114;2369;91;2460;NA;329193;205;2021-10-24;99696
2021-10-23;"Bratislavský kraj";301;2666;91;2757;NA;329193;392;2021-10-23;99491
2021-10-22;"Bratislavský kraj";309;4466;122;4588;NA;329193;431;2021-10-22;99099
2021-10-21;"Bratislavský kraj";244;4544;101;4645;NA;329193;345;2021-10-21;98668
2021-10-20;"Bratislavský kraj";262;3897;95;3992;NA;329193;357;2021-10-20;98323
2021-10-19;"Bratislavský kraj";260;4116;68;4184;NA;329193;328;2021-10-19;97966
2021-10-18;"Bratislavský kraj";250;5014;114;5128;NA;329193;364;2021-10-18;97638
2021-10-17;"Bratislavský kraj";54;2460;73;2533;NA;329193;127;2021-10-17;97274
2021-10-16;"Bratislavský kraj";185;2687;63;2750;NA;329193;248;2021-10-16;97147
2021-10-15;"Bratislavský kraj";169;4200;64;4264;NA;329193;233;2021-10-15;96899
2021-10-14;"Bratislavský kraj";173;4714;61;4775;NA;329193;234;2021-10-14;96666
2021-10-13;"Bratislavský kraj";143;3671;76;3747;NA;329193;219;2021-10-13;96432
2021-10-12;"Bratislavský kraj";183;4037;78;4115;NA;329193;261;2021-10-12;96213
2021-10-11;"Bratislavský kraj";191;4798;88;4886;NA;329193;279;2021-10-11;95952
2021-10-10;"Bratislavský kraj";29;2176;43;2219;NA;329193;72;2021-10-10;95673
2021-10-09;"Bratislavský kraj";141;2419;34;2453;NA;329193;175;2021-10-09;95601
2021-10-08;"Bratislavský kraj";130;4511;63;4574;NA;329193;193;2021-10-08;95426
2021-10-07;"Bratislavský kraj";92;4137;61;4198;NA;329193;153;2021-10-07;95233
2021-10-06;"Bratislavský kraj";147;4028;68;4096;NA;329193;215;2021-10-06;95080
2021-10-05;"Bratislavský kraj";164;4468;70;4538;NA;329193;234;2021-10-05;94865
2021-10-04;"Bratislavský kraj";129;4653;79;4732;NA;329193;208;2021-10-04;94631
2021-10-03;"Bratislavský kraj";41;2144;42;2186;NA;329193;83;2021-10-03;94423
2021-10-02;"Bratislavský kraj";104;2605;40;2645;NA;329193;144;2021-10-02;94340
2021-10-01;"Bratislavský kraj";108;4818;57;4875;NA;329193;165;2021-10-01;94196
2021-09-30;"Bratislavský kraj";90;3854;60;3914;NA;329193;150;2021-09-30;94031
2021-09-29;"Bratislavský kraj";115;3508;58;3566;NA;329193;173;2021-09-29;93881
2021-09-28;"Bratislavský kraj";144;4003;48;4051;NA;329193;192;2021-09-28;93708
2021-09-27;"Bratislavský kraj";123;4427;70;4497;NA;329193;193;2021-09-27;93516
2021-09-26;"Bratislavský kraj";32;2194;31;2225;NA;329193;63;2021-09-26;93323
2021-09-25;"Bratislavský kraj";85;2742;38;2780;NA;329193;123;2021-09-25;93260
2021-09-24;"Bratislavský kraj";82;4212;59;4271;NA;329193;141;2021-09-24;93137
2021-09-23;"Bratislavský kraj";90;3975;51;4026;NA;329193;141;2021-09-23;92996
2021-09-22;"Bratislavský kraj";84;3757;63;3820;NA;329193;147;2021-09-22;92855
2021-09-21;"Bratislavský kraj";95;3574;39;3613;NA;329193;134;2021-09-21;92708
2021-09-20;"Bratislavský kraj";84;3937;31;3968;NA;329193;115;2021-09-20;92574
2021-09-19;"Bratislavský kraj";31;1850;28;1878;NA;329193;59;2021-09-19;92459
2021-09-18;"Bratislavský kraj";60;1989;19;2008;NA;329193;79;2021-09-18;92400
2021-09-17;"Bratislavský kraj";87;3443;27;3470;NA;329193;114;2021-09-17;92321
2021-09-16;"Bratislavský kraj";57;3781;43;3824;NA;329193;100;2021-09-16;92207
2021-09-15;"Bratislavský kraj";41;1104;21;1125;NA;329193;62;2021-09-15;92107
2021-09-14;"Bratislavský kraj";78;3518;31;3549;NA;329193;109;2021-09-14;92045
2021-09-13;"Bratislavský kraj";47;3191;28;3219;NA;329193;75;2021-09-13;91936
2021-09-12;"Bratislavský kraj";13;1713;21;1734;NA;329193;34;2021-09-12;91861
2021-09-11;"Bratislavský kraj";36;2064;13;2077;NA;329193;49;2021-09-11;91827
2021-09-10;"Bratislavský kraj";47;3628;18;3646;NA;329193;65;2021-09-10;91778
2021-09-09;"Bratislavský kraj";50;3010;30;3040;NA;329193;80;2021-09-09;91713
2021-09-08;"Bratislavský kraj";56;2925;20;2945;NA;329193;76;2021-09-08;91633
2021-09-07;"Bratislavský kraj";50;3272;18;3290;NA;329193;68;2021-09-07;91557
2021-09-06;"Bratislavský kraj";63;2821;29;2850;NA;329193;92;2021-09-06;91489
2021-09-05;"Bratislavský kraj";10;1682;14;1696;NA;329193;24;2021-09-05;91397
2021-09-04;"Bratislavský kraj";41;2612;11;2623;NA;329193;52;2021-09-04;91373
2021-09-03;"Bratislavský kraj";55;3016;14;3030;NA;329193;69;2021-09-03;91321
2021-09-02;"Bratislavský kraj";35;2423;23;2446;NA;329193;58;2021-09-02;91252
2021-09-01;"Bratislavský kraj";16;929;9;938;NA;329193;25;2021-09-01;91194
2021-08-31;"Bratislavský kraj";28;5197;22;5219;NA;329193;50;2021-08-31;91169
2021-08-30;"Bratislavský kraj";24;2403;13;2416;NA;329193;37;2021-08-30;91119
2021-08-29;"Bratislavský kraj";11;1016;6;1022;NA;329193;17;2021-08-29;91082
2021-08-28;"Bratislavský kraj";24;1714;11;1725;NA;329193;35;2021-08-28;91065
2021-08-27;"Bratislavský kraj";19;2850;9;2859;NA;329193;28;2021-08-27;91030
2021-08-26;"Bratislavský kraj";15;2382;19;2401;NA;329193;34;2021-08-26;91002
2021-08-25;"Bratislavský kraj";29;1888;10;1898;NA;329193;39;2021-08-25;90968
2021-08-24;"Bratislavský kraj";22;1785;4;1789;NA;329193;26;2021-08-24;90929
2021-08-23;"Bratislavský kraj";21;2183;7;2190;NA;329193;28;2021-08-23;90903
2021-08-22;"Bratislavský kraj";5;1383;8;1391;NA;329193;13;2021-08-22;90875
2021-08-21;"Bratislavský kraj";18;1681;4;1685;NA;329193;22;2021-08-21;90862
2021-08-20;"Bratislavský kraj";27;2747;19;2766;NA;329193;46;2021-08-20;90840
2021-08-19;"Bratislavský kraj";15;2122;9;2131;NA;329193;24;2021-08-19;90794
2021-08-18;"Bratislavský kraj";16;1659;11;1670;NA;329193;27;2021-08-18;90770
2021-08-17;"Bratislavský kraj";18;1608;5;1613;NA;329193;23;2021-08-17;90743
2021-08-16;"Bratislavský kraj";18;2559;12;2571;NA;329193;30;2021-08-16;90720
2021-08-15;"Bratislavský kraj";3;1169;6;1175;NA;329193;9;2021-08-15;90690
2021-08-14;"Bratislavský kraj";11;1519;4;1523;NA;329193;15;2021-08-14;90681
2021-08-13;"Bratislavský kraj";32;2634;7;2641;NA;329193;39;2021-08-13;90666
2021-08-12;"Bratislavský kraj";16;1824;9;1833;NA;329193;25;2021-08-12;90627
2021-08-11;"Bratislavský kraj";22;1621;5;1626;NA;329193;27;2021-08-11;90602
2021-08-10;"Bratislavský kraj";15;1630;7;1637;NA;329193;22;2021-08-10;90575
2021-08-09;"Bratislavský kraj";35;1927;9;1936;NA;329193;44;2021-08-09;90553
2021-08-08;"Bratislavský kraj";3;1152;4;1156;NA;329193;7;2021-08-08;90509
2021-08-07;"Bratislavský kraj";6;1572;9;1581;NA;329193;15;2021-08-07;90502
2021-08-06;"Bratislavský kraj";9;2510;10;2520;NA;329193;19;2021-08-06;90487
2021-08-05;"Bratislavský kraj";10;1651;7;1658;NA;329193;17;2021-08-05;90468
2021-08-04;"Bratislavský kraj";9;1578;0;1578;NA;329193;9;2021-08-04;90451
2021-08-03;"Bratislavský kraj";11;1507;5;1512;NA;329193;16;2021-08-03;90442
2021-08-02;"Bratislavský kraj";15;1749;11;1760;NA;329193;26;2021-08-02;90426
2021-08-01;"Bratislavský kraj";4;1224;8;1232;NA;329193;12;2021-08-01;90400
2021-07-31;"Bratislavský kraj";7;1623;2;1625;NA;329193;9;2021-07-31;90388
2021-07-30;"Bratislavský kraj";15;2540;7;2547;NA;329193;22;2021-07-30;90379
2021-07-29;"Bratislavský kraj";19;1790;7;1797;NA;329193;26;2021-07-29;90357
2021-07-28;"Bratislavský kraj";8;1538;11;1549;NA;329193;19;2021-07-28;90331
2021-07-27;"Bratislavský kraj";9;1476;5;1481;NA;329193;14;2021-07-27;90312
2021-07-26;"Bratislavský kraj";17;1806;7;1813;NA;329193;24;2021-07-26;90298
2021-07-25;"Bratislavský kraj";4;1411;2;1413;NA;329193;6;2021-07-25;90274
2021-07-24;"Bratislavský kraj";9;1732;3;1735;NA;329193;12;2021-07-24;90268
2021-07-23;"Bratislavský kraj";6;2400;3;2403;NA;329193;9;2021-07-23;90256
2021-07-22;"Bratislavský kraj";12;1944;6;1950;NA;329193;18;2021-07-22;90247
2021-07-21;"Bratislavský kraj";5;1860;6;1866;NA;329193;11;2021-07-21;90229
2021-07-20;"Bratislavský kraj";19;1559;1;1560;NA;329193;20;2021-07-20;90218
2021-07-19;"Bratislavský kraj";15;2259;3;2262;NA;329193;18;2021-07-19;90198
2021-07-18;"Bratislavský kraj";2;1462;3;1465;NA;329193;5;2021-07-18;90180
2021-07-17;"Bratislavský kraj";3;1870;2;1872;NA;329193;5;2021-07-17;90175
2021-07-16;"Bratislavský kraj";8;2834;4;2838;NA;329193;12;2021-07-16;90170
2021-07-15;"Bratislavský kraj";5;1677;0;1677;NA;329193;5;2021-07-15;90158
2021-07-14;"Bratislavský kraj";5;1904;3;1907;NA;329193;8;2021-07-14;90153
2021-07-13;"Bratislavský kraj";4;1584;4;1588;NA;329193;8;2021-07-13;90145
2021-07-12;"Bratislavský kraj";6;1780;5;1785;NA;329193;11;2021-07-12;90137
2021-07-11;"Bratislavský kraj";3;1896;3;1899;NA;329193;6;2021-07-11;90126
2021-07-10;"Bratislavský kraj";5;2240;3;2243;NA;329193;8;2021-07-10;90120
2021-07-09;"Bratislavský kraj";13;3546;7;3553;NA;329193;20;2021-07-09;90112
2021-07-08;"Bratislavský kraj";9;2433;4;2437;NA;329193;13;2021-07-08;90092
2021-07-07;"Bratislavský kraj";5;2792;4;2796;NA;329193;9;2021-07-07;90079
2021-07-06;"Bratislavský kraj";19;2771;4;2775;NA;329193;23;2021-07-06;90070
2021-07-05;"Bratislavský kraj";5;2481;5;2486;NA;329193;10;2021-07-05;90047
2021-07-04;"Bratislavský kraj";3;1824;2;1826;NA;329193;5;2021-07-04;90037
2021-07-03;"Bratislavský kraj";8;2205;5;2210;NA;329193;13;2021-07-03;90032
2021-07-02;"Bratislavský kraj";4;2227;4;2231;NA;329193;8;2021-07-02;90019
2021-07-01;"Bratislavský kraj";6;1809;5;1814;NA;329193;11;2021-07-01;90011
2021-06-30;"Bratislavský kraj";2;11548;11;11559;NA;329193;13;2021-06-30;90000
2021-06-29;"Bratislavský kraj";5;6831;7;6838;NA;329193;12;2021-06-29;89987
2021-06-28;"Bratislavský kraj";16;6654;24;6678;NA;329193;40;2021-06-28;89975
2021-06-27;"Bratislavský kraj";4;6689;11;6700;NA;329193;15;2021-06-27;89935
2021-06-26;"Bratislavský kraj";3;8741;6;8747;NA;329193;9;2021-06-26;89920
2021-06-25;"Bratislavský kraj";7;10285;15;10300;NA;329193;22;2021-06-25;89911
2021-06-24;"Bratislavský kraj";3;7384;16;7400;NA;329193;19;2021-06-24;89889
2021-06-23;"Bratislavský kraj";4;7346;12;7358;NA;329193;16;2021-06-23;89870
2021-06-22;"Bratislavský kraj";6;7244;10;7254;NA;329193;16;2021-06-22;89854
2021-06-21;"Bratislavský kraj";5;7641;9;7650;NA;329193;14;2021-06-21;89838
2021-06-20;"Bratislavský kraj";0;7369;5;7374;NA;329193;5;2021-06-20;89824
2021-06-19;"Bratislavský kraj";3;9226;4;9230;NA;329193;7;2021-06-19;89819
2021-06-18;"Bratislavský kraj";5;12763;9;12772;NA;329193;14;2021-06-18;89812
2021-06-17;"Bratislavský kraj";3;8625;13;8638;NA;329193;16;2021-06-17;89798
2021-06-16;"Bratislavský kraj";3;7105;4;7109;NA;329193;7;2021-06-16;89782
2021-06-15;"Bratislavský kraj";7;7309;17;7326;NA;329193;24;2021-06-15;89775
2021-06-14;"Bratislavský kraj";4;8231;9;8240;NA;329193;13;2021-06-14;89751
2021-06-13;"Bratislavský kraj";2;8791;11;8802;NA;329193;13;2021-06-13;89738
2021-06-12;"Bratislavský kraj";4;11152;11;11163;NA;329193;15;2021-06-12;89725
2021-06-11;"Bratislavský kraj";9;13644;21;13665;NA;329193;30;2021-06-11;89710
2021-06-10;"Bratislavský kraj";12;8637;15;8652;NA;329193;27;2021-06-10;89680
2021-06-09;"Bratislavský kraj";12;7596;12;7608;NA;329193;24;2021-06-09;89653
2021-06-08;"Bratislavský kraj";13;7907;29;7936;NA;329193;42;2021-06-08;89629
2021-06-07;"Bratislavský kraj";13;9247;43;9290;NA;329193;56;2021-06-07;89587
2021-06-06;"Bratislavský kraj";3;10350;20;10370;NA;329193;23;2021-06-06;89531
2021-06-05;"Bratislavský kraj";2;12692;15;12707;NA;329193;17;2021-06-05;89508
2021-06-04;"Bratislavský kraj";10;13846;31;13877;NA;329193;41;2021-06-04;89491
2021-06-03;"Bratislavský kraj";12;9615;19;9634;NA;329193;31;2021-06-03;89450
2021-06-02;"Bratislavský kraj";10;8684;17;8701;NA;329193;27;2021-06-02;89419
2021-06-01;"Bratislavský kraj";3;8812;25;8837;NA;329193;28;2021-06-01;89392
2021-05-31;"Bratislavský kraj";18;11248;32;11280;NA;329193;50;2021-05-31;89364
2021-05-30;"Bratislavský kraj";1;11758;17;11775;NA;329193;18;2021-05-30;89314
2021-05-29;"Bratislavský kraj";4;12245;8;12253;NA;329193;12;2021-05-29;89296
2021-05-28;"Bratislavský kraj";14;15865;23;15888;NA;329193;37;2021-05-28;89284
2021-05-27;"Bratislavský kraj";5;11321;18;11339;NA;329193;23;2021-05-27;89247
2021-05-26;"Bratislavský kraj";20;10709;17;10726;NA;329193;37;2021-05-26;89224
2021-05-25;"Bratislavský kraj";19;11864;31;11895;NA;329193;50;2021-05-25;89187
2021-05-24;"Bratislavský kraj";12;12966;23;12989;NA;329193;35;2021-05-24;89137
2021-05-23;"Bratislavský kraj";7;13074;24;13098;NA;329193;31;2021-05-23;89102
2021-05-22;"Bratislavský kraj";6;14044;22;14066;NA;329193;28;2021-05-22;89071
2021-05-21;"Bratislavský kraj";15;18996;22;19018;NA;329193;37;2021-05-21;89043
2021-05-20;"Bratislavský kraj";15;14112;17;14129;NA;329193;32;2021-05-20;89006
2021-05-19;"Bratislavský kraj";21;11958;24;11982;NA;329193;45;2021-05-19;88974
2021-05-18;"Bratislavský kraj";14;13005;33;13038;NA;329193;47;2021-05-18;88929
2021-05-17;"Bratislavský kraj";15;13854;29;13883;NA;329193;44;2021-05-17;88882
2021-05-16;"Bratislavský kraj";12;19797;32;19829;NA;329193;44;2021-05-16;88838
2021-05-15;"Bratislavský kraj";1;18113;30;18143;NA;329193;31;2021-05-15;88794
2021-05-14;"Bratislavský kraj";15;22228;30;22258;NA;329193;45;2021-05-14;88763
2021-05-13;"Bratislavský kraj";9;16211;17;16228;NA;329193;26;2021-05-13;88718
2021-05-12;"Bratislavský kraj";11;14638;28;14666;NA;329193;39;2021-05-12;88692
2021-05-11;"Bratislavský kraj";29;16741;32;16773;NA;329193;61;2021-05-11;88653
2021-05-10;"Bratislavský kraj";27;19991;64;20055;NA;329193;91;2021-05-10;88592
2021-05-09;"Bratislavský kraj";9;29358;32;29390;NA;329193;41;2021-05-09;88501
2021-05-08;"Bratislavský kraj";5;19451;24;19475;NA;329193;29;2021-05-08;88460
2021-05-07;"Bratislavský kraj";32;28211;65;28276;NA;329193;97;2021-05-07;88431
2021-05-06;"Bratislavský kraj";19;20079;52;20131;NA;329193;71;2021-05-06;88334
2021-05-05;"Bratislavský kraj";29;15526;31;15557;NA;329193;60;2021-05-05;88263
2021-05-04;"Bratislavský kraj";46;19143;53;19196;NA;329193;99;2021-05-04;88203
2021-05-03;"Bratislavský kraj";37;22322;64;22386;NA;329193;101;2021-05-03;88104
2021-05-02;"Bratislavský kraj";38;43064;75;43139;NA;329193;113;2021-05-02;88003
2021-05-01;"Bratislavský kraj";11;39905;40;39945;NA;329193;51;2021-05-01;87890
2021-04-30;"Bratislavský kraj";43;47403;82;47485;NA;329193;125;2021-04-30;87839
2021-04-29;"Bratislavský kraj";48;30257;96;30353;NA;329193;144;2021-04-29;87714
2021-04-28;"Bratislavský kraj";40;28905;78;28983;NA;329193;118;2021-04-28;87570
2021-04-27;"Bratislavský kraj";41;30168;52;30220;NA;329193;93;2021-04-27;87452
2021-04-26;"Bratislavský kraj";59;34733;97;34830;NA;329193;156;2021-04-26;87359
2021-04-25;"Bratislavský kraj";8;57615;74;57689;NA;329193;82;2021-04-25;87203
2021-04-24;"Bratislavský kraj";28;74858;66;74924;NA;329193;94;2021-04-24;87121
2021-04-23;"Bratislavský kraj";70;48614;62;48676;NA;329193;132;2021-04-23;87027
2021-04-22;"Bratislavský kraj";39;31037;72;31109;NA;329193;111;2021-04-22;86895
2021-04-21;"Bratislavský kraj";48;30442;62;30504;NA;329193;110;2021-04-21;86784
2021-04-20;"Bratislavský kraj";58;35216;63;35279;NA;329193;121;2021-04-20;86674
2021-04-19;"Bratislavský kraj";48;39500;80;39580;NA;329193;128;2021-04-19;86553
2021-04-18;"Bratislavský kraj";35;62300;76;62376;NA;329193;111;2021-04-18;86425
2021-04-17;"Bratislavský kraj";13;80359;111;80470;NA;329193;124;2021-04-17;86314
2021-04-16;"Bratislavský kraj";62;47296;80;47376;NA;329193;142;2021-04-16;86190
2021-04-15;"Bratislavský kraj";34;32176;74;32250;NA;329193;108;2021-04-15;86048
2021-04-14;"Bratislavský kraj";65;33961;88;34049;NA;329193;153;2021-04-14;85940
2021-04-13;"Bratislavský kraj";82;35512;82;35594;NA;329193;164;2021-04-13;85787
2021-04-12;"Bratislavský kraj";77;42286;115;42401;NA;329193;192;2021-04-12;85623
2021-04-11;"Bratislavský kraj";42;61151;123;61274;NA;329193;165;2021-04-11;85431
2021-04-10;"Bratislavský kraj";14;77874;167;78041;NA;329193;181;2021-04-10;85266
2021-04-09;"Bratislavský kraj";72;41556;97;41653;NA;329193;169;2021-04-09;85085
2021-04-08;"Bratislavský kraj";71;28866;95;28961;NA;329193;166;2021-04-08;84916
2021-04-07;"Bratislavský kraj";96;38061;101;38162;NA;329193;197;2021-04-07;84750
2021-04-06;"Bratislavský kraj";94;56204;179;56383;NA;329193;273;2021-04-06;84553
2021-04-05;"Bratislavský kraj";85;18538;85;18623;NA;329193;170;2021-04-05;84280
2021-04-04;"Bratislavský kraj";37;29225;75;29300;NA;329193;112;2021-04-04;84110
2021-04-03;"Bratislavský kraj";52;79865;220;80085;NA;329193;272;2021-04-03;83998
2021-04-02;"Bratislavský kraj";33;23790;104;23894;NA;329193;137;2021-04-02;83726
2021-04-01;"Bratislavský kraj";119;57388;159;57547;NA;329193;278;2021-04-01;83589
2021-03-31;"Bratislavský kraj";105;46371;177;46548;NA;329193;282;2021-03-31;83311
2021-03-30;"Bratislavský kraj";100;39599;144;39743;NA;329193;244;2021-03-30;83029
2021-03-29;"Bratislavský kraj";153;40364;178;40542;NA;329193;331;2021-03-29;82785
2021-03-28;"Bratislavský kraj";59;53372;137;53509;NA;329193;196;2021-03-28;82454
2021-03-27;"Bratislavský kraj";53;79834;240;80074;NA;329193;293;2021-03-27;82258
2021-03-26;"Bratislavský kraj";114;56108;191;56299;NA;329193;305;2021-03-26;81965
2021-03-25;"Bratislavský kraj";76;36859;172;37031;NA;329193;248;2021-03-25;81660
2021-03-24;"Bratislavský kraj";120;30567;201;30768;NA;329193;321;2021-03-24;81412
2021-03-23;"Bratislavský kraj";138;36438;190;36628;NA;329193;328;2021-03-23;81091
2021-03-22;"Bratislavský kraj";110;42756;220;42976;NA;329193;330;2021-03-22;80763
2021-03-21;"Bratislavský kraj";54;61299;212;61511;NA;329193;266;2021-03-21;80433
2021-03-20;"Bratislavský kraj";59;73300;228;73528;NA;329193;287;2021-03-20;80167
2021-03-19;"Bratislavský kraj";139;54576;257;54833;NA;329193;396;2021-03-19;79880
2021-03-18;"Bratislavský kraj";142;34611;192;34803;NA;329193;334;2021-03-18;79484
2021-03-17;"Bratislavský kraj";177;30482;217;30699;NA;329193;394;2021-03-17;79150
2021-03-16;"Bratislavský kraj";258;36798;287;37085;NA;329193;545;2021-03-16;78756
2021-03-15;"Bratislavský kraj";180;38226;255;38481;NA;329193;435;2021-03-15;78211
2021-03-14;"Bratislavský kraj";75;52611;275;52886;NA;329193;350;2021-03-14;77776
2021-03-13;"Bratislavský kraj";110;81405;341;81746;NA;329193;451;2021-03-13;77426
2021-03-12;"Bratislavský kraj";152;55233;312;55545;NA;329193;464;2021-03-12;76975
2021-03-11;"Bratislavský kraj";178;34678;286;34964;NA;329193;464;2021-03-11;76511
2021-03-10;"Bratislavský kraj";164;31061;280;31341;NA;329193;444;2021-03-10;76047
2021-03-09;"Bratislavský kraj";242;37687;267;37954;NA;329193;509;2021-03-09;75603
2021-03-08;"Bratislavský kraj";255;41199;348;41547;NA;329193;603;2021-03-08;75094
2021-03-07;"Bratislavský kraj";142;52812;301;53113;NA;329193;443;2021-03-07;74491
2021-03-06;"Bratislavský kraj";79;71821;415;72236;NA;329193;494;2021-03-06;74048
2021-03-05;"Bratislavský kraj";238;50653;293;50946;NA;329193;531;2021-03-05;73554
2021-03-04;"Bratislavský kraj";204;34544;344;34888;NA;329193;548;2021-03-04;73023
2021-03-03;"Bratislavský kraj";250;30527;364;30891;NA;329193;614;2021-03-03;72475
2021-03-02;"Bratislavský kraj";267;39735;388;40123;NA;329193;655;2021-03-02;71861
2021-03-01;"Bratislavský kraj";320;38222;432;38654;NA;329193;752;2021-03-01;71206
2021-02-28;"Bratislavský kraj";184;50323;323;50646;NA;329193;507;2021-02-28;70454
2021-02-27;"Bratislavský kraj";151;76580;464;77044;NA;329193;615;2021-02-27;69947
2021-02-26;"Bratislavský kraj";277;47326;401;47727;NA;329193;678;2021-02-26;69332
2021-02-25;"Bratislavský kraj";277;28769;405;29174;NA;329193;682;2021-02-25;68654
2021-02-24;"Bratislavský kraj";217;27095;412;27507;NA;329193;629;2021-02-24;67972
2021-02-23;"Bratislavský kraj";257;31297;395;31692;NA;329193;652;2021-02-23;67343
2021-02-22;"Bratislavský kraj";353;36607;483;37090;NA;329193;836;2021-02-22;66691
2021-02-21;"Bratislavský kraj";185;54150;396;54546;NA;329193;581;2021-02-21;65855
2021-02-20;"Bratislavský kraj";167;74814;550;75364;NA;329193;717;2021-02-20;65274
2021-02-19;"Bratislavský kraj";280;44882;416;45298;NA;329193;696;2021-02-19;64557
2021-02-18;"Bratislavský kraj";263;26379;371;26750;NA;329193;634;2021-02-18;63861
2021-02-17;"Bratislavský kraj";264;22820;316;23136;NA;329193;580;2021-02-17;63227
2021-02-16;"Bratislavský kraj";289;28262;352;28614;NA;329193;641;2021-02-16;62647
2021-02-15;"Bratislavský kraj";248;36893;396;37289;NA;329193;644;2021-02-15;62006
2021-02-14;"Bratislavský kraj";153;47948;323;48271;NA;329193;476;2021-02-14;61362
2021-02-13;"Bratislavský kraj";173;68589;515;69104;NA;329193;688;2021-02-13;60886
2021-02-12;"Bratislavský kraj";282;35729;327;36056;NA;329193;609;2021-02-12;60198
2021-02-11;"Bratislavský kraj";337;24565;285;24850;NA;329193;622;2021-02-11;59589
2021-02-10;"Bratislavský kraj";314;22944;356;23300;NA;329193;670;2021-02-10;58967
2021-02-09;"Bratislavský kraj";288;36565;454;37019;NA;329193;742;2021-02-09;58297
2021-02-08;"Bratislavský kraj";484;31896;397;32293;NA;329193;881;2021-02-08;57555
2021-02-07;"Bratislavský kraj";243;51290;425;51715;NA;329193;668;2021-02-07;56674
2021-02-06;"Bratislavský kraj";116;61682;501;62183;NA;329193;617;2021-02-06;56006
2021-02-05;"Bratislavský kraj";327;27033;375;27408;NA;329193;702;2021-02-05;55389
2021-02-04;"Bratislavský kraj";555;17260;348;17608;NA;329193;903;2021-02-04;54687
2021-02-03;"Bratislavský kraj";161;13020;352;13372;NA;329193;513;2021-02-03;53784
2021-02-02;"Bratislavský kraj";397;25947;480;26427;NA;329193;877;2021-02-02;53271
2021-02-01;"Bratislavský kraj";221;35541;513;36054;NA;329193;734;2021-02-01;52394
2021-01-31;"Bratislavský kraj";180;35693;425;36118;NA;329193;605;2021-01-31;51660
2021-01-30;"Bratislavský kraj";310;49588;521;50109;NA;329193;831;2021-01-30;51055
2021-01-29;"Bratislavský kraj";344;16568;344;16912;NA;329193;688;2021-01-29;50224
2021-01-28;"Bratislavský kraj";307;10715;297;11012;NA;329193;604;2021-01-28;49536
2021-01-27;"Bratislavský kraj";336;22222;345;22567;NA;329193;681;2021-01-27;48932
2021-01-26;"Bratislavský kraj";297;21894;300;22194;NA;329193;597;2021-01-26;48251
2021-01-25;"Bratislavský kraj";356;23335;249;23584;NA;329193;605;2021-01-25;47654
2021-01-24;"Bratislavský kraj";175;37903;404;38307;NA;329193;579;2021-01-24;47049
2021-01-23;"Bratislavský kraj";396;79453;690;80143;NA;329193;1086;2021-01-23;46470
2021-01-22;"Bratislavský kraj";199;42055;365;42420;NA;329193;564;2021-01-22;45384
2021-01-21;"Bratislavský kraj";255;105746;1317;107063;NA;329193;1572;2021-01-21;44820
2021-01-20;"Bratislavský kraj";360;27289;452;27741;NA;329193;812;2021-01-20;43248
2021-01-19;"Bratislavský kraj";375;15318;346;15664;NA;329193;721;2021-01-19;42436
2021-01-18;"Bratislavský kraj";357;12533;707;13240;NA;329193;1064;2021-01-18;41715
2021-01-17;"Bratislavský kraj";244;482;26;508;NA;329193;270;2021-01-17;40651
2021-01-16;"Bratislavský kraj";70;3016;156;3172;NA;329193;226;2021-01-16;40381
2021-01-15;"Bratislavský kraj";251;7896;256;8152;NA;329193;507;2021-01-15;40155
2021-01-14;"Bratislavský kraj";363;8523;273;8796;NA;329193;636;2021-01-14;39648
2021-01-13;"Bratislavský kraj";336;8490;327;8817;NA;329193;663;2021-01-13;39012
2021-01-12;"Bratislavský kraj";450;10509;455;10964;NA;329193;905;2021-01-12;38349
2021-01-11;"Bratislavský kraj";397;19863;364;20227;NA;329193;761;2021-01-11;37444
2021-01-10;"Bratislavský kraj";252;1507;79;1586;NA;329193;331;2021-01-10;36683
2021-01-09;"Bratislavský kraj";351;4721;277;4998;NA;329193;628;2021-01-09;36352
2021-01-08;"Bratislavský kraj";556;10045;436;10481;NA;329193;992;2021-01-08;35724
2021-01-07;"Bratislavský kraj";537;6872;352;7224;NA;329193;889;2021-01-07;34732
2021-01-06;"Bratislavský kraj";271;3329;216;3545;NA;329193;487;2021-01-06;33843
2021-01-05;"Bratislavský kraj";619;10635;814;11449;NA;329193;1433;2021-01-05;33356
2021-01-04;"Bratislavský kraj";601;8226;538;8764;NA;329193;1139;2021-01-04;31923
2021-01-03;"Bratislavský kraj";77;433;41;474;NA;329193;118;2021-01-03;30784
2021-01-02;"Bratislavský kraj";185;462;57;519;NA;329193;242;2021-01-02;30666
2021-01-01;"Bratislavský kraj";235;3277;131;3408;NA;329193;366;2021-01-01;30424
2020-12-31;"Bratislavský kraj";925;14135;519;14654;NA;329193;1444;2020-12-31;30058
2020-12-30;"Bratislavský kraj";650;9164;533;9697;NA;329193;1183;2020-12-30;28614
2020-12-29;"Bratislavský kraj";303;10108;699;10807;NA;329193;1002;2020-12-29;27431
2020-12-28;"Bratislavský kraj";255;7784;473;8257;NA;329193;728;2020-12-28;26429
2020-12-27;"Bratislavský kraj";160;709;76;785;NA;329193;236;2020-12-27;25701
2020-12-26;"Bratislavský kraj";75;480;27;507;NA;329193;102;2020-12-26;25465
2020-12-25;"Bratislavský kraj";114;503;38;541;NA;329193;152;2020-12-25;25363
2020-12-24;"Bratislavský kraj";536;3367;104;3471;NA;329193;640;2020-12-24;25211
2020-12-23;"Bratislavský kraj";416;12590;447;13037;NA;329193;863;2020-12-23;24571
2020-12-22;"Bratislavský kraj";327;14587;699;15286;NA;329193;1026;2020-12-22;23708
2020-12-21;"Bratislavský kraj";392;14972;1946;16918;NA;329193;2338;2020-12-21;22682
2020-12-20;"Bratislavský kraj";180;797;57;854;NA;329193;237;2020-12-20;20344
2020-12-19;"Bratislavský kraj";396;3314;130;3444;NA;329193;526;2020-12-19;20107
2020-12-18;"Bratislavský kraj";306;9938;345;10283;NA;329193;651;2020-12-18;19581
2020-12-17;"Bratislavský kraj";502;9739;386;10125;NA;329193;888;2020-12-17;18930
2020-12-16;"Bratislavský kraj";282;10201;418;10619;NA;329193;700;2020-12-16;18042
2020-12-15;"Bratislavský kraj";423;10450;454;10904;NA;329193;877;2020-12-15;17342
2020-12-14;"Bratislavský kraj";279;6793;261;7054;NA;329193;540;2020-12-14;16465
2020-12-13;"Bratislavský kraj";125;139;10;149;NA;329193;135;2020-12-13;15925
2020-12-12;"Bratislavský kraj";361;3886;157;4043;NA;329193;518;2020-12-12;15790
2020-12-11;"Bratislavský kraj";326;6824;235;7059;NA;329193;561;2020-12-11;15272
2020-12-10;"Bratislavský kraj";286;5279;166;5445;NA;329193;452;2020-12-10;14711
2020-12-09;"Bratislavský kraj";382;4778;177;4955;NA;329193;559;2020-12-09;14259
2020-12-08;"Bratislavský kraj";234;6243;207;6450;NA;329193;441;2020-12-08;13700
2020-12-07;"Bratislavský kraj";272;4639;152;4791;NA;329193;424;2020-12-07;13259
2020-12-06;"Bratislavský kraj";61;1625;52;1677;NA;329193;113;2020-12-06;12835
2020-12-05;"Bratislavský kraj";266;2221;41;2262;NA;329193;307;2020-12-05;12722
2020-12-04;"Bratislavský kraj";200;4954;99;5053;NA;329193;299;2020-12-04;12415
2020-12-03;"Bratislavský kraj";213;5672;95;5767;NA;329193;308;2020-12-03;12116
2020-12-02;"Bratislavský kraj";205;3462;103;3565;NA;329193;308;2020-12-02;11808
2020-12-01;"Bratislavský kraj";255;3889;172;4061;NA;329193;427;2020-12-01;11500
2020-11-30;"Bratislavský kraj";152;2153;121;2274;NA;329193;273;2020-11-30;11073
2020-11-29;"Bratislavský kraj";52;201;24;225;NA;329193;76;2020-11-29;10800
2020-11-28;"Bratislavský kraj";232;2624;33;2657;NA;329193;265;2020-11-28;10724
2020-11-27;"Bratislavský kraj";54;2540;64;2604;NA;329193;118;2020-11-27;10459
2020-11-26;"Bratislavský kraj";129;1976;60;2036;NA;329193;189;2020-11-26;10341
2020-11-25;"Bratislavský kraj";140;1770;47;1817;NA;329193;187;2020-11-25;10152
2020-11-24;"Bratislavský kraj";81;2988;67;3055;NA;329193;148;2020-11-24;9965
2020-11-23;"Bratislavský kraj";67;7083;58;7141;NA;329193;125;2020-11-23;9817
2020-11-22;"Bratislavský kraj";36;81;7;88;NA;329193;43;2020-11-22;9692
2020-11-21;"Bratislavský kraj";109;2126;47;2173;NA;329193;156;2020-11-21;9649
2020-11-20;"Bratislavský kraj";118;2876;48;2924;NA;329193;166;2020-11-20;9493
2020-11-19;"Bratislavský kraj";173;987;29;1016;NA;329193;202;2020-11-19;9327
2020-11-18;"Bratislavský kraj";118;616;75;691;NA;329193;193;2020-11-18;9125
2020-11-17;"Bratislavský kraj";108;928;23;951;NA;329193;131;2020-11-17;8932
2020-11-16;"Bratislavský kraj";82;651;9;660;NA;329193;91;2020-11-16;8801
2020-11-15;"Bratislavský kraj";47;236;0;236;NA;329193;47;2020-11-15;8710
2020-11-14;"Bratislavský kraj";53;1834;15;1849;NA;329193;68;2020-11-14;8663
2020-11-13;"Bratislavský kraj";94;2096;21;2117;NA;329193;115;2020-11-13;8595
2020-11-12;"Bratislavský kraj";141;1727;6;1733;NA;329193;147;2020-11-12;8480
2020-11-11;"Bratislavský kraj";159;1429;12;1441;NA;329193;171;2020-11-11;8333
2020-11-10;"Bratislavský kraj";136;805;14;819;NA;329193;150;2020-11-10;8162
2020-11-09;"Bratislavský kraj";70;616;8;624;NA;329193;78;2020-11-09;8012
2020-11-08;"Bratislavský kraj";82;869;6;875;NA;329193;88;2020-11-08;7934
2020-11-07;"Bratislavský kraj";88;4039;17;4056;NA;329193;105;2020-11-07;7846
2020-11-06;"Bratislavský kraj";281;6441;25;6466;NA;329193;306;2020-11-06;7741
2020-11-05;"Bratislavský kraj";175;476;11;487;NA;329193;186;2020-11-05;7435
2020-11-04;"Bratislavský kraj";65;411;10;421;NA;329193;75;2020-11-04;7249
2020-11-03;"Bratislavský kraj";251;1085;12;1097;NA;329193;263;2020-11-03;7174
2020-11-02;"Bratislavský kraj";202;3365;22;3387;NA;329193;224;2020-11-02;6911
2020-11-01;"Bratislavský kraj";85;8694;39;8733;NA;329193;124;2020-11-01;6687
2022-04-03;"Košický kraj";208;289;67;356;227770;334322;275;2022-04-03;334322
2022-04-02;"Košický kraj";331;383;63;446;NA;334322;394;2022-04-02;334047
2022-04-01;"Košický kraj";714;1438;191;1629;NA;334322;905;2022-04-01;333653
2022-03-31;"Košický kraj";745;1763;193;1956;NA;334322;938;2022-03-31;332748
2022-03-30;"Košický kraj";1081;2127;236;2363;NA;334322;1317;2022-03-30;331810
2022-03-29;"Košický kraj";683;2377;317;2694;NA;334322;1000;2022-03-29;330493
2022-03-28;"Košický kraj";886;3359;443;3802;NA;334322;1329;2022-03-28;329493
2022-03-27;"Košický kraj";355;1168;230;1398;NA;334322;585;2022-03-27;328164
2022-03-26;"Košický kraj";593;932;165;1097;NA;334322;758;2022-03-26;327579
2022-03-25;"Košický kraj";958;1819;316;2135;NA;334322;1274;2022-03-25;326821
2022-03-24;"Košický kraj";998;2422;324;2746;NA;334322;1322;2022-03-24;325547
2022-03-23;"Košický kraj";1143;2607;346;2953;NA;334322;1489;2022-03-23;324225
2022-03-22;"Košický kraj";1508;2756;378;3134;NA;334322;1886;2022-03-22;322736
2022-03-21;"Košický kraj";1241;3457;529;3986;NA;334322;1770;2022-03-21;320850
2022-03-20;"Košický kraj";199;1514;318;1832;NA;334322;517;2022-03-20;319080
2022-03-19;"Košický kraj";952;1133;241;1374;NA;334322;1193;2022-03-19;318563
2022-03-18;"Košický kraj";1382;2272;343;2615;NA;334322;1725;2022-03-18;317370
2022-03-17;"Košický kraj";1181;2717;358;3075;NA;334322;1539;2022-03-17;315645
2022-03-16;"Košický kraj";1631;4800;372;5172;NA;334322;2003;2022-03-16;314106
2022-03-15;"Košický kraj";1591;2885;436;3321;NA;334322;2027;2022-03-15;312103
2022-03-14;"Košický kraj";1424;3479;585;4064;NA;334322;2009;2022-03-14;310076
2022-03-13;"Košický kraj";565;1711;375;2086;NA;334322;940;2022-03-13;308067
2022-03-12;"Košický kraj";1227;1263;218;1481;NA;334322;1445;2022-03-12;307127
2022-03-11;"Košický kraj";1451;2815;513;3328;NA;334322;1964;2022-03-11;305682
2022-03-10;"Košický kraj";990;3153;406;3559;NA;334322;1396;2022-03-10;303718
2022-03-09;"Košický kraj";1545;3322;397;3719;NA;334322;1942;2022-03-09;302322
2022-03-08;"Košický kraj";1487;3633;441;4074;NA;334322;1928;2022-03-08;300380
2022-03-07;"Košický kraj";1347;4964;713;5677;NA;334322;2060;2022-03-07;298452
2022-03-06;"Košický kraj";297;1811;372;2183;NA;334322;669;2022-03-06;296392
2022-03-05;"Košický kraj";874;1317;264;1581;NA;334322;1138;2022-03-05;295723
2022-03-04;"Košický kraj";1255;3126;424;3550;NA;334322;1679;2022-03-04;294585
2022-03-03;"Košický kraj";1111;3543;433;3976;NA;334322;1544;2022-03-03;292906
2022-03-02;"Košický kraj";1458;3437;455;3892;NA;334322;1913;2022-03-02;291362
2022-03-01;"Košický kraj";1723;3716;487;4203;NA;334322;2210;2022-03-01;289449
2022-02-28;"Košický kraj";1345;5497;805;6302;NA;334322;2150;2022-02-28;287239
2022-02-27;"Košický kraj";465;2397;440;2837;NA;334322;905;2022-02-27;285089
2022-02-26;"Košický kraj";979;1348;329;1677;NA;334322;1308;2022-02-26;284184
2022-02-25;"Košický kraj";1691;3274;510;3784;NA;334322;2201;2022-02-25;282876
2022-02-24;"Košický kraj";1988;4033;594;4627;NA;334322;2582;2022-02-24;280675
2022-02-23;"Košický kraj";1787;4151;558;4709;NA;334322;2345;2022-02-23;278093
2022-02-22;"Košický kraj";2649;4695;660;5355;NA;334322;3309;2022-02-22;275748
2022-02-21;"Košický kraj";1646;6499;910;7409;NA;334322;2556;2022-02-21;272439
2022-02-20;"Košický kraj";577;2919;578;3497;NA;334322;1155;2022-02-20;269883
2022-02-19;"Košický kraj";1941;2169;409;2578;NA;334322;2350;2022-02-19;268728
2022-02-18;"Košický kraj";2210;4534;640;5174;NA;334322;2850;2022-02-18;266378
2022-02-17;"Košický kraj";2555;4668;675;5343;NA;334322;3230;2022-02-17;263528
2022-02-16;"Košický kraj";2153;5477;736;6213;NA;334322;2889;2022-02-16;260298
2022-02-15;"Košický kraj";2768;5507;830;6337;NA;334322;3598;2022-02-15;257409
2022-02-14;"Košický kraj";2337;8076;1104;9180;NA;334322;3441;2022-02-14;253811
2022-02-13;"Košický kraj";1235;4248;809;5057;NA;334322;2044;2022-02-13;250370
2022-02-12;"Košický kraj";1728;2014;524;2538;NA;334322;2252;2022-02-12;248326
2022-02-11;"Košický kraj";2665;4797;633;5430;NA;334322;3298;2022-02-11;246074
2022-02-10;"Košický kraj";2135;5323;728;6051;NA;334322;2863;2022-02-10;242776
2022-02-09;"Košický kraj";2067;5940;743;6683;NA;334322;2810;2022-02-09;239913
2022-02-08;"Košický kraj";2993;6143;762;6905;NA;334322;3755;2022-02-08;237103
2022-02-07;"Košický kraj";1939;7973;978;8951;NA;334322;2917;2022-02-07;233348
2022-02-06;"Košický kraj";998;4482;680;5162;NA;334322;1678;2022-02-06;230431
2022-02-05;"Košický kraj";2209;2454;434;2888;NA;334322;2643;2022-02-05;228753
2022-02-04;"Košický kraj";2563;5634;632;6266;NA;334322;3195;2022-02-04;226110
2022-02-03;"Košický kraj";1916;6379;659;7038;NA;334322;2575;2022-02-03;222915
2022-02-02;"Košický kraj";2498;6923;629;7552;NA;334322;3127;2022-02-02;220340
2022-02-01;"Košický kraj";2173;6706;678;7384;NA;334322;2851;2022-02-01;217213
2022-01-31;"Košický kraj";2020;9960;841;10801;NA;334322;2861;2022-01-31;214362
2022-01-30;"Košický kraj";1002;5716;541;6257;NA;334322;1543;2022-01-30;211501
2022-01-29;"Košický kraj";1731;2720;387;3107;NA;334322;2118;2022-01-29;209958
2022-01-28;"Košický kraj";1743;5571;492;6063;NA;334322;2235;2022-01-28;207840
2022-01-27;"Košický kraj";1553;5792;413;6205;NA;334322;1966;2022-01-27;205605
2022-01-26;"Košický kraj";1683;5613;399;6012;NA;334322;2082;2022-01-26;203639
2022-01-25;"Košický kraj";1409;6210;404;6614;NA;334322;1813;2022-01-25;201557
2022-01-24;"Košický kraj";1141;8669;431;9100;NA;334322;1572;2022-01-24;199744
2022-01-23;"Košický kraj";516;5418;287;5705;NA;334322;803;2022-01-23;198172
2022-01-22;"Košický kraj";914;2528;177;2705;NA;334322;1091;2022-01-22;197369
2022-01-21;"Košický kraj";589;5194;227;5421;NA;334322;816;2022-01-21;196278
2022-01-20;"Košický kraj";769;5379;200;5579;NA;334322;969;2022-01-20;195462
2022-01-19;"Košický kraj";629;5329;178;5507;NA;334322;807;2022-01-19;194493
2022-01-18;"Košický kraj";716;5758;140;5898;NA;334322;856;2022-01-18;193686
2022-01-17;"Košický kraj";486;9004;187;9191;NA;334322;673;2022-01-17;192830
2022-01-16;"Košický kraj";51;5264;137;5401;NA;334322;188;2022-01-16;192157
2022-01-15;"Košický kraj";422;2208;69;2277;NA;334322;491;2022-01-15;191969
2022-01-14;"Košický kraj";175;4208;93;4301;NA;334322;268;2022-01-14;191478
2022-01-13;"Košický kraj";165;4919;77;4996;NA;334322;242;2022-01-13;191210
2022-01-12;"Košický kraj";295;4609;78;4687;NA;334322;373;2022-01-12;190968
2022-01-11;"Košický kraj";349;5295;70;5365;NA;334322;419;2022-01-11;190595
2022-01-10;"Košický kraj";290;8254;128;8382;NA;334322;418;2022-01-10;190176
2022-01-09;"Košický kraj";230;5838;86;5924;NA;334322;316;2022-01-09;189758
2022-01-08;"Košický kraj";157;2417;57;2474;NA;334322;214;2022-01-08;189442
2022-01-07;"Košický kraj";388;5017;129;5146;NA;334322;517;2022-01-07;189228
2022-01-06;"Košický kraj";118;1576;55;1631;NA;334322;173;2022-01-06;188711
2022-01-05;"Košický kraj";354;5082;102;5184;NA;334322;456;2022-01-05;188538
2022-01-04;"Košický kraj";450;5273;84;5357;NA;334322;534;2022-01-04;188082
2022-01-03;"Košický kraj";439;7970;140;8110;NA;334322;579;2022-01-03;187548
2022-01-02;"Košický kraj";284;4614;109;4723;NA;334322;393;2022-01-02;186969
2022-01-01;"Košický kraj";28;360;18;378;NA;334322;46;2022-01-01;186576
2021-12-31;"Košický kraj";122;2999;86;3085;NA;334322;208;2021-12-31;186530
2021-12-30;"Košický kraj";401;3949;118;4067;NA;334322;519;2021-12-30;186322
2021-12-29;"Košický kraj";378;4194;111;4305;NA;334322;489;2021-12-29;185803
2021-12-28;"Košický kraj";509;4450;125;4575;NA;334322;634;2021-12-28;185314
2021-12-27;"Košický kraj";495;6822;205;7027;NA;334322;700;2021-12-27;184680
2021-12-26;"Košický kraj";109;2510;115;2625;NA;334322;224;2021-12-26;183980
2021-12-25;"Košický kraj";30;644;43;687;NA;334322;73;2021-12-25;183756
2021-12-24;"Košický kraj";95;1055;50;1105;NA;334322;145;2021-12-24;183683
2021-12-23;"Košický kraj";644;4479;131;4610;NA;334322;775;2021-12-23;183538
2021-12-22;"Košický kraj";224;4309;106;4415;NA;334322;330;2021-12-22;182763
2021-12-21;"Košický kraj";544;6491;138;6629;NA;334322;682;2021-12-21;182433
2021-12-20;"Košický kraj";464;8630;196;8826;NA;334322;660;2021-12-20;181751
2021-12-19;"Košický kraj";137;5447;177;5624;NA;334322;314;2021-12-19;181091
2021-12-18;"Košický kraj";414;2555;102;2657;NA;334322;516;2021-12-18;180777
2021-12-17;"Košický kraj";428;4832;145;4977;NA;334322;573;2021-12-17;180261
2021-12-16;"Košický kraj";476;5845;168;6013;NA;334322;644;2021-12-16;179688
2021-12-15;"Košický kraj";508;5956;172;6128;NA;334322;680;2021-12-15;179044
2021-12-14;"Košický kraj";957;5789;172;5961;NA;334322;1129;2021-12-14;178364
2021-12-13;"Košický kraj";679;9657;248;9905;NA;334322;927;2021-12-13;177235
2021-12-12;"Košický kraj";243;6657;198;6855;NA;334322;441;2021-12-12;176308
2021-12-11;"Košický kraj";519;2996;134;3130;NA;334322;653;2021-12-11;175867
2021-12-10;"Košický kraj";936;5465;185;5650;NA;334322;1121;2021-12-10;175214
2021-12-09;"Košický kraj";755;5779;198;5977;NA;334322;953;2021-12-09;174093
2021-12-08;"Košický kraj";1095;6574;275;6849;NA;334322;1370;2021-12-08;173140
2021-12-07;"Košický kraj";1212;6323;267;6590;NA;334322;1479;2021-12-07;171770
2021-12-06;"Košický kraj";904;10627;313;10940;NA;334322;1217;2021-12-06;170291
2021-12-05;"Košický kraj";404;7756;263;8019;NA;334322;667;2021-12-05;169074
2021-12-04;"Košický kraj";1007;3097;180;3277;NA;334322;1187;2021-12-04;168407
2021-12-03;"Košický kraj";1338;6065;271;6336;NA;334322;1609;2021-12-03;167220
2021-12-02;"Košický kraj";2209;5654;302;5956;NA;334322;2511;2021-12-02;165611
2021-12-01;"Košický kraj";1016;6483;388;6871;NA;334322;1404;2021-12-01;163100
2021-11-30;"Košický kraj";1125;8173;471;8644;NA;334322;1596;2021-11-30;161696
2021-11-29;"Košický kraj";993;14057;634;14691;NA;334322;1627;2021-11-29;160100
2021-11-28;"Košický kraj";972;10211;473;10684;NA;334322;1445;2021-11-28;158473
2021-11-27;"Košický kraj";1103;3566;219;3785;NA;334322;1322;2021-11-27;157028
2021-11-26;"Košický kraj";1395;6059;383;6442;NA;334322;1778;2021-11-26;155706
2021-11-25;"Košický kraj";1373;7016;499;7515;NA;334322;1872;2021-11-25;153928
2021-11-24;"Košický kraj";1194;7067;473;7540;NA;334322;1667;2021-11-24;152056
2021-11-23;"Košický kraj";1178;7185;488;7673;NA;334322;1666;2021-11-23;150389
2021-11-22;"Košický kraj";861;10709;741;11450;NA;334322;1602;2021-11-22;148723
2021-11-21;"Košický kraj";985;7394;657;8051;NA;334322;1642;2021-11-21;147121
2021-11-20;"Košický kraj";1083;2859;295;3154;NA;334322;1378;2021-11-20;145479
2021-11-19;"Košický kraj";1078;7543;516;8059;NA;334322;1594;2021-11-19;144101
2021-11-18;"Košický kraj";1061;9410;719;10129;NA;334322;1780;2021-11-18;142507
2021-11-17;"Košický kraj";1319;2824;262;3086;NA;334322;1581;2021-11-17;140727
2021-11-16;"Košický kraj";1484;7135;543;7678;NA;334322;2027;2021-11-16;139146
2021-11-15;"Košický kraj";902;10812;754;11566;NA;334322;1656;2021-11-15;137119
2021-11-14;"Košický kraj";715;5756;455;6211;NA;334322;1170;2021-11-14;135463
2021-11-13;"Košický kraj";869;2686;312;2998;NA;334322;1181;2021-11-13;134293
2021-11-12;"Košický kraj";1132;5616;410;6026;NA;334322;1542;2021-11-12;133112
2021-11-11;"Košický kraj";1035;6139;460;6599;NA;334322;1495;2021-11-11;131570
2021-11-10;"Košický kraj";933;6633;497;7130;NA;334322;1430;2021-11-10;130075
2021-11-09;"Košický kraj";967;5540;389;5929;NA;334322;1356;2021-11-09;128645
2021-11-08;"Košický kraj";701;7838;601;8439;NA;334322;1302;2021-11-08;127289
2021-11-07;"Košický kraj";691;4578;425;5003;NA;334322;1116;2021-11-07;125987
2021-11-06;"Košický kraj";996;2276;217;2493;NA;334322;1213;2021-11-06;124871
2021-11-05;"Košický kraj";1029;4905;367;5272;NA;334322;1396;2021-11-05;123658
2021-11-04;"Košický kraj";1000;5354;360;5714;NA;334322;1360;2021-11-04;122262
2021-11-03;"Košický kraj";1051;5749;361;6110;NA;334322;1412;2021-11-03;120902
2021-11-02;"Košický kraj";915;8775;566;9341;NA;334322;1481;2021-11-02;119490
2021-11-01;"Košický kraj";181;1999;265;2264;NA;334322;446;2021-11-01;118009
2021-10-31;"Košický kraj";385;2337;227;2564;NA;334322;612;2021-10-31;117563
2021-10-30;"Košický kraj";641;2380;180;2560;NA;334322;821;2021-10-30;116951
2021-10-29;"Košický kraj";750;4608;289;4897;NA;334322;1039;2021-10-29;116130
2021-10-28;"Košický kraj";823;5115;255;5370;NA;334322;1078;2021-10-28;115091
2021-10-27;"Košický kraj";723;4831;259;5090;NA;334322;982;2021-10-27;114013
2021-10-26;"Košický kraj";618;5049;225;5274;NA;334322;843;2021-10-26;113031
2021-10-25;"Košický kraj";268;6747;292;7039;NA;334322;560;2021-10-25;112188
2021-10-24;"Košický kraj";170;3447;205;3652;NA;334322;375;2021-10-24;111628
2021-10-23;"Košický kraj";397;1953;86;2039;NA;334322;483;2021-10-23;111253
2021-10-22;"Košický kraj";474;4679;130;4809;NA;334322;604;2021-10-22;110770
2021-10-21;"Košický kraj";669;5094;172;5266;NA;334322;841;2021-10-21;110166
2021-10-20;"Košický kraj";398;4963;152;5115;NA;334322;550;2021-10-20;109325
2021-10-19;"Košický kraj";579;4870;161;5031;NA;334322;740;2021-10-19;108775
2021-10-18;"Košický kraj";180;7090;171;7261;NA;334322;351;2021-10-18;108035
2021-10-17;"Košický kraj";70;3614;125;3739;NA;334322;195;2021-10-17;107684
2021-10-16;"Košický kraj";312;1839;40;1879;NA;334322;352;2021-10-16;107489
2021-10-15;"Košický kraj";312;4530;77;4607;NA;334322;389;2021-10-15;107137
2021-10-14;"Košický kraj";327;4652;95;4747;NA;334322;422;2021-10-14;106748
2021-10-13;"Košický kraj";168;4168;88;4256;NA;334322;256;2021-10-13;106326
2021-10-12;"Košický kraj";391;4119;75;4194;NA;334322;466;2021-10-12;106070
2021-10-11;"Košický kraj";119;6351;121;6472;NA;334322;240;2021-10-11;105604
2021-10-10;"Košický kraj";104;2921;63;2984;NA;334322;167;2021-10-10;105364
2021-10-09;"Košický kraj";111;1687;43;1730;NA;334322;154;2021-10-09;105197
2021-10-08;"Košický kraj";274;4143;68;4211;NA;334322;342;2021-10-08;105043
2021-10-07;"Košický kraj";277;4399;74;4473;NA;334322;351;2021-10-07;104701
2021-10-06;"Košický kraj";178;4369;89;4458;NA;334322;267;2021-10-06;104350
2021-10-05;"Košický kraj";345;4542;78;4620;NA;334322;423;2021-10-05;104083
2021-10-04;"Košický kraj";122;6094;110;6204;NA;334322;232;2021-10-04;103660
2021-10-03;"Košický kraj";133;3176;74;3250;NA;334322;207;2021-10-03;103428
2021-10-02;"Košický kraj";124;2567;41;2608;NA;334322;165;2021-10-02;103221
2021-10-01;"Košický kraj";181;4251;73;4324;NA;334322;254;2021-10-01;103056
2021-09-30;"Košický kraj";244;4780;71;4851;NA;334322;315;2021-09-30;102802
2021-09-29;"Košický kraj";183;3824;64;3888;NA;334322;247;2021-09-29;102487
2021-09-28;"Košický kraj";303;4339;80;4419;NA;334322;383;2021-09-28;102240
2021-09-27;"Košický kraj";117;6358;77;6435;NA;334322;194;2021-09-27;101857
2021-09-26;"Košický kraj";13;2809;44;2853;NA;334322;57;2021-09-26;101663
2021-09-25;"Košický kraj";162;2521;35;2556;NA;334322;197;2021-09-25;101606
2021-09-24;"Košický kraj";183;4756;43;4799;NA;334322;226;2021-09-24;101409
2021-09-23;"Košický kraj";142;3880;51;3931;NA;334322;193;2021-09-23;101183
2021-09-22;"Košický kraj";151;4436;52;4488;NA;334322;203;2021-09-22;100990
2021-09-21;"Košický kraj";234;4441;44;4485;NA;334322;278;2021-09-21;100787
2021-09-20;"Košický kraj";158;6017;73;6090;NA;334322;231;2021-09-20;100509
2021-09-19;"Košický kraj";15;2487;30;2517;NA;334322;45;2021-09-19;100278
2021-09-18;"Košický kraj";187;2504;24;2528;NA;334322;211;2021-09-18;100233
2021-09-17;"Košický kraj";121;4797;41;4838;NA;334322;162;2021-09-17;100022
2021-09-16;"Košický kraj";228;4503;71;4574;NA;334322;299;2021-09-16;99860
2021-09-15;"Košický kraj";52;989;16;1005;NA;334322;68;2021-09-15;99561
2021-09-14;"Košický kraj";142;3456;47;3503;NA;334322;189;2021-09-14;99493
2021-09-13;"Košický kraj";96;4949;48;4997;NA;334322;144;2021-09-13;99304
2021-09-12;"Košický kraj";14;2003;31;2034;NA;334322;45;2021-09-12;99160
2021-09-11;"Košický kraj";105;2186;19;2205;NA;334322;124;2021-09-11;99115
2021-09-10;"Košický kraj";125;4293;42;4335;NA;334322;167;2021-09-10;98991
2021-09-09;"Košický kraj";115;3226;30;3256;NA;334322;145;2021-09-09;98824
2021-09-08;"Košický kraj";86;2753;36;2789;NA;334322;122;2021-09-08;98679
2021-09-07;"Košický kraj";79;2686;53;2739;NA;334322;132;2021-09-07;98557
2021-09-06;"Košický kraj";41;2786;36;2822;NA;334322;77;2021-09-06;98425
2021-09-05;"Košický kraj";52;1393;18;1411;NA;334322;70;2021-09-05;98348
2021-09-04;"Košický kraj";37;1678;12;1690;NA;334322;49;2021-09-04;98278
2021-09-03;"Košický kraj";47;2913;35;2948;NA;334322;82;2021-09-03;98229
2021-09-02;"Košický kraj";56;2686;26;2712;NA;334322;82;2021-09-02;98147
2021-09-01;"Košický kraj";95;629;13;642;NA;334322;108;2021-09-01;98065
2021-08-31;"Košický kraj";30;2525;22;2547;NA;334322;52;2021-08-31;97957
2021-08-30;"Košický kraj";8;2404;28;2432;NA;334322;36;2021-08-30;97905
2021-08-29;"Košický kraj";16;603;1;604;NA;334322;17;2021-08-29;97869
2021-08-28;"Košický kraj";14;2103;11;2114;NA;334322;25;2021-08-28;97852
2021-08-27;"Košický kraj";22;2908;16;2924;NA;334322;38;2021-08-27;97827
2021-08-26;"Košický kraj";19;2292;13;2305;NA;334322;32;2021-08-26;97789
2021-08-25;"Košický kraj";33;2010;6;2016;NA;334322;39;2021-08-25;97757
2021-08-24;"Košický kraj";14;2337;3;2340;NA;334322;17;2021-08-24;97718
2021-08-23;"Košický kraj";33;2461;5;2466;NA;334322;38;2021-08-23;97701
2021-08-22;"Košický kraj";4;1457;8;1465;NA;334322;12;2021-08-22;97663
2021-08-21;"Košický kraj";35;2134;5;2139;NA;334322;40;2021-08-21;97651
2021-08-20;"Košický kraj";13;3215;5;3220;NA;334322;18;2021-08-20;97611
2021-08-19;"Košický kraj";14;2178;6;2184;NA;334322;20;2021-08-19;97593
2021-08-18;"Košický kraj";30;1827;8;1835;NA;334322;38;2021-08-18;97573
2021-08-17;"Košický kraj";24;1619;3;1622;NA;334322;27;2021-08-17;97535
2021-08-16;"Košický kraj";3;2236;10;2246;NA;334322;13;2021-08-16;97508
2021-08-15;"Košický kraj";1;778;5;783;NA;334322;6;2021-08-15;97495
2021-08-14;"Košický kraj";15;1222;1;1223;NA;334322;16;2021-08-14;97489
2021-08-13;"Košický kraj";14;1928;8;1936;NA;334322;22;2021-08-13;97473
2021-08-12;"Košický kraj";10;1248;3;1251;NA;334322;13;2021-08-12;97451
2021-08-11;"Košický kraj";6;1368;5;1373;NA;334322;11;2021-08-11;97438
2021-08-10;"Košický kraj";10;1352;8;1360;NA;334322;18;2021-08-10;97427
2021-08-09;"Košický kraj";12;1651;3;1654;NA;334322;15;2021-08-09;97409
2021-08-08;"Košický kraj";8;688;1;689;NA;334322;9;2021-08-08;97394
2021-08-07;"Košický kraj";3;1125;3;1128;NA;334322;6;2021-08-07;97385
2021-08-06;"Košický kraj";9;1614;6;1620;NA;334322;15;2021-08-06;97379
2021-08-05;"Košický kraj";26;1254;6;1260;NA;334322;32;2021-08-05;97364
2021-08-04;"Košický kraj";8;1373;5;1378;NA;334322;13;2021-08-04;97332
2021-08-03;"Košický kraj";33;1121;3;1124;NA;334322;36;2021-08-03;97319
2021-08-02;"Košický kraj";6;1702;8;1710;NA;334322;14;2021-08-02;97283
2021-08-01;"Košický kraj";1;662;1;663;NA;334322;2;2021-08-01;97269
2021-07-31;"Košický kraj";17;1153;2;1155;NA;334322;19;2021-07-31;97267
2021-07-30;"Košický kraj";12;1657;7;1664;NA;334322;19;2021-07-30;97248
2021-07-29;"Košický kraj";7;1242;5;1247;NA;334322;12;2021-07-29;97229
2021-07-28;"Košický kraj";15;956;5;961;NA;334322;20;2021-07-28;97217
2021-07-27;"Košický kraj";17;1180;7;1187;NA;334322;24;2021-07-27;97197
2021-07-26;"Košický kraj";3;1666;9;1675;NA;334322;12;2021-07-26;97173
2021-07-25;"Košický kraj";0;719;3;722;NA;334322;3;2021-07-25;97161
2021-07-24;"Košický kraj";18;996;4;1000;NA;334322;22;2021-07-24;97158
2021-07-23;"Košický kraj";9;1524;5;1529;NA;334322;14;2021-07-23;97136
2021-07-22;"Košický kraj";1;1254;4;1258;NA;334322;5;2021-07-22;97122
2021-07-21;"Košický kraj";4;1117;3;1120;NA;334322;7;2021-07-21;97117
2021-07-20;"Košický kraj";6;1355;1;1356;NA;334322;7;2021-07-20;97110
2021-07-19;"Košický kraj";2;1517;2;1519;NA;334322;4;2021-07-19;97103
2021-07-18;"Košický kraj";0;644;0;644;NA;334322;0;2021-07-18;97099
2021-07-17;"Košický kraj";3;1101;5;1106;NA;334322;8;2021-07-17;97099
2021-07-16;"Košický kraj";3;1609;4;1613;NA;334322;7;2021-07-16;97091
2021-07-15;"Košický kraj";4;1383;4;1387;NA;334322;8;2021-07-15;97084
2021-07-14;"Košický kraj";2;1175;4;1179;NA;334322;6;2021-07-14;97076
2021-07-13;"Košický kraj";4;1331;1;1332;NA;334322;5;2021-07-13;97070
2021-07-12;"Košický kraj";3;1894;3;1897;NA;334322;6;2021-07-12;97065
2021-07-11;"Košický kraj";1;537;2;539;NA;334322;3;2021-07-11;97059
2021-07-10;"Košický kraj";9;1167;0;1167;NA;334322;9;2021-07-10;97056
2021-07-09;"Košický kraj";5;2005;5;2010;NA;334322;10;2021-07-09;97047
2021-07-08;"Košický kraj";13;1282;2;1284;NA;334322;15;2021-07-08;97037
2021-07-07;"Košický kraj";6;1524;1;1525;NA;334322;7;2021-07-07;97022
2021-07-06;"Košický kraj";4;1886;2;1888;NA;334322;6;2021-07-06;97015
2021-07-05;"Košický kraj";1;573;1;574;NA;334322;2;2021-07-05;97009
2021-07-04;"Košický kraj";0;482;2;484;NA;334322;2;2021-07-04;97007
2021-07-03;"Košický kraj";2;1227;0;1227;NA;334322;2;2021-07-03;97005
2021-07-02;"Košický kraj";2;1883;3;1886;NA;334322;5;2021-07-02;97003
2021-07-01;"Košický kraj";0;1211;2;1213;NA;334322;2;2021-07-01;96998
2021-06-30;"Košický kraj";5;9306;7;9313;NA;334322;12;2021-06-30;96996
2021-06-29;"Košický kraj";6;5692;7;5699;NA;334322;13;2021-06-29;96984
2021-06-28;"Košický kraj";5;6129;2;6131;NA;334322;7;2021-06-28;96971
2021-06-27;"Košický kraj";8;4636;3;4639;NA;334322;11;2021-06-27;96964
2021-06-26;"Košický kraj";4;5699;14;5713;NA;334322;18;2021-06-26;96953
2021-06-25;"Košický kraj";5;6981;2;6983;NA;334322;7;2021-06-25;96935
2021-06-24;"Košický kraj";1;5072;3;5075;NA;334322;4;2021-06-24;96928
2021-06-23;"Košický kraj";8;5373;3;5376;NA;334322;11;2021-06-23;96924
2021-06-22;"Košický kraj";1;5269;3;5272;NA;334322;4;2021-06-22;96913
2021-06-21;"Košický kraj";5;6830;11;6841;NA;334322;16;2021-06-21;96909
2021-06-20;"Košický kraj";0;4882;6;4888;NA;334322;6;2021-06-20;96893
2021-06-19;"Košický kraj";7;6473;1;6474;NA;334322;8;2021-06-19;96887
2021-06-18;"Košický kraj";4;7969;8;7977;NA;334322;12;2021-06-18;96879
2021-06-17;"Košický kraj";6;6128;3;6131;NA;334322;9;2021-06-17;96867
2021-06-16;"Košický kraj";11;6059;7;6066;NA;334322;18;2021-06-16;96858
2021-06-15;"Košický kraj";12;6301;2;6303;NA;334322;14;2021-06-15;96840
2021-06-14;"Košický kraj";10;7076;9;7085;NA;334322;19;2021-06-14;96826
2021-06-13;"Košický kraj";7;6948;8;6956;NA;334322;15;2021-06-13;96807
2021-06-12;"Košický kraj";7;7485;9;7494;NA;334322;16;2021-06-12;96792
2021-06-11;"Košický kraj";15;8973;6;8979;NA;334322;21;2021-06-11;96776
2021-06-10;"Košický kraj";11;6588;16;6604;NA;334322;27;2021-06-10;96755
2021-06-09;"Košický kraj";37;6056;7;6063;NA;334322;44;2021-06-09;96728
2021-06-08;"Košický kraj";33;7019;13;7032;NA;334322;46;2021-06-08;96684
2021-06-07;"Košický kraj";11;8106;22;8128;NA;334322;33;2021-06-07;96638
2021-06-06;"Košický kraj";1;7843;7;7850;NA;334322;8;2021-06-06;96605
2021-06-05;"Košický kraj";21;9286;3;9289;NA;334322;24;2021-06-05;96597
2021-06-04;"Košický kraj";26;11418;20;11438;NA;334322;46;2021-06-04;96573
2021-06-03;"Košický kraj";23;6467;14;6481;NA;334322;37;2021-06-03;96527
2021-06-02;"Košický kraj";15;7180;24;7204;NA;334322;39;2021-06-02;96490
2021-06-01;"Košický kraj";13;7562;10;7572;NA;334322;23;2021-06-01;96451
2021-05-31;"Košický kraj";13;9256;18;9274;NA;334322;31;2021-05-31;96428
2021-05-30;"Košický kraj";3;11215;10;11225;NA;334322;13;2021-05-30;96397
2021-05-29;"Košický kraj";25;10942;22;10964;NA;334322;47;2021-05-29;96384
2021-05-28;"Košický kraj";17;13055;29;13084;NA;334322;46;2021-05-28;96337
2021-05-27;"Košický kraj";19;7924;26;7950;NA;334322;45;2021-05-27;96291
2021-05-26;"Košický kraj";35;8118;27;8145;NA;334322;62;2021-05-26;96246
2021-05-25;"Košický kraj";33;9296;29;9325;NA;334322;62;2021-05-25;96184
2021-05-24;"Košický kraj";10;10855;27;10882;NA;334322;37;2021-05-24;96122
2021-05-23;"Košický kraj";4;12151;15;12166;NA;334322;19;2021-05-23;96085
2021-05-22;"Košický kraj";27;12601;19;12620;NA;334322;46;2021-05-22;96066
2021-05-21;"Košický kraj";24;14910;27;14937;NA;334322;51;2021-05-21;96020
2021-05-20;"Košický kraj";20;9422;28;9450;NA;334322;48;2021-05-20;95969
2021-05-19;"Košický kraj";30;10421;21;10442;NA;334322;51;2021-05-19;95921
2021-05-18;"Košický kraj";34;10254;36;10290;NA;334322;70;2021-05-18;95870
2021-05-17;"Košický kraj";20;12686;38;12724;NA;334322;58;2021-05-17;95800
2021-05-16;"Košický kraj";37;17865;20;17885;NA;334322;57;2021-05-16;95742
2021-05-15;"Košický kraj";22;25602;28;25630;NA;334322;50;2021-05-15;95685
2021-05-14;"Košický kraj";32;21824;42;21866;NA;334322;74;2021-05-14;95635
2021-05-13;"Košický kraj";39;10172;32;10204;NA;334322;71;2021-05-13;95561
2021-05-12;"Košický kraj";85;10868;33;10901;NA;334322;118;2021-05-12;95490
2021-05-11;"Košický kraj";68;11166;32;11198;NA;334322;100;2021-05-11;95372
2021-05-10;"Košický kraj";25;17044;42;17086;NA;334322;67;2021-05-10;95272
2021-05-09;"Košický kraj";84;25594;55;25649;NA;334322;139;2021-05-09;95205
2021-05-08;"Košický kraj";18;23399;23;23422;NA;334322;41;2021-05-08;95066
2021-05-07;"Košický kraj";51;24497;57;24554;NA;334322;108;2021-05-07;95025
2021-05-06;"Košický kraj";55;11847;43;11890;NA;334322;98;2021-05-06;94917
2021-05-05;"Košický kraj";23;12124;35;12159;NA;334322;58;2021-05-05;94819
2021-05-04;"Košický kraj";143;13562;38;13600;NA;334322;181;2021-05-04;94761
2021-05-03;"Košický kraj";37;16944;68;17012;NA;334322;105;2021-05-03;94580
2021-05-02;"Košický kraj";45;36096;56;36152;NA;334322;101;2021-05-02;94475
2021-05-01;"Košický kraj";54;52075;76;52151;NA;334322;130;2021-05-01;94374
2021-04-30;"Košický kraj";59;44602;94;44696;NA;334322;153;2021-04-30;94244
2021-04-29;"Košický kraj";76;17014;53;17067;NA;334322;129;2021-04-29;94091
2021-04-28;"Košický kraj";99;17970;52;18022;NA;334322;151;2021-04-28;93962
2021-04-27;"Košický kraj";108;20670;43;20713;NA;334322;151;2021-04-27;93811
2021-04-26;"Košický kraj";39;25915;96;26011;NA;334322;135;2021-04-26;93660
2021-04-25;"Košický kraj";23;48355;57;48412;NA;334322;80;2021-04-25;93525
2021-04-24;"Košický kraj";68;90124;114;90238;NA;334322;182;2021-04-24;93445
2021-04-23;"Košický kraj";110;41232;72;41304;NA;334322;182;2021-04-23;93263
2021-04-22;"Košický kraj";56;16772;44;16816;NA;334322;100;2021-04-22;93081
2021-04-21;"Košický kraj";114;19519;61;19580;NA;334322;175;2021-04-21;92981
2021-04-20;"Košický kraj";81;25432;63;25495;NA;334322;144;2021-04-20;92806
2021-04-19;"Košický kraj";93;29950;108;30058;NA;334322;201;2021-04-19;92662
2021-04-18;"Košický kraj";10;48913;82;48995;NA;334322;92;2021-04-18;92461
2021-04-17;"Košický kraj";187;83856;103;83959;NA;334322;290;2021-04-17;92369
2021-04-16;"Košický kraj";83;41568;127;41695;NA;334322;210;2021-04-16;92079
2021-04-15;"Košický kraj";104;18522;93;18615;NA;334322;197;2021-04-15;91869
2021-04-14;"Košický kraj";119;20089;64;20153;NA;334322;183;2021-04-14;91672
2021-04-13;"Košický kraj";81;23175;120;23295;NA;334322;201;2021-04-13;91489
2021-04-12;"Košický kraj";129;26573;124;26697;NA;334322;253;2021-04-12;91288
2021-04-11;"Košický kraj";29;46949;80;47029;NA;334322;109;2021-04-11;91035
2021-04-10;"Košický kraj";138;100114;183;100297;NA;334322;321;2021-04-10;90926
2021-04-09;"Košický kraj";168;35206;133;35339;NA;334322;301;2021-04-09;90605
2021-04-08;"Košický kraj";81;18530;90;18620;NA;334322;171;2021-04-08;90304
2021-04-07;"Košický kraj";232;28027;194;28221;NA;334322;426;2021-04-07;90133
2021-04-06;"Košický kraj";121;36495;164;36659;NA;334322;285;2021-04-06;89707
2021-04-05;"Košický kraj";19;14361;66;14427;NA;334322;85;2021-04-05;89422
2021-04-04;"Košický kraj";33;15089;66;15155;NA;334322;99;2021-04-04;89337
2021-04-03;"Košický kraj";138;97664;241;97905;NA;334322;379;2021-04-03;89238
2021-04-02;"Košický kraj";128;24515;76;24591;NA;334322;204;2021-04-02;88859
2021-04-01;"Košický kraj";165;46151;156;46307;NA;334322;321;2021-04-01;88655
2021-03-31;"Košický kraj";160;29659;124;29783;NA;334322;284;2021-03-31;88334
2021-03-30;"Košický kraj";229;24038;163;24201;NA;334322;392;2021-03-30;88050
2021-03-29;"Košický kraj";78;28843;194;29037;NA;334322;272;2021-03-29;87658
2021-03-28;"Košický kraj";39;44263;128;44391;NA;334322;167;2021-03-28;87386
2021-03-27;"Košický kraj";222;96602;265;96867;NA;334322;487;2021-03-27;87219
2021-03-26;"Košický kraj";233;45252;202;45454;NA;334322;435;2021-03-26;86732
2021-03-25;"Košický kraj";133;23804;175;23979;NA;334322;308;2021-03-25;86297
2021-03-24;"Košický kraj";165;20696;155;20851;NA;334322;320;2021-03-24;85989
2021-03-23;"Košický kraj";202;22434;192;22626;NA;334322;394;2021-03-23;85669
2021-03-22;"Košický kraj";169;26890;228;27118;NA;334322;397;2021-03-22;85275
2021-03-21;"Košický kraj";109;46746;167;46913;NA;334322;276;2021-03-21;84878
2021-03-20;"Košický kraj";126;101334;311;101645;NA;334322;437;2021-03-20;84602
2021-03-19;"Košický kraj";205;45632;260;45892;NA;334322;465;2021-03-19;84165
2021-03-18;"Košický kraj";274;23827;212;24039;NA;334322;486;2021-03-18;83700
2021-03-17;"Košický kraj";177;21548;195;21743;NA;334322;372;2021-03-17;83214
2021-03-16;"Košický kraj";386;23454;226;23680;NA;334322;612;2021-03-16;82842
2021-03-15;"Košický kraj";173;27900;297;28197;NA;334322;470;2021-03-15;82230
2021-03-14;"Košický kraj";145;44354;220;44574;NA;334322;365;2021-03-14;81760
2021-03-13;"Košický kraj";146;103790;483;104273;NA;334322;629;2021-03-13;81395
2021-03-12;"Košický kraj";366;47871;321;48192;NA;334322;687;2021-03-12;80766
2021-03-11;"Košický kraj";396;23229;263;23492;NA;334322;659;2021-03-11;80079
2021-03-10;"Košický kraj";121;22205;269;22474;NA;334322;390;2021-03-10;79420
2021-03-09;"Košický kraj";676;24509;300;24809;NA;334322;976;2021-03-09;79030
2021-03-08;"Košický kraj";559;29852;344;30196;NA;334322;903;2021-03-08;78054
2021-03-07;"Košický kraj";45;44230;299;44529;NA;334322;344;2021-03-07;77151
2021-03-06;"Košický kraj";177;105598;532;106130;NA;334322;709;2021-03-06;76807
2021-03-05;"Košický kraj";439;45567;424;45991;NA;334322;863;2021-03-05;76098
2021-03-04;"Košický kraj";417;23862;320;24182;NA;334322;737;2021-03-04;75235
2021-03-03;"Košický kraj";390;23169;298;23467;NA;334322;688;2021-03-03;74498
2021-03-02;"Košický kraj";464;24158;368;24526;NA;334322;832;2021-03-02;73810
2021-03-01;"Košický kraj";389;30013;514;30527;NA;334322;903;2021-03-01;72978
2021-02-28;"Košický kraj";265;43053;334;43387;NA;334322;599;2021-02-28;72075
2021-02-27;"Košický kraj";301;100559;784;101343;NA;334322;1085;2021-02-27;71476
2021-02-26;"Košický kraj";440;45466;492;45958;NA;334322;932;2021-02-26;70391
2021-02-25;"Košický kraj";331;19872;342;20214;NA;334322;673;2021-02-25;69459
2021-02-24;"Košický kraj";263;18751;505;19256;NA;334322;768;2021-02-24;68786
2021-02-23;"Košický kraj";642;21605;341;21946;NA;334322;983;2021-02-23;68018
2021-02-22;"Košický kraj";362;30858;434;31292;NA;334322;796;2021-02-22;67035
2021-02-21;"Košický kraj";170;40464;385;40849;NA;334322;555;2021-02-21;66239
2021-02-20;"Košický kraj";283;92550;770;93320;NA;334322;1053;2021-02-20;65684
2021-02-19;"Košický kraj";507;41579;583;42162;NA;334322;1090;2021-02-19;64631
2021-02-18;"Košický kraj";397;18442;345;18787;NA;334322;742;2021-02-18;63541
2021-02-17;"Košický kraj";322;18080;387;18467;NA;334322;709;2021-02-17;62799
2021-02-16;"Košický kraj";600;22111;463;22574;NA;334322;1063;2021-02-16;62090
2021-02-15;"Košický kraj";216;27633;419;28052;NA;334322;635;2021-02-15;61027
2021-02-14;"Košický kraj";241;56743;524;57267;NA;334322;765;2021-02-14;60392
2021-02-13;"Košický kraj";206;93745;765;94510;NA;334322;971;2021-02-13;59627
2021-02-12;"Košický kraj";448;49924;611;50535;NA;334322;1059;2021-02-12;58656
2021-02-11;"Košický kraj";435;14524;323;14847;NA;334322;758;2021-02-11;57597
2021-02-10;"Košický kraj";360;18475;431;18906;NA;334322;791;2021-02-10;56839
2021-02-09;"Košický kraj";544;24841;463;25304;NA;334322;1007;2021-02-09;56048
2021-02-08;"Košický kraj";237;24836;392;25228;NA;334322;629;2021-02-08;55041
2021-02-07;"Košický kraj";208;56897;612;57509;NA;334322;820;2021-02-07;54412
2021-02-06;"Košický kraj";318;104357;884;105241;NA;334322;1202;2021-02-06;53592
2021-02-05;"Košický kraj";384;43186;494;43680;NA;334322;878;2021-02-05;52390
2021-02-04;"Košický kraj";391;14512;371;14883;NA;334322;762;2021-02-04;51512
2021-02-03;"Košický kraj";296;12599;339;12938;NA;334322;635;2021-02-03;50750
2021-02-02;"Košický kraj";473;43883;1212;45095;NA;334322;1685;2021-02-02;50115
2021-02-01;"Košický kraj";415;21984;362;22346;NA;334322;777;2021-02-01;48430
2021-01-31;"Košický kraj";142;54690;617;55307;NA;334322;759;2021-01-31;47653
2021-01-30;"Košický kraj";320;76722;661;77383;NA;334322;981;2021-01-30;46894
2021-01-29;"Košický kraj";311;37164;466;37630;NA;334322;777;2021-01-29;45913
2021-01-28;"Košický kraj";540;9006;244;9250;NA;334322;784;2021-01-28;45136
2021-01-27;"Košický kraj";265;7575;211;7786;NA;334322;476;2021-01-27;44352
2021-01-26;"Košický kraj";530;14210;245;14455;NA;334322;775;2021-01-26;43876
2021-01-25;"Košický kraj";226;26431;413;26844;NA;334322;639;2021-01-25;43101
2021-01-24;"Košický kraj";150;44419;581;45000;NA;334322;731;2021-01-24;42462
2021-01-23;"Košický kraj";232;82705;857;83562;NA;334322;1089;2021-01-23;41731
2021-01-22;"Košický kraj";316;19997;265;20262;NA;334322;581;2021-01-22;40642
2021-01-21;"Košický kraj";274;14053;159;14212;NA;334322;433;2021-01-21;40061
2021-01-20;"Košický kraj";374;10844;201;11045;NA;334322;575;2021-01-20;39628
2021-01-19;"Košický kraj";248;9717;181;9898;NA;334322;429;2021-01-19;39053
2021-01-18;"Košický kraj";333;7659;262;7921;NA;334322;595;2021-01-18;38624
2021-01-17;"Košický kraj";155;535;14;549;NA;334322;169;2021-01-17;38029
2021-01-16;"Košický kraj";153;1403;47;1450;NA;334322;200;2021-01-16;37860
2021-01-15;"Košický kraj";308;6443;213;6656;NA;334322;521;2021-01-15;37660
2021-01-14;"Košický kraj";358;5471;221;5692;NA;334322;579;2021-01-14;37139
2021-01-13;"Košický kraj";421;4897;226;5123;NA;334322;647;2021-01-13;36560
2021-01-12;"Košický kraj";482;6473;237;6710;NA;334322;719;2021-01-12;35913
2021-01-11;"Košický kraj";309;7553;286;7839;NA;334322;595;2021-01-11;35194
2021-01-10;"Košický kraj";193;136;6;142;NA;334322;199;2021-01-10;34599
2021-01-09;"Košický kraj";469;1134;45;1179;NA;334322;514;2021-01-09;34400
2021-01-08;"Košický kraj";551;7106;348;7454;NA;334322;899;2021-01-08;33886
2021-01-07;"Košický kraj";251;5853;398;6251;NA;334322;649;2021-01-07;32987
2021-01-06;"Košický kraj";442;429;33;462;NA;334322;475;2021-01-06;32338
2021-01-05;"Košický kraj";584;7633;527;8160;NA;334322;1111;2021-01-05;31863
2021-01-04;"Košický kraj";407;6479;660;7139;NA;334322;1067;2021-01-04;30752
2021-01-03;"Košický kraj";118;661;22;683;NA;334322;140;2021-01-03;29685
2021-01-02;"Košický kraj";88;440;52;492;NA;334322;140;2021-01-02;29545
2021-01-01;"Košický kraj";398;725;49;774;NA;334322;447;2021-01-01;29405
2020-12-31;"Košický kraj";625;7509;453;7962;NA;334322;1078;2020-12-31;28958
2020-12-30;"Košický kraj";590;6076;395;6471;NA;334322;985;2020-12-30;27880
2020-12-29;"Košický kraj";419;7454;596;8050;NA;334322;1015;2020-12-29;26895
2020-12-28;"Košický kraj";356;7933;756;8689;NA;334322;1112;2020-12-28;25880
2020-12-27;"Košický kraj";159;147;16;163;NA;334322;175;2020-12-27;24768
2020-12-26;"Košický kraj";163;274;23;297;NA;334322;186;2020-12-26;24593
2020-12-25;"Košický kraj";237;140;10;150;NA;334322;247;2020-12-25;24407
2020-12-24;"Košický kraj";564;1470;90;1560;NA;334322;654;2020-12-24;24160
2020-12-23;"Košický kraj";304;7339;327;7666;NA;334322;631;2020-12-23;23506
2020-12-22;"Košický kraj";438;7284;429;7713;NA;334322;867;2020-12-22;22875
2020-12-21;"Košický kraj";405;6703;504;7207;NA;334322;909;2020-12-21;22008
2020-12-20;"Košický kraj";215;73;11;84;NA;334322;226;2020-12-20;21099
2020-12-19;"Košický kraj";207;1309;63;1372;NA;334322;270;2020-12-19;20873
2020-12-18;"Košický kraj";310;7707;292;7999;NA;334322;602;2020-12-18;20603
2020-12-17;"Košický kraj";463;5101;253;5354;NA;334322;716;2020-12-17;20001
2020-12-16;"Košický kraj";455;5725;295;6020;NA;334322;750;2020-12-16;19285
2020-12-15;"Košický kraj";319;4787;327;5114;NA;334322;646;2020-12-15;18535
2020-12-14;"Košický kraj";256;2905;225;3130;NA;334322;481;2020-12-14;17889
2020-12-13;"Košický kraj";47;181;2;183;NA;334322;49;2020-12-13;17408
2020-12-12;"Košický kraj";369;1587;118;1705;NA;334322;487;2020-12-12;17359
2020-12-11;"Košický kraj";354;5328;256;5584;NA;334322;610;2020-12-11;16872
2020-12-10;"Košický kraj";283;3987;174;4161;NA;334322;457;2020-12-10;16262
2020-12-09;"Košický kraj";279;3786;166;3952;NA;334322;445;2020-12-09;15805
2020-12-08;"Košický kraj";226;4105;355;4460;NA;334322;581;2020-12-08;15360
2020-12-07;"Košický kraj";270;2383;106;2489;NA;334322;376;2020-12-07;14779
2020-12-06;"Košický kraj";121;482;33;515;NA;334322;154;2020-12-06;14403
2020-12-05;"Košický kraj";90;1096;48;1144;NA;334322;138;2020-12-05;14249
2020-12-04;"Košický kraj";224;2680;82;2762;NA;334322;306;2020-12-04;14111
2020-12-03;"Košický kraj";211;7717;173;7890;NA;334322;384;2020-12-03;13805
2020-12-02;"Košický kraj";193;8132;496;8628;NA;334322;689;2020-12-02;13421
2020-12-01;"Košický kraj";178;2237;124;2361;NA;334322;302;2020-12-01;12732
2020-11-30;"Košický kraj";171;3598;59;3657;NA;334322;230;2020-11-30;12430
2020-11-29;"Košický kraj";31;325;17;342;NA;334322;48;2020-11-29;12200
2020-11-28;"Košický kraj";69;721;52;773;NA;334322;121;2020-11-28;12152
2020-11-27;"Košický kraj";149;2921;78;2999;NA;334322;227;2020-11-27;12031
2020-11-26;"Košický kraj";239;1234;60;1294;NA;334322;299;2020-11-26;11804
2020-11-25;"Košický kraj";237;1785;123;1908;NA;334322;360;2020-11-25;11505
2020-11-24;"Košický kraj";196;1976;67;2043;NA;334322;263;2020-11-24;11145
2020-11-23;"Košický kraj";51;4115;63;4178;NA;334322;114;2020-11-23;10882
2020-11-22;"Košický kraj";57;57;5;62;NA;334322;62;2020-11-22;10768
2020-11-21;"Košický kraj";87;858;36;894;NA;334322;123;2020-11-21;10706
2020-11-20;"Košický kraj";176;3084;49;3133;NA;334322;225;2020-11-20;10583
2020-11-19;"Košický kraj";206;1736;48;1784;NA;334322;254;2020-11-19;10358
2020-11-18;"Košický kraj";122;532;17;549;NA;334322;139;2020-11-18;10104
2020-11-17;"Košický kraj";152;82;9;91;NA;334322;161;2020-11-17;9965
2020-11-16;"Košický kraj";114;596;27;623;NA;334322;141;2020-11-16;9804
2020-11-15;"Košický kraj";15;338;7;345;NA;334322;22;2020-11-15;9663
2020-11-14;"Košický kraj";234;520;12;532;NA;334322;246;2020-11-14;9641
2020-11-13;"Košický kraj";207;664;29;693;NA;334322;236;2020-11-13;9395
2020-11-12;"Košický kraj";192;736;13;749;NA;334322;205;2020-11-12;9159
2020-11-11;"Košický kraj";301;593;7;600;NA;334322;308;2020-11-11;8954
2020-11-10;"Košický kraj";190;541;11;552;NA;334322;201;2020-11-10;8646
2020-11-09;"Košický kraj";129;380;17;397;NA;334322;146;2020-11-09;8445
2020-11-08;"Košický kraj";78;1306;8;1314;NA;334322;86;2020-11-08;8299
2020-11-07;"Košický kraj";192;3909;22;3931;NA;334322;214;2020-11-07;8213
2020-11-06;"Košický kraj";195;5310;34;5344;NA;334322;229;2020-11-06;7999
2020-11-05;"Košický kraj";342;330;31;361;NA;334322;373;2020-11-05;7770
2020-11-04;"Košický kraj";101;154;6;160;NA;334322;107;2020-11-04;7397
2020-11-03;"Košický kraj";358;1122;13;1135;NA;334322;371;2020-11-03;7290
2020-11-02;"Košický kraj";111;6125;56;6181;NA;334322;167;2020-11-02;6919
2020-11-01;"Košický kraj";114;6522;34;6556;NA;334322;148;2020-11-01;6752
2022-04-03;"Nitriansky kraj";199;549;76;625;179179;275798;275;2022-04-03;275798
2022-04-02;"Nitriansky kraj";362;365;37;402;NA;275798;399;2022-04-02;275523
2022-04-01;"Nitriansky kraj";614;1018;121;1139;NA;275798;735;2022-04-01;275124
2022-03-31;"Nitriansky kraj";685;1533;154;1687;NA;275798;839;2022-03-31;274389
2022-03-30;"Nitriansky kraj";751;1205;126;1331;NA;275798;877;2022-03-30;273550
2022-03-29;"Nitriansky kraj";1187;1498;170;1668;NA;275798;1357;2022-03-29;272673
2022-03-28;"Nitriansky kraj";711;1924;274;2198;NA;275798;985;2022-03-28;271316
2022-03-27;"Nitriansky kraj";463;581;135;716;NA;275798;598;2022-03-27;270331
2022-03-26;"Nitriansky kraj";653;399;80;479;NA;275798;733;2022-03-26;269733
2022-03-25;"Nitriansky kraj";918;1116;206;1322;NA;275798;1124;2022-03-25;269000
2022-03-24;"Nitriansky kraj";1391;1234;186;1420;NA;275798;1577;2022-03-24;267876
2022-03-23;"Nitriansky kraj";1401;1428;225;1653;NA;275798;1626;2022-03-23;266299
2022-03-22;"Nitriansky kraj";1360;1533;191;1724;NA;275798;1551;2022-03-22;264673
2022-03-21;"Nitriansky kraj";1304;2098;334;2432;NA;275798;1638;2022-03-21;263122
2022-03-20;"Nitriansky kraj";552;933;226;1159;NA;275798;778;2022-03-20;261484
2022-03-19;"Nitriansky kraj";839;424;146;570;NA;275798;985;2022-03-19;260706
2022-03-18;"Nitriansky kraj";1205;1201;271;1472;NA;275798;1476;2022-03-18;259721
2022-03-17;"Nitriansky kraj";1734;1457;236;1693;NA;275798;1970;2022-03-17;258245
2022-03-16;"Nitriansky kraj";1214;1472;232;1704;NA;275798;1446;2022-03-16;256275
2022-03-15;"Nitriansky kraj";1590;1566;256;1822;NA;275798;1846;2022-03-15;254829
2022-03-14;"Nitriansky kraj";1325;2630;384;3014;NA;275798;1709;2022-03-14;252983
2022-03-13;"Nitriansky kraj";527;992;202;1194;NA;275798;729;2022-03-13;251274
2022-03-12;"Nitriansky kraj";711;739;169;908;NA;275798;880;2022-03-12;250545
2022-03-11;"Nitriansky kraj";1085;1890;365;2255;NA;275798;1450;2022-03-11;249665
2022-03-10;"Nitriansky kraj";1403;2015;313;2328;NA;275798;1716;2022-03-10;248215
2022-03-09;"Nitriansky kraj";1452;2118;323;2441;NA;275798;1775;2022-03-09;246499
2022-03-08;"Nitriansky kraj";1695;2542;350;2892;NA;275798;2045;2022-03-08;244724
2022-03-07;"Nitriansky kraj";1115;3386;521;3907;NA;275798;1636;2022-03-07;242679
2022-03-06;"Nitriansky kraj";566;1509;350;1859;NA;275798;916;2022-03-06;241043
2022-03-05;"Nitriansky kraj";614;1239;214;1453;NA;275798;828;2022-03-05;240127
2022-03-04;"Nitriansky kraj";1315;1597;323;1920;NA;275798;1638;2022-03-04;239299
2022-03-03;"Nitriansky kraj";1405;2944;379;3323;NA;275798;1784;2022-03-03;237661
2022-03-02;"Nitriansky kraj";1417;2717;422;3139;NA;275798;1839;2022-03-02;235877
2022-03-01;"Nitriansky kraj";1380;2422;412;2834;NA;275798;1792;2022-03-01;234038
2022-02-28;"Nitriansky kraj";1577;4819;599;5418;NA;275798;2176;2022-02-28;232246
2022-02-27;"Nitriansky kraj";797;1271;294;1565;NA;275798;1091;2022-02-27;230070
2022-02-26;"Nitriansky kraj";895;799;217;1016;NA;275798;1112;2022-02-26;228979
2022-02-25;"Nitriansky kraj";1400;2314;339;2653;NA;275798;1739;2022-02-25;227867
2022-02-24;"Nitriansky kraj";1592;3586;389;3975;NA;275798;1981;2022-02-24;226128
2022-02-23;"Nitriansky kraj";1885;3930;476;4406;NA;275798;2361;2022-02-23;224147
2022-02-22;"Nitriansky kraj";2323;3849;502;4351;NA;275798;2825;2022-02-22;221786
2022-02-21;"Nitriansky kraj";1593;6250;816;7066;NA;275798;2409;2022-02-21;218961
2022-02-20;"Nitriansky kraj";1049;1987;439;2426;NA;275798;1488;2022-02-20;216552
2022-02-19;"Nitriansky kraj";1084;1341;336;1677;NA;275798;1420;2022-02-19;215064
2022-02-18;"Nitriansky kraj";2021;3277;583;3860;NA;275798;2604;2022-02-18;213644
2022-02-17;"Nitriansky kraj";2134;3890;480;4370;NA;275798;2614;2022-02-17;211040
2022-02-16;"Nitriansky kraj";2152;3945;532;4477;NA;275798;2684;2022-02-16;208426
2022-02-15;"Nitriansky kraj";2093;4069;780;4849;NA;275798;2873;2022-02-15;205742
2022-02-14;"Nitriansky kraj";2094;6253;921;7174;NA;275798;3015;2022-02-14;202869
2022-02-13;"Nitriansky kraj";1146;2832;547;3379;NA;275798;1693;2022-02-13;199854
2022-02-12;"Nitriansky kraj";1301;1171;343;1514;NA;275798;1644;2022-02-12;198161
2022-02-11;"Nitriansky kraj";2042;2942;561;3503;NA;275798;2603;2022-02-11;196517
2022-02-10;"Nitriansky kraj";2374;3366;537;3903;NA;275798;2911;2022-02-10;193914
2022-02-09;"Nitriansky kraj";2133;4802;653;5455;NA;275798;2786;2022-02-09;191003
2022-02-08;"Nitriansky kraj";1801;4935;736;5671;NA;275798;2537;2022-02-08;188217
2022-02-07;"Nitriansky kraj";2240;6803;762;7565;NA;275798;3002;2022-02-07;185680
2022-02-06;"Nitriansky kraj";1309;2690;494;3184;NA;275798;1803;2022-02-06;182678
2022-02-05;"Nitriansky kraj";1609;1504;358;1862;NA;275798;1967;2022-02-05;180875
2022-02-04;"Nitriansky kraj";1848;4185;510;4695;NA;275798;2358;2022-02-04;178908
2022-02-03;"Nitriansky kraj";2425;4186;491;4677;NA;275798;2916;2022-02-03;176550
2022-02-02;"Nitriansky kraj";1903;5318;766;6084;NA;275798;2669;2022-02-02;173634
2022-02-01;"Nitriansky kraj";2288;4717;597;5314;NA;275798;2885;2022-02-01;170965
2022-01-31;"Nitriansky kraj";1329;8991;746;9737;NA;275798;2075;2022-01-31;168080
2022-01-30;"Nitriansky kraj";777;3498;471;3969;NA;275798;1248;2022-01-30;166005
2022-01-29;"Nitriansky kraj";1099;1670;298;1968;NA;275798;1397;2022-01-29;164757
2022-01-28;"Nitriansky kraj";1610;4217;374;4591;NA;275798;1984;2022-01-28;163360
2022-01-27;"Nitriansky kraj";1429;3796;289;4085;NA;275798;1718;2022-01-27;161376
2022-01-26;"Nitriansky kraj";1392;4444;306;4750;NA;275798;1698;2022-01-26;159658
2022-01-25;"Nitriansky kraj";1591;4624;426;5050;NA;275798;2017;2022-01-25;157960
2022-01-24;"Nitriansky kraj";770;7459;359;7818;NA;275798;1129;2022-01-24;155943
2022-01-23;"Nitriansky kraj";327;3109;205;3314;NA;275798;532;2022-01-23;154814
2022-01-22;"Nitriansky kraj";596;1974;153;2127;NA;275798;749;2022-01-22;154282
2022-01-21;"Nitriansky kraj";532;3472;141;3613;NA;275798;673;2022-01-21;153533
2022-01-20;"Nitriansky kraj";737;3537;129;3666;NA;275798;866;2022-01-20;152860
2022-01-19;"Nitriansky kraj";614;4581;121;4702;NA;275798;735;2022-01-19;151994
2022-01-18;"Nitriansky kraj";650;3329;125;3454;NA;275798;775;2022-01-18;151259
2022-01-17;"Nitriansky kraj";439;7781;152;7933;NA;275798;591;2022-01-17;150484
2022-01-16;"Nitriansky kraj";140;3191;71;3262;NA;275798;211;2022-01-16;149893
2022-01-15;"Nitriansky kraj";268;1651;50;1701;NA;275798;318;2022-01-15;149682
2022-01-14;"Nitriansky kraj";167;2900;68;2968;NA;275798;235;2022-01-14;149364
2022-01-13;"Nitriansky kraj";244;3297;53;3350;NA;275798;297;2022-01-13;149129
2022-01-12;"Nitriansky kraj";298;4325;66;4391;NA;275798;364;2022-01-12;148832
2022-01-11;"Nitriansky kraj";424;3990;50;4040;NA;275798;474;2022-01-11;148468
2022-01-10;"Nitriansky kraj";292;7648;71;7719;NA;275798;363;2022-01-10;147994
2022-01-09;"Nitriansky kraj";100;3419;48;3467;NA;275798;148;2022-01-09;147631
2022-01-08;"Nitriansky kraj";206;1352;47;1399;NA;275798;253;2022-01-08;147483
2022-01-07;"Nitriansky kraj";326;2970;74;3044;NA;275798;400;2022-01-07;147230
2022-01-06;"Nitriansky kraj";125;910;33;943;NA;275798;158;2022-01-06;146830
2022-01-05;"Nitriansky kraj";357;4227;66;4293;NA;275798;423;2022-01-05;146672
2022-01-04;"Nitriansky kraj";453;3697;85;3782;NA;275798;538;2022-01-04;146249
2022-01-03;"Nitriansky kraj";353;7361;117;7478;NA;275798;470;2022-01-03;145711
2022-01-02;"Nitriansky kraj";25;3035;95;3130;NA;275798;120;2022-01-02;145241
2022-01-01;"Nitriansky kraj";71;177;9;186;NA;275798;80;2022-01-01;145121
2021-12-31;"Nitriansky kraj";382;1506;69;1575;NA;275798;451;2021-12-31;145041
2021-12-30;"Nitriansky kraj";325;3330;89;3419;NA;275798;414;2021-12-30;144590
2021-12-29;"Nitriansky kraj";347;2371;61;2432;NA;275798;408;2021-12-29;144176
2021-12-28;"Nitriansky kraj";628;2501;88;2589;NA;275798;716;2021-12-28;143768
2021-12-27;"Nitriansky kraj";402;4253;169;4422;NA;275798;571;2021-12-27;143052
2021-12-26;"Nitriansky kraj";84;1039;53;1092;NA;275798;137;2021-12-26;142481
2021-12-25;"Nitriansky kraj";22;499;31;530;NA;275798;53;2021-12-25;142344
2021-12-24;"Nitriansky kraj";175;448;26;474;NA;275798;201;2021-12-24;142291
2021-12-23;"Nitriansky kraj";472;3420;110;3530;NA;275798;582;2021-12-23;142090
2021-12-22;"Nitriansky kraj";398;3517;95;3612;NA;275798;493;2021-12-22;141508
2021-12-21;"Nitriansky kraj";735;2913;93;3006;NA;275798;828;2021-12-21;141015
2021-12-20;"Nitriansky kraj";407;6754;169;6923;NA;275798;576;2021-12-20;140187
2021-12-19;"Nitriansky kraj";198;3587;98;3685;NA;275798;296;2021-12-19;139611
2021-12-18;"Nitriansky kraj";361;1456;96;1552;NA;275798;457;2021-12-18;139315
2021-12-17;"Nitriansky kraj";409;4934;153;5087;NA;275798;562;2021-12-17;138858
2021-12-16;"Nitriansky kraj";429;4230;144;4374;NA;275798;573;2021-12-16;138296
2021-12-15;"Nitriansky kraj";639;5682;143;5825;NA;275798;782;2021-12-15;137723
2021-12-14;"Nitriansky kraj";907;4720;200;4920;NA;275798;1107;2021-12-14;136941
2021-12-13;"Nitriansky kraj";524;7388;291;7679;NA;275798;815;2021-12-13;135834
2021-12-12;"Nitriansky kraj";289;3893;174;4067;NA;275798;463;2021-12-12;135019
2021-12-11;"Nitriansky kraj";458;1754;121;1875;NA;275798;579;2021-12-11;134556
2021-12-10;"Nitriansky kraj";591;4868;177;5045;NA;275798;768;2021-12-10;133977
2021-12-09;"Nitriansky kraj";741;3428;202;3630;NA;275798;943;2021-12-09;133209
2021-12-08;"Nitriansky kraj";954;5136;200;5336;NA;275798;1154;2021-12-08;132266
2021-12-07;"Nitriansky kraj";900;4045;197;4242;NA;275798;1097;2021-12-07;131112
2021-12-06;"Nitriansky kraj";699;8196;339;8535;NA;275798;1038;2021-12-06;130015
2021-12-05;"Nitriansky kraj";337;4314;192;4506;NA;275798;529;2021-12-05;128977
2021-12-04;"Nitriansky kraj";758;2045;180;2225;NA;275798;938;2021-12-04;128448
2021-12-03;"Nitriansky kraj";920;5783;237;6020;NA;275798;1157;2021-12-03;127510
2021-12-02;"Nitriansky kraj";1388;3898;267;4165;NA;275798;1655;2021-12-02;126353
2021-12-01;"Nitriansky kraj";982;4107;261;4368;NA;275798;1243;2021-12-01;124698
2021-11-30;"Nitriansky kraj";751;5575;241;5816;NA;275798;992;2021-11-30;123455
2021-11-29;"Nitriansky kraj";665;10153;499;10652;NA;275798;1164;2021-11-29;122463
2021-11-28;"Nitriansky kraj";357;6214;300;6514;NA;275798;657;2021-11-28;121299
2021-11-27;"Nitriansky kraj";560;2879;281;3160;NA;275798;841;2021-11-27;120642
2021-11-26;"Nitriansky kraj";824;5529;290;5819;NA;275798;1114;2021-11-26;119801
2021-11-25;"Nitriansky kraj";847;4154;342;4496;NA;275798;1189;2021-11-25;118687
2021-11-24;"Nitriansky kraj";875;4422;325;4747;NA;275798;1200;2021-11-24;117498
2021-11-23;"Nitriansky kraj";1103;5148;353;5501;NA;275798;1456;2021-11-23;116298
2021-11-22;"Nitriansky kraj";545;7105;465;7570;NA;275798;1010;2021-11-22;114842
2021-11-21;"Nitriansky kraj";345;3410;314;3724;NA;275798;659;2021-11-21;113832
2021-11-20;"Nitriansky kraj";579;1865;252;2117;NA;275798;831;2021-11-20;113173
2021-11-19;"Nitriansky kraj";571;4256;349;4605;NA;275798;920;2021-11-19;112342
2021-11-18;"Nitriansky kraj";677;4883;420;5303;NA;275798;1097;2021-11-18;111422
2021-11-17;"Nitriansky kraj";479;1622;207;1829;NA;275798;686;2021-11-17;110325
2021-11-16;"Nitriansky kraj";668;3882;266;4148;NA;275798;934;2021-11-16;109639
2021-11-15;"Nitriansky kraj";556;6033;440;6473;NA;275798;996;2021-11-15;108705
2021-11-14;"Nitriansky kraj";229;2796;259;3055;NA;275798;488;2021-11-14;107709
2021-11-13;"Nitriansky kraj";387;1473;201;1674;NA;275798;588;2021-11-13;107221
2021-11-12;"Nitriansky kraj";552;3096;270;3366;NA;275798;822;2021-11-12;106633
2021-11-11;"Nitriansky kraj";539;3545;238;3783;NA;275798;777;2021-11-11;105811
2021-11-10;"Nitriansky kraj";411;3494;234;3728;NA;275798;645;2021-11-10;105034
2021-11-09;"Nitriansky kraj";413;3313;210;3523;NA;275798;623;2021-11-09;104389
2021-11-08;"Nitriansky kraj";464;4936;331;5267;NA;275798;795;2021-11-08;103766
2021-11-07;"Nitriansky kraj";209;2074;161;2235;NA;275798;370;2021-11-07;102971
2021-11-06;"Nitriansky kraj";236;1407;114;1521;NA;275798;350;2021-11-06;102601
2021-11-05;"Nitriansky kraj";407;2583;185;2768;NA;275798;592;2021-11-05;102251
2021-11-04;"Nitriansky kraj";437;3083;168;3251;NA;275798;605;2021-11-04;101659
2021-11-03;"Nitriansky kraj";525;2891;157;3048;NA;275798;682;2021-11-03;101054
2021-11-02;"Nitriansky kraj";320;4279;239;4518;NA;275798;559;2021-11-02;100372
2021-11-01;"Nitriansky kraj";136;712;61;773;NA;275798;197;2021-11-01;99813
2021-10-31;"Nitriansky kraj";109;1234;114;1348;NA;275798;223;2021-10-31;99616
2021-10-30;"Nitriansky kraj";202;1218;82;1300;NA;275798;284;2021-10-30;99393
2021-10-29;"Nitriansky kraj";347;2481;120;2601;NA;275798;467;2021-10-29;99109
2021-10-28;"Nitriansky kraj";281;2603;95;2698;NA;275798;376;2021-10-28;98642
2021-10-27;"Nitriansky kraj";340;2923;112;3035;NA;275798;452;2021-10-27;98266
2021-10-26;"Nitriansky kraj";297;2926;117;3043;NA;275798;414;2021-10-26;97814
2021-10-25;"Nitriansky kraj";171;3599;124;3723;NA;275798;295;2021-10-25;97400
2021-10-24;"Nitriansky kraj";58;1914;74;1988;NA;275798;132;2021-10-24;97105
2021-10-23;"Nitriansky kraj";173;1815;77;1892;NA;275798;250;2021-10-23;96973
2021-10-22;"Nitriansky kraj";202;2216;68;2284;NA;275798;270;2021-10-22;96723
2021-10-21;"Nitriansky kraj";214;2793;65;2858;NA;275798;279;2021-10-21;96453
2021-10-20;"Nitriansky kraj";218;2328;74;2402;NA;275798;292;2021-10-20;96174
2021-10-19;"Nitriansky kraj";250;2929;65;2994;NA;275798;315;2021-10-19;95882
2021-10-18;"Nitriansky kraj";81;3259;90;3349;NA;275798;171;2021-10-18;95567
2021-10-17;"Nitriansky kraj";36;3010;92;3102;NA;275798;128;2021-10-17;95396
2021-10-16;"Nitriansky kraj";37;1477;38;1515;NA;275798;75;2021-10-16;95268
2021-10-15;"Nitriansky kraj";145;2653;34;2687;NA;275798;179;2021-10-15;95193
2021-10-14;"Nitriansky kraj";95;2389;30;2419;NA;275798;125;2021-10-14;95014
2021-10-13;"Nitriansky kraj";91;2248;36;2284;NA;275798;127;2021-10-13;94889
2021-10-12;"Nitriansky kraj";119;2905;34;2939;NA;275798;153;2021-10-12;94762
2021-10-11;"Nitriansky kraj";91;2703;42;2745;NA;275798;133;2021-10-11;94609
2021-10-10;"Nitriansky kraj";33;1527;22;1549;NA;275798;55;2021-10-10;94476
2021-10-09;"Nitriansky kraj";17;1395;17;1412;NA;275798;34;2021-10-09;94421
2021-10-08;"Nitriansky kraj";61;3004;37;3041;NA;275798;98;2021-10-08;94387
2021-10-07;"Nitriansky kraj";59;2829;30;2859;NA;275798;89;2021-10-07;94289
2021-10-06;"Nitriansky kraj";66;2657;28;2685;NA;275798;94;2021-10-06;94200
2021-10-05;"Nitriansky kraj";97;2536;32;2568;NA;275798;129;2021-10-05;94106
2021-10-04;"Nitriansky kraj";56;3263;49;3312;NA;275798;105;2021-10-04;93977
2021-10-03;"Nitriansky kraj";10;1591;24;1615;NA;275798;34;2021-10-03;93872
2021-10-02;"Nitriansky kraj";46;1567;20;1587;NA;275798;66;2021-10-02;93838
2021-10-01;"Nitriansky kraj";26;2860;34;2894;NA;275798;60;2021-10-01;93772
2021-09-30;"Nitriansky kraj";66;2468;15;2483;NA;275798;81;2021-09-30;93712
2021-09-29;"Nitriansky kraj";92;2266;16;2282;NA;275798;108;2021-09-29;93631
2021-09-28;"Nitriansky kraj";86;2893;27;2920;NA;275798;113;2021-09-28;93523
2021-09-27;"Nitriansky kraj";50;3633;41;3674;NA;275798;91;2021-09-27;93410
2021-09-26;"Nitriansky kraj";12;1635;20;1655;NA;275798;32;2021-09-26;93319
2021-09-25;"Nitriansky kraj";43;1456;20;1476;NA;275798;63;2021-09-25;93287
2021-09-24;"Nitriansky kraj";35;2783;15;2798;NA;275798;50;2021-09-24;93224
2021-09-23;"Nitriansky kraj";69;2503;20;2523;NA;275798;89;2021-09-23;93174
2021-09-22;"Nitriansky kraj";68;2380;17;2397;NA;275798;85;2021-09-22;93085
2021-09-21;"Nitriansky kraj";70;2684;30;2714;NA;275798;100;2021-09-21;93000
2021-09-20;"Nitriansky kraj";41;2497;21;2518;NA;275798;62;2021-09-20;92900
2021-09-19;"Nitriansky kraj";16;1553;20;1573;NA;275798;36;2021-09-19;92838
2021-09-18;"Nitriansky kraj";42;1421;19;1440;NA;275798;61;2021-09-18;92802
2021-09-17;"Nitriansky kraj";54;2757;30;2787;NA;275798;84;2021-09-17;92741
2021-09-16;"Nitriansky kraj";55;2499;44;2543;NA;275798;99;2021-09-16;92657
2021-09-15;"Nitriansky kraj";34;538;12;550;NA;275798;46;2021-09-15;92558
2021-09-14;"Nitriansky kraj";52;1821;20;1841;NA;275798;72;2021-09-14;92512
2021-09-13;"Nitriansky kraj";27;2373;27;2400;NA;275798;54;2021-09-13;92440
2021-09-12;"Nitriansky kraj";4;1182;17;1199;NA;275798;21;2021-09-12;92386
2021-09-11;"Nitriansky kraj";36;1181;8;1189;NA;275798;44;2021-09-11;92365
2021-09-10;"Nitriansky kraj";25;2133;12;2145;NA;275798;37;2021-09-10;92321
2021-09-09;"Nitriansky kraj";15;1611;20;1631;NA;275798;35;2021-09-09;92284
2021-09-08;"Nitriansky kraj";30;1463;22;1485;NA;275798;52;2021-09-08;92249
2021-09-07;"Nitriansky kraj";35;1460;9;1469;NA;275798;44;2021-09-07;92197
2021-09-06;"Nitriansky kraj";19;1668;27;1695;NA;275798;46;2021-09-06;92153
2021-09-05;"Nitriansky kraj";10;1007;8;1015;NA;275798;18;2021-09-05;92107
2021-09-04;"Nitriansky kraj";18;1119;10;1129;NA;275798;28;2021-09-04;92089
2021-09-03;"Nitriansky kraj";20;1743;17;1760;NA;275798;37;2021-09-03;92061
2021-09-02;"Nitriansky kraj";16;1389;14;1403;NA;275798;30;2021-09-02;92024
2021-09-01;"Nitriansky kraj";9;337;2;339;NA;275798;11;2021-09-01;91994
2021-08-31;"Nitriansky kraj";10;1360;6;1366;NA;275798;16;2021-08-31;91983
2021-08-30;"Nitriansky kraj";8;1381;10;1391;NA;275798;18;2021-08-30;91967
2021-08-29;"Nitriansky kraj";2;450;1;451;NA;275798;3;2021-08-29;91949
2021-08-28;"Nitriansky kraj";5;1071;3;1074;NA;275798;8;2021-08-28;91946
2021-08-27;"Nitriansky kraj";7;1804;4;1808;NA;275798;11;2021-08-27;91938
2021-08-26;"Nitriansky kraj";2;1255;6;1261;NA;275798;8;2021-08-26;91927
2021-08-25;"Nitriansky kraj";15;1087;3;1090;NA;275798;18;2021-08-25;91919
2021-08-24;"Nitriansky kraj";6;990;2;992;NA;275798;8;2021-08-24;91901
2021-08-23;"Nitriansky kraj";13;1271;4;1275;NA;275798;17;2021-08-23;91893
2021-08-22;"Nitriansky kraj";0;1167;3;1170;NA;275798;3;2021-08-22;91876
2021-08-21;"Nitriansky kraj";1;853;2;855;NA;275798;3;2021-08-21;91873
2021-08-20;"Nitriansky kraj";8;1580;5;1585;NA;275798;13;2021-08-20;91870
2021-08-19;"Nitriansky kraj";11;1167;4;1171;NA;275798;15;2021-08-19;91857
2021-08-18;"Nitriansky kraj";8;1180;7;1187;NA;275798;15;2021-08-18;91842
2021-08-17;"Nitriansky kraj";4;1035;3;1038;NA;275798;7;2021-08-17;91827
2021-08-16;"Nitriansky kraj";7;1129;4;1133;NA;275798;11;2021-08-16;91820
2021-08-15;"Nitriansky kraj";2;662;1;663;NA;275798;3;2021-08-15;91809
2021-08-14;"Nitriansky kraj";1;878;5;883;NA;275798;6;2021-08-14;91806
2021-08-13;"Nitriansky kraj";0;957;1;958;NA;275798;1;2021-08-13;91800
2021-08-12;"Nitriansky kraj";5;765;0;765;NA;275798;5;2021-08-12;91799
2021-08-11;"Nitriansky kraj";3;527;1;528;NA;275798;4;2021-08-11;91794
2021-08-10;"Nitriansky kraj";3;570;1;571;NA;275798;4;2021-08-10;91790
2021-08-09;"Nitriansky kraj";3;992;1;993;NA;275798;4;2021-08-09;91786
2021-08-08;"Nitriansky kraj";0;668;1;669;NA;275798;1;2021-08-08;91782
2021-08-07;"Nitriansky kraj";0;557;1;558;NA;275798;1;2021-08-07;91781
2021-08-06;"Nitriansky kraj";5;799;0;799;NA;275798;5;2021-08-06;91780
2021-08-05;"Nitriansky kraj";6;612;0;612;NA;275798;6;2021-08-05;91775
2021-08-04;"Nitriansky kraj";1;497;2;499;NA;275798;3;2021-08-04;91769
2021-08-03;"Nitriansky kraj";5;1455;0;1455;NA;275798;5;2021-08-03;91766
2021-08-02;"Nitriansky kraj";1;683;4;687;NA;275798;5;2021-08-02;91761
2021-08-01;"Nitriansky kraj";1;606;0;606;NA;275798;1;2021-08-01;91756
2021-07-31;"Nitriansky kraj";1;514;1;515;NA;275798;2;2021-07-31;91755
2021-07-30;"Nitriansky kraj";2;827;0;827;NA;275798;2;2021-07-30;91753
2021-07-29;"Nitriansky kraj";3;720;2;722;NA;275798;5;2021-07-29;91751
2021-07-28;"Nitriansky kraj";4;598;0;598;NA;275798;4;2021-07-28;91746
2021-07-27;"Nitriansky kraj";12;602;1;603;NA;275798;13;2021-07-27;91742
2021-07-26;"Nitriansky kraj";7;970;1;971;NA;275798;8;2021-07-26;91729
2021-07-25;"Nitriansky kraj";1;654;1;655;NA;275798;2;2021-07-25;91721
2021-07-24;"Nitriansky kraj";0;620;0;620;NA;275798;0;2021-07-24;91719
2021-07-23;"Nitriansky kraj";3;851;1;852;NA;275798;4;2021-07-23;91719
2021-07-22;"Nitriansky kraj";5;689;0;689;NA;275798;5;2021-07-22;91715
2021-07-21;"Nitriansky kraj";6;650;2;652;NA;275798;8;2021-07-21;91710
2021-07-20;"Nitriansky kraj";1;527;1;528;NA;275798;2;2021-07-20;91702
2021-07-19;"Nitriansky kraj";2;965;0;965;NA;275798;2;2021-07-19;91700
2021-07-18;"Nitriansky kraj";1;747;0;747;NA;275798;1;2021-07-18;91698
2021-07-17;"Nitriansky kraj";5;612;0;612;NA;275798;5;2021-07-17;91697
2021-07-16;"Nitriansky kraj";2;876;0;876;NA;275798;2;2021-07-16;91692
2021-07-15;"Nitriansky kraj";11;708;0;708;NA;275798;11;2021-07-15;91690
2021-07-14;"Nitriansky kraj";4;646;0;646;NA;275798;4;2021-07-14;91679
2021-07-13;"Nitriansky kraj";2;697;2;699;NA;275798;4;2021-07-13;91675
2021-07-12;"Nitriansky kraj";1;819;0;819;NA;275798;1;2021-07-12;91671
2021-07-11;"Nitriansky kraj";1;961;0;961;NA;275798;1;2021-07-11;91670
2021-07-10;"Nitriansky kraj";1;630;0;630;NA;275798;1;2021-07-10;91669
2021-07-09;"Nitriansky kraj";3;1000;0;1000;NA;275798;3;2021-07-09;91668
2021-07-08;"Nitriansky kraj";0;683;0;683;NA;275798;0;2021-07-08;91665
2021-07-07;"Nitriansky kraj";2;935;2;937;NA;275798;4;2021-07-07;91665
2021-07-06;"Nitriansky kraj";1;1269;1;1270;NA;275798;2;2021-07-06;91661
2021-07-05;"Nitriansky kraj";1;507;0;507;NA;275798;1;2021-07-05;91659
2021-07-04;"Nitriansky kraj";0;821;1;822;NA;275798;1;2021-07-04;91658
2021-07-03;"Nitriansky kraj";0;611;0;611;NA;275798;0;2021-07-03;91657
2021-07-02;"Nitriansky kraj";0;1259;0;1259;NA;275798;0;2021-07-02;91657
2021-07-01;"Nitriansky kraj";0;369;1;370;NA;275798;1;2021-07-01;91657
2021-06-30;"Nitriansky kraj";1;6777;2;6779;NA;275798;3;2021-06-30;91656
2021-06-29;"Nitriansky kraj";1;3536;0;3536;NA;275798;1;2021-06-29;91653
2021-06-28;"Nitriansky kraj";3;4393;0;4393;NA;275798;3;2021-06-28;91652
2021-06-27;"Nitriansky kraj";0;3263;0;3263;NA;275798;0;2021-06-27;91649
2021-06-26;"Nitriansky kraj";1;4979;3;4982;NA;275798;4;2021-06-26;91649
2021-06-25;"Nitriansky kraj";8;5182;1;5183;NA;275798;9;2021-06-25;91645
2021-06-24;"Nitriansky kraj";1;3354;0;3354;NA;275798;1;2021-06-24;91636
2021-06-23;"Nitriansky kraj";1;3033;0;3033;NA;275798;1;2021-06-23;91635
2021-06-22;"Nitriansky kraj";1;3240;3;3243;NA;275798;4;2021-06-22;91634
2021-06-21;"Nitriansky kraj";8;5362;8;5370;NA;275798;16;2021-06-21;91630
2021-06-20;"Nitriansky kraj";0;4437;6;4443;NA;275798;6;2021-06-20;91614
2021-06-19;"Nitriansky kraj";0;5983;4;5987;NA;275798;4;2021-06-19;91608
2021-06-18;"Nitriansky kraj";4;6453;3;6456;NA;275798;7;2021-06-18;91604
2021-06-17;"Nitriansky kraj";5;4152;1;4153;NA;275798;6;2021-06-17;91597
2021-06-16;"Nitriansky kraj";4;3694;3;3697;NA;275798;7;2021-06-16;91591
2021-06-15;"Nitriansky kraj";1;3995;0;3995;NA;275798;1;2021-06-15;91584
2021-06-14;"Nitriansky kraj";0;5875;3;5878;NA;275798;3;2021-06-14;91583
2021-06-13;"Nitriansky kraj";0;6073;3;6076;NA;275798;3;2021-06-13;91580
2021-06-12;"Nitriansky kraj";1;8293;1;8294;NA;275798;2;2021-06-12;91577
2021-06-11;"Nitriansky kraj";3;6891;4;6895;NA;275798;7;2021-06-11;91575
2021-06-10;"Nitriansky kraj";7;4539;1;4540;NA;275798;8;2021-06-10;91568
2021-06-09;"Nitriansky kraj";2;4706;2;4708;NA;275798;4;2021-06-09;91560
2021-06-08;"Nitriansky kraj";8;4239;3;4242;NA;275798;11;2021-06-08;91556
2021-06-07;"Nitriansky kraj";6;5841;8;5849;NA;275798;14;2021-06-07;91545
2021-06-06;"Nitriansky kraj";0;6981;4;6985;NA;275798;4;2021-06-06;91531
2021-06-05;"Nitriansky kraj";6;9089;9;9098;NA;275798;15;2021-06-05;91527
2021-06-04;"Nitriansky kraj";9;7639;5;7644;NA;275798;14;2021-06-04;91512
2021-06-03;"Nitriansky kraj";2;5064;6;5070;NA;275798;8;2021-06-03;91498
2021-06-02;"Nitriansky kraj";11;5119;11;5130;NA;275798;22;2021-06-02;91490
2021-06-01;"Nitriansky kraj";3;4862;2;4864;NA;275798;5;2021-06-01;91468
2021-05-31;"Nitriansky kraj";8;8933;8;8941;NA;275798;16;2021-05-31;91463
2021-05-30;"Nitriansky kraj";1;9067;8;9075;NA;275798;9;2021-05-30;91447
2021-05-29;"Nitriansky kraj";2;13610;7;13617;NA;275798;9;2021-05-29;91438
2021-05-28;"Nitriansky kraj";10;8872;6;8878;NA;275798;16;2021-05-28;91429
2021-05-27;"Nitriansky kraj";4;6164;5;6169;NA;275798;9;2021-05-27;91413
2021-05-26;"Nitriansky kraj";11;8509;10;8519;NA;275798;21;2021-05-26;91404
2021-05-25;"Nitriansky kraj";15;7350;8;7358;NA;275798;23;2021-05-25;91383
2021-05-24;"Nitriansky kraj";14;9816;17;9833;NA;275798;31;2021-05-24;91360
2021-05-23;"Nitriansky kraj";1;9456;13;9469;NA;275798;14;2021-05-23;91329
2021-05-22;"Nitriansky kraj";7;16939;11;16950;NA;275798;18;2021-05-22;91315
2021-05-21;"Nitriansky kraj";18;10632;15;10647;NA;275798;33;2021-05-21;91297
2021-05-20;"Nitriansky kraj";8;7185;7;7192;NA;275798;15;2021-05-20;91264
2021-05-19;"Nitriansky kraj";20;6787;14;6801;NA;275798;34;2021-05-19;91249
2021-05-18;"Nitriansky kraj";23;7797;18;7815;NA;275798;41;2021-05-18;91215
2021-05-17;"Nitriansky kraj";22;9774;20;9794;NA;275798;42;2021-05-17;91174
2021-05-16;"Nitriansky kraj";4;13830;15;13845;NA;275798;19;2021-05-16;91132
2021-05-15;"Nitriansky kraj";5;25389;23;25412;NA;275798;28;2021-05-15;91113
2021-05-14;"Nitriansky kraj";18;13385;23;13408;NA;275798;41;2021-05-14;91085
2021-05-13;"Nitriansky kraj";24;8289;19;8308;NA;275798;43;2021-05-13;91044
2021-05-12;"Nitriansky kraj";10;7682;26;7708;NA;275798;36;2021-05-12;91001
2021-05-11;"Nitriansky kraj";36;8169;13;8182;NA;275798;49;2021-05-11;90965
2021-05-10;"Nitriansky kraj";16;13800;42;13842;NA;275798;58;2021-05-10;90916
2021-05-09;"Nitriansky kraj";8;21879;35;21914;NA;275798;43;2021-05-09;90858
2021-05-08;"Nitriansky kraj";0;24318;29;24347;NA;275798;29;2021-05-08;90815
2021-05-07;"Nitriansky kraj";32;14915;20;14935;NA;275798;52;2021-05-07;90786
2021-05-06;"Nitriansky kraj";30;9463;20;9483;NA;275798;50;2021-05-06;90734
2021-05-05;"Nitriansky kraj";19;8527;23;8550;NA;275798;42;2021-05-05;90684
2021-05-04;"Nitriansky kraj";46;9385;27;9412;NA;275798;73;2021-05-04;90642
2021-05-03;"Nitriansky kraj";32;14490;44;14534;NA;275798;76;2021-05-03;90569
2021-05-02;"Nitriansky kraj";4;31751;46;31797;NA;275798;50;2021-05-02;90493
2021-05-01;"Nitriansky kraj";23;60451;43;60494;NA;275798;66;2021-05-01;90443
2021-04-30;"Nitriansky kraj";28;31803;53;31856;NA;275798;81;2021-04-30;90377
2021-04-29;"Nitriansky kraj";27;14265;34;14299;NA;275798;61;2021-04-29;90296
2021-04-28;"Nitriansky kraj";36;14716;45;14761;NA;275798;81;2021-04-28;90235
2021-04-27;"Nitriansky kraj";51;13154;35;13189;NA;275798;86;2021-04-27;90154
2021-04-26;"Nitriansky kraj";38;21029;44;21073;NA;275798;82;2021-04-26;90068
2021-04-25;"Nitriansky kraj";7;44312;46;44358;NA;275798;53;2021-04-25;89986
2021-04-24;"Nitriansky kraj";23;93455;72;93527;NA;275798;95;2021-04-24;89933
2021-04-23;"Nitriansky kraj";54;35145;51;35196;NA;275798;105;2021-04-23;89838
2021-04-22;"Nitriansky kraj";32;15435;44;15479;NA;275798;76;2021-04-22;89733
2021-04-21;"Nitriansky kraj";38;14228;45;14273;NA;275798;83;2021-04-21;89657
2021-04-20;"Nitriansky kraj";67;16058;51;16109;NA;275798;118;2021-04-20;89574
2021-04-19;"Nitriansky kraj";35;24819;59;24878;NA;275798;94;2021-04-19;89456
2021-04-18;"Nitriansky kraj";0;39569;27;39596;NA;275798;27;2021-04-18;89362
2021-04-17;"Nitriansky kraj";34;92102;82;92184;NA;275798;116;2021-04-17;89335
2021-04-16;"Nitriansky kraj";46;32348;37;32385;NA;275798;83;2021-04-16;89219
2021-04-15;"Nitriansky kraj";75;16215;52;16267;NA;275798;127;2021-04-15;89136
2021-04-14;"Nitriansky kraj";43;15303;42;15345;NA;275798;85;2021-04-14;89009
2021-04-13;"Nitriansky kraj";110;15104;44;15148;NA;275798;154;2021-04-13;88924
2021-04-12;"Nitriansky kraj";29;22817;50;22867;NA;275798;79;2021-04-12;88770
2021-04-11;"Nitriansky kraj";1;37537;31;37568;NA;275798;32;2021-04-11;88691
2021-04-10;"Nitriansky kraj";35;95851;115;95966;NA;275798;150;2021-04-10;88659
2021-04-09;"Nitriansky kraj";69;30669;58;30727;NA;275798;127;2021-04-09;88509
2021-04-08;"Nitriansky kraj";71;15361;36;15397;NA;275798;107;2021-04-08;88382
2021-04-07;"Nitriansky kraj";64;18541;47;18588;NA;275798;111;2021-04-07;88275
2021-04-06;"Nitriansky kraj";65;33218;112;33330;NA;275798;177;2021-04-06;88164
2021-04-05;"Nitriansky kraj";37;12673;48;12721;NA;275798;85;2021-04-05;87987
2021-04-04;"Nitriansky kraj";5;17887;35;17922;NA;275798;40;2021-04-04;87902
2021-04-03;"Nitriansky kraj";26;85465;153;85618;NA;275798;179;2021-04-03;87862
2021-04-02;"Nitriansky kraj";32;18743;46;18789;NA;275798;78;2021-04-02;87683
2021-04-01;"Nitriansky kraj";63;24640;83;24723;NA;275798;146;2021-04-01;87605
2021-03-31;"Nitriansky kraj";73;21752;94;21846;NA;275798;167;2021-03-31;87459
2021-03-30;"Nitriansky kraj";125;17122;83;17205;NA;275798;208;2021-03-30;87292
2021-03-29;"Nitriansky kraj";81;25139;100;25239;NA;275798;181;2021-03-29;87084
2021-03-28;"Nitriansky kraj";6;45581;106;45687;NA;275798;112;2021-03-28;86903
2021-03-27;"Nitriansky kraj";39;104104;174;104278;NA;275798;213;2021-03-27;86791
2021-03-26;"Nitriansky kraj";90;40444;115;40559;NA;275798;205;2021-03-26;86578
2021-03-25;"Nitriansky kraj";95;19219;94;19313;NA;275798;189;2021-03-25;86373
2021-03-24;"Nitriansky kraj";90;14787;91;14878;NA;275798;181;2021-03-24;86184
2021-03-23;"Nitriansky kraj";167;16753;66;16819;NA;275798;233;2021-03-23;86003
2021-03-22;"Nitriansky kraj";101;24886;125;25011;NA;275798;226;2021-03-22;85770
2021-03-21;"Nitriansky kraj";27;42773;99;42872;NA;275798;126;2021-03-21;85544
2021-03-20;"Nitriansky kraj";36;100640;207;100847;NA;275798;243;2021-03-20;85418
2021-03-19;"Nitriansky kraj";76;37312;102;37414;NA;275798;178;2021-03-19;85175
2021-03-18;"Nitriansky kraj";103;20051;113;20164;NA;275798;216;2021-03-18;84997
2021-03-17;"Nitriansky kraj";87;15839;127;15966;NA;275798;214;2021-03-17;84781
2021-03-16;"Nitriansky kraj";172;18085;121;18206;NA;275798;293;2021-03-16;84567
2021-03-15;"Nitriansky kraj";130;24481;165;24646;NA;275798;295;2021-03-15;84274
2021-03-14;"Nitriansky kraj";3;45770;107;45877;NA;275798;110;2021-03-14;83979
2021-03-13;"Nitriansky kraj";65;112573;242;112815;NA;275798;307;2021-03-13;83869
2021-03-12;"Nitriansky kraj";127;40777;159;40936;NA;275798;286;2021-03-12;83562
2021-03-11;"Nitriansky kraj";131;18686;130;18816;NA;275798;261;2021-03-11;83276
2021-03-10;"Nitriansky kraj";96;17422;143;17565;NA;275798;239;2021-03-10;83015
2021-03-09;"Nitriansky kraj";260;17635;149;17784;NA;275798;409;2021-03-09;82776
2021-03-08;"Nitriansky kraj";145;27214;172;27386;NA;275798;317;2021-03-08;82367
2021-03-07;"Nitriansky kraj";48;46867;185;47052;NA;275798;233;2021-03-07;82050
2021-03-06;"Nitriansky kraj";86;112027;327;112354;NA;275798;413;2021-03-06;81817
2021-03-05;"Nitriansky kraj";133;39068;200;39268;NA;275798;333;2021-03-05;81404
2021-03-04;"Nitriansky kraj";176;18340;173;18513;NA;275798;349;2021-03-04;81071
2021-03-03;"Nitriansky kraj";172;17210;177;17387;NA;275798;349;2021-03-03;80722
2021-03-02;"Nitriansky kraj";274;21003;366;21369;NA;275798;640;2021-03-02;80373
2021-03-01;"Nitriansky kraj";133;27881;279;28160;NA;275798;412;2021-03-01;79733
2021-02-28;"Nitriansky kraj";80;40866;218;41084;NA;275798;298;2021-02-28;79321
2021-02-27;"Nitriansky kraj";101;106352;496;106848;NA;275798;597;2021-02-27;79023
2021-02-26;"Nitriansky kraj";109;36788;308;37096;NA;275798;417;2021-02-26;78426
2021-02-25;"Nitriansky kraj";188;15243;212;15455;NA;275798;400;2021-02-25;78009
2021-02-24;"Nitriansky kraj";125;13833;260;14093;NA;275798;385;2021-02-24;77609
2021-02-23;"Nitriansky kraj";273;15402;273;15675;NA;275798;546;2021-02-23;77224
2021-02-22;"Nitriansky kraj";154;26478;330;26808;NA;275798;484;2021-02-22;76678
2021-02-21;"Nitriansky kraj";22;43664;320;43984;NA;275798;342;2021-02-21;76194
2021-02-20;"Nitriansky kraj";128;109038;586;109624;NA;275798;714;2021-02-20;75852
2021-02-19;"Nitriansky kraj";173;36849;328;37177;NA;275798;501;2021-02-19;75138
2021-02-18;"Nitriansky kraj";202;17045;275;17320;NA;275798;477;2021-02-18;74637
2021-02-17;"Nitriansky kraj";198;12080;310;12390;NA;275798;508;2021-02-17;74160
2021-02-16;"Nitriansky kraj";284;16066;288;16354;NA;275798;572;2021-02-16;73652
2021-02-15;"Nitriansky kraj";122;28636;474;29110;NA;275798;596;2021-02-15;73080
2021-02-14;"Nitriansky kraj";8;49392;315;49707;NA;275798;323;2021-02-14;72484
2021-02-13;"Nitriansky kraj";127;110294;690;110984;NA;275798;817;2021-02-13;72161
2021-02-12;"Nitriansky kraj";162;33405;407;33812;NA;275798;569;2021-02-12;71344
2021-02-11;"Nitriansky kraj";195;12406;270;12676;NA;275798;465;2021-02-11;70775
2021-02-10;"Nitriansky kraj";186;17770;644;18414;NA;275798;830;2021-02-10;70310
2021-02-09;"Nitriansky kraj";260;18530;385;18915;NA;275798;645;2021-02-09;69480
2021-02-08;"Nitriansky kraj";177;37530;569;38099;NA;275798;746;2021-02-08;68835
2021-02-07;"Nitriansky kraj";20;52307;513;52820;NA;275798;533;2021-02-07;68089
2021-02-06;"Nitriansky kraj";129;101439;764;102203;NA;275798;893;2021-02-06;67556
2021-02-05;"Nitriansky kraj";244;26137;491;26628;NA;275798;735;2021-02-05;66663
2021-02-04;"Nitriansky kraj";308;15681;512;16193;NA;275798;820;2021-02-04;65928
2021-02-03;"Nitriansky kraj";191;13459;382;13841;NA;275798;573;2021-02-03;65108
2021-02-02;"Nitriansky kraj";327;17880;382;18262;NA;275798;709;2021-02-02;64535
2021-02-01;"Nitriansky kraj";221;24002;460;24462;NA;275798;681;2021-02-01;63826
2021-01-31;"Nitriansky kraj";9;46215;507;46722;NA;275798;516;2021-01-31;63145
2021-01-30;"Nitriansky kraj";152;99241;1090;100331;NA;275798;1242;2021-01-30;62629
2021-01-29;"Nitriansky kraj";302;22461;477;22938;NA;275798;779;2021-01-29;61387
2021-01-28;"Nitriansky kraj";269;11370;398;11768;NA;275798;667;2021-01-28;60608
2021-01-27;"Nitriansky kraj";235;6758;299;7057;NA;275798;534;2021-01-27;59941
2021-01-26;"Nitriansky kraj";345;16015;454;16469;NA;275798;799;2021-01-26;59407
2021-01-25;"Nitriansky kraj";201;21909;434;22343;NA;275798;635;2021-01-25;58608
2021-01-24;"Nitriansky kraj";12;79041;897;79938;NA;275798;909;2021-01-24;57973
2021-01-23;"Nitriansky kraj";277;97845;1446;99291;NA;275798;1723;2021-01-23;57064
2021-01-22;"Nitriansky kraj";139;35924;619;36543;NA;275798;758;2021-01-22;55341
2021-01-21;"Nitriansky kraj";305;14649;412;15061;NA;275798;717;2021-01-21;54583
2021-01-20;"Nitriansky kraj";326;11991;625;12616;NA;275798;951;2021-01-20;53866
2021-01-19;"Nitriansky kraj";344;11015;633;11648;NA;275798;977;2021-01-19;52915
2021-01-18;"Nitriansky kraj";367;8901;519;9420;NA;275798;886;2021-01-18;51938
2021-01-17;"Nitriansky kraj";97;15061;275;15336;NA;275798;372;2021-01-17;51052
2021-01-16;"Nitriansky kraj";64;36838;679;37517;NA;275798;743;2021-01-16;50680
2021-01-15;"Nitriansky kraj";373;15940;474;16414;NA;275798;847;2021-01-15;49937
2021-01-14;"Nitriansky kraj";627;10577;452;11029;NA;275798;1079;2021-01-14;49090
2021-01-13;"Nitriansky kraj";663;9234;484;9718;NA;275798;1147;2021-01-13;48011
2021-01-12;"Nitriansky kraj";642;8805;545;9350;NA;275798;1187;2021-01-12;46864
2021-01-11;"Nitriansky kraj";422;8347;513;8860;NA;275798;935;2021-01-11;45677
2021-01-10;"Nitriansky kraj";44;19841;730;20571;NA;275798;774;2021-01-10;44742
2021-01-09;"Nitriansky kraj";532;36823;1071;37894;NA;275798;1603;2021-01-09;43968
2021-01-08;"Nitriansky kraj";817;14001;691;14692;NA;275798;1508;2021-01-08;42365
2021-01-07;"Nitriansky kraj";438;10121;795;10916;NA;275798;1233;2021-01-07;40857
2021-01-06;"Nitriansky kraj";259;3192;197;3389;NA;275798;456;2021-01-06;39624
2021-01-05;"Nitriansky kraj";732;8918;1208;10126;NA;275798;1940;2021-01-05;39168
2021-01-04;"Nitriansky kraj";362;8409;1287;9696;NA;275798;1649;2021-01-04;37228
2021-01-03;"Nitriansky kraj";42;84;20;104;NA;275798;62;2021-01-03;35579
2021-01-02;"Nitriansky kraj";249;1090;26;1116;NA;275798;275;2021-01-02;35517
2021-01-01;"Nitriansky kraj";119;781;95;876;NA;275798;214;2021-01-01;35242
2020-12-31;"Nitriansky kraj";786;7646;962;8608;NA;275798;1748;2020-12-31;35028
2020-12-30;"Nitriansky kraj";1094;9619;1165;10784;NA;275798;2259;2020-12-30;33280
2020-12-29;"Nitriansky kraj";607;8028;1245;9273;NA;275798;1852;2020-12-29;31021
2020-12-28;"Nitriansky kraj";83;6804;1220;8024;NA;275798;1303;2020-12-28;29169
2020-12-27;"Nitriansky kraj";22;60;8;68;NA;275798;30;2020-12-27;27866
2020-12-26;"Nitriansky kraj";54;297;56;353;NA;275798;110;2020-12-26;27836
2020-12-25;"Nitriansky kraj";35;60;11;71;NA;275798;46;2020-12-25;27726
2020-12-24;"Nitriansky kraj";514;1861;176;2037;NA;275798;690;2020-12-24;27680
2020-12-23;"Nitriansky kraj";349;14679;782;15461;NA;275798;1131;2020-12-23;26990
2020-12-22;"Nitriansky kraj";673;10623;949;11572;NA;275798;1622;2020-12-22;25859
2020-12-21;"Nitriansky kraj";128;7587;931;8518;NA;275798;1059;2020-12-21;24237
2020-12-20;"Nitriansky kraj";77;50;10;60;NA;275798;87;2020-12-20;23178
2020-12-19;"Nitriansky kraj";262;2259;159;2418;NA;275798;421;2020-12-19;23091
2020-12-18;"Nitriansky kraj";512;7946;518;8464;NA;275798;1030;2020-12-18;22670
2020-12-17;"Nitriansky kraj";586;6519;486;7005;NA;275798;1072;2020-12-17;21640
2020-12-16;"Nitriansky kraj";357;8097;500;8597;NA;275798;857;2020-12-16;20568
2020-12-15;"Nitriansky kraj";461;9084;750;9834;NA;275798;1211;2020-12-15;19711
2020-12-14;"Nitriansky kraj";217;7816;797;8613;NA;275798;1014;2020-12-14;18500
2020-12-13;"Nitriansky kraj";12;69;6;75;NA;275798;18;2020-12-13;17486
2020-12-12;"Nitriansky kraj";341;1832;125;1957;NA;275798;466;2020-12-12;17468
2020-12-11;"Nitriansky kraj";409;5117;384;5501;NA;275798;793;2020-12-11;17002
2020-12-10;"Nitriansky kraj";360;5239;345;5584;NA;275798;705;2020-12-10;16209
2020-12-09;"Nitriansky kraj";362;5494;529;6023;NA;275798;891;2020-12-09;15504
2020-12-08;"Nitriansky kraj";340;8168;548;8716;NA;275798;888;2020-12-08;14613
2020-12-07;"Nitriansky kraj";139;6243;573;6816;NA;275798;712;2020-12-07;13725
2020-12-06;"Nitriansky kraj";15;89;4;93;NA;275798;19;2020-12-06;13013
2020-12-05;"Nitriansky kraj";136;1388;19;1407;NA;275798;155;2020-12-05;12994
2020-12-04;"Nitriansky kraj";232;2884;74;2958;NA;275798;306;2020-12-04;12839
2020-12-03;"Nitriansky kraj";248;2471;110;2581;NA;275798;358;2020-12-03;12533
2020-12-02;"Nitriansky kraj";252;2580;151;2731;NA;275798;403;2020-12-02;12175
2020-12-01;"Nitriansky kraj";331;2891;131;3022;NA;275798;462;2020-12-01;11772
2020-11-30;"Nitriansky kraj";91;4228;188;4416;NA;275798;279;2020-11-30;11310
2020-11-29;"Nitriansky kraj";3;634;42;676;NA;275798;45;2020-11-29;11031
2020-11-28;"Nitriansky kraj";135;892;31;923;NA;275798;166;2020-11-28;10986
2020-11-27;"Nitriansky kraj";177;2069;73;2142;NA;275798;250;2020-11-27;10820
2020-11-26;"Nitriansky kraj";191;2813;80;2893;NA;275798;271;2020-11-26;10570
2020-11-25;"Nitriansky kraj";325;2478;91;2569;NA;275798;416;2020-11-25;10299
2020-11-24;"Nitriansky kraj";147;1641;64;1705;NA;275798;211;2020-11-24;9883
2020-11-23;"Nitriansky kraj";102;9891;212;10103;NA;275798;314;2020-11-23;9672
2020-11-22;"Nitriansky kraj";7;1176;25;1201;NA;275798;32;2020-11-22;9358
2020-11-21;"Nitriansky kraj";86;1083;38;1121;NA;275798;124;2020-11-21;9326
2020-11-20;"Nitriansky kraj";264;4180;103;4283;NA;275798;367;2020-11-20;9202
2020-11-19;"Nitriansky kraj";185;3065;134;3199;NA;275798;319;2020-11-19;8835
2020-11-18;"Nitriansky kraj";188;2214;79;2293;NA;275798;267;2020-11-18;8516
2020-11-17;"Nitriansky kraj";178;596;29;625;NA;275798;207;2020-11-17;8249
2020-11-16;"Nitriansky kraj";139;1877;75;1952;NA;275798;214;2020-11-16;8042
2020-11-15;"Nitriansky kraj";14;180;5;185;NA;275798;19;2020-11-15;7828
2020-11-14;"Nitriansky kraj";114;1131;32;1163;NA;275798;146;2020-11-14;7809
2020-11-13;"Nitriansky kraj";210;936;46;982;NA;275798;256;2020-11-13;7663
2020-11-12;"Nitriansky kraj";256;1195;35;1230;NA;275798;291;2020-11-12;7407
2020-11-11;"Nitriansky kraj";279;1247;22;1269;NA;275798;301;2020-11-11;7116
2020-11-10;"Nitriansky kraj";192;2623;39;2662;NA;275798;231;2020-11-10;6815
2020-11-09;"Nitriansky kraj";128;3136;43;3179;NA;275798;171;2020-11-09;6584
2020-11-08;"Nitriansky kraj";43;1462;32;1494;NA;275798;75;2020-11-08;6413
2020-11-07;"Nitriansky kraj";130;1046;4;1050;NA;275798;134;2020-11-07;6338
2020-11-06;"Nitriansky kraj";210;2264;32;2296;NA;275798;242;2020-11-06;6204
2020-11-05;"Nitriansky kraj";178;313;14;327;NA;275798;192;2020-11-05;5962
2020-11-04;"Nitriansky kraj";211;297;16;313;NA;275798;227;2020-11-04;5770
2020-11-03;"Nitriansky kraj";216;435;25;460;NA;275798;241;2020-11-03;5543
2020-11-02;"Nitriansky kraj";171;4208;46;4254;NA;275798;217;2020-11-02;5302
2020-11-01;"Nitriansky kraj";46;2546;27;2573;NA;275798;73;2020-11-01;5085
2022-04-03;"Prešovský kraj";159;416;55;471;254805;354950;214;2022-04-03;354950
2022-04-02;"Prešovský kraj";359;295;39;334;NA;354950;398;2022-04-02;354736
2022-04-01;"Prešovský kraj";621;795;90;885;NA;354950;711;2022-04-01;354338
2022-03-31;"Prešovský kraj";717;2113;120;2233;NA;354950;837;2022-03-31;353627
2022-03-30;"Prešovský kraj";973;1992;143;2135;NA;354950;1116;2022-03-30;352790
2022-03-29;"Prešovský kraj";645;2007;155;2162;NA;354950;800;2022-03-29;351674
2022-03-28;"Prešovský kraj";946;3115;238;3353;NA;354950;1184;2022-03-28;350874
2022-03-27;"Prešovský kraj";256;734;95;829;NA;354950;351;2022-03-27;349690
2022-03-26;"Prešovský kraj";719;663;80;743;NA;354950;799;2022-03-26;349339
2022-03-25;"Prešovský kraj";895;1907;209;2116;NA;354950;1104;2022-03-25;348540
2022-03-24;"Prešovský kraj";909;2099;185;2284;NA;354950;1094;2022-03-24;347436
2022-03-23;"Prešovský kraj";1291;2100;195;2295;NA;354950;1486;2022-03-23;346342
2022-03-22;"Prešovský kraj";1398;2200;180;2380;NA;354950;1578;2022-03-22;344856
2022-03-21;"Prešovský kraj";1234;2891;270;3161;NA;354950;1504;2022-03-21;343278
2022-03-20;"Prešovský kraj";262;781;120;901;NA;354950;382;2022-03-20;341774
2022-03-19;"Prešovský kraj";802;887;106;993;NA;354950;908;2022-03-19;341392
2022-03-18;"Prešovský kraj";1217;2093;221;2314;NA;354950;1438;2022-03-18;340484
2022-03-17;"Prešovský kraj";1118;2436;179;2615;NA;354950;1297;2022-03-17;339046
2022-03-16;"Prešovský kraj";1585;2073;212;2285;NA;354950;1797;2022-03-16;337749
2022-03-15;"Prešovský kraj";1460;2311;209;2520;NA;354950;1669;2022-03-15;335952
2022-03-14;"Prešovský kraj";1438;3310;380;3690;NA;354950;1818;2022-03-14;334283
2022-03-13;"Prešovský kraj";432;1045;190;1235;NA;354950;622;2022-03-13;332465
2022-03-12;"Prešovský kraj";1150;857;117;974;NA;354950;1267;2022-03-12;331843
2022-03-11;"Prešovský kraj";1271;2551;287;2838;NA;354950;1558;2022-03-11;330576
2022-03-10;"Prešovský kraj";1114;2577;278;2855;NA;354950;1392;2022-03-10;329018
2022-03-09;"Prešovský kraj";1477;2813;345;3158;NA;354950;1822;2022-03-09;327626
2022-03-08;"Prešovský kraj";1716;2999;308;3307;NA;354950;2024;2022-03-08;325804
2022-03-07;"Prešovský kraj";1326;4197;509;4706;NA;354950;1835;2022-03-07;323780
2022-03-06;"Prešovský kraj";278;1650;232;1882;NA;354950;510;2022-03-06;321945
2022-03-05;"Prešovský kraj";785;1194;136;1330;NA;354950;921;2022-03-05;321435
2022-03-04;"Prešovský kraj";1263;2812;303;3115;NA;354950;1566;2022-03-04;320514
2022-03-03;"Prešovský kraj";1049;3016;373;3389;NA;354950;1422;2022-03-03;318948
2022-03-02;"Prešovský kraj";1526;2955;335;3290;NA;354950;1861;2022-03-02;317526
2022-03-01;"Prešovský kraj";1612;3302;338;3640;NA;354950;1950;2022-03-01;315665
2022-02-28;"Prešovský kraj";1234;4963;538;5501;NA;354950;1772;2022-02-28;313715
2022-02-27;"Prešovský kraj";523;1467;278;1745;NA;354950;801;2022-02-27;311943
2022-02-26;"Prešovský kraj";867;1317;167;1484;NA;354950;1034;2022-02-26;311142
2022-02-25;"Prešovský kraj";1740;2768;346;3114;NA;354950;2086;2022-02-25;310108
2022-02-24;"Prešovský kraj";1435;3301;399;3700;NA;354950;1834;2022-02-24;308022
2022-02-23;"Prešovský kraj";1837;3516;404;3920;NA;354950;2241;2022-02-23;306188
2022-02-22;"Prešovský kraj";2294;3893;407;4300;NA;354950;2701;2022-02-22;303947
2022-02-21;"Prešovský kraj";1609;5165;618;5783;NA;354950;2227;2022-02-21;301246
2022-02-20;"Prešovský kraj";759;1877;319;2196;NA;354950;1078;2022-02-20;299019
2022-02-19;"Prešovský kraj";1535;1556;247;1803;NA;354950;1782;2022-02-19;297941
2022-02-18;"Prešovský kraj";2332;3580;393;3973;NA;354950;2725;2022-02-18;296159
2022-02-17;"Prešovský kraj";2293;3740;457;4197;NA;354950;2750;2022-02-17;293434
2022-02-16;"Prešovský kraj";2494;4049;484;4533;NA;354950;2978;2022-02-16;290684
2022-02-15;"Prešovský kraj";2992;4583;551;5134;NA;354950;3543;2022-02-15;287706
2022-02-14;"Prešovský kraj";2122;6203;845;7048;NA;354950;2967;2022-02-14;284163
2022-02-13;"Prešovský kraj";1338;2452;434;2886;NA;354950;1772;2022-02-13;281196
2022-02-12;"Prešovský kraj";2333;1867;352;2219;NA;354950;2685;2022-02-12;279424
2022-02-11;"Prešovský kraj";2666;3930;520;4450;NA;354950;3186;2022-02-11;276739
2022-02-10;"Prešovský kraj";2977;4516;599;5115;NA;354950;3576;2022-02-10;273553
2022-02-09;"Prešovský kraj";2644;4502;634;5136;NA;354950;3278;2022-02-09;269977
2022-02-08;"Prešovský kraj";3387;4890;651;5541;NA;354950;4038;2022-02-08;266699
2022-02-07;"Prešovský kraj";2132;6919;941;7860;NA;354950;3073;2022-02-07;262661
2022-02-06;"Prešovský kraj";1360;2884;490;3374;NA;354950;1850;2022-02-06;259588
2022-02-05;"Prešovský kraj";2813;1993;334;2327;NA;354950;3147;2022-02-05;257738
2022-02-04;"Prešovský kraj";2944;4556;573;5129;NA;354950;3517;2022-02-04;254591
2022-02-03;"Prešovský kraj";3375;5205;487;5692;NA;354950;3862;2022-02-03;251074
2022-02-02;"Prešovský kraj";3150;5686;562;6248;NA;354950;3712;2022-02-02;247212
2022-02-01;"Prešovský kraj";2791;5693;631;6324;NA;354950;3422;2022-02-01;243500
2022-01-31;"Prešovský kraj";2444;9142;929;10071;NA;354950;3373;2022-01-31;240078
2022-01-30;"Prešovský kraj";1311;3437;495;3932;NA;354950;1806;2022-01-30;236705
2022-01-29;"Prešovský kraj";2291;1949;282;2231;NA;354950;2573;2022-01-29;234899
2022-01-28;"Prešovský kraj";2473;4784;486;5270;NA;354950;2959;2022-01-28;232326
2022-01-27;"Prešovský kraj";2353;4558;412;4970;NA;354950;2765;2022-01-27;229367
2022-01-26;"Prešovský kraj";2311;5628;405;6033;NA;354950;2716;2022-01-26;226602
2022-01-25;"Prešovský kraj";2127;5284;346;5630;NA;354950;2473;2022-01-25;223886
2022-01-24;"Prešovský kraj";1324;7619;410;8029;NA;354950;1734;2022-01-24;221413
2022-01-23;"Prešovský kraj";262;3584;218;3802;NA;354950;480;2022-01-23;219679
2022-01-22;"Prešovský kraj";1448;1764;157;1921;NA;354950;1605;2022-01-22;219199
2022-01-21;"Prešovský kraj";1128;4312;196;4508;NA;354950;1324;2022-01-21;217594
2022-01-20;"Prešovský kraj";1184;4012;156;4168;NA;354950;1340;2022-01-20;216270
2022-01-19;"Prešovský kraj";822;4781;173;4954;NA;354950;995;2022-01-19;214930
2022-01-18;"Prešovský kraj";1032;4918;163;5081;NA;354950;1195;2022-01-18;213935
2022-01-17;"Prešovský kraj";784;7143;150;7293;NA;354950;934;2022-01-17;212740
2022-01-16;"Prešovský kraj";113;3113;98;3211;NA;354950;211;2022-01-16;211806
2022-01-15;"Prešovský kraj";675;1546;64;1610;NA;354950;739;2022-01-15;211595
2022-01-14;"Prešovský kraj";202;3792;78;3870;NA;354950;280;2022-01-14;210856
2022-01-13;"Prešovský kraj";252;3550;89;3639;NA;354950;341;2022-01-13;210576
2022-01-12;"Prešovský kraj";431;4183;77;4260;NA;354950;508;2022-01-12;210235
2022-01-11;"Prešovský kraj";438;4812;80;4892;NA;354950;518;2022-01-11;209727
2022-01-10;"Prešovský kraj";469;7561;135;7696;NA;354950;604;2022-01-10;209209
2022-01-09;"Prešovský kraj";114;4129;78;4207;NA;354950;192;2022-01-09;208605
2022-01-08;"Prešovský kraj";291;2097;39;2136;NA;354950;330;2022-01-08;208413
2022-01-07;"Prešovský kraj";370;3882;106;3988;NA;354950;476;2022-01-07;208083
2022-01-06;"Prešovský kraj";104;1000;43;1043;NA;354950;147;2022-01-06;207607
2022-01-05;"Prešovský kraj";373;4752;100;4852;NA;354950;473;2022-01-05;207460
2022-01-04;"Prešovský kraj";428;4558;77;4635;NA;354950;505;2022-01-04;206987
2022-01-03;"Prešovský kraj";390;6868;105;6973;NA;354950;495;2022-01-03;206482
2022-01-02;"Prešovský kraj";158;3180;75;3255;NA;354950;233;2022-01-02;205987
2022-01-01;"Prešovský kraj";55;379;8;387;NA;354950;63;2022-01-01;205754
2021-12-31;"Prešovský kraj";220;2217;77;2294;NA;354950;297;2021-12-31;205691
2021-12-30;"Prešovský kraj";230;2985;81;3066;NA;354950;311;2021-12-30;205394
2021-12-29;"Prešovský kraj";298;3924;73;3997;NA;354950;371;2021-12-29;205083
2021-12-28;"Prešovský kraj";365;3625;60;3685;NA;354950;425;2021-12-28;204712
2021-12-27;"Prešovský kraj";593;5336;93;5429;NA;354950;686;2021-12-27;204287
2021-12-26;"Prešovský kraj";112;1584;62;1646;NA;354950;174;2021-12-26;203601
2021-12-25;"Prešovský kraj";12;600;29;629;NA;354950;41;2021-12-25;203427
2021-12-24;"Prešovský kraj";27;463;26;489;NA;354950;53;2021-12-24;203386
2021-12-23;"Prešovský kraj";623;3125;76;3201;NA;354950;699;2021-12-23;203333
2021-12-22;"Prešovský kraj";234;3600;86;3686;NA;354950;320;2021-12-22;202634
2021-12-21;"Prešovský kraj";520;4571;78;4649;NA;354950;598;2021-12-21;202314
2021-12-20;"Prešovský kraj";371;7190;107;7297;NA;354950;478;2021-12-20;201716
2021-12-19;"Prešovský kraj";110;3166;74;3240;NA;354950;184;2021-12-19;201238
2021-12-18;"Prešovský kraj";313;1562;61;1623;NA;354950;374;2021-12-18;201054
2021-12-17;"Prešovský kraj";429;4482;96;4578;NA;354950;525;2021-12-17;200680
2021-12-16;"Prešovský kraj";401;4557;95;4652;NA;354950;496;2021-12-16;200155
2021-12-15;"Prešovský kraj";473;4499;79;4578;NA;354950;552;2021-12-15;199659
2021-12-14;"Prešovský kraj";662;5468;125;5593;NA;354950;787;2021-12-14;199107
2021-12-13;"Prešovský kraj";588;8085;175;8260;NA;354950;763;2021-12-13;198320
2021-12-12;"Prešovský kraj";160;3852;106;3958;NA;354950;266;2021-12-12;197557
2021-12-11;"Prešovský kraj";483;2040;91;2131;NA;354950;574;2021-12-11;197291
2021-12-10;"Prešovský kraj";649;5018;140;5158;NA;354950;789;2021-12-10;196717
2021-12-09;"Prešovský kraj";669;4702;135;4837;NA;354950;804;2021-12-09;195928
2021-12-08;"Prešovský kraj";944;4794;167;4961;NA;354950;1111;2021-12-08;195124
2021-12-07;"Prešovský kraj";1217;5853;188;6041;NA;354950;1405;2021-12-07;194013
2021-12-06;"Prešovský kraj";784;8604;247;8851;NA;354950;1031;2021-12-06;192608
2021-12-05;"Prešovský kraj";145;4439;133;4572;NA;354950;278;2021-12-05;191577
2021-12-04;"Prešovský kraj";1025;2290;127;2417;NA;354950;1152;2021-12-04;191299
2021-12-03;"Prešovský kraj";1040;5268;231;5499;NA;354950;1271;2021-12-03;190147
2021-12-02;"Prešovský kraj";2255;5291;183;5474;NA;354950;2438;2021-12-02;188876
2021-12-01;"Prešovský kraj";826;5267;239;5506;NA;354950;1065;2021-12-01;186438
2021-11-30;"Prešovský kraj";1123;6651;265;6916;NA;354950;1388;2021-11-30;185373
2021-11-29;"Prešovský kraj";583;11478;473;11951;NA;354950;1056;2021-11-29;183985
2021-11-28;"Prešovský kraj";919;5898;234;6132;NA;354950;1153;2021-11-28;182929
2021-11-27;"Prešovský kraj";884;2977;219;3196;NA;354950;1103;2021-11-27;181776
2021-11-26;"Prešovský kraj";1311;5890;328;6218;NA;354950;1639;2021-11-26;180673
2021-11-25;"Prešovský kraj";1285;5051;307;5358;NA;354950;1592;2021-11-25;179034
2021-11-24;"Prešovský kraj";1209;6120;357;6477;NA;354950;1566;2021-11-24;177442
2021-11-23;"Prešovský kraj";1099;6631;314;6945;NA;354950;1413;2021-11-23;175876
2021-11-22;"Prešovský kraj";905;8209;529;8738;NA;354950;1434;2021-11-22;174463
2021-11-21;"Prešovský kraj";950;3766;316;4082;NA;354950;1266;2021-11-21;173029
2021-11-20;"Prešovský kraj";1372;2193;222;2415;NA;354950;1594;2021-11-20;171763
2021-11-19;"Prešovský kraj";1629;5864;452;6316;NA;354950;2081;2021-11-19;170169
2021-11-18;"Prešovský kraj";823;6696;518;7214;NA;354950;1341;2021-11-18;168088
2021-11-17;"Prešovský kraj";1648;1336;148;1484;NA;354950;1796;2021-11-17;166747
2021-11-16;"Prešovský kraj";1346;5511;398;5909;NA;354950;1744;2021-11-16;164951
2021-11-15;"Prešovský kraj";897;7804;577;8381;NA;354950;1474;2021-11-15;163207
2021-11-14;"Prešovský kraj";603;3168;311;3479;NA;354950;914;2021-11-14;161733
2021-11-13;"Prešovský kraj";1255;2068;262;2330;NA;354950;1517;2021-11-13;160819
2021-11-12;"Prešovský kraj";1358;5236;371;5607;NA;354950;1729;2021-11-12;159302
2021-11-11;"Prešovský kraj";1218;5087;438;5525;NA;354950;1656;2021-11-11;157573
2021-11-10;"Prešovský kraj";1278;4966;380;5346;NA;354950;1658;2021-11-10;155917
2021-11-09;"Prešovský kraj";1038;5431;407;5838;NA;354950;1445;2021-11-09;154259
2021-11-08;"Prešovský kraj";1068;6987;574;7561;NA;354950;1642;2021-11-08;152814
2021-11-07;"Prešovský kraj";421;2500;242;2742;NA;354950;663;2021-11-07;151172
2021-11-06;"Prešovský kraj";1389;1899;234;2133;NA;354950;1623;2021-11-06;150509
2021-11-05;"Prešovský kraj";1080;4974;367;5341;NA;354950;1447;2021-11-05;148886
2021-11-04;"Prešovský kraj";1743;5162;322;5484;NA;354950;2065;2021-11-04;147439
2021-11-03;"Prešovský kraj";1326;5337;387;5724;NA;354950;1713;2021-11-03;145374
2021-11-02;"Prešovský kraj";1002;7553;556;8109;NA;354950;1558;2021-11-02;143661
2021-11-01;"Prešovský kraj";347;1402;131;1533;NA;354950;478;2021-11-01;142103
2021-10-31;"Prešovský kraj";447;2045;210;2255;NA;354950;657;2021-10-31;141625
2021-10-30;"Prešovský kraj";1148;1928;183;2111;NA;354950;1331;2021-10-30;140968
2021-10-29;"Prešovský kraj";1360;4460;253;4713;NA;354950;1613;2021-10-29;139637
2021-10-28;"Prešovský kraj";960;4500;300;4800;NA;354950;1260;2021-10-28;138024
2021-10-27;"Prešovský kraj";1444;4325;221;4546;NA;354950;1665;2021-10-27;136764
2021-10-26;"Prešovský kraj";940;5125;217;5342;NA;354950;1157;2021-10-26;135099
2021-10-25;"Prešovský kraj";673;6077;348;6425;NA;354950;1021;2021-10-25;133942
2021-10-24;"Prešovský kraj";110;2180;149;2329;NA;354950;259;2021-10-24;132921
2021-10-23;"Prešovský kraj";1145;1928;141;2069;NA;354950;1286;2021-10-23;132662
2021-10-22;"Prešovský kraj";792;4876;177;5053;NA;354950;969;2021-10-22;131376
2021-10-21;"Prešovský kraj";901;4738;191;4929;NA;354950;1092;2021-10-21;130407
2021-10-20;"Prešovský kraj";833;4199;195;4394;NA;354950;1028;2021-10-20;129315
2021-10-19;"Prešovský kraj";830;4728;175;4903;NA;354950;1005;2021-10-19;128287
2021-10-18;"Prešovský kraj";454;5752;240;5992;NA;354950;694;2021-10-18;127282
2021-10-17;"Prešovský kraj";181;2430;131;2561;NA;354950;312;2021-10-17;126588
2021-10-16;"Prešovský kraj";561;1924;94;2018;NA;354950;655;2021-10-16;126276
2021-10-15;"Prešovský kraj";533;4735;107;4842;NA;354950;640;2021-10-15;125621
2021-10-14;"Prešovský kraj";506;3948;85;4033;NA;354950;591;2021-10-14;124981
2021-10-13;"Prešovský kraj";549;3794;98;3892;NA;354950;647;2021-10-13;124390
2021-10-12;"Prešovský kraj";520;3966;101;4067;NA;354950;621;2021-10-12;123743
2021-10-11;"Prešovský kraj";433;5421;131;5552;NA;354950;564;2021-10-11;123122
2021-10-10;"Prešovský kraj";78;2099;64;2163;NA;354950;142;2021-10-10;122558
2021-10-09;"Prešovský kraj";311;2077;47;2124;NA;354950;358;2021-10-09;122416
2021-10-08;"Prešovský kraj";636;4934;94;5028;NA;354950;730;2021-10-08;122058
2021-10-07;"Prešovský kraj";487;3919;101;4020;NA;354950;588;2021-10-07;121328
2021-10-06;"Prešovský kraj";296;3851;104;3955;NA;354950;400;2021-10-06;120740
2021-10-05;"Prešovský kraj";430;4151;90;4241;NA;354950;520;2021-10-05;120340
2021-10-04;"Prešovský kraj";353;5569;125;5694;NA;354950;478;2021-10-04;119820
2021-10-03;"Prešovský kraj";19;2324;47;2371;NA;354950;66;2021-10-03;119342
2021-10-02;"Prešovský kraj";269;2238;58;2296;NA;354950;327;2021-10-02;119276
2021-10-01;"Prešovský kraj";325;4997;63;5060;NA;354950;388;2021-10-01;118949
2021-09-30;"Prešovský kraj";265;4044;83;4127;NA;354950;348;2021-09-30;118561
2021-09-29;"Prešovský kraj";381;3825;55;3880;NA;354950;436;2021-09-29;118213
2021-09-28;"Prešovský kraj";312;4714;69;4783;NA;354950;381;2021-09-28;117777
2021-09-27;"Prešovský kraj";257;5062;104;5166;NA;354950;361;2021-09-27;117396
2021-09-26;"Prešovský kraj";8;2422;67;2489;NA;354950;75;2021-09-26;117035
2021-09-25;"Prešovský kraj";134;2540;46;2586;NA;354950;180;2021-09-25;116960
2021-09-24;"Prešovský kraj";297;4822;61;4883;NA;354950;358;2021-09-24;116780
2021-09-23;"Prešovský kraj";109;4105;45;4150;NA;354950;154;2021-09-23;116422
2021-09-22;"Prešovský kraj";177;3836;41;3877;NA;354950;218;2021-09-22;116268
2021-09-21;"Prešovský kraj";219;5059;66;5125;NA;354950;285;2021-09-21;116050
2021-09-20;"Prešovský kraj";180;5183;68;5251;NA;354950;248;2021-09-20;115765
2021-09-19;"Prešovský kraj";7;2726;30;2756;NA;354950;37;2021-09-19;115517
2021-09-18;"Prešovský kraj";169;2406;37;2443;NA;354950;206;2021-09-18;115480
2021-09-17;"Prešovský kraj";157;4402;52;4454;NA;354950;209;2021-09-17;115274
2021-09-16;"Prešovský kraj";146;4371;71;4442;NA;354950;217;2021-09-16;115065
2021-09-15;"Prešovský kraj";68;701;19;720;NA;354950;87;2021-09-15;114848
2021-09-14;"Prešovský kraj";133;3369;38;3407;NA;354950;171;2021-09-14;114761
2021-09-13;"Prešovský kraj";105;4225;37;4262;NA;354950;142;2021-09-13;114590
2021-09-12;"Prešovský kraj";4;1776;29;1805;NA;354950;33;2021-09-12;114448
2021-09-11;"Prešovský kraj";65;2012;24;2036;NA;354950;89;2021-09-11;114415
2021-09-10;"Prešovský kraj";105;3241;30;3271;NA;354950;135;2021-09-10;114326
2021-09-09;"Prešovský kraj";29;3090;27;3117;NA;354950;56;2021-09-09;114191
2021-09-08;"Prešovský kraj";73;2444;20;2464;NA;354950;93;2021-09-08;114135
2021-09-07;"Prešovský kraj";82;2449;24;2473;NA;354950;106;2021-09-07;114042
2021-09-06;"Prešovský kraj";61;3282;20;3302;NA;354950;81;2021-09-06;113936
2021-09-05;"Prešovský kraj";5;1338;11;1349;NA;354950;16;2021-09-05;113855
2021-09-04;"Prešovský kraj";27;1864;14;1878;NA;354950;41;2021-09-04;113839
2021-09-03;"Prešovský kraj";39;2976;15;2991;NA;354950;54;2021-09-03;113798
2021-09-02;"Prešovský kraj";39;2558;20;2578;NA;354950;59;2021-09-02;113744
2021-09-01;"Prešovský kraj";14;575;6;581;NA;354950;20;2021-09-01;113685
2021-08-31;"Prešovský kraj";47;2438;13;2451;NA;354950;60;2021-08-31;113665
2021-08-30;"Prešovský kraj";23;2827;19;2846;NA;354950;42;2021-08-30;113605
2021-08-29;"Prešovský kraj";3;781;1;782;NA;354950;4;2021-08-29;113563
2021-08-28;"Prešovský kraj";5;2101;8;2109;NA;354950;13;2021-08-28;113559
2021-08-27;"Prešovský kraj";32;3084;8;3092;NA;354950;40;2021-08-27;113546
2021-08-26;"Prešovský kraj";13;2094;8;2102;NA;354950;21;2021-08-26;113506
2021-08-25;"Prešovský kraj";18;1947;4;1951;NA;354950;22;2021-08-25;113485
2021-08-24;"Prešovský kraj";10;2138;5;2143;NA;354950;15;2021-08-24;113463
2021-08-23;"Prešovský kraj";16;2576;6;2582;NA;354950;22;2021-08-23;113448
2021-08-22;"Prešovský kraj";0;1440;6;1446;NA;354950;6;2021-08-22;113426
2021-08-21;"Prešovský kraj";28;2018;4;2022;NA;354950;32;2021-08-21;113420
2021-08-20;"Prešovský kraj";15;2906;7;2913;NA;354950;22;2021-08-20;113388
2021-08-19;"Prešovský kraj";22;2242;8;2250;NA;354950;30;2021-08-19;113366
2021-08-18;"Prešovský kraj";6;1752;11;1763;NA;354950;17;2021-08-18;113336
2021-08-17;"Prešovský kraj";29;1829;6;1835;NA;354950;35;2021-08-17;113319
2021-08-16;"Prešovský kraj";11;2524;7;2531;NA;354950;18;2021-08-16;113284
2021-08-15;"Prešovský kraj";0;896;2;898;NA;354950;2;2021-08-15;113266
2021-08-14;"Prešovský kraj";14;1662;1;1663;NA;354950;15;2021-08-14;113264
2021-08-13;"Prešovský kraj";24;1646;12;1658;NA;354950;36;2021-08-13;113249
2021-08-12;"Prešovský kraj";9;1752;3;1755;NA;354950;12;2021-08-12;113213
2021-08-11;"Prešovský kraj";15;1193;3;1196;NA;354950;18;2021-08-11;113201
2021-08-10;"Prešovský kraj";10;1102;4;1106;NA;354950;14;2021-08-10;113183
2021-08-09;"Prešovský kraj";13;2156;4;2160;NA;354950;17;2021-08-09;113169
2021-08-08;"Prešovský kraj";2;675;2;677;NA;354950;4;2021-08-08;113152
2021-08-07;"Prešovský kraj";5;1114;3;1117;NA;354950;8;2021-08-07;113148
2021-08-06;"Prešovský kraj";9;1459;4;1463;NA;354950;13;2021-08-06;113140
2021-08-05;"Prešovský kraj";9;1370;2;1372;NA;354950;11;2021-08-05;113127
2021-08-04;"Prešovský kraj";6;1007;1;1008;NA;354950;7;2021-08-04;113116
2021-08-03;"Prešovský kraj";8;976;1;977;NA;354950;9;2021-08-03;113109
2021-08-02;"Prešovský kraj";5;1477;6;1483;NA;354950;11;2021-08-02;113100
2021-08-01;"Prešovský kraj";0;738;2;740;NA;354950;2;2021-08-01;113089
2021-07-31;"Prešovský kraj";20;1080;0;1080;NA;354950;20;2021-07-31;113087
2021-07-30;"Prešovský kraj";2;1518;1;1519;NA;354950;3;2021-07-30;113067
2021-07-29;"Prešovský kraj";6;1302;1;1303;NA;354950;7;2021-07-29;113064
2021-07-28;"Prešovský kraj";6;1106;1;1107;NA;354950;7;2021-07-28;113057
2021-07-27;"Prešovský kraj";5;1140;2;1142;NA;354950;7;2021-07-27;113050
2021-07-26;"Prešovský kraj";12;1583;1;1584;NA;354950;13;2021-07-26;113043
2021-07-25;"Prešovský kraj";0;687;1;688;NA;354950;1;2021-07-25;113030
2021-07-24;"Prešovský kraj";8;1040;0;1040;NA;354950;8;2021-07-24;113029
2021-07-23;"Prešovský kraj";8;1608;1;1609;NA;354950;9;2021-07-23;113021
2021-07-22;"Prešovský kraj";13;1431;10;1441;NA;354950;23;2021-07-22;113012
2021-07-21;"Prešovský kraj";5;1076;1;1077;NA;354950;6;2021-07-21;112989
2021-07-20;"Prešovský kraj";4;1064;0;1064;NA;354950;4;2021-07-20;112983
2021-07-19;"Prešovský kraj";2;1644;4;1648;NA;354950;6;2021-07-19;112979
2021-07-18;"Prešovský kraj";1;647;0;647;NA;354950;1;2021-07-18;112973
2021-07-17;"Prešovský kraj";6;1245;1;1246;NA;354950;7;2021-07-17;112972
2021-07-16;"Prešovský kraj";4;1558;2;1560;NA;354950;6;2021-07-16;112965
2021-07-15;"Prešovský kraj";5;1310;4;1314;NA;354950;9;2021-07-15;112959
2021-07-14;"Prešovský kraj";1;1051;2;1053;NA;354950;3;2021-07-14;112950
2021-07-13;"Prešovský kraj";1;1071;2;1073;NA;354950;3;2021-07-13;112947
2021-07-12;"Prešovský kraj";1;1949;2;1951;NA;354950;3;2021-07-12;112944
2021-07-11;"Prešovský kraj";0;660;1;661;NA;354950;1;2021-07-11;112941
2021-07-10;"Prešovský kraj";4;1229;2;1231;NA;354950;6;2021-07-10;112940
2021-07-09;"Prešovský kraj";6;1957;1;1958;NA;354950;7;2021-07-09;112934
2021-07-08;"Prešovský kraj";5;1192;0;1192;NA;354950;5;2021-07-08;112927
2021-07-07;"Prešovský kraj";7;1468;3;1471;NA;354950;10;2021-07-07;112922
2021-07-06;"Prešovský kraj";5;1423;2;1425;NA;354950;7;2021-07-06;112912
2021-07-05;"Prešovský kraj";2;645;0;645;NA;354950;2;2021-07-05;112905
2021-07-04;"Prešovský kraj";0;788;0;788;NA;354950;0;2021-07-04;112903
2021-07-03;"Prešovský kraj";2;1391;0;1391;NA;354950;2;2021-07-03;112903
2021-07-02;"Prešovský kraj";4;1796;0;1796;NA;354950;4;2021-07-02;112901
2021-07-01;"Prešovský kraj";2;1590;1;1591;NA;354950;3;2021-07-01;112897
2021-06-30;"Prešovský kraj";3;8829;4;8833;NA;354950;7;2021-06-30;112894
2021-06-29;"Prešovský kraj";1;4935;3;4938;NA;354950;4;2021-06-29;112887
2021-06-28;"Prešovský kraj";5;6109;2;6111;NA;354950;7;2021-06-28;112883
2021-06-27;"Prešovský kraj";0;3852;1;3853;NA;354950;1;2021-06-27;112876
2021-06-26;"Prešovský kraj";4;5815;1;5816;NA;354950;5;2021-06-26;112875
2021-06-25;"Prešovský kraj";7;7321;4;7325;NA;354950;11;2021-06-25;112870
2021-06-24;"Prešovský kraj";10;5406;5;5411;NA;354950;15;2021-06-24;112859
2021-06-23;"Prešovský kraj";4;5124;2;5126;NA;354950;6;2021-06-23;112844
2021-06-22;"Prešovský kraj";5;5143;1;5144;NA;354950;6;2021-06-22;112838
2021-06-21;"Prešovský kraj";13;7033;6;7039;NA;354950;19;2021-06-21;112832
2021-06-20;"Prešovský kraj";0;5204;3;5207;NA;354950;3;2021-06-20;112813
2021-06-19;"Prešovský kraj";1;7349;5;7354;NA;354950;6;2021-06-19;112810
2021-06-18;"Prešovský kraj";9;8682;10;8692;NA;354950;19;2021-06-18;112804
2021-06-17;"Prešovský kraj";9;6548;5;6553;NA;354950;14;2021-06-17;112785
2021-06-16;"Prešovský kraj";6;6422;3;6425;NA;354950;9;2021-06-16;112771
2021-06-15;"Prešovský kraj";2;5709;4;5713;NA;354950;6;2021-06-15;112762
2021-06-14;"Prešovský kraj";5;8229;13;8242;NA;354950;18;2021-06-14;112756
2021-06-13;"Prešovský kraj";1;6455;7;6462;NA;354950;8;2021-06-13;112738
2021-06-12;"Prešovský kraj";3;8904;9;8913;NA;354950;12;2021-06-12;112730
2021-06-11;"Prešovský kraj";21;9877;9;9886;NA;354950;30;2021-06-11;112718
2021-06-10;"Prešovský kraj";11;6512;10;6522;NA;354950;21;2021-06-10;112688
2021-06-09;"Prešovský kraj";16;6375;3;6378;NA;354950;19;2021-06-09;112667
2021-06-08;"Prešovský kraj";31;6495;12;6507;NA;354950;43;2021-06-08;112648
2021-06-07;"Prešovský kraj";11;9111;15;9126;NA;354950;26;2021-06-07;112605
2021-06-06;"Prešovský kraj";0;8016;5;8021;NA;354950;5;2021-06-06;112579
2021-06-05;"Prešovský kraj";17;10248;15;10263;NA;354950;32;2021-06-05;112574
2021-06-04;"Prešovský kraj";26;10375;18;10393;NA;354950;44;2021-06-04;112542
2021-06-03;"Prešovský kraj";14;6820;16;6836;NA;354950;30;2021-06-03;112498
2021-06-02;"Prešovský kraj";47;7372;14;7386;NA;354950;61;2021-06-02;112468
2021-06-01;"Prešovský kraj";15;6926;14;6940;NA;354950;29;2021-06-01;112407
2021-05-31;"Prešovský kraj";27;9951;22;9973;NA;354950;49;2021-05-31;112378
2021-05-30;"Prešovský kraj";2;9717;14;9731;NA;354950;16;2021-05-30;112329
2021-05-29;"Prešovský kraj";23;12733;24;12757;NA;354950;47;2021-05-29;112313
2021-05-28;"Prešovský kraj";30;12468;19;12487;NA;354950;49;2021-05-28;112266
2021-05-27;"Prešovský kraj";16;7653;37;7690;NA;354950;53;2021-05-27;112217
2021-05-26;"Prešovský kraj";32;8140;23;8163;NA;354950;55;2021-05-26;112164
2021-05-25;"Prešovský kraj";38;8690;20;8710;NA;354950;58;2021-05-25;112109
2021-05-24;"Prešovský kraj";17;13298;37;13335;NA;354950;54;2021-05-24;112051
2021-05-23;"Prešovský kraj";3;11947;20;11967;NA;354950;23;2021-05-23;111997
2021-05-22;"Prešovský kraj";11;14422;44;14466;NA;354950;55;2021-05-22;111974
2021-05-21;"Prešovský kraj";44;13803;24;13827;NA;354950;68;2021-05-21;111919
2021-05-20;"Prešovský kraj";13;9437;29;9466;NA;354950;42;2021-05-20;111851
2021-05-19;"Prešovský kraj";60;10756;36;10792;NA;354950;96;2021-05-19;111809
2021-05-18;"Prešovský kraj";44;9062;27;9089;NA;354950;71;2021-05-18;111713
2021-05-17;"Prešovský kraj";60;12856;47;12903;NA;354950;107;2021-05-17;111642
2021-05-16;"Prešovský kraj";20;16302;66;16368;NA;354950;86;2021-05-16;111535
2021-05-15;"Prešovský kraj";20;24604;81;24685;NA;354950;101;2021-05-15;111449
2021-05-14;"Prešovský kraj";49;18671;68;18739;NA;354950;117;2021-05-14;111348
2021-05-13;"Prešovský kraj";54;11166;71;11237;NA;354950;125;2021-05-13;111231
2021-05-12;"Prešovský kraj";59;10822;39;10861;NA;354950;98;2021-05-12;111106
2021-05-11;"Prešovský kraj";61;10728;48;10776;NA;354950;109;2021-05-11;111008
2021-05-10;"Prešovský kraj";79;15726;67;15793;NA;354950;146;2021-05-10;110899
2021-05-09;"Prešovský kraj";54;21658;82;21740;NA;354950;136;2021-05-09;110753
2021-05-08;"Prešovský kraj";39;23050;52;23102;NA;354950;91;2021-05-08;110617
2021-05-07;"Prešovský kraj";81;23543;66;23609;NA;354950;147;2021-05-07;110526
2021-05-06;"Prešovský kraj";107;12924;66;12990;NA;354950;173;2021-05-06;110379
2021-05-05;"Prešovský kraj";60;12808;84;12892;NA;354950;144;2021-05-05;110206
2021-05-04;"Prešovský kraj";203;13470;67;13537;NA;354950;270;2021-05-04;110062
2021-05-03;"Prešovský kraj";68;18458;109;18567;NA;354950;177;2021-05-03;109792
2021-05-02;"Prešovský kraj";29;36676;102;36778;NA;354950;131;2021-05-02;109615
2021-05-01;"Prešovský kraj";70;57153;183;57336;NA;354950;253;2021-05-01;109484
2021-04-30;"Prešovský kraj";135;39333;118;39451;NA;354950;253;2021-04-30;109231
2021-04-29;"Prešovský kraj";110;16635;97;16732;NA;354950;207;2021-04-29;108978
2021-04-28;"Prešovský kraj";122;18671;89;18760;NA;354950;211;2021-04-28;108771
2021-04-27;"Prešovský kraj";154;19994;120;20114;NA;354950;274;2021-04-27;108560
2021-04-26;"Prešovský kraj";99;27241;123;27364;NA;354950;222;2021-04-26;108286
2021-04-25;"Prešovský kraj";9;52776;156;52932;NA;354950;165;2021-04-25;108064
2021-04-24;"Prešovský kraj";61;85698;243;85941;NA;354950;304;2021-04-24;107899
2021-04-23;"Prešovský kraj";171;40365;137;40502;NA;354950;308;2021-04-23;107595
2021-04-22;"Prešovský kraj";86;18104;125;18229;NA;354950;211;2021-04-22;107287
2021-04-21;"Prešovský kraj";144;21550;139;21689;NA;354950;283;2021-04-21;107076
2021-04-20;"Prešovský kraj";115;23346;128;23474;NA;354950;243;2021-04-20;106793
2021-04-19;"Prešovský kraj";106;29133;145;29278;NA;354950;251;2021-04-19;106550
2021-04-18;"Prešovský kraj";4;51824;129;51953;NA;354950;133;2021-04-18;106299
2021-04-17;"Prešovský kraj";119;97970;238;98208;NA;354950;357;2021-04-17;106166
2021-04-16;"Prešovský kraj";135;40989;146;41135;NA;354950;281;2021-04-16;105809
2021-04-15;"Prešovský kraj";112;20179;137;20316;NA;354950;249;2021-04-15;105528
2021-04-14;"Prešovský kraj";199;23332;130;23462;NA;354950;329;2021-04-14;105279
2021-04-13;"Prešovský kraj";180;23907;116;24023;NA;354950;296;2021-04-13;104950
2021-04-12;"Prešovský kraj";172;30152;175;30327;NA;354950;347;2021-04-12;104654
2021-04-11;"Prešovský kraj";11;49955;187;50142;NA;354950;198;2021-04-11;104307
2021-04-10;"Prešovský kraj";94;90181;297;90478;NA;354950;391;2021-04-10;104109
2021-04-09;"Prešovský kraj";255;37163;200;37363;NA;354950;455;2021-04-09;103718
2021-04-08;"Prešovský kraj";192;18893;157;19050;NA;354950;349;2021-04-08;103263
2021-04-07;"Prešovský kraj";314;27797;154;27951;NA;354950;468;2021-04-07;102914
2021-04-06;"Prešovský kraj";231;41711;268;41979;NA;354950;499;2021-04-06;102446
2021-04-05;"Prešovský kraj";54;18454;132;18586;NA;354950;186;2021-04-05;101947
2021-04-04;"Prešovský kraj";31;18569;91;18660;NA;354950;122;2021-04-04;101761
2021-04-03;"Prešovský kraj";104;90664;321;90985;NA;354950;425;2021-04-03;101639
2021-04-02;"Prešovský kraj";194;23381;134;23515;NA;354950;328;2021-04-02;101214
2021-04-01;"Prešovský kraj";256;42879;195;43074;NA;354950;451;2021-04-01;100886
2021-03-31;"Prešovský kraj";311;30176;227;30403;NA;354950;538;2021-03-31;100435
2021-03-30;"Prešovský kraj";374;20751;203;20954;NA;354950;577;2021-03-30;99897
2021-03-29;"Prešovský kraj";219;28188;229;28417;NA;354950;448;2021-03-29;99320
2021-03-28;"Prešovský kraj";26;46811;256;47067;NA;354950;282;2021-03-28;98872
2021-03-27;"Prešovský kraj";181;88673;372;89045;NA;354950;553;2021-03-27;98590
2021-03-26;"Prešovský kraj";310;47751;299;48050;NA;354950;609;2021-03-26;98037
2021-03-25;"Prešovský kraj";248;22281;213;22494;NA;354950;461;2021-03-25;97428
2021-03-24;"Prešovský kraj";381;19590;213;19803;NA;354950;594;2021-03-24;96967
2021-03-23;"Prešovský kraj";241;20351;255;20606;NA;354950;496;2021-03-23;96373
2021-03-22;"Prešovský kraj";299;28634;287;28921;NA;354950;586;2021-03-22;95877
2021-03-21;"Prešovský kraj";32;49439;266;49705;NA;354950;298;2021-03-21;95291
2021-03-20;"Prešovský kraj";180;92529;426;92955;NA;354950;606;2021-03-20;94993
2021-03-19;"Prešovský kraj";373;46582;326;46908;NA;354950;699;2021-03-19;94387
2021-03-18;"Prešovský kraj";251;21721;217;21938;NA;354950;468;2021-03-18;93688
2021-03-17;"Prešovský kraj";331;20887;231;21118;NA;354950;562;2021-03-17;93220
2021-03-16;"Prešovský kraj";461;21094;278;21372;NA;354950;739;2021-03-16;92658
2021-03-15;"Prešovský kraj";370;28813;324;29137;NA;354950;694;2021-03-15;91919
2021-03-14;"Prešovský kraj";52;50410;356;50766;NA;354950;408;2021-03-14;91225
2021-03-13;"Prešovský kraj";200;94768;531;95299;NA;354950;731;2021-03-13;90817
2021-03-12;"Prešovský kraj";425;47691;368;48059;NA;354950;793;2021-03-12;90086
2021-03-11;"Prešovský kraj";463;22059;253;22312;NA;354950;716;2021-03-11;89293
2021-03-10;"Prešovský kraj";325;20821;293;21114;NA;354950;618;2021-03-10;88577
2021-03-09;"Prešovský kraj";505;21496;288;21784;NA;354950;793;2021-03-09;87959
2021-03-08;"Prešovský kraj";314;28903;333;29236;NA;354950;647;2021-03-08;87166
2021-03-07;"Prešovský kraj";19;48328;388;48716;NA;354950;407;2021-03-07;86519
2021-03-06;"Prešovský kraj";193;97527;591;98118;NA;354950;784;2021-03-06;86112
2021-03-05;"Prešovský kraj";497;46054;397;46451;NA;354950;894;2021-03-05;85328
2021-03-04;"Prešovský kraj";372;22670;359;23029;NA;354950;731;2021-03-04;84434
2021-03-03;"Prešovský kraj";397;21623;333;21956;NA;354950;730;2021-03-03;83703
2021-03-02;"Prešovský kraj";421;22682;357;23039;NA;354950;778;2021-03-02;82973
2021-03-01;"Prešovský kraj";303;27716;406;28122;NA;354950;709;2021-03-01;82195
2021-02-28;"Prešovský kraj";75;45000;387;45387;NA;354950;462;2021-02-28;81486
2021-02-27;"Prešovský kraj";273;90231;734;90965;NA;354950;1007;2021-02-27;81024
2021-02-26;"Prešovský kraj";455;41340;438;41778;NA;354950;893;2021-02-26;80017
2021-02-25;"Prešovský kraj";270;19496;337;19833;NA;354950;607;2021-02-25;79124
2021-02-24;"Prešovský kraj";328;19026;377;19403;NA;354950;705;2021-02-24;78517
2021-02-23;"Prešovský kraj";430;21277;345;21622;NA;354950;775;2021-02-23;77812
2021-02-22;"Prešovský kraj";351;27180;356;27536;NA;354950;707;2021-02-22;77037
2021-02-21;"Prešovský kraj";66;31453;301;31754;NA;354950;367;2021-02-21;76330
2021-02-20;"Prešovský kraj";129;71413;517;71930;NA;354950;646;2021-02-20;75963
2021-02-19;"Prešovský kraj";381;38995;430;39425;NA;354950;811;2021-02-19;75317
2021-02-18;"Prešovský kraj";268;16960;322;17282;NA;354950;590;2021-02-18;74506
2021-02-17;"Prešovský kraj";293;17392;246;17638;NA;354950;539;2021-02-17;73916
2021-02-16;"Prešovský kraj";422;18862;265;19127;NA;354950;687;2021-02-16;73377
2021-02-15;"Prešovský kraj";211;31366;303;31669;NA;354950;514;2021-02-15;72690
2021-02-14;"Prešovský kraj";27;39387;321;39708;NA;354950;348;2021-02-14;72176
2021-02-13;"Prešovský kraj";157;74747;402;75149;NA;354950;559;2021-02-13;71828
2021-02-12;"Prešovský kraj";308;38758;365;39123;NA;354950;673;2021-02-12;71269
2021-02-11;"Prešovský kraj";218;16218;239;16457;NA;354950;457;2021-02-11;70596
2021-02-10;"Prešovský kraj";220;18542;282;18824;NA;354950;502;2021-02-10;70139
2021-02-09;"Prešovský kraj";323;21497;370;21867;NA;354950;693;2021-02-09;69637
2021-02-08;"Prešovský kraj";161;36924;261;37185;NA;354950;422;2021-02-08;68944
2021-02-07;"Prešovský kraj";21;34227;209;34436;NA;354950;230;2021-02-07;68522
2021-02-06;"Prešovský kraj";176;69164;360;69524;NA;354950;536;2021-02-06;68292
2021-02-05;"Prešovský kraj";177;31271;262;31533;NA;354950;439;2021-02-05;67756
2021-02-04;"Prešovský kraj";176;13080;237;13317;NA;354950;413;2021-02-04;67317
2021-02-03;"Prešovský kraj";251;8421;236;8657;NA;354950;487;2021-02-03;66904
2021-02-02;"Prešovský kraj";249;11769;264;12033;NA;354950;513;2021-02-02;66417
2021-02-01;"Prešovský kraj";220;16059;316;16375;NA;354950;536;2021-02-01;65904
2021-01-31;"Prešovský kraj";42;10587;107;10694;NA;354950;149;2021-01-31;65368
2021-01-30;"Prešovský kraj";142;23939;215;24154;NA;354950;357;2021-01-30;65219
2021-01-29;"Prešovský kraj";185;17924;326;18250;NA;354950;511;2021-01-29;64862
2021-01-28;"Prešovský kraj";311;7348;150;7498;NA;354950;461;2021-01-28;64351
2021-01-27;"Prešovský kraj";153;9730;147;9877;NA;354950;300;2021-01-27;63890
2021-01-26;"Prešovský kraj";252;16653;151;16804;NA;354950;403;2021-01-26;63590
2021-01-25;"Prešovský kraj";196;30092;253;30345;NA;354950;449;2021-01-25;63187
2021-01-24;"Prešovský kraj";12;45706;304;46010;NA;354950;316;2021-01-24;62738
2021-01-23;"Prešovský kraj";189;96883;487;97370;NA;354950;676;2021-01-23;62422
2021-01-22;"Prešovský kraj";187;35383;261;35644;NA;354950;448;2021-01-22;61746
2021-01-21;"Prešovský kraj";187;20434;212;20646;NA;354950;399;2021-01-21;61298
2021-01-20;"Prešovský kraj";253;14782;195;14977;NA;354950;448;2021-01-20;60899
2021-01-19;"Prešovský kraj";281;12329;305;12634;NA;354950;586;2021-01-19;60451
2021-01-18;"Prešovský kraj";203;10422;336;10758;NA;354950;539;2021-01-18;59865
2021-01-17;"Prešovský kraj";107;14391;1008;15399;NA;354950;1115;2021-01-17;59326
2021-01-16;"Prešovský kraj";72;1838;81;1919;NA;354950;153;2021-01-16;58211
2021-01-15;"Prešovský kraj";159;7033;257;7290;NA;354950;416;2021-01-15;58058
2021-01-14;"Prešovský kraj";268;5534;256;5790;NA;354950;524;2021-01-14;57642
2021-01-13;"Prešovský kraj";342;5649;226;5875;NA;354950;568;2021-01-13;57118
2021-01-12;"Prešovský kraj";455;8251;386;8637;NA;354950;841;2021-01-12;56550
2021-01-11;"Prešovský kraj";343;8149;471;8620;NA;354950;814;2021-01-11;55709
2021-01-10;"Prešovský kraj";63;476;23;499;NA;354950;86;2021-01-10;54895
2021-01-09;"Prešovský kraj";439;2248;125;2373;NA;354950;564;2021-01-09;54809
2021-01-08;"Prešovský kraj";430;10416;561;10977;NA;354950;991;2021-01-08;54245
2021-01-07;"Prešovský kraj";268;7432;622;8054;NA;354950;890;2021-01-07;53254
2021-01-06;"Prešovský kraj";315;1484;134;1618;NA;354950;449;2021-01-06;52364
2021-01-05;"Prešovský kraj";655;11275;976;12251;NA;354950;1631;2021-01-05;51915
2021-01-04;"Prešovský kraj";371;16845;1789;18634;NA;354950;2160;2021-01-04;50284
2021-01-03;"Prešovský kraj";89;459;41;500;NA;354950;130;2021-01-03;48124
2021-01-02;"Prešovský kraj";65;1556;160;1716;NA;354950;225;2021-01-02;47994
2021-01-01;"Prešovský kraj";174;956;71;1027;NA;354950;245;2021-01-01;47769
2020-12-31;"Prešovský kraj";640;11959;783;12742;NA;354950;1423;2020-12-31;47524
2020-12-30;"Prešovský kraj";729;8729;769;9498;NA;354950;1498;2020-12-30;46101
2020-12-29;"Prešovský kraj";435;9273;949;10222;NA;354950;1384;2020-12-29;44603
2020-12-28;"Prešovský kraj";393;9046;1079;10125;NA;354950;1472;2020-12-28;43219
2020-12-27;"Prešovský kraj";40;613;45;658;NA;354950;85;2020-12-27;41747
2020-12-26;"Prešovský kraj";64;176;12;188;NA;354950;76;2020-12-26;41662
2020-12-25;"Prešovský kraj";208;274;11;285;NA;354950;219;2020-12-25;41586
2020-12-24;"Prešovský kraj";452;1214;85;1299;NA;354950;537;2020-12-24;41367
2020-12-23;"Prešovský kraj";361;11006;618;11624;NA;354950;979;2020-12-23;40830
2020-12-22;"Prešovský kraj";439;9023;695;9718;NA;354950;1134;2020-12-22;39851
2020-12-21;"Prešovský kraj";432;9577;847;10424;NA;354950;1279;2020-12-21;38717
2020-12-20;"Prešovský kraj";184;396;20;416;NA;354950;204;2020-12-20;37438
2020-12-19;"Prešovský kraj";276;1658;151;1809;NA;354950;427;2020-12-19;37234
2020-12-18;"Prešovský kraj";396;8246;566;8812;NA;354950;962;2020-12-18;36807
2020-12-17;"Prešovský kraj";427;10505;866;11371;NA;354950;1293;2020-12-17;35845
2020-12-16;"Prešovský kraj";466;5613;473;6086;NA;354950;939;2020-12-16;34552
2020-12-15;"Prešovský kraj";411;5406;574;5980;NA;354950;985;2020-12-15;33613
2020-12-14;"Prešovský kraj";334;5538;477;6015;NA;354950;811;2020-12-14;32628
2020-12-13;"Prešovský kraj";89;29;8;37;NA;354950;97;2020-12-13;31817
2020-12-12;"Prešovský kraj";319;2474;166;2640;NA;354950;485;2020-12-12;31720
2020-12-11;"Prešovský kraj";560;5602;402;6004;NA;354950;962;2020-12-11;31235
2020-12-10;"Prešovský kraj";337;5019;423;5442;NA;354950;760;2020-12-10;30273
2020-12-09;"Prešovský kraj";358;4357;314;4671;NA;354950;672;2020-12-09;29513
2020-12-08;"Prešovský kraj";350;6629;651;7280;NA;354950;1001;2020-12-08;28841
2020-12-07;"Prešovský kraj";309;4345;327;4672;NA;354950;636;2020-12-07;27840
2020-12-06;"Prešovský kraj";59;655;26;681;NA;354950;85;2020-12-06;27204
2020-12-05;"Prešovský kraj";218;984;87;1071;NA;354950;305;2020-12-05;27119
2020-12-04;"Prešovský kraj";352;5070;293;5363;NA;354950;645;2020-12-04;26814
2020-12-03;"Prešovský kraj";284;2456;179;2635;NA;354950;463;2020-12-03;26169
2020-12-02;"Prešovský kraj";232;2830;225;3055;NA;354950;457;2020-12-02;25706
2020-12-01;"Prešovský kraj";281;1884;196;2080;NA;354950;477;2020-12-01;25249
2020-11-30;"Prešovský kraj";196;5333;97;5430;NA;354950;293;2020-11-30;24772
2020-11-29;"Prešovský kraj";27;379;42;421;NA;354950;69;2020-11-29;24479
2020-11-28;"Prešovský kraj";199;772;77;849;NA;354950;276;2020-11-28;24410
2020-11-27;"Prešovský kraj";232;2350;130;2480;NA;354950;362;2020-11-27;24134
2020-11-26;"Prešovský kraj";263;3014;329;3343;NA;354950;592;2020-11-26;23772
2020-11-25;"Prešovský kraj";302;2174;103;2277;NA;354950;405;2020-11-25;23180
2020-11-24;"Prešovský kraj";365;1777;156;1933;NA;354950;521;2020-11-24;22775
2020-11-23;"Prešovský kraj";164;1099;60;1159;NA;354950;224;2020-11-23;22254
2020-11-22;"Prešovský kraj";46;44;1;45;NA;354950;47;2020-11-22;22030
2020-11-21;"Prešovský kraj";205;754;62;816;NA;354950;267;2020-11-21;21983
2020-11-20;"Prešovský kraj";363;2258;102;2360;NA;354950;465;2020-11-20;21716
2020-11-19;"Prešovský kraj";359;2096;238;2334;NA;354950;597;2020-11-19;21251
2020-11-18;"Prešovský kraj";270;488;43;531;NA;354950;313;2020-11-18;20654
2020-11-17;"Prešovský kraj";347;205;23;228;NA;354950;370;2020-11-17;20341
2020-11-16;"Prešovský kraj";226;540;58;598;NA;354950;284;2020-11-16;19971
2020-11-15;"Prešovský kraj";186;39;4;43;NA;354950;190;2020-11-15;19687
2020-11-14;"Prešovský kraj";261;54;4;58;NA;354950;265;2020-11-14;19497
2020-11-13;"Prešovský kraj";395;166;8;174;NA;354950;403;2020-11-13;19232
2020-11-12;"Prešovský kraj";397;229;50;279;NA;354950;447;2020-11-12;18829
2020-11-11;"Prešovský kraj";516;161;15;176;NA;354950;531;2020-11-11;18382
2020-11-10;"Prešovský kraj";437;197;9;206;NA;354950;446;2020-11-10;17851
2020-11-09;"Prešovský kraj";190;4110;945;5055;NA;354950;1135;2020-11-09;17405
2020-11-08;"Prešovský kraj";97;2817;32;2849;NA;354950;129;2020-11-08;16270
2020-11-07;"Prešovský kraj";416;8578;81;8659;NA;354950;497;2020-11-07;16141
2020-11-06;"Prešovský kraj";520;4791;76;4867;NA;354950;596;2020-11-06;15644
2020-11-05;"Prešovský kraj";397;180;5;185;NA;354950;402;2020-11-05;15048
2020-11-04;"Prešovský kraj";350;807;8;815;NA;354950;358;2020-11-04;14646
2020-11-03;"Prešovský kraj";565;98;12;110;NA;354950;577;2020-11-03;14288
2020-11-02;"Prešovský kraj";203;4158;1004;5162;NA;354950;1207;2020-11-02;13711
2020-11-01;"Prešovský kraj";131;2906;53;2959;NA;354950;184;2020-11-01;12504
2022-04-03;"Trenčiansky kraj";127;127;23;150;206374;292650;150;2022-04-03;292650
2022-04-02;"Trenčiansky kraj";368;242;34;276;NA;292650;402;2022-04-02;292500
2022-04-01;"Trenčiansky kraj";510;446;41;487;NA;292650;551;2022-04-01;292098
2022-03-31;"Trenčiansky kraj";520;755;79;834;NA;292650;599;2022-03-31;291547
2022-03-30;"Trenčiansky kraj";706;1322;83;1405;NA;292650;789;2022-03-30;290948
2022-03-29;"Trenčiansky kraj";682;899;84;983;NA;292650;766;2022-03-29;290159
2022-03-28;"Trenčiansky kraj";673;1285;118;1403;NA;292650;791;2022-03-28;289393
2022-03-27;"Trenčiansky kraj";167;565;75;640;NA;292650;242;2022-03-27;288602
2022-03-26;"Trenčiansky kraj";513;383;41;424;NA;292650;554;2022-03-26;288360
2022-03-25;"Trenčiansky kraj";534;794;90;884;NA;292650;624;2022-03-25;287806
2022-03-24;"Trenčiansky kraj";712;1114;104;1218;NA;292650;816;2022-03-24;287182
2022-03-23;"Trenčiansky kraj";903;899;93;992;NA;292650;996;2022-03-23;286366
2022-03-22;"Trenčiansky kraj";918;934;114;1048;NA;292650;1032;2022-03-22;285370
2022-03-21;"Trenčiansky kraj";745;1317;198;1515;NA;292650;943;2022-03-21;284338
2022-03-20;"Trenčiansky kraj";334;826;89;915;NA;292650;423;2022-03-20;283395
2022-03-19;"Trenčiansky kraj";560;510;77;587;NA;292650;637;2022-03-19;282972
2022-03-18;"Trenčiansky kraj";884;827;128;955;NA;292650;1012;2022-03-18;282335
2022-03-17;"Trenčiansky kraj";863;991;127;1118;NA;292650;990;2022-03-17;281323
2022-03-16;"Trenčiansky kraj";1147;1128;125;1253;NA;292650;1272;2022-03-16;280333
2022-03-15;"Trenčiansky kraj";1054;1155;122;1277;NA;292650;1176;2022-03-15;279061
2022-03-14;"Trenčiansky kraj";934;2078;253;2331;NA;292650;1187;2022-03-14;277885
2022-03-13;"Trenčiansky kraj";373;698;97;795;NA;292650;470;2022-03-13;276698
2022-03-12;"Trenčiansky kraj";674;550;94;644;NA;292650;768;2022-03-12;276228
2022-03-11;"Trenčiansky kraj";1131;1191;215;1406;NA;292650;1346;2022-03-11;275460
2022-03-10;"Trenčiansky kraj";1087;1178;220;1398;NA;292650;1307;2022-03-10;274114
2022-03-09;"Trenčiansky kraj";1515;1346;236;1582;NA;292650;1751;2022-03-09;272807
2022-03-08;"Trenčiansky kraj";1059;1589;247;1836;NA;292650;1306;2022-03-08;271056
2022-03-07;"Trenčiansky kraj";1079;1920;342;2262;NA;292650;1421;2022-03-07;269750
2022-03-06;"Trenčiansky kraj";354;832;134;966;NA;292650;488;2022-03-06;268329
2022-03-05;"Trenčiansky kraj";583;700;138;838;NA;292650;721;2022-03-05;267841
2022-03-04;"Trenčiansky kraj";1125;1158;204;1362;NA;292650;1329;2022-03-04;267120
2022-03-03;"Trenčiansky kraj";1346;1521;216;1737;NA;292650;1562;2022-03-03;265791
2022-03-02;"Trenčiansky kraj";1345;1548;239;1787;NA;292650;1584;2022-03-02;264229
2022-03-01;"Trenčiansky kraj";1409;1609;299;1908;NA;292650;1708;2022-03-01;262645
2022-02-28;"Trenčiansky kraj";1390;2383;363;2746;NA;292650;1753;2022-02-28;260937
2022-02-27;"Trenčiansky kraj";573;1043;218;1261;NA;292650;791;2022-02-27;259184
2022-02-26;"Trenčiansky kraj";934;784;147;931;NA;292650;1081;2022-02-26;258393
2022-02-25;"Trenčiansky kraj";1460;1422;271;1693;NA;292650;1731;2022-02-25;257312
2022-02-24;"Trenčiansky kraj";1372;2288;274;2562;NA;292650;1646;2022-02-24;255581
2022-02-23;"Trenčiansky kraj";1677;1895;291;2186;NA;292650;1968;2022-02-23;253935
2022-02-22;"Trenčiansky kraj";2073;2075;418;2493;NA;292650;2491;2022-02-22;251967
2022-02-21;"Trenčiansky kraj";2172;3615;547;4162;NA;292650;2719;2022-02-21;249476
2022-02-20;"Trenčiansky kraj";1079;1436;322;1758;NA;292650;1401;2022-02-20;246757
2022-02-19;"Trenčiansky kraj";1168;1008;244;1252;NA;292650;1412;2022-02-19;245356
2022-02-18;"Trenčiansky kraj";2456;2175;440;2615;NA;292650;2896;2022-02-18;243944
2022-02-17;"Trenčiansky kraj";2090;2540;388;2928;NA;292650;2478;2022-02-17;241048
2022-02-16;"Trenčiansky kraj";2928;2286;469;2755;NA;292650;3397;2022-02-16;238570
2022-02-15;"Trenčiansky kraj";2372;2408;534;2942;NA;292650;2906;2022-02-15;235173
2022-02-14;"Trenčiansky kraj";2401;3916;686;4602;NA;292650;3087;2022-02-14;232267
2022-02-13;"Trenčiansky kraj";1357;1777;454;2231;NA;292650;1811;2022-02-13;229180
2022-02-12;"Trenčiansky kraj";1802;1448;277;1725;NA;292650;2079;2022-02-12;227369
2022-02-11;"Trenčiansky kraj";2863;2376;456;2832;NA;292650;3319;2022-02-11;225290
2022-02-10;"Trenčiansky kraj";2853;2529;462;2991;NA;292650;3315;2022-02-10;221971
2022-02-09;"Trenčiansky kraj";2788;4158;559;4717;NA;292650;3347;2022-02-09;218656
2022-02-08;"Trenčiansky kraj";2592;2987;621;3608;NA;292650;3213;2022-02-08;215309
2022-02-07;"Trenčiansky kraj";2787;4732;862;5594;NA;292650;3649;2022-02-07;212096
2022-02-06;"Trenčiansky kraj";1431;2181;472;2653;NA;292650;1903;2022-02-06;208447
2022-02-05;"Trenčiansky kraj";1458;1689;323;2012;NA;292650;1781;2022-02-05;206544
2022-02-04;"Trenčiansky kraj";2480;3036;483;3519;NA;292650;2963;2022-02-04;204763
2022-02-03;"Trenčiansky kraj";2391;3381;462;3843;NA;292650;2853;2022-02-03;201800
2022-02-02;"Trenčiansky kraj";2486;4411;563;4974;NA;292650;3049;2022-02-02;198947
2022-02-01;"Trenčiansky kraj";2359;3701;509;4210;NA;292650;2868;2022-02-01;195898
2022-01-31;"Trenčiansky kraj";1823;7070;627;7697;NA;292650;2450;2022-01-31;193030
2022-01-30;"Trenčiansky kraj";680;2463;319;2782;NA;292650;999;2022-01-30;190580
2022-01-29;"Trenčiansky kraj";1227;1772;227;1999;NA;292650;1454;2022-01-29;189581
2022-01-28;"Trenčiansky kraj";1709;3602;322;3924;NA;292650;2031;2022-01-28;188127
2022-01-27;"Trenčiansky kraj";1533;3414;322;3736;NA;292650;1855;2022-01-27;186096
2022-01-26;"Trenčiansky kraj";1415;4533;311;4844;NA;292650;1726;2022-01-26;184241
2022-01-25;"Trenčiansky kraj";1553;3168;258;3426;NA;292650;1811;2022-01-25;182515
2022-01-24;"Trenčiansky kraj";755;6691;290;6981;NA;292650;1045;2022-01-24;180704
2022-01-23;"Trenčiansky kraj";337;2409;179;2588;NA;292650;516;2022-01-23;179659
2022-01-22;"Trenčiansky kraj";683;1675;103;1778;NA;292650;786;2022-01-22;179143
2022-01-21;"Trenčiansky kraj";576;3394;139;3533;NA;292650;715;2022-01-21;178357
2022-01-20;"Trenčiansky kraj";710;2578;104;2682;NA;292650;814;2022-01-20;177642
2022-01-19;"Trenčiansky kraj";621;3627;111;3738;NA;292650;732;2022-01-19;176828
2022-01-18;"Trenčiansky kraj";579;3455;101;3556;NA;292650;680;2022-01-18;176096
2022-01-17;"Trenčiansky kraj";380;6158;122;6280;NA;292650;502;2022-01-17;175416
2022-01-16;"Trenčiansky kraj";89;2319;72;2391;NA;292650;161;2022-01-16;174914
2022-01-15;"Trenčiansky kraj";194;1345;40;1385;NA;292650;234;2022-01-15;174753
2022-01-14;"Trenčiansky kraj";189;2755;48;2803;NA;292650;237;2022-01-14;174519
2022-01-13;"Trenčiansky kraj";134;3201;62;3263;NA;292650;196;2022-01-13;174282
2022-01-12;"Trenčiansky kraj";346;2953;53;3006;NA;292650;399;2022-01-12;174086
2022-01-11;"Trenčiansky kraj";300;2896;50;2946;NA;292650;350;2022-01-11;173687
2022-01-10;"Trenčiansky kraj";218;6882;81;6963;NA;292650;299;2022-01-10;173337
2022-01-09;"Trenčiansky kraj";40;2808;52;2860;NA;292650;92;2022-01-09;173038
2022-01-08;"Trenčiansky kraj";267;1601;45;1646;NA;292650;312;2022-01-08;172946
2022-01-07;"Trenčiansky kraj";334;2717;64;2781;NA;292650;398;2022-01-07;172634
2022-01-06;"Trenčiansky kraj";75;1111;45;1156;NA;292650;120;2022-01-06;172236
2022-01-05;"Trenčiansky kraj";496;2875;64;2939;NA;292650;560;2022-01-05;172116
2022-01-04;"Trenčiansky kraj";521;3760;73;3833;NA;292650;594;2022-01-04;171556
2022-01-03;"Trenčiansky kraj";357;5680;117;5797;NA;292650;474;2022-01-03;170962
2022-01-02;"Trenčiansky kraj";179;2403;74;2477;NA;292650;253;2022-01-02;170488
2022-01-01;"Trenčiansky kraj";4;526;28;554;NA;292650;32;2022-01-01;170235
2021-12-31;"Trenčiansky kraj";443;1426;77;1503;NA;292650;520;2021-12-31;170203
2021-12-30;"Trenčiansky kraj";370;2351;126;2477;NA;292650;496;2021-12-30;169683
2021-12-29;"Trenčiansky kraj";429;2436;83;2519;NA;292650;512;2021-12-29;169187
2021-12-28;"Trenčiansky kraj";609;2696;108;2804;NA;292650;717;2021-12-28;168675
2021-12-27;"Trenčiansky kraj";546;3200;100;3300;NA;292650;646;2021-12-27;167958
2021-12-26;"Trenčiansky kraj";147;1098;78;1176;NA;292650;225;2021-12-26;167312
2021-12-25;"Trenčiansky kraj";52;503;27;530;NA;292650;79;2021-12-25;167087
2021-12-24;"Trenčiansky kraj";176;652;37;689;NA;292650;213;2021-12-24;167008
2021-12-23;"Trenčiansky kraj";532;2380;103;2483;NA;292650;635;2021-12-23;166795
2021-12-22;"Trenčiansky kraj";512;2546;116;2662;NA;292650;628;2021-12-22;166160
2021-12-21;"Trenčiansky kraj";694;3219;119;3338;NA;292650;813;2021-12-21;165532
2021-12-20;"Trenčiansky kraj";488;6613;200;6813;NA;292650;688;2021-12-20;164719
2021-12-19;"Trenčiansky kraj";202;2574;118;2692;NA;292650;320;2021-12-19;164031
2021-12-18;"Trenčiansky kraj";438;1752;108;1860;NA;292650;546;2021-12-18;163711
2021-12-17;"Trenčiansky kraj";427;4006;135;4141;NA;292650;562;2021-12-17;163165
2021-12-16;"Trenčiansky kraj";649;3169;177;3346;NA;292650;826;2021-12-16;162603
2021-12-15;"Trenčiansky kraj";791;4596;165;4761;NA;292650;956;2021-12-15;161777
2021-12-14;"Trenčiansky kraj";885;3590;139;3729;NA;292650;1024;2021-12-14;160821
2021-12-13;"Trenčiansky kraj";573;7310;247;7557;NA;292650;820;2021-12-13;159797
2021-12-12;"Trenčiansky kraj";306;3156;156;3312;NA;292650;462;2021-12-12;158977
2021-12-11;"Trenčiansky kraj";706;1876;138;2014;NA;292650;844;2021-12-11;158515
2021-12-10;"Trenčiansky kraj";789;3643;199;3842;NA;292650;988;2021-12-10;157671
2021-12-09;"Trenčiansky kraj";967;3847;202;4049;NA;292650;1169;2021-12-09;156683
2021-12-08;"Trenčiansky kraj";1020;4428;201;4629;NA;292650;1221;2021-12-08;155514
2021-12-07;"Trenčiansky kraj";1241;6232;214;6446;NA;292650;1455;2021-12-07;154293
2021-12-06;"Trenčiansky kraj";751;8778;421;9199;NA;292650;1172;2021-12-06;152838
2021-12-05;"Trenčiansky kraj";510;3610;210;3820;NA;292650;720;2021-12-05;151666
2021-12-04;"Trenčiansky kraj";1058;2043;156;2199;NA;292650;1214;2021-12-04;150946
2021-12-03;"Trenčiansky kraj";1272;4379;304;4683;NA;292650;1576;2021-12-03;149732
2021-12-02;"Trenčiansky kraj";2007;4087;263;4350;NA;292650;2270;2021-12-02;148156
2021-12-01;"Trenčiansky kraj";1000;4935;296;5231;NA;292650;1296;2021-12-01;145886
2021-11-30;"Trenčiansky kraj";1086;4702;329;5031;NA;292650;1415;2021-11-30;144590
2021-11-29;"Trenčiansky kraj";1165;10325;540;10865;NA;292650;1705;2021-11-29;143175
2021-11-28;"Trenčiansky kraj";664;5566;308;5874;NA;292650;972;2021-11-28;141470
2021-11-27;"Trenčiansky kraj";1080;2782;301;3083;NA;292650;1381;2021-11-27;140498
2021-11-26;"Trenčiansky kraj";1238;4493;346;4839;NA;292650;1584;2021-11-26;139117
2021-11-25;"Trenčiansky kraj";1018;3590;343;3933;NA;292650;1361;2021-11-25;137533
2021-11-24;"Trenčiansky kraj";1362;5559;466;6025;NA;292650;1828;2021-11-24;136172
2021-11-23;"Trenčiansky kraj";1140;3717;347;4064;NA;292650;1487;2021-11-23;134344
2021-11-22;"Trenčiansky kraj";920;6467;566;7033;NA;292650;1486;2021-11-22;132857
2021-11-21;"Trenčiansky kraj";413;3233;377;3610;NA;292650;790;2021-11-21;131371
2021-11-20;"Trenčiansky kraj";914;2379;341;2720;NA;292650;1255;2021-11-20;130581
2021-11-19;"Trenčiansky kraj";1261;3785;445;4230;NA;292650;1706;2021-11-19;129326
2021-11-18;"Trenčiansky kraj";810;5024;524;5548;NA;292650;1334;2021-11-18;127620
2021-11-17;"Trenčiansky kraj";796;1852;237;2089;NA;292650;1033;2021-11-17;126286
2021-11-16;"Trenčiansky kraj";859;4060;401;4461;NA;292650;1260;2021-11-16;125253
2021-11-15;"Trenčiansky kraj";720;5114;550;5664;NA;292650;1270;2021-11-15;123993
2021-11-14;"Trenčiansky kraj";447;2462;343;2805;NA;292650;790;2021-11-14;122723
2021-11-13;"Trenčiansky kraj";478;1879;254;2133;NA;292650;732;2021-11-13;121933
2021-11-12;"Trenčiansky kraj";784;3855;338;4193;NA;292650;1122;2021-11-12;121201
2021-11-11;"Trenčiansky kraj";805;3561;345;3906;NA;292650;1150;2021-11-11;120079
2021-11-10;"Trenčiansky kraj";647;3358;279;3637;NA;292650;926;2021-11-10;118929
2021-11-09;"Trenčiansky kraj";752;2886;304;3190;NA;292650;1056;2021-11-09;118003
2021-11-08;"Trenčiansky kraj";489;4643;348;4991;NA;292650;837;2021-11-08;116947
2021-11-07;"Trenčiansky kraj";405;2043;220;2263;NA;292650;625;2021-11-07;116110
2021-11-06;"Trenčiansky kraj";542;1755;176;1931;NA;292650;718;2021-11-06;115485
2021-11-05;"Trenčiansky kraj";677;3083;238;3321;NA;292650;915;2021-11-05;114767
2021-11-04;"Trenčiansky kraj";563;2713;229;2942;NA;292650;792;2021-11-04;113852
2021-11-03;"Trenčiansky kraj";619;2955;222;3177;NA;292650;841;2021-11-03;113060
2021-11-02;"Trenčiansky kraj";663;3808;309;4117;NA;292650;972;2021-11-02;112219
2021-11-01;"Trenčiansky kraj";219;1029;101;1130;NA;292650;320;2021-11-01;111247
2021-10-31;"Trenčiansky kraj";151;1462;152;1614;NA;292650;303;2021-10-31;110927
2021-10-30;"Trenčiansky kraj";345;1770;130;1900;NA;292650;475;2021-10-30;110624
2021-10-29;"Trenčiansky kraj";415;2860;129;2989;NA;292650;544;2021-10-29;110149
2021-10-28;"Trenčiansky kraj";429;2653;157;2810;NA;292650;586;2021-10-28;109605
2021-10-27;"Trenčiansky kraj";463;2612;93;2705;NA;292650;556;2021-10-27;109019
2021-10-26;"Trenčiansky kraj";419;2635;133;2768;NA;292650;552;2021-10-26;108463
2021-10-25;"Trenčiansky kraj";192;3370;130;3500;NA;292650;322;2021-10-25;107911
2021-10-24;"Trenčiansky kraj";121;1643;79;1722;NA;292650;200;2021-10-24;107589
2021-10-23;"Trenčiansky kraj";326;1737;64;1801;NA;292650;390;2021-10-23;107389
2021-10-22;"Trenčiansky kraj";358;2694;78;2772;NA;292650;436;2021-10-22;106999
2021-10-21;"Trenčiansky kraj";247;2343;74;2417;NA;292650;321;2021-10-21;106563
2021-10-20;"Trenčiansky kraj";302;2101;70;2171;NA;292650;372;2021-10-20;106242
2021-10-19;"Trenčiansky kraj";227;2847;59;2906;NA;292650;286;2021-10-19;105870
2021-10-18;"Trenčiansky kraj";143;2453;71;2524;NA;292650;214;2021-10-18;105584
2021-10-17;"Trenčiansky kraj";46;1457;31;1488;NA;292650;77;2021-10-17;105370
2021-10-16;"Trenčiansky kraj";76;1671;35;1706;NA;292650;111;2021-10-16;105293
2021-10-15;"Trenčiansky kraj";126;2925;50;2975;NA;292650;176;2021-10-15;105182
2021-10-14;"Trenčiansky kraj";103;1717;27;1744;NA;292650;130;2021-10-14;105006
2021-10-13;"Trenčiansky kraj";171;2656;28;2684;NA;292650;199;2021-10-13;104876
2021-10-12;"Trenčiansky kraj";114;2350;32;2382;NA;292650;146;2021-10-12;104677
2021-10-11;"Trenčiansky kraj";109;2541;48;2589;NA;292650;157;2021-10-11;104531
2021-10-10;"Trenčiansky kraj";17;1487;23;1510;NA;292650;40;2021-10-10;104374
2021-10-09;"Trenčiansky kraj";157;1809;16;1825;NA;292650;173;2021-10-09;104334
2021-10-08;"Trenčiansky kraj";82;3087;37;3124;NA;292650;119;2021-10-08;104161
2021-10-07;"Trenčiansky kraj";107;2039;30;2069;NA;292650;137;2021-10-07;104042
2021-10-06;"Trenčiansky kraj";193;2289;36;2325;NA;292650;229;2021-10-06;103905
2021-10-05;"Trenčiansky kraj";119;2229;40;2269;NA;292650;159;2021-10-05;103676
2021-10-04;"Trenčiansky kraj";105;2769;52;2821;NA;292650;157;2021-10-04;103517
2021-10-03;"Trenčiansky kraj";30;1558;27;1585;NA;292650;57;2021-10-03;103360
2021-10-02;"Trenčiansky kraj";107;1794;35;1829;NA;292650;142;2021-10-02;103303
2021-10-01;"Trenčiansky kraj";119;2690;37;2727;NA;292650;156;2021-10-01;103161
2021-09-30;"Trenčiansky kraj";74;2327;50;2377;NA;292650;124;2021-09-30;103005
2021-09-29;"Trenčiansky kraj";170;2150;30;2180;NA;292650;200;2021-09-29;102881
2021-09-28;"Trenčiansky kraj";95;2267;31;2298;NA;292650;126;2021-09-28;102681
2021-09-27;"Trenčiansky kraj";56;2813;57;2870;NA;292650;113;2021-09-27;102555
2021-09-26;"Trenčiansky kraj";20;1675;33;1708;NA;292650;53;2021-09-26;102442
2021-09-25;"Trenčiansky kraj";76;1674;21;1695;NA;292650;97;2021-09-25;102389
2021-09-24;"Trenčiansky kraj";104;3220;35;3255;NA;292650;139;2021-09-24;102292
2021-09-23;"Trenčiansky kraj";91;2251;27;2278;NA;292650;118;2021-09-23;102153
2021-09-22;"Trenčiansky kraj";90;2146;24;2170;NA;292650;114;2021-09-22;102035
2021-09-21;"Trenčiansky kraj";79;2307;29;2336;NA;292650;108;2021-09-21;101921
2021-09-20;"Trenčiansky kraj";78;2612;37;2649;NA;292650;115;2021-09-20;101813
2021-09-19;"Trenčiansky kraj";11;1571;20;1591;NA;292650;31;2021-09-19;101698
2021-09-18;"Trenčiansky kraj";53;2099;14;2113;NA;292650;67;2021-09-18;101667
2021-09-17;"Trenčiansky kraj";55;3143;26;3169;NA;292650;81;2021-09-17;101600
2021-09-16;"Trenčiansky kraj";52;2160;20;2180;NA;292650;72;2021-09-16;101519
2021-09-15;"Trenčiansky kraj";63;1043;7;1050;NA;292650;70;2021-09-15;101447
2021-09-14;"Trenčiansky kraj";67;2449;25;2474;NA;292650;92;2021-09-14;101377
2021-09-13;"Trenčiansky kraj";33;2271;35;2306;NA;292650;68;2021-09-13;101285
2021-09-12;"Trenčiansky kraj";3;1411;11;1422;NA;292650;14;2021-09-12;101217
2021-09-11;"Trenčiansky kraj";55;1729;6;1735;NA;292650;61;2021-09-11;101203
2021-09-10;"Trenčiansky kraj";49;2246;15;2261;NA;292650;64;2021-09-10;101142
2021-09-09;"Trenčiansky kraj";24;1684;30;1714;NA;292650;54;2021-09-09;101078
2021-09-08;"Trenčiansky kraj";54;1770;15;1785;NA;292650;69;2021-09-08;101024
2021-09-07;"Trenčiansky kraj";43;1393;18;1411;NA;292650;61;2021-09-07;100955
2021-09-06;"Trenčiansky kraj";47;1398;15;1413;NA;292650;62;2021-09-06;100894
2021-09-05;"Trenčiansky kraj";2;966;23;989;NA;292650;25;2021-09-05;100832
2021-09-04;"Trenčiansky kraj";41;925;4;929;NA;292650;45;2021-09-04;100807
2021-09-03;"Trenčiansky kraj";53;1421;15;1436;NA;292650;68;2021-09-03;100762
2021-09-02;"Trenčiansky kraj";7;999;14;1013;NA;292650;21;2021-09-02;100694
2021-09-01;"Trenčiansky kraj";27;431;8;439;NA;292650;35;2021-09-01;100673
2021-08-31;"Trenčiansky kraj";21;1146;15;1161;NA;292650;36;2021-08-31;100638
2021-08-30;"Trenčiansky kraj";32;1166;10;1176;NA;292650;42;2021-08-30;100602
2021-08-29;"Trenčiansky kraj";1;482;11;493;NA;292650;12;2021-08-29;100560
2021-08-28;"Trenčiansky kraj";9;976;10;986;NA;292650;19;2021-08-28;100548
2021-08-27;"Trenčiansky kraj";21;1599;1;1600;NA;292650;22;2021-08-27;100529
2021-08-26;"Trenčiansky kraj";8;992;6;998;NA;292650;14;2021-08-26;100507
2021-08-25;"Trenčiansky kraj";40;875;7;882;NA;292650;47;2021-08-25;100493
2021-08-24;"Trenčiansky kraj";4;822;4;826;NA;292650;8;2021-08-24;100446
2021-08-23;"Trenčiansky kraj";6;1165;17;1182;NA;292650;23;2021-08-23;100438
2021-08-22;"Trenčiansky kraj";0;726;10;736;NA;292650;10;2021-08-22;100415
2021-08-21;"Trenčiansky kraj";5;964;7;971;NA;292650;12;2021-08-21;100405
2021-08-20;"Trenčiansky kraj";15;1537;2;1539;NA;292650;17;2021-08-20;100393
2021-08-19;"Trenčiansky kraj";2;985;2;987;NA;292650;4;2021-08-19;100376
2021-08-18;"Trenčiansky kraj";6;814;7;821;NA;292650;13;2021-08-18;100372
2021-08-17;"Trenčiansky kraj";9;633;1;634;NA;292650;10;2021-08-17;100359
2021-08-16;"Trenčiansky kraj";5;925;3;928;NA;292650;8;2021-08-16;100349
2021-08-15;"Trenčiansky kraj";0;558;1;559;NA;292650;1;2021-08-15;100341
2021-08-14;"Trenčiansky kraj";12;574;6;580;NA;292650;18;2021-08-14;100340
2021-08-13;"Trenčiansky kraj";2;933;0;933;NA;292650;2;2021-08-13;100322
2021-08-12;"Trenčiansky kraj";2;564;3;567;NA;292650;5;2021-08-12;100320
2021-08-11;"Trenčiansky kraj";1;680;0;680;NA;292650;1;2021-08-11;100315
2021-08-10;"Trenčiansky kraj";8;530;1;531;NA;292650;9;2021-08-10;100314
2021-08-09;"Trenčiansky kraj";8;694;1;695;NA;292650;9;2021-08-09;100305
2021-08-08;"Trenčiansky kraj";0;468;0;468;NA;292650;0;2021-08-08;100296
2021-08-07;"Trenčiansky kraj";3;464;0;464;NA;292650;3;2021-08-07;100296
2021-08-06;"Trenčiansky kraj";3;955;1;956;NA;292650;4;2021-08-06;100293
2021-08-05;"Trenčiansky kraj";3;579;1;580;NA;292650;4;2021-08-05;100289
2021-08-04;"Trenčiansky kraj";14;546;3;549;NA;292650;17;2021-08-04;100285
2021-08-03;"Trenčiansky kraj";9;508;5;513;NA;292650;14;2021-08-03;100268
2021-08-02;"Trenčiansky kraj";1;807;2;809;NA;292650;3;2021-08-02;100254
2021-08-01;"Trenčiansky kraj";0;458;1;459;NA;292650;1;2021-08-01;100251
2021-07-31;"Trenčiansky kraj";4;525;2;527;NA;292650;6;2021-07-31;100250
2021-07-30;"Trenčiansky kraj";2;1069;0;1069;NA;292650;2;2021-07-30;100244
2021-07-29;"Trenčiansky kraj";5;708;0;708;NA;292650;5;2021-07-29;100242
2021-07-28;"Trenčiansky kraj";3;517;2;519;NA;292650;5;2021-07-28;100237
2021-07-27;"Trenčiansky kraj";6;551;1;552;NA;292650;7;2021-07-27;100232
2021-07-26;"Trenčiansky kraj";7;772;1;773;NA;292650;8;2021-07-26;100225
2021-07-25;"Trenčiansky kraj";0;487;2;489;NA;292650;2;2021-07-25;100217
2021-07-24;"Trenčiansky kraj";3;643;1;644;NA;292650;4;2021-07-24;100215
2021-07-23;"Trenčiansky kraj";3;1151;0;1151;NA;292650;3;2021-07-23;100211
2021-07-22;"Trenčiansky kraj";2;844;2;846;NA;292650;4;2021-07-22;100208
2021-07-21;"Trenčiansky kraj";8;661;2;663;NA;292650;10;2021-07-21;100204
2021-07-20;"Trenčiansky kraj";4;525;1;526;NA;292650;5;2021-07-20;100194
2021-07-19;"Trenčiansky kraj";0;866;4;870;NA;292650;4;2021-07-19;100189
2021-07-18;"Trenčiansky kraj";0;526;0;526;NA;292650;0;2021-07-18;100185
2021-07-17;"Trenčiansky kraj";3;673;0;673;NA;292650;3;2021-07-17;100185
2021-07-16;"Trenčiansky kraj";4;1122;0;1122;NA;292650;4;2021-07-16;100182
2021-07-15;"Trenčiansky kraj";2;824;0;824;NA;292650;2;2021-07-15;100178
2021-07-14;"Trenčiansky kraj";8;645;0;645;NA;292650;8;2021-07-14;100176
2021-07-13;"Trenčiansky kraj";1;520;3;523;NA;292650;4;2021-07-13;100168
2021-07-12;"Trenčiansky kraj";9;820;2;822;NA;292650;11;2021-07-12;100164
2021-07-11;"Trenčiansky kraj";0;611;2;613;NA;292650;2;2021-07-11;100153
2021-07-10;"Trenčiansky kraj";2;535;0;535;NA;292650;2;2021-07-10;100151
2021-07-09;"Trenčiansky kraj";7;1379;0;1379;NA;292650;7;2021-07-09;100149
2021-07-08;"Trenčiansky kraj";2;815;1;816;NA;292650;3;2021-07-08;100142
2021-07-07;"Trenčiansky kraj";2;928;0;928;NA;292650;2;2021-07-07;100139
2021-07-06;"Trenčiansky kraj";4;1041;1;1042;NA;292650;5;2021-07-06;100137
2021-07-05;"Trenčiansky kraj";1;508;0;508;NA;292650;1;2021-07-05;100132
2021-07-04;"Trenčiansky kraj";0;612;1;613;NA;292650;1;2021-07-04;100131
2021-07-03;"Trenčiansky kraj";3;815;1;816;NA;292650;4;2021-07-03;100130
2021-07-02;"Trenčiansky kraj";5;1583;2;1585;NA;292650;7;2021-07-02;100126
2021-07-01;"Trenčiansky kraj";4;1152;1;1153;NA;292650;5;2021-07-01;100119
2021-06-30;"Trenčiansky kraj";2;7021;6;7027;NA;292650;8;2021-06-30;100114
2021-06-29;"Trenčiansky kraj";4;2773;5;2778;NA;292650;9;2021-06-29;100106
2021-06-28;"Trenčiansky kraj";5;3644;4;3648;NA;292650;9;2021-06-28;100097
2021-06-27;"Trenčiansky kraj";0;2861;1;2862;NA;292650;1;2021-06-27;100088
2021-06-26;"Trenčiansky kraj";1;3547;4;3551;NA;292650;5;2021-06-26;100087
2021-06-25;"Trenčiansky kraj";2;4626;1;4627;NA;292650;3;2021-06-25;100082
2021-06-24;"Trenčiansky kraj";3;3320;4;3324;NA;292650;7;2021-06-24;100079
2021-06-23;"Trenčiansky kraj";4;2808;2;2810;NA;292650;6;2021-06-23;100072
2021-06-22;"Trenčiansky kraj";7;3137;4;3141;NA;292650;11;2021-06-22;100066
2021-06-21;"Trenčiansky kraj";10;3891;4;3895;NA;292650;14;2021-06-21;100055
2021-06-20;"Trenčiansky kraj";0;3579;5;3584;NA;292650;5;2021-06-20;100041
2021-06-19;"Trenčiansky kraj";5;4528;1;4529;NA;292650;6;2021-06-19;100036
2021-06-18;"Trenčiansky kraj";7;6725;7;6732;NA;292650;14;2021-06-18;100030
2021-06-17;"Trenčiansky kraj";0;3469;6;3475;NA;292650;6;2021-06-17;100016
2021-06-16;"Trenčiansky kraj";4;3183;3;3186;NA;292650;7;2021-06-16;100010
2021-06-15;"Trenčiansky kraj";10;3697;2;3699;NA;292650;12;2021-06-15;100003
2021-06-14;"Trenčiansky kraj";10;4805;15;4820;NA;292650;25;2021-06-14;99991
2021-06-13;"Trenčiansky kraj";0;4643;4;4647;NA;292650;4;2021-06-13;99966
2021-06-12;"Trenčiansky kraj";4;5260;8;5268;NA;292650;12;2021-06-12;99962
2021-06-11;"Trenčiansky kraj";10;7365;11;7376;NA;292650;21;2021-06-11;99950
2021-06-10;"Trenčiansky kraj";5;4345;7;4352;NA;292650;12;2021-06-10;99929
2021-06-09;"Trenčiansky kraj";7;3693;7;3700;NA;292650;14;2021-06-09;99917
2021-06-08;"Trenčiansky kraj";21;3965;7;3972;NA;292650;28;2021-06-08;99903
2021-06-07;"Trenčiansky kraj";13;5560;10;5570;NA;292650;23;2021-06-07;99875
2021-06-06;"Trenčiansky kraj";0;5500;10;5510;NA;292650;10;2021-06-06;99852
2021-06-05;"Trenčiansky kraj";7;6511;5;6516;NA;292650;12;2021-06-05;99842
2021-06-04;"Trenčiansky kraj";16;7653;3;7656;NA;292650;19;2021-06-04;99830
2021-06-03;"Trenčiansky kraj";9;4485;10;4495;NA;292650;19;2021-06-03;99811
2021-06-02;"Trenčiansky kraj";28;4329;8;4337;NA;292650;36;2021-06-02;99792
2021-06-01;"Trenčiansky kraj";22;5396;18;5414;NA;292650;40;2021-06-01;99756
2021-05-31;"Trenčiansky kraj";30;6117;24;6141;NA;292650;54;2021-05-31;99716
2021-05-30;"Trenčiansky kraj";0;8258;16;8274;NA;292650;16;2021-05-30;99662
2021-05-29;"Trenčiansky kraj";13;7915;14;7929;NA;292650;27;2021-05-29;99646
2021-05-28;"Trenčiansky kraj";22;8995;25;9020;NA;292650;47;2021-05-28;99619
2021-05-27;"Trenčiansky kraj";6;5205;12;5217;NA;292650;18;2021-05-27;99572
2021-05-26;"Trenčiansky kraj";26;5069;15;5084;NA;292650;41;2021-05-26;99554
2021-05-25;"Trenčiansky kraj";18;6168;24;6192;NA;292650;42;2021-05-25;99513
2021-05-24;"Trenčiansky kraj";19;9292;37;9329;NA;292650;56;2021-05-24;99471
2021-05-23;"Trenčiansky kraj";0;9083;26;9109;NA;292650;26;2021-05-23;99415
2021-05-22;"Trenčiansky kraj";11;11314;21;11335;NA;292650;32;2021-05-22;99389
2021-05-21;"Trenčiansky kraj";23;11572;26;11598;NA;292650;49;2021-05-21;99357
2021-05-20;"Trenčiansky kraj";23;6320;25;6345;NA;292650;48;2021-05-20;99308
2021-05-19;"Trenčiansky kraj";16;5694;32;5726;NA;292650;48;2021-05-19;99260
2021-05-18;"Trenčiansky kraj";26;7779;28;7807;NA;292650;54;2021-05-18;99212
2021-05-17;"Trenčiansky kraj";37;7671;43;7714;NA;292650;80;2021-05-17;99158
2021-05-16;"Trenčiansky kraj";25;15615;41;15656;NA;292650;66;2021-05-16;99078
2021-05-15;"Trenčiansky kraj";3;21237;32;21269;NA;292650;35;2021-05-15;99012
2021-05-14;"Trenčiansky kraj";41;18676;42;18718;NA;292650;83;2021-05-14;98977
2021-05-13;"Trenčiansky kraj";41;8195;24;8219;NA;292650;65;2021-05-13;98894
2021-05-12;"Trenčiansky kraj";41;7409;31;7440;NA;292650;72;2021-05-12;98829
2021-05-11;"Trenčiansky kraj";66;10507;32;10539;NA;292650;98;2021-05-11;98757
2021-05-10;"Trenčiansky kraj";48;12989;55;13044;NA;292650;103;2021-05-10;98659
2021-05-09;"Trenčiansky kraj";52;17737;39;17776;NA;292650;91;2021-05-09;98556
2021-05-08;"Trenčiansky kraj";3;23822;33;23855;NA;292650;36;2021-05-08;98465
2021-05-07;"Trenčiansky kraj";45;23549;56;23605;NA;292650;101;2021-05-07;98429
2021-05-06;"Trenčiansky kraj";26;10771;44;10815;NA;292650;70;2021-05-06;98328
2021-05-05;"Trenčiansky kraj";73;9377;41;9418;NA;292650;114;2021-05-05;98258
2021-05-04;"Trenčiansky kraj";55;12733;53;12786;NA;292650;108;2021-05-04;98144
2021-05-03;"Trenčiansky kraj";60;15331;51;15382;NA;292650;111;2021-05-03;98036
2021-05-02;"Trenčiansky kraj";0;31152;65;31217;NA;292650;65;2021-05-02;97925
2021-05-01;"Trenčiansky kraj";71;56982;60;57042;NA;292650;131;2021-05-01;97860
2021-04-30;"Trenčiansky kraj";77;29427;61;29488;NA;292650;138;2021-04-30;97729
2021-04-29;"Trenčiansky kraj";49;13184;59;13243;NA;292650;108;2021-04-29;97591
2021-04-28;"Trenčiansky kraj";79;12537;52;12589;NA;292650;131;2021-04-28;97483
2021-04-27;"Trenčiansky kraj";107;15527;40;15567;NA;292650;147;2021-04-27;97352
2021-04-26;"Trenčiansky kraj";52;21070;63;21133;NA;292650;115;2021-04-26;97205
2021-04-25;"Trenčiansky kraj";0;34560;48;34608;NA;292650;48;2021-04-25;97090
2021-04-24;"Trenčiansky kraj";76;72398;100;72498;NA;292650;176;2021-04-24;97042
2021-04-23;"Trenčiansky kraj";143;29959;79;30038;NA;292650;222;2021-04-23;96866
2021-04-22;"Trenčiansky kraj";71;13847;64;13911;NA;292650;135;2021-04-22;96644
2021-04-21;"Trenčiansky kraj";79;13000;67;13067;NA;292650;146;2021-04-21;96509
2021-04-20;"Trenčiansky kraj";142;17740;80;17820;NA;292650;222;2021-04-20;96363
2021-04-19;"Trenčiansky kraj";102;22631;103;22734;NA;292650;205;2021-04-19;96141
2021-04-18;"Trenčiansky kraj";3;40879;97;40976;NA;292650;100;2021-04-18;95936
2021-04-17;"Trenčiansky kraj";77;81498;136;81634;NA;292650;213;2021-04-17;95836
2021-04-16;"Trenčiansky kraj";100;31961;90;32051;NA;292650;190;2021-04-16;95623
2021-04-15;"Trenčiansky kraj";71;14479;69;14548;NA;292650;140;2021-04-15;95433
2021-04-14;"Trenčiansky kraj";135;15563;72;15635;NA;292650;207;2021-04-14;95293
2021-04-13;"Trenčiansky kraj";189;18721;75;18796;NA;292650;264;2021-04-13;95086
2021-04-12;"Trenčiansky kraj";97;23743;91;23834;NA;292650;188;2021-04-12;94822
2021-04-11;"Trenčiansky kraj";1;34735;75;34810;NA;292650;76;2021-04-11;94634
2021-04-10;"Trenčiansky kraj";81;83093;145;83238;NA;292650;226;2021-04-10;94558
2021-04-09;"Trenčiansky kraj";120;28014;91;28105;NA;292650;211;2021-04-09;94332
2021-04-08;"Trenčiansky kraj";112;13283;85;13368;NA;292650;197;2021-04-08;94121
2021-04-07;"Trenčiansky kraj";204;17688;123;17811;NA;292650;327;2021-04-07;93924
2021-04-06;"Trenčiansky kraj";157;28567;178;28745;NA;292650;335;2021-04-06;93597
2021-04-05;"Trenčiansky kraj";15;9227;64;9291;NA;292650;79;2021-04-05;93262
2021-04-04;"Trenčiansky kraj";2;20291;85;20376;NA;292650;87;2021-04-04;93183
2021-04-03;"Trenčiansky kraj";86;80473;221;80694;NA;292650;307;2021-04-03;93096
2021-04-02;"Trenčiansky kraj";126;21620;81;21701;NA;292650;207;2021-04-02;92789
2021-04-01;"Trenčiansky kraj";159;32376;139;32515;NA;292650;298;2021-04-01;92582
2021-03-31;"Trenčiansky kraj";198;20100;130;20230;NA;292650;328;2021-03-31;92284
2021-03-30;"Trenčiansky kraj";272;17305;136;17441;NA;292650;408;2021-03-30;91956
2021-03-29;"Trenčiansky kraj";142;19479;170;19649;NA;292650;312;2021-03-29;91548
2021-03-28;"Trenčiansky kraj";3;34759;116;34875;NA;292650;119;2021-03-28;91236
2021-03-27;"Trenčiansky kraj";130;77314;293;77607;NA;292650;423;2021-03-27;91117
2021-03-26;"Trenčiansky kraj";211;35095;157;35252;NA;292650;368;2021-03-26;90694
2021-03-25;"Trenčiansky kraj";184;16580;176;16756;NA;292650;360;2021-03-25;90326
2021-03-24;"Trenčiansky kraj";259;13102;171;13273;NA;292650;430;2021-03-24;89966
2021-03-23;"Trenčiansky kraj";349;17589;174;17763;NA;292650;523;2021-03-23;89536
2021-03-22;"Trenčiansky kraj";141;21116;213;21329;NA;292650;354;2021-03-22;89013
2021-03-21;"Trenčiansky kraj";85;32711;164;32875;NA;292650;249;2021-03-21;88659
2021-03-20;"Trenčiansky kraj";128;80035;322;80357;NA;292650;450;2021-03-20;88410
2021-03-19;"Trenčiansky kraj";231;34783;232;35015;NA;292650;463;2021-03-19;87960
2021-03-18;"Trenčiansky kraj";262;16105;178;16283;NA;292650;440;2021-03-18;87497
2021-03-17;"Trenčiansky kraj";366;13435;164;13599;NA;292650;530;2021-03-17;87057
2021-03-16;"Trenčiansky kraj";450;15282;241;15523;NA;292650;691;2021-03-16;86527
2021-03-15;"Trenčiansky kraj";162;21235;261;21496;NA;292650;423;2021-03-15;85836
2021-03-14;"Trenčiansky kraj";42;34416;238;34654;NA;292650;280;2021-03-14;85413
2021-03-13;"Trenčiansky kraj";270;79186;453;79639;NA;292650;723;2021-03-13;85133
2021-03-12;"Trenčiansky kraj";366;34795;307;35102;NA;292650;673;2021-03-12;84410
2021-03-11;"Trenčiansky kraj";302;15558;213;15771;NA;292650;515;2021-03-11;83737
2021-03-10;"Trenčiansky kraj";402;13585;237;13822;NA;292650;639;2021-03-10;83222
2021-03-09;"Trenčiansky kraj";586;17982;285;18267;NA;292650;871;2021-03-09;82583
2021-03-08;"Trenčiansky kraj";174;21704;363;22067;NA;292650;537;2021-03-08;81712
2021-03-07;"Trenčiansky kraj";4;33660;313;33973;NA;292650;317;2021-03-07;81175
2021-03-06;"Trenčiansky kraj";260;79661;529;80190;NA;292650;789;2021-03-06;80858
2021-03-05;"Trenčiansky kraj";326;32969;415;33384;NA;292650;741;2021-03-05;80069
2021-03-04;"Trenčiansky kraj";323;16821;317;17138;NA;292650;640;2021-03-04;79328
2021-03-03;"Trenčiansky kraj";413;13960;347;14307;NA;292650;760;2021-03-03;78688
2021-03-02;"Trenčiansky kraj";612;17794;344;18138;NA;292650;956;2021-03-02;77928
2021-03-01;"Trenčiansky kraj";217;21104;445;21549;NA;292650;662;2021-03-01;76972
2021-02-28;"Trenčiansky kraj";45;30238;376;30614;NA;292650;421;2021-02-28;76310
2021-02-27;"Trenčiansky kraj";277;78735;686;79421;NA;292650;963;2021-02-27;75889
2021-02-26;"Trenčiansky kraj";420;32940;434;33374;NA;292650;854;2021-02-26;74926
2021-02-25;"Trenčiansky kraj";424;14029;328;14357;NA;292650;752;2021-02-25;74072
2021-02-24;"Trenčiansky kraj";427;12014;399;12413;NA;292650;826;2021-02-24;73320
2021-02-23;"Trenčiansky kraj";577;14904;390;15294;NA;292650;967;2021-02-23;72494
2021-02-22;"Trenčiansky kraj";160;19969;468;20437;NA;292650;628;2021-02-22;71527
2021-02-21;"Trenčiansky kraj";64;29478;392;29870;NA;292650;456;2021-02-21;70899
2021-02-20;"Trenčiansky kraj";274;77840;745;78585;NA;292650;1019;2021-02-20;70443
2021-02-19;"Trenčiansky kraj";272;30260;523;30783;NA;292650;795;2021-02-19;69424
2021-02-18;"Trenčiansky kraj";355;14094;403;14497;NA;292650;758;2021-02-18;68629
2021-02-17;"Trenčiansky kraj";363;11412;376;11788;NA;292650;739;2021-02-17;67871
2021-02-16;"Trenčiansky kraj";488;17761;406;18167;NA;292650;894;2021-02-16;67132
2021-02-15;"Trenčiansky kraj";151;21846;463;22309;NA;292650;614;2021-02-15;66238
2021-02-14;"Trenčiansky kraj";2;31255;324;31579;NA;292650;326;2021-02-14;65624
2021-02-13;"Trenčiansky kraj";274;63006;522;63528;NA;292650;796;2021-02-13;65298
2021-02-12;"Trenčiansky kraj";276;27979;412;28391;NA;292650;688;2021-02-12;64502
2021-02-11;"Trenčiansky kraj";291;11567;323;11890;NA;292650;614;2021-02-11;63814
2021-02-10;"Trenčiansky kraj";304;11408;317;11725;NA;292650;621;2021-02-10;63200
2021-02-09;"Trenčiansky kraj";514;18412;360;18772;NA;292650;874;2021-02-09;62579
2021-02-08;"Trenčiansky kraj";182;26832;430;27262;NA;292650;612;2021-02-08;61705
2021-02-07;"Trenčiansky kraj";31;36781;341;37122;NA;292650;372;2021-02-07;61093
2021-02-06;"Trenčiansky kraj";216;63931;560;64491;NA;292650;776;2021-02-06;60721
2021-02-05;"Trenčiansky kraj";202;18164;367;18531;NA;292650;569;2021-02-05;59945
2021-02-04;"Trenčiansky kraj";266;7253;311;7564;NA;292650;577;2021-02-04;59376
2021-02-03;"Trenčiansky kraj";162;6723;320;7043;NA;292650;482;2021-02-03;58799
2021-02-02;"Trenčiansky kraj";347;8074;381;8455;NA;292650;728;2021-02-02;58317
2021-02-01;"Trenčiansky kraj";167;8921;311;9232;NA;292650;478;2021-02-01;57589
2021-01-31;"Trenčiansky kraj";7;19103;159;19262;NA;292650;166;2021-01-31;57111
2021-01-30;"Trenčiansky kraj";228;38167;332;38499;NA;292650;560;2021-01-30;56945
2021-01-29;"Trenčiansky kraj";214;7590;235;7825;NA;292650;449;2021-01-29;56385
2021-01-28;"Trenčiansky kraj";307;5442;158;5600;NA;292650;465;2021-01-28;55936
2021-01-27;"Trenčiansky kraj";166;4842;181;5023;NA;292650;347;2021-01-27;55471
2021-01-26;"Trenčiansky kraj";303;14589;250;14839;NA;292650;553;2021-01-26;55124
2021-01-25;"Trenčiansky kraj";160;24310;207;24517;NA;292650;367;2021-01-25;54571
2021-01-24;"Trenčiansky kraj";51;38369;282;38651;NA;292650;333;2021-01-24;54204
2021-01-23;"Trenčiansky kraj";206;114125;749;114874;NA;292650;955;2021-01-23;53871
2021-01-22;"Trenčiansky kraj";148;21831;241;22072;NA;292650;389;2021-01-22;52916
2021-01-21;"Trenčiansky kraj";143;8586;166;8752;NA;292650;309;2021-01-21;52527
2021-01-20;"Trenčiansky kraj";181;8189;227;8416;NA;292650;408;2021-01-20;52218
2021-01-19;"Trenčiansky kraj";363;6600;262;6862;NA;292650;625;2021-01-19;51810
2021-01-18;"Trenčiansky kraj";72;4970;321;5291;NA;292650;393;2021-01-18;51185
2021-01-17;"Trenčiansky kraj";124;156;11;167;NA;292650;135;2021-01-17;50792
2021-01-16;"Trenčiansky kraj";39;1288;53;1341;NA;292650;92;2021-01-16;50657
2021-01-15;"Trenčiansky kraj";264;4031;214;4245;NA;292650;478;2021-01-15;50565
2021-01-14;"Trenčiansky kraj";275;3193;189;3382;NA;292650;464;2021-01-14;50087
2021-01-13;"Trenčiansky kraj";222;3893;215;4108;NA;292650;437;2021-01-13;49623
2021-01-12;"Trenčiansky kraj";508;4604;261;4865;NA;292650;769;2021-01-12;49186
2021-01-11;"Trenčiansky kraj";142;4367;354;4721;NA;292650;496;2021-01-11;48417
2021-01-10;"Trenčiansky kraj";89;4969;77;5046;NA;292650;166;2021-01-10;47921
2021-01-09;"Trenčiansky kraj";276;8280;128;8408;NA;292650;404;2021-01-09;47755
2021-01-08;"Trenčiansky kraj";489;6435;484;6919;NA;292650;973;2021-01-08;47351
2021-01-07;"Trenčiansky kraj";420;6138;577;6715;NA;292650;997;2021-01-07;46378
2021-01-06;"Trenčiansky kraj";221;1021;64;1085;NA;292650;285;2021-01-06;45381
2021-01-05;"Trenčiansky kraj";669;5753;706;6459;NA;292650;1375;2021-01-05;45096
2021-01-04;"Trenčiansky kraj";337;5248;782;6030;NA;292650;1119;2021-01-04;43721
2021-01-03;"Trenčiansky kraj";38;114;15;129;NA;292650;53;2021-01-03;42602
2021-01-02;"Trenčiansky kraj";129;196;23;219;NA;292650;152;2021-01-02;42549
2021-01-01;"Trenčiansky kraj";329;347;23;370;NA;292650;352;2021-01-01;42397
2020-12-31;"Trenčiansky kraj";597;4943;557;5500;NA;292650;1154;2020-12-31;42045
2020-12-30;"Trenčiansky kraj";836;7012;762;7774;NA;292650;1598;2020-12-30;40891
2020-12-29;"Trenčiansky kraj";459;6121;1009;7130;NA;292650;1468;2020-12-29;39293
2020-12-28;"Trenčiansky kraj";258;4195;777;4972;NA;292650;1035;2020-12-28;37825
2020-12-27;"Trenčiansky kraj";5;208;36;244;NA;292650;41;2020-12-27;36790
2020-12-26;"Trenčiansky kraj";174;74;10;84;NA;292650;184;2020-12-26;36749
2020-12-25;"Trenčiansky kraj";251;325;47;372;NA;292650;298;2020-12-25;36565
2020-12-24;"Trenčiansky kraj";552;2194;256;2450;NA;292650;808;2020-12-24;36267
2020-12-23;"Trenčiansky kraj";421;6552;661;7213;NA;292650;1082;2020-12-23;35459
2020-12-22;"Trenčiansky kraj";673;5760;694;6454;NA;292650;1367;2020-12-22;34377
2020-12-21;"Trenčiansky kraj";248;13395;979;14374;NA;292650;1227;2020-12-21;33010
2020-12-20;"Trenčiansky kraj";238;12504;292;12796;NA;292650;530;2020-12-20;31783
2020-12-19;"Trenčiansky kraj";341;1611;150;1761;NA;292650;491;2020-12-19;31253
2020-12-18;"Trenčiansky kraj";521;5199;615;5814;NA;292650;1136;2020-12-18;30762
2020-12-17;"Trenčiansky kraj";670;3843;524;4367;NA;292650;1194;2020-12-17;29626
2020-12-16;"Trenčiansky kraj";461;4474;648;5122;NA;292650;1109;2020-12-16;28432
2020-12-15;"Trenčiansky kraj";595;3805;670;4475;NA;292650;1265;2020-12-15;27323
2020-12-14;"Trenčiansky kraj";318;2907;552;3459;NA;292650;870;2020-12-14;26058
2020-12-13;"Trenčiansky kraj";77;49;6;55;NA;292650;83;2020-12-13;25188
2020-12-12;"Trenčiansky kraj";314;1191;136;1327;NA;292650;450;2020-12-12;25105
2020-12-11;"Trenčiansky kraj";751;3773;453;4226;NA;292650;1204;2020-12-11;24655
2020-12-10;"Trenčiansky kraj";271;3354;473;3827;NA;292650;744;2020-12-10;23451
2020-12-09;"Trenčiansky kraj";508;3788;466;4254;NA;292650;974;2020-12-09;22707
2020-12-08;"Trenčiansky kraj";546;3440;522;3962;NA;292650;1068;2020-12-08;21733
2020-12-07;"Trenčiansky kraj";258;3832;468;4300;NA;292650;726;2020-12-07;20665
2020-12-06;"Trenčiansky kraj";114;179;10;189;NA;292650;124;2020-12-06;19939
2020-12-05;"Trenčiansky kraj";223;610;56;666;NA;292650;279;2020-12-05;19815
2020-12-04;"Trenčiansky kraj";253;2943;273;3216;NA;292650;526;2020-12-04;19536
2020-12-03;"Trenčiansky kraj";503;1714;178;1892;NA;292650;681;2020-12-03;19010
2020-12-02;"Trenčiansky kraj";418;1844;232;2076;NA;292650;650;2020-12-02;18329
2020-12-01;"Trenčiansky kraj";321;5642;351;5993;NA;292650;672;2020-12-01;17679
2020-11-30;"Trenčiansky kraj";167;11514;520;12034;NA;292650;687;2020-11-30;17007
2020-11-29;"Trenčiansky kraj";29;30;5;35;NA;292650;34;2020-11-29;16320
2020-11-28;"Trenčiansky kraj";202;1051;93;1144;NA;292650;295;2020-11-28;16286
2020-11-27;"Trenčiansky kraj";330;1888;186;2074;NA;292650;516;2020-11-27;15991
2020-11-26;"Trenčiansky kraj";395;1252;122;1374;NA;292650;517;2020-11-26;15475
2020-11-25;"Trenčiansky kraj";322;1444;160;1604;NA;292650;482;2020-11-25;14958
2020-11-24;"Trenčiansky kraj";348;2553;308;2861;NA;292650;656;2020-11-24;14476
2020-11-23;"Trenčiansky kraj";159;1186;122;1308;NA;292650;281;2020-11-23;13820
2020-11-22;"Trenčiansky kraj";26;30;7;37;NA;292650;33;2020-11-22;13539
2020-11-21;"Trenčiansky kraj";255;1376;69;1445;NA;292650;324;2020-11-21;13506
2020-11-20;"Trenčiansky kraj";316;861;93;954;NA;292650;409;2020-11-20;13182
2020-11-19;"Trenčiansky kraj";316;740;113;853;NA;292650;429;2020-11-19;12773
2020-11-18;"Trenčiansky kraj";233;379;66;445;NA;292650;299;2020-11-18;12344
2020-11-17;"Trenčiansky kraj";222;106;15;121;NA;292650;237;2020-11-17;12045
2020-11-16;"Trenčiansky kraj";245;236;45;281;NA;292650;290;2020-11-16;11808
2020-11-15;"Trenčiansky kraj";109;29;6;35;NA;292650;115;2020-11-15;11518
2020-11-14;"Trenčiansky kraj";190;74;11;85;NA;292650;201;2020-11-14;11403
2020-11-13;"Trenčiansky kraj";308;131;13;144;NA;292650;321;2020-11-13;11202
2020-11-12;"Trenčiansky kraj";324;124;5;129;NA;292650;329;2020-11-12;10881
2020-11-11;"Trenčiansky kraj";366;113;10;123;NA;292650;376;2020-11-11;10552
2020-11-10;"Trenčiansky kraj";277;106;6;112;NA;292650;283;2020-11-10;10176
2020-11-09;"Trenčiansky kraj";115;1407;48;1455;NA;292650;163;2020-11-09;9893
2020-11-08;"Trenčiansky kraj";81;1271;8;1279;NA;292650;89;2020-11-08;9730
2020-11-07;"Trenčiansky kraj";319;3662;59;3721;NA;292650;378;2020-11-07;9641
2020-11-06;"Trenčiansky kraj";383;6893;84;6977;NA;292650;467;2020-11-06;9263
2020-11-05;"Trenčiansky kraj";399;98;15;113;NA;292650;414;2020-11-05;8796
2020-11-04;"Trenčiansky kraj";370;91;9;100;NA;292650;379;2020-11-04;8382
2020-11-03;"Trenčiansky kraj";575;97;8;105;NA;292650;583;2020-11-03;8003
2020-11-02;"Trenčiansky kraj";197;1833;68;1901;NA;292650;265;2020-11-02;7420
2020-11-01;"Trenčiansky kraj";82;808;24;832;NA;292650;106;2020-11-01;7155
2022-04-03;"Trnavský kraj";35;65;13;78;196562;264803;48;2022-04-03;264803
2022-04-02;"Trnavský kraj";478;112;14;126;NA;264803;492;2022-04-02;264755
2022-04-01;"Trnavský kraj";630;615;63;678;NA;264803;693;2022-04-01;264263
2022-03-31;"Trnavský kraj";709;462;68;530;NA;264803;777;2022-03-31;263570
2022-03-30;"Trnavský kraj";885;464;72;536;NA;264803;957;2022-03-30;262793
2022-03-29;"Trnavský kraj";845;640;69;709;NA;264803;914;2022-03-29;261836
2022-03-28;"Trnavský kraj";623;763;106;869;NA;264803;729;2022-03-28;260922
2022-03-27;"Trnavský kraj";340;175;31;206;NA;264803;371;2022-03-27;260193
2022-03-26;"Trnavský kraj";762;206;33;239;NA;264803;795;2022-03-26;259822
2022-03-25;"Trnavský kraj";859;664;69;733;NA;264803;928;2022-03-25;259027
2022-03-24;"Trnavský kraj";920;626;66;692;NA;264803;986;2022-03-24;258099
2022-03-23;"Trnavský kraj";1112;793;96;889;NA;264803;1208;2022-03-23;257113
2022-03-22;"Trnavský kraj";1096;766;69;835;NA;264803;1165;2022-03-22;255905
2022-03-21;"Trnavský kraj";1096;999;106;1105;NA;264803;1202;2022-03-21;254740
2022-03-20;"Trnavský kraj";229;244;42;286;NA;264803;271;2022-03-20;253538
2022-03-19;"Trnavský kraj";1000;233;55;288;NA;264803;1055;2022-03-19;253267
2022-03-18;"Trnavský kraj";1038;881;107;988;NA;264803;1145;2022-03-18;252212
2022-03-17;"Trnavský kraj";1148;703;86;789;NA;264803;1234;2022-03-17;251067
2022-03-16;"Trnavský kraj";1344;579;84;663;NA;264803;1428;2022-03-16;249833
2022-03-15;"Trnavský kraj";1179;1018;117;1135;NA;264803;1296;2022-03-15;248405
2022-03-14;"Trnavský kraj";890;1517;171;1688;NA;264803;1061;2022-03-14;247109
2022-03-13;"Trnavský kraj";290;411;53;464;NA;264803;343;2022-03-13;246048
2022-03-12;"Trnavský kraj";958;298;39;337;NA;264803;997;2022-03-12;245705
2022-03-11;"Trnavský kraj";961;1021;125;1146;NA;264803;1086;2022-03-11;244708
2022-03-10;"Trnavský kraj";1049;1228;147;1375;NA;264803;1196;2022-03-10;243622
2022-03-09;"Trnavský kraj";1271;1135;157;1292;NA;264803;1428;2022-03-09;242426
2022-03-08;"Trnavský kraj";1393;1347;172;1519;NA;264803;1565;2022-03-08;240998
2022-03-07;"Trnavský kraj";1005;2016;254;2270;NA;264803;1259;2022-03-07;239433
2022-03-06;"Trnavský kraj";395;552;115;667;NA;264803;510;2022-03-06;238174
2022-03-05;"Trnavský kraj";806;461;89;550;NA;264803;895;2022-03-05;237664
2022-03-04;"Trnavský kraj";1028;1043;122;1165;NA;264803;1150;2022-03-04;236769
2022-03-03;"Trnavský kraj";1513;1116;158;1274;NA;264803;1671;2022-03-03;235619
2022-03-02;"Trnavský kraj";1330;1484;189;1673;NA;264803;1519;2022-03-02;233948
2022-03-01;"Trnavský kraj";1527;1321;191;1512;NA;264803;1718;2022-03-01;232429
2022-02-28;"Trnavský kraj";1318;2104;264;2368;NA;264803;1582;2022-02-28;230711
2022-02-27;"Trnavský kraj";386;640;106;746;NA;264803;492;2022-02-27;229129
2022-02-26;"Trnavský kraj";1268;526;112;638;NA;264803;1380;2022-02-26;228637
2022-02-25;"Trnavský kraj";1439;1490;211;1701;NA;264803;1650;2022-02-25;227257
2022-02-24;"Trnavský kraj";1397;1419;183;1602;NA;264803;1580;2022-02-24;225607
2022-02-23;"Trnavský kraj";2032;1668;238;1906;NA;264803;2270;2022-02-23;224027
2022-02-22;"Trnavský kraj";2171;1891;271;2162;NA;264803;2442;2022-02-22;221757
2022-02-21;"Trnavský kraj";1983;2849;438;3287;NA;264803;2421;2022-02-21;219315
2022-02-20;"Trnavský kraj";888;829;186;1015;NA;264803;1074;2022-02-20;216894
2022-02-19;"Trnavský kraj";1838;707;149;856;NA;264803;1987;2022-02-19;215820
2022-02-18;"Trnavský kraj";2132;1723;269;1992;NA;264803;2401;2022-02-18;213833
2022-02-17;"Trnavský kraj";1987;1763;269;2032;NA;264803;2256;2022-02-17;211432
2022-02-16;"Trnavský kraj";2047;1809;317;2126;NA;264803;2364;2022-02-16;209176
2022-02-15;"Trnavský kraj";2228;2412;400;2812;NA;264803;2628;2022-02-15;206812
2022-02-14;"Trnavský kraj";2216;3424;492;3916;NA;264803;2708;2022-02-14;204184
2022-02-13;"Trnavský kraj";805;1129;247;1376;NA;264803;1052;2022-02-13;201476
2022-02-12;"Trnavský kraj";2081;966;175;1141;NA;264803;2256;2022-02-12;200424
2022-02-11;"Trnavský kraj";1665;2158;266;2424;NA;264803;1931;2022-02-11;198168
2022-02-10;"Trnavský kraj";2491;1942;256;2198;NA;264803;2747;2022-02-10;196237
2022-02-09;"Trnavský kraj";2205;2474;365;2839;NA;264803;2570;2022-02-09;193490
2022-02-08;"Trnavský kraj";1758;2352;353;2705;NA;264803;2111;2022-02-08;190920
2022-02-07;"Trnavský kraj";2581;3356;459;3815;NA;264803;3040;2022-02-07;188809
2022-02-06;"Trnavský kraj";1194;1309;276;1585;NA;264803;1470;2022-02-06;185769
2022-02-05;"Trnavský kraj";2165;1102;187;1289;NA;264803;2352;2022-02-05;184299
2022-02-04;"Trnavský kraj";2191;2179;253;2432;NA;264803;2444;2022-02-04;181947
2022-02-03;"Trnavský kraj";2124;3295;347;3642;NA;264803;2471;2022-02-03;179503
2022-02-02;"Trnavský kraj";1812;2684;281;2965;NA;264803;2093;2022-02-02;177032
2022-02-01;"Trnavský kraj";2344;2656;318;2974;NA;264803;2662;2022-02-01;174939
2022-01-31;"Trnavský kraj";1931;5001;489;5490;NA;264803;2420;2022-01-31;172277
2022-01-30;"Trnavský kraj";709;1672;176;1848;NA;264803;885;2022-01-30;169857
2022-01-29;"Trnavský kraj";2136;1174;159;1333;NA;264803;2295;2022-01-29;168972
2022-01-28;"Trnavský kraj";1734;2340;216;2556;NA;264803;1950;2022-01-28;166677
2022-01-27;"Trnavský kraj";1989;2333;246;2579;NA;264803;2235;2022-01-27;164727
2022-01-26;"Trnavský kraj";1906;2730;217;2947;NA;264803;2123;2022-01-26;162492
2022-01-25;"Trnavský kraj";1631;2422;195;2617;NA;264803;1826;2022-01-25;160369
2022-01-24;"Trnavský kraj";999;4194;236;4430;NA;264803;1235;2022-01-24;158543
2022-01-23;"Trnavský kraj";299;1897;105;2002;NA;264803;404;2022-01-23;157308
2022-01-22;"Trnavský kraj";1169;1197;81;1278;NA;264803;1250;2022-01-22;156904
2022-01-21;"Trnavský kraj";830;2134;104;2238;NA;264803;934;2022-01-21;155654
2022-01-20;"Trnavský kraj";917;2511;100;2611;NA;264803;1017;2022-01-20;154720
2022-01-19;"Trnavský kraj";832;2122;84;2206;NA;264803;916;2022-01-19;153703
2022-01-18;"Trnavský kraj";704;2051;74;2125;NA;264803;778;2022-01-18;152787
2022-01-17;"Trnavský kraj";366;3885;87;3972;NA;264803;453;2022-01-17;152009
2022-01-16;"Trnavský kraj";84;1696;44;1740;NA;264803;128;2022-01-16;151556
2022-01-15;"Trnavský kraj";421;1015;33;1048;NA;264803;454;2022-01-15;151428
2022-01-14;"Trnavský kraj";349;2040;50;2090;NA;264803;399;2022-01-14;150974
2022-01-13;"Trnavský kraj";234;2057;52;2109;NA;264803;286;2022-01-13;150575
2022-01-12;"Trnavský kraj";400;1927;35;1962;NA;264803;435;2022-01-12;150289
2022-01-11;"Trnavský kraj";384;2261;33;2294;NA;264803;417;2022-01-11;149854
2022-01-10;"Trnavský kraj";258;4357;71;4428;NA;264803;329;2022-01-10;149437
2022-01-09;"Trnavský kraj";35;1921;22;1943;NA;264803;57;2022-01-09;149108
2022-01-08;"Trnavský kraj";364;1005;29;1034;NA;264803;393;2022-01-08;149051
2022-01-07;"Trnavský kraj";332;1984;47;2031;NA;264803;379;2022-01-07;148658
2022-01-06;"Trnavský kraj";234;830;20;850;NA;264803;254;2022-01-06;148279
2022-01-05;"Trnavský kraj";416;1925;37;1962;NA;264803;453;2022-01-05;148025
2022-01-04;"Trnavský kraj";538;2337;37;2374;NA;264803;575;2022-01-04;147572
2022-01-03;"Trnavský kraj";441;3897;65;3962;NA;264803;506;2022-01-03;146997
2022-01-02;"Trnavský kraj";79;1561;21;1582;NA;264803;100;2022-01-02;146491
2022-01-01;"Trnavský kraj";4;190;7;197;NA;264803;11;2022-01-01;146391
2021-12-31;"Trnavský kraj";485;1246;60;1306;NA;264803;545;2021-12-31;146380
2021-12-30;"Trnavský kraj";401;1927;58;1985;NA;264803;459;2021-12-30;145835
2021-12-29;"Trnavský kraj";401;1756;70;1826;NA;264803;471;2021-12-29;145376
2021-12-28;"Trnavský kraj";633;1742;73;1815;NA;264803;706;2021-12-28;144905
2021-12-27;"Trnavský kraj";463;2814;134;2948;NA;264803;597;2021-12-27;144199
2021-12-26;"Trnavský kraj";253;1019;30;1049;NA;264803;283;2021-12-26;143602
2021-12-25;"Trnavský kraj";104;341;41;382;NA;264803;145;2021-12-25;143319
2021-12-24;"Trnavský kraj";216;369;27;396;NA;264803;243;2021-12-24;143174
2021-12-23;"Trnavský kraj";570;1825;102;1927;NA;264803;672;2021-12-23;142931
2021-12-22;"Trnavský kraj";545;1732;81;1813;NA;264803;626;2021-12-22;142259
2021-12-21;"Trnavský kraj";699;2577;89;2666;NA;264803;788;2021-12-21;141633
2021-12-20;"Trnavský kraj";438;3941;103;4044;NA;264803;541;2021-12-20;140845
2021-12-19;"Trnavský kraj";155;1762;63;1825;NA;264803;218;2021-12-19;140304
2021-12-18;"Trnavský kraj";627;1302;77;1379;NA;264803;704;2021-12-18;140086
2021-12-17;"Trnavský kraj";576;2276;109;2385;NA;264803;685;2021-12-17;139382
2021-12-16;"Trnavský kraj";653;2530;123;2653;NA;264803;776;2021-12-16;138697
2021-12-15;"Trnavský kraj";746;2198;120;2318;NA;264803;866;2021-12-15;137921
2021-12-14;"Trnavský kraj";976;2718;134;2852;NA;264803;1110;2021-12-14;137055
2021-12-13;"Trnavský kraj";521;4857;175;5032;NA;264803;696;2021-12-13;135945
2021-12-12;"Trnavský kraj";337;2117;87;2204;NA;264803;424;2021-12-12;135249
2021-12-11;"Trnavský kraj";720;1324;83;1407;NA;264803;803;2021-12-11;134825
2021-12-10;"Trnavský kraj";702;2909;136;3045;NA;264803;838;2021-12-10;134022
2021-12-09;"Trnavský kraj";926;2313;96;2409;NA;264803;1022;2021-12-09;133184
2021-12-08;"Trnavský kraj";1233;2547;137;2684;NA;264803;1370;2021-12-08;132162
2021-12-07;"Trnavský kraj";1159;3637;174;3811;NA;264803;1333;2021-12-07;130792
2021-12-06;"Trnavský kraj";911;3649;208;3857;NA;264803;1119;2021-12-06;129459
2021-12-05;"Trnavský kraj";269;2303;106;2409;NA;264803;375;2021-12-05;128340
2021-12-04;"Trnavský kraj";1225;1623;115;1738;NA;264803;1340;2021-12-04;127965
2021-12-03;"Trnavský kraj";1246;2998;201;3199;NA;264803;1447;2021-12-03;126625
2021-12-02;"Trnavský kraj";1809;2379;188;2567;NA;264803;1997;2021-12-02;125178
2021-12-01;"Trnavský kraj";738;3011;179;3190;NA;264803;917;2021-12-01;123181
2021-11-30;"Trnavský kraj";1166;4217;202;4419;NA;264803;1368;2021-11-30;122264
2021-11-29;"Trnavský kraj";814;5360;299;5659;NA;264803;1113;2021-11-29;120896
2021-11-28;"Trnavský kraj";482;3087;146;3233;NA;264803;628;2021-11-28;119783
2021-11-27;"Trnavský kraj";1186;2240;206;2446;NA;264803;1392;2021-11-27;119155
2021-11-26;"Trnavský kraj";880;2895;202;3097;NA;264803;1082;2021-11-26;117763
2021-11-25;"Trnavský kraj";1002;2680;158;2838;NA;264803;1160;2021-11-25;116681
2021-11-24;"Trnavský kraj";1060;3442;250;3692;NA;264803;1310;2021-11-24;115521
2021-11-23;"Trnavský kraj";1078;3714;273;3987;NA;264803;1351;2021-11-23;114211
2021-11-22;"Trnavský kraj";696;4028;295;4323;NA;264803;991;2021-11-22;112860
2021-11-21;"Trnavský kraj";298;2270;212;2482;NA;264803;510;2021-11-21;111869
2021-11-20;"Trnavský kraj";826;1529;196;1725;NA;264803;1022;2021-11-20;111359
2021-11-19;"Trnavský kraj";901;3369;315;3684;NA;264803;1216;2021-11-19;110337
2021-11-18;"Trnavský kraj";796;2872;240;3112;NA;264803;1036;2021-11-18;109121
2021-11-17;"Trnavský kraj";769;1201;139;1340;NA;264803;908;2021-11-17;108085
2021-11-16;"Trnavský kraj";591;2755;206;2961;NA;264803;797;2021-11-16;107177
2021-11-15;"Trnavský kraj";606;3350;239;3589;NA;264803;845;2021-11-15;106380
2021-11-14;"Trnavský kraj";236;1579;141;1720;NA;264803;377;2021-11-14;105535
2021-11-13;"Trnavský kraj";815;1314;132;1446;NA;264803;947;2021-11-13;105158
2021-11-12;"Trnavský kraj";563;2585;157;2742;NA;264803;720;2021-11-12;104211
2021-11-11;"Trnavský kraj";512;2426;161;2587;NA;264803;673;2021-11-11;103491
2021-11-10;"Trnavský kraj";590;2315;173;2488;NA;264803;763;2021-11-10;102818
2021-11-09;"Trnavský kraj";585;2538;187;2725;NA;264803;772;2021-11-09;102055
2021-11-08;"Trnavský kraj";357;2715;163;2878;NA;264803;520;2021-11-08;101283
2021-11-07;"Trnavský kraj";162;1349;111;1460;NA;264803;273;2021-11-07;100763
2021-11-06;"Trnavský kraj";391;1287;82;1369;NA;264803;473;2021-11-06;100490
2021-11-05;"Trnavský kraj";447;2202;102;2304;NA;264803;549;2021-11-05;100017
2021-11-04;"Trnavský kraj";432;2289;112;2401;NA;264803;544;2021-11-04;99468
2021-11-03;"Trnavský kraj";420;2091;97;2188;NA;264803;517;2021-11-03;98924
2021-11-02;"Trnavský kraj";365;2777;124;2901;NA;264803;489;2021-11-02;98407
2021-11-01;"Trnavský kraj";220;583;27;610;NA;264803;247;2021-11-01;97918
2021-10-31;"Trnavský kraj";61;887;62;949;NA;264803;123;2021-10-31;97671
2021-10-30;"Trnavský kraj";251;1099;50;1149;NA;264803;301;2021-10-30;97548
2021-10-29;"Trnavský kraj";312;2123;53;2176;NA;264803;365;2021-10-29;97247
2021-10-28;"Trnavský kraj";339;2034;65;2099;NA;264803;404;2021-10-28;96882
2021-10-27;"Trnavský kraj";232;1884;58;1942;NA;264803;290;2021-10-27;96478
2021-10-26;"Trnavský kraj";366;1964;54;2018;NA;264803;420;2021-10-26;96188
2021-10-25;"Trnavský kraj";142;2786;72;2858;NA;264803;214;2021-10-25;95768
2021-10-24;"Trnavský kraj";11;990;30;1020;NA;264803;41;2021-10-24;95554
2021-10-23;"Trnavský kraj";228;1126;27;1153;NA;264803;255;2021-10-23;95513
2021-10-22;"Trnavský kraj";204;2269;51;2320;NA;264803;255;2021-10-22;95258
2021-10-21;"Trnavský kraj";188;1671;46;1717;NA;264803;234;2021-10-21;95003
2021-10-20;"Trnavský kraj";212;1634;47;1681;NA;264803;259;2021-10-20;94769
2021-10-19;"Trnavský kraj";240;1848;30;1878;NA;264803;270;2021-10-19;94510
2021-10-18;"Trnavský kraj";95;2316;72;2388;NA;264803;167;2021-10-18;94240
2021-10-17;"Trnavský kraj";5;1218;17;1235;NA;264803;22;2021-10-17;94073
2021-10-16;"Trnavský kraj";129;1233;17;1250;NA;264803;146;2021-10-16;94051
2021-10-15;"Trnavský kraj";122;2121;24;2145;NA;264803;146;2021-10-15;93905
2021-10-14;"Trnavský kraj";131;1663;24;1687;NA;264803;155;2021-10-14;93759
2021-10-13;"Trnavský kraj";128;2072;23;2095;NA;264803;151;2021-10-13;93604
2021-10-12;"Trnavský kraj";189;2788;38;2826;NA;264803;227;2021-10-12;93453
2021-10-11;"Trnavský kraj";115;2621;35;2656;NA;264803;150;2021-10-11;93226
2021-10-10;"Trnavský kraj";2;993;15;1008;NA;264803;17;2021-10-10;93076
2021-10-09;"Trnavský kraj";151;1099;10;1109;NA;264803;161;2021-10-09;93059
2021-10-08;"Trnavský kraj";106;2326;34;2360;NA;264803;140;2021-10-08;92898
2021-10-07;"Trnavský kraj";151;1744;25;1769;NA;264803;176;2021-10-07;92758
2021-10-06;"Trnavský kraj";122;1929;27;1956;NA;264803;149;2021-10-06;92582
2021-10-05;"Trnavský kraj";220;3726;34;3760;NA;264803;254;2021-10-05;92433
2021-10-04;"Trnavský kraj";54;1963;47;2010;NA;264803;101;2021-10-04;92179
2021-10-03;"Trnavský kraj";1;1106;17;1123;NA;264803;18;2021-10-03;92078
2021-10-02;"Trnavský kraj";52;1055;12;1067;NA;264803;64;2021-10-02;92060
2021-10-01;"Trnavský kraj";113;2243;17;2260;NA;264803;130;2021-10-01;91996
2021-09-30;"Trnavský kraj";109;1872;18;1890;NA;264803;127;2021-09-30;91866
2021-09-29;"Trnavský kraj";83;1331;11;1342;NA;264803;94;2021-09-29;91739
2021-09-28;"Trnavský kraj";135;1934;31;1965;NA;264803;166;2021-09-28;91645
2021-09-27;"Trnavský kraj";80;2084;25;2109;NA;264803;105;2021-09-27;91479
2021-09-26;"Trnavský kraj";2;1048;12;1060;NA;264803;14;2021-09-26;91374
2021-09-25;"Trnavský kraj";61;1105;9;1114;NA;264803;70;2021-09-25;91360
2021-09-24;"Trnavský kraj";41;2229;15;2244;NA;264803;56;2021-09-24;91290
2021-09-23;"Trnavský kraj";89;1691;16;1707;NA;264803;105;2021-09-23;91234
2021-09-22;"Trnavský kraj";119;1706;28;1734;NA;264803;147;2021-09-22;91129
2021-09-21;"Trnavský kraj";108;1505;17;1522;NA;264803;125;2021-09-21;90982
2021-09-20;"Trnavský kraj";50;1652;20;1672;NA;264803;70;2021-09-20;90857
2021-09-19;"Trnavský kraj";2;924;8;932;NA;264803;10;2021-09-19;90787
2021-09-18;"Trnavský kraj";100;982;6;988;NA;264803;106;2021-09-18;90777
2021-09-17;"Trnavský kraj";77;1709;20;1729;NA;264803;97;2021-09-17;90671
2021-09-16;"Trnavský kraj";105;1279;32;1311;NA;264803;137;2021-09-16;90574
2021-09-15;"Trnavský kraj";59;841;5;846;NA;264803;64;2021-09-15;90437
2021-09-14;"Trnavský kraj";38;1583;12;1595;NA;264803;50;2021-09-14;90373
2021-09-13;"Trnavský kraj";56;1410;16;1426;NA;264803;72;2021-09-13;90323
2021-09-12;"Trnavský kraj";0;653;1;654;NA;264803;1;2021-09-12;90251
2021-09-11;"Trnavský kraj";37;971;10;981;NA;264803;47;2021-09-11;90250
2021-09-10;"Trnavský kraj";43;1441;9;1450;NA;264803;52;2021-09-10;90203
2021-09-09;"Trnavský kraj";42;954;13;967;NA;264803;55;2021-09-09;90151
2021-09-08;"Trnavský kraj";65;802;15;817;NA;264803;80;2021-09-08;90096
2021-09-07;"Trnavský kraj";29;844;5;849;NA;264803;34;2021-09-07;90016
2021-09-06;"Trnavský kraj";18;1234;14;1248;NA;264803;32;2021-09-06;89982
2021-09-05;"Trnavský kraj";2;580;4;584;NA;264803;6;2021-09-05;89950
2021-09-04;"Trnavský kraj";17;868;6;874;NA;264803;23;2021-09-04;89944
2021-09-03;"Trnavský kraj";14;1060;5;1065;NA;264803;19;2021-09-03;89921
2021-09-02;"Trnavský kraj";30;830;10;840;NA;264803;40;2021-09-02;89902
2021-09-01;"Trnavský kraj";6;409;4;413;NA;264803;10;2021-09-01;89862
2021-08-31;"Trnavský kraj";13;884;3;887;NA;264803;16;2021-08-31;89852
2021-08-30;"Trnavský kraj";7;904;1;905;NA;264803;8;2021-08-30;89836
2021-08-29;"Trnavský kraj";8;427;1;428;NA;264803;9;2021-08-29;89828
2021-08-28;"Trnavský kraj";17;694;2;696;NA;264803;19;2021-08-28;89819
2021-08-27;"Trnavský kraj";1;1186;4;1190;NA;264803;5;2021-08-27;89800
2021-08-26;"Trnavský kraj";8;713;3;716;NA;264803;11;2021-08-26;89795
2021-08-25;"Trnavský kraj";11;683;6;689;NA;264803;17;2021-08-25;89784
2021-08-24;"Trnavský kraj";7;801;1;802;NA;264803;8;2021-08-24;89767
2021-08-23;"Trnavský kraj";4;844;1;845;NA;264803;5;2021-08-23;89759
2021-08-22;"Trnavský kraj";0;474;0;474;NA;264803;0;2021-08-22;89754
2021-08-21;"Trnavský kraj";8;703;0;703;NA;264803;8;2021-08-21;89754
2021-08-20;"Trnavský kraj";4;1095;4;1099;NA;264803;8;2021-08-20;89746
2021-08-19;"Trnavský kraj";10;881;3;884;NA;264803;13;2021-08-19;89738
2021-08-18;"Trnavský kraj";6;789;2;791;NA;264803;8;2021-08-18;89725
2021-08-17;"Trnavský kraj";7;524;4;528;NA;264803;11;2021-08-17;89717
2021-08-16;"Trnavský kraj";9;966;3;969;NA;264803;12;2021-08-16;89706
2021-08-15;"Trnavský kraj";0;556;1;557;NA;264803;1;2021-08-15;89694
2021-08-14;"Trnavský kraj";10;801;3;804;NA;264803;13;2021-08-14;89693
2021-08-13;"Trnavský kraj";5;1077;6;1083;NA;264803;11;2021-08-13;89680
2021-08-12;"Trnavský kraj";3;666;3;669;NA;264803;6;2021-08-12;89669
2021-08-11;"Trnavský kraj";7;576;2;578;NA;264803;9;2021-08-11;89663
2021-08-10;"Trnavský kraj";3;757;3;760;NA;264803;6;2021-08-10;89654
2021-08-09;"Trnavský kraj";12;808;0;808;NA;264803;12;2021-08-09;89648
2021-08-08;"Trnavský kraj";1;545;0;545;NA;264803;1;2021-08-08;89636
2021-08-07;"Trnavský kraj";9;724;0;724;NA;264803;9;2021-08-07;89635
2021-08-06;"Trnavský kraj";3;988;0;988;NA;264803;3;2021-08-06;89626
2021-08-05;"Trnavský kraj";2;662;1;663;NA;264803;3;2021-08-05;89623
2021-08-04;"Trnavský kraj";1;891;1;892;NA;264803;2;2021-08-04;89620
2021-08-03;"Trnavský kraj";13;645;0;645;NA;264803;13;2021-08-03;89618
2021-08-02;"Trnavský kraj";2;725;1;726;NA;264803;3;2021-08-02;89605
2021-08-01;"Trnavský kraj";0;565;2;567;NA;264803;2;2021-08-01;89602
2021-07-31;"Trnavský kraj";3;886;0;886;NA;264803;3;2021-07-31;89600
2021-07-30;"Trnavský kraj";3;1084;3;1087;NA;264803;6;2021-07-30;89597
2021-07-29;"Trnavský kraj";1;775;0;775;NA;264803;1;2021-07-29;89591
2021-07-28;"Trnavský kraj";5;794;1;795;NA;264803;6;2021-07-28;89590
2021-07-27;"Trnavský kraj";7;623;2;625;NA;264803;9;2021-07-27;89584
2021-07-26;"Trnavský kraj";2;857;2;859;NA;264803;4;2021-07-26;89575
2021-07-25;"Trnavský kraj";0;707;0;707;NA;264803;0;2021-07-25;89571
2021-07-24;"Trnavský kraj";4;828;2;830;NA;264803;6;2021-07-24;89571
2021-07-23;"Trnavský kraj";3;1057;0;1057;NA;264803;3;2021-07-23;89565
2021-07-22;"Trnavský kraj";0;671;2;673;NA;264803;2;2021-07-22;89562
2021-07-21;"Trnavský kraj";2;660;2;662;NA;264803;4;2021-07-21;89560
2021-07-20;"Trnavský kraj";2;593;0;593;NA;264803;2;2021-07-20;89556
2021-07-19;"Trnavský kraj";9;886;0;886;NA;264803;9;2021-07-19;89554
2021-07-18;"Trnavský kraj";0;600;2;602;NA;264803;2;2021-07-18;89545
2021-07-17;"Trnavský kraj";8;796;0;796;NA;264803;8;2021-07-17;89543
2021-07-16;"Trnavský kraj";11;963;0;963;NA;264803;11;2021-07-16;89535
2021-07-15;"Trnavský kraj";4;832;1;833;NA;264803;5;2021-07-15;89524
2021-07-14;"Trnavský kraj";1;699;1;700;NA;264803;2;2021-07-14;89519
2021-07-13;"Trnavský kraj";1;693;1;694;NA;264803;2;2021-07-13;89517
2021-07-12;"Trnavský kraj";4;959;0;959;NA;264803;4;2021-07-12;89515
2021-07-11;"Trnavský kraj";0;692;0;692;NA;264803;0;2021-07-11;89511
2021-07-10;"Trnavský kraj";1;803;0;803;NA;264803;1;2021-07-10;89511
2021-07-09;"Trnavský kraj";3;1262;3;1265;NA;264803;6;2021-07-09;89510
2021-07-08;"Trnavský kraj";4;755;0;755;NA;264803;4;2021-07-08;89504
2021-07-07;"Trnavský kraj";9;924;2;926;NA;264803;11;2021-07-07;89500
2021-07-06;"Trnavský kraj";2;1401;1;1402;NA;264803;3;2021-07-06;89489
2021-07-05;"Trnavský kraj";1;503;2;505;NA;264803;3;2021-07-05;89486
2021-07-04;"Trnavský kraj";0;1129;3;1132;NA;264803;3;2021-07-04;89483
2021-07-03;"Trnavský kraj";4;815;0;815;NA;264803;4;2021-07-03;89480
2021-07-02;"Trnavský kraj";2;1137;2;1139;NA;264803;4;2021-07-02;89476
2021-07-01;"Trnavský kraj";4;487;0;487;NA;264803;4;2021-07-01;89472
2021-06-30;"Trnavský kraj";0;5135;1;5136;NA;264803;1;2021-06-30;89468
2021-06-29;"Trnavský kraj";4;2563;1;2564;NA;264803;5;2021-06-29;89467
2021-06-28;"Trnavský kraj";2;2600;1;2601;NA;264803;3;2021-06-28;89462
2021-06-27;"Trnavský kraj";0;3213;0;3213;NA;264803;0;2021-06-27;89459
2021-06-26;"Trnavský kraj";3;3871;1;3872;NA;264803;4;2021-06-26;89459
2021-06-25;"Trnavský kraj";2;4374;3;4377;NA;264803;5;2021-06-25;89455
2021-06-24;"Trnavský kraj";4;2520;3;2523;NA;264803;7;2021-06-24;89450
2021-06-23;"Trnavský kraj";4;2842;2;2844;NA;264803;6;2021-06-23;89443
2021-06-22;"Trnavský kraj";2;2996;1;2997;NA;264803;3;2021-06-22;89437
2021-06-21;"Trnavský kraj";6;3114;5;3119;NA;264803;11;2021-06-21;89434
2021-06-20;"Trnavský kraj";0;3952;1;3953;NA;264803;1;2021-06-20;89423
2021-06-19;"Trnavský kraj";3;4735;2;4737;NA;264803;5;2021-06-19;89422
2021-06-18;"Trnavský kraj";5;6125;4;6129;NA;264803;9;2021-06-18;89417
2021-06-17;"Trnavský kraj";3;3340;0;3340;NA;264803;3;2021-06-17;89408
2021-06-16;"Trnavský kraj";6;2926;3;2929;NA;264803;9;2021-06-16;89405
2021-06-15;"Trnavský kraj";8;3234;3;3237;NA;264803;11;2021-06-15;89396
2021-06-14;"Trnavský kraj";2;3829;1;3830;NA;264803;3;2021-06-14;89385
2021-06-13;"Trnavský kraj";0;5001;8;5009;NA;264803;8;2021-06-13;89382
2021-06-12;"Trnavský kraj";11;5807;2;5809;NA;264803;13;2021-06-12;89374
2021-06-11;"Trnavský kraj";17;5850;4;5854;NA;264803;21;2021-06-11;89361
2021-06-10;"Trnavský kraj";14;3476;1;3477;NA;264803;15;2021-06-10;89340
2021-06-09;"Trnavský kraj";10;3685;1;3686;NA;264803;11;2021-06-09;89325
2021-06-08;"Trnavský kraj";8;3344;4;3348;NA;264803;12;2021-06-08;89314
2021-06-07;"Trnavský kraj";12;4498;8;4506;NA;264803;20;2021-06-07;89302
2021-06-06;"Trnavský kraj";0;5517;2;5519;NA;264803;2;2021-06-06;89282
2021-06-05;"Trnavský kraj";20;6905;8;6913;NA;264803;28;2021-06-05;89280
2021-06-04;"Trnavský kraj";9;6735;10;6745;NA;264803;19;2021-06-04;89252
2021-06-03;"Trnavský kraj";14;4361;11;4372;NA;264803;25;2021-06-03;89233
2021-06-02;"Trnavský kraj";4;4148;11;4159;NA;264803;15;2021-06-02;89208
2021-06-01;"Trnavský kraj";18;3662;5;3667;NA;264803;23;2021-06-01;89193
2021-05-31;"Trnavský kraj";14;5515;16;5531;NA;264803;30;2021-05-31;89170
2021-05-30;"Trnavský kraj";0;6473;7;6480;NA;264803;7;2021-05-30;89140
2021-05-29;"Trnavský kraj";11;8964;4;8968;NA;264803;15;2021-05-29;89133
2021-05-28;"Trnavský kraj";14;7160;11;7171;NA;264803;25;2021-05-28;89118
2021-05-27;"Trnavský kraj";22;4753;8;4761;NA;264803;30;2021-05-27;89093
2021-05-26;"Trnavský kraj";6;4870;8;4878;NA;264803;14;2021-05-26;89063
2021-05-25;"Trnavský kraj";19;5026;27;5053;NA;264803;46;2021-05-25;89049
2021-05-24;"Trnavský kraj";15;6520;22;6542;NA;264803;37;2021-05-24;89003
2021-05-23;"Trnavský kraj";0;7920;8;7928;NA;264803;8;2021-05-23;88966
2021-05-22;"Trnavský kraj";13;13381;21;13402;NA;264803;34;2021-05-22;88958
2021-05-21;"Trnavský kraj";16;8525;19;8544;NA;264803;35;2021-05-21;88924
2021-05-20;"Trnavský kraj";15;5511;11;5522;NA;264803;26;2021-05-20;88889
2021-05-19;"Trnavský kraj";18;5431;13;5444;NA;264803;31;2021-05-19;88863
2021-05-18;"Trnavský kraj";26;5768;15;5783;NA;264803;41;2021-05-18;88832
2021-05-17;"Trnavský kraj";17;6262;24;6286;NA;264803;41;2021-05-17;88791
2021-05-16;"Trnavský kraj";10;9984;8;9992;NA;264803;18;2021-05-16;88750
2021-05-15;"Trnavský kraj";11;18525;14;18539;NA;264803;25;2021-05-15;88732
2021-05-14;"Trnavský kraj";34;10279;21;10300;NA;264803;55;2021-05-14;88707
2021-05-13;"Trnavský kraj";26;6913;12;6925;NA;264803;38;2021-05-13;88652
2021-05-12;"Trnavský kraj";34;6621;26;6647;NA;264803;60;2021-05-12;88614
2021-05-11;"Trnavský kraj";32;6393;13;6406;NA;264803;45;2021-05-11;88554
2021-05-10;"Trnavský kraj";58;9139;24;9163;NA;264803;82;2021-05-10;88509
2021-05-09;"Trnavský kraj";21;12570;12;12582;NA;264803;33;2021-05-09;88427
2021-05-08;"Trnavský kraj";4;23028;22;23050;NA;264803;26;2021-05-08;88394
2021-05-07;"Trnavský kraj";26;15465;30;15495;NA;264803;56;2021-05-07;88368
2021-05-06;"Trnavský kraj";22;8407;22;8429;NA;264803;44;2021-05-06;88312
2021-05-05;"Trnavský kraj";34;6273;22;6295;NA;264803;56;2021-05-05;88268
2021-05-04;"Trnavský kraj";51;8538;17;8555;NA;264803;68;2021-05-04;88212
2021-05-03;"Trnavský kraj";20;8957;22;8979;NA;264803;42;2021-05-03;88144
2021-05-02;"Trnavský kraj";0;25657;29;25686;NA;264803;29;2021-05-02;88102
2021-05-01;"Trnavský kraj";30;81353;64;81417;NA;264803;94;2021-05-01;88073
2021-04-30;"Trnavský kraj";45;26846;35;26881;NA;264803;80;2021-04-30;87979
2021-04-29;"Trnavský kraj";25;20323;28;20351;NA;264803;53;2021-04-29;87899
2021-04-28;"Trnavský kraj";46;8896;28;8924;NA;264803;74;2021-04-28;87846
2021-04-27;"Trnavský kraj";54;8756;37;8793;NA;264803;91;2021-04-27;87772
2021-04-26;"Trnavský kraj";53;16116;42;16158;NA;264803;95;2021-04-26;87681
2021-04-25;"Trnavský kraj";0;30183;24;30207;NA;264803;24;2021-04-25;87586
2021-04-24;"Trnavský kraj";46;126077;84;126161;NA;264803;130;2021-04-24;87562
2021-04-23;"Trnavský kraj";71;25741;53;25794;NA;264803;124;2021-04-23;87432
2021-04-22;"Trnavský kraj";40;10904;25;10929;NA;264803;65;2021-04-22;87308
2021-04-21;"Trnavský kraj";60;10748;45;10793;NA;264803;105;2021-04-21;87243
2021-04-20;"Trnavský kraj";57;13504;28;13532;NA;264803;85;2021-04-20;87138
2021-04-19;"Trnavský kraj";46;14603;18;14621;NA;264803;64;2021-04-19;87053
2021-04-18;"Trnavský kraj";7;40843;43;40886;NA;264803;50;2021-04-18;86989
2021-04-17;"Trnavský kraj";58;118102;89;118191;NA;264803;147;2021-04-17;86939
2021-04-16;"Trnavský kraj";67;25962;48;26010;NA;264803;115;2021-04-16;86792
2021-04-15;"Trnavský kraj";65;11373;36;11409;NA;264803;101;2021-04-15;86677
2021-04-14;"Trnavský kraj";78;18442;53;18495;NA;264803;131;2021-04-14;86576
2021-04-13;"Trnavský kraj";126;9871;44;9915;NA;264803;170;2021-04-13;86445
2021-04-12;"Trnavský kraj";40;15577;40;15617;NA;264803;80;2021-04-12;86275
2021-04-11;"Trnavský kraj";3;44420;44;44464;NA;264803;47;2021-04-11;86195
2021-04-10;"Trnavský kraj";60;123822;107;123929;NA;264803;167;2021-04-10;86148
2021-04-09;"Trnavský kraj";95;26191;34;26225;NA;264803;129;2021-04-09;85981
2021-04-08;"Trnavský kraj";85;10913;54;10967;NA;264803;139;2021-04-08;85852
2021-04-07;"Trnavský kraj";131;15979;81;16060;NA;264803;212;2021-04-07;85713
2021-04-06;"Trnavský kraj";92;20586;90;20676;NA;264803;182;2021-04-06;85501
2021-04-05;"Trnavský kraj";91;7542;17;7559;NA;264803;108;2021-04-05;85319
2021-04-04;"Trnavský kraj";9;28831;49;28880;NA;264803;58;2021-04-04;85211
2021-04-03;"Trnavský kraj";29;144452;186;144638;NA;264803;215;2021-04-03;85153
2021-04-02;"Trnavský kraj";91;17538;33;17571;NA;264803;124;2021-04-02;84938
2021-04-01;"Trnavský kraj";118;22279;71;22350;NA;264803;189;2021-04-01;84814
2021-03-31;"Trnavský kraj";140;15828;82;15910;NA;264803;222;2021-03-31;84625
2021-03-30;"Trnavský kraj";182;10482;79;10561;NA;264803;261;2021-03-30;84403
2021-03-29;"Trnavský kraj";126;19255;122;19377;NA;264803;248;2021-03-29;84142
2021-03-28;"Trnavský kraj";26;50664;134;50798;NA;264803;160;2021-03-28;83894
2021-03-27;"Trnavský kraj";64;130217;246;130463;NA;264803;310;2021-03-27;83734
2021-03-26;"Trnavský kraj";139;30217;130;30347;NA;264803;269;2021-03-26;83424
2021-03-25;"Trnavský kraj";135;14212;80;14292;NA;264803;215;2021-03-25;83155
2021-03-24;"Trnavský kraj";159;10521;89;10610;NA;264803;248;2021-03-24;82940
2021-03-23;"Trnavský kraj";221;12735;104;12839;NA;264803;325;2021-03-23;82692
2021-03-22;"Trnavský kraj";103;17118;110;17228;NA;264803;213;2021-03-22;82367
2021-03-21;"Trnavský kraj";31;49119;150;49269;NA;264803;181;2021-03-21;82154
2021-03-20;"Trnavský kraj";112;136963;317;137280;NA;264803;429;2021-03-20;81973
2021-03-19;"Trnavský kraj";174;29071;137;29208;NA;264803;311;2021-03-19;81544
2021-03-18;"Trnavský kraj";158;12217;136;12353;NA;264803;294;2021-03-18;81233
2021-03-17;"Trnavský kraj";245;10434;103;10537;NA;264803;348;2021-03-17;80939
2021-03-16;"Trnavský kraj";311;12811;135;12946;NA;264803;446;2021-03-16;80591
2021-03-15;"Trnavský kraj";127;18271;146;18417;NA;264803;273;2021-03-15;80145
2021-03-14;"Trnavský kraj";14;47608;164;47772;NA;264803;178;2021-03-14;79872
2021-03-13;"Trnavský kraj";155;139224;409;139633;NA;264803;564;2021-03-13;79694
2021-03-12;"Trnavský kraj";201;28566;181;28747;NA;264803;382;2021-03-12;79130
2021-03-11;"Trnavský kraj";204;13301;140;13441;NA;264803;344;2021-03-11;78748
2021-03-10;"Trnavský kraj";242;10583;135;10718;NA;264803;377;2021-03-10;78404
2021-03-09;"Trnavský kraj";442;12824;155;12979;NA;264803;597;2021-03-09;78027
2021-03-08;"Trnavský kraj";182;21812;166;21978;NA;264803;348;2021-03-08;77430
2021-03-07;"Trnavský kraj";30;45463;227;45690;NA;264803;257;2021-03-07;77082
2021-03-06;"Trnavský kraj";154;135784;531;136315;NA;264803;685;2021-03-06;76825
2021-03-05;"Trnavský kraj";299;27959;239;28198;NA;264803;538;2021-03-05;76140
2021-03-04;"Trnavský kraj";238;14505;176;14681;NA;264803;414;2021-03-04;75602
2021-03-03;"Trnavský kraj";413;11583;246;11829;NA;264803;659;2021-03-03;75188
2021-03-02;"Trnavský kraj";477;12367;191;12558;NA;264803;668;2021-03-02;74529
2021-03-01;"Trnavský kraj";189;18586;234;18820;NA;264803;423;2021-03-01;73861
2021-02-28;"Trnavský kraj";87;47709;321;48030;NA;264803;408;2021-02-28;73438
2021-02-27;"Trnavský kraj";264;140224;800;141024;NA;264803;1064;2021-02-27;73030
2021-02-26;"Trnavský kraj";362;26637;284;26921;NA;264803;646;2021-02-26;71966
2021-02-25;"Trnavský kraj";433;10490;227;10717;NA;264803;660;2021-02-25;71320
2021-02-24;"Trnavský kraj";407;9113;290;9403;NA;264803;697;2021-02-24;70660
2021-02-23;"Trnavský kraj";469;11322;284;11606;NA;264803;753;2021-02-23;69963
2021-02-22;"Trnavský kraj";206;19901;330;20231;NA;264803;536;2021-02-22;69210
2021-02-21;"Trnavský kraj";38;48221;329;48550;NA;264803;367;2021-02-21;68674
2021-02-20;"Trnavský kraj";273;135835;859;136694;NA;264803;1132;2021-02-20;68307
2021-02-19;"Trnavský kraj";335;26382;366;26748;NA;264803;701;2021-02-19;67175
2021-02-18;"Trnavský kraj";344;11264;348;11612;NA;264803;692;2021-02-18;66474
2021-02-17;"Trnavský kraj";431;8783;416;9199;NA;264803;847;2021-02-17;65782
2021-02-16;"Trnavský kraj";426;11236;294;11530;NA;264803;720;2021-02-16;64935
2021-02-15;"Trnavský kraj";146;18276;326;18602;NA;264803;472;2021-02-15;64215
2021-02-14;"Trnavský kraj";51;57642;495;58137;NA;264803;546;2021-02-14;63743
2021-02-13;"Trnavský kraj";218;137051;994;138045;NA;264803;1212;2021-02-13;63197
2021-02-12;"Trnavský kraj";300;24090;352;24442;NA;264803;652;2021-02-12;61985
2021-02-11;"Trnavský kraj";422;9831;349;10180;NA;264803;771;2021-02-11;61333
2021-02-10;"Trnavský kraj";511;9194;342;9536;NA;264803;853;2021-02-10;60562
2021-02-09;"Trnavský kraj";544;12755;369;13124;NA;264803;913;2021-02-09;59709
2021-02-08;"Trnavský kraj";220;33414;497;33911;NA;264803;717;2021-02-08;58796
2021-02-07;"Trnavský kraj";140;69694;628;70322;NA;264803;768;2021-02-07;58079
2021-02-06;"Trnavský kraj";348;112687;1482;114169;NA;264803;1830;2021-02-06;57311
2021-02-05;"Trnavský kraj";377;16063;373;16436;NA;264803;750;2021-02-05;55481
2021-02-04;"Trnavský kraj";456;7317;456;7773;NA;264803;912;2021-02-04;54731
2021-02-03;"Trnavský kraj";472;6583;434;7017;NA;264803;906;2021-02-03;53819
2021-02-02;"Trnavský kraj";446;14243;424;14667;NA;264803;870;2021-02-02;52913
2021-02-01;"Trnavský kraj";198;38882;679;39561;NA;264803;877;2021-02-01;52043
2021-01-31;"Trnavský kraj";19;64707;822;65529;NA;264803;841;2021-01-31;51166
2021-01-30;"Trnavský kraj";323;111483;1288;112771;NA;264803;1611;2021-01-30;50325
2021-01-29;"Trnavský kraj";421;9689;290;9979;NA;264803;711;2021-01-29;48714
2021-01-28;"Trnavský kraj";389;5817;289;6106;NA;264803;678;2021-01-28;48003
2021-01-27;"Trnavský kraj";433;5554;225;5779;NA;264803;658;2021-01-27;47325
2021-01-26;"Trnavský kraj";565;25411;636;26047;NA;264803;1201;2021-01-26;46667
2021-01-25;"Trnavský kraj";210;41805;620;42425;NA;264803;830;2021-01-25;45466
2021-01-24;"Trnavský kraj";91;66399;779;67178;NA;264803;870;2021-01-24;44636
2021-01-23;"Trnavský kraj";372;113375;1319;114694;NA;264803;1691;2021-01-23;43766
2021-01-22;"Trnavský kraj";217;32755;505;33260;NA;264803;722;2021-01-22;42075
2021-01-21;"Trnavský kraj";311;13913;377;14290;NA;264803;688;2021-01-21;41353
2021-01-20;"Trnavský kraj";503;8685;283;8968;NA;264803;786;2021-01-20;40665
2021-01-19;"Trnavský kraj";415;7013;347;7360;NA;264803;762;2021-01-19;39879
2021-01-18;"Trnavský kraj";247;6690;513;7203;NA;264803;760;2021-01-18;39117
2021-01-17;"Trnavský kraj";128;854;215;1069;NA;264803;343;2021-01-17;38357
2021-01-16;"Trnavský kraj";103;898;24;922;NA;264803;127;2021-01-16;38014
2021-01-15;"Trnavský kraj";278;5467;336;5803;NA;264803;614;2021-01-15;37887
2021-01-14;"Trnavský kraj";452;4001;338;4339;NA;264803;790;2021-01-14;37273
2021-01-13;"Trnavský kraj";457;4751;378;5129;NA;264803;835;2021-01-13;36483
2021-01-12;"Trnavský kraj";469;6860;470;7330;NA;264803;939;2021-01-12;35648
2021-01-11;"Trnavský kraj";370;4587;360;4947;NA;264803;730;2021-01-11;34709
2021-01-10;"Trnavský kraj";71;13;0;13;NA;264803;71;2021-01-10;33979
2021-01-09;"Trnavský kraj";417;1775;100;1875;NA;264803;517;2021-01-09;33908
2021-01-08;"Trnavský kraj";381;6016;506;6522;NA;264803;887;2021-01-08;33391
2021-01-07;"Trnavský kraj";501;3545;329;3874;NA;264803;830;2021-01-07;32504
2021-01-06;"Trnavský kraj";179;758;132;890;NA;264803;311;2021-01-06;31674
2021-01-05;"Trnavský kraj";611;5165;561;5726;NA;264803;1172;2021-01-05;31363
2021-01-04;"Trnavský kraj";302;5556;709;6265;NA;264803;1011;2021-01-04;30191
2021-01-03;"Trnavský kraj";60;53;7;60;NA;264803;67;2021-01-03;29180
2021-01-02;"Trnavský kraj";282;417;32;449;NA;264803;314;2021-01-02;29113
2021-01-01;"Trnavský kraj";143;455;76;531;NA;264803;219;2021-01-01;28799
2020-12-31;"Trnavský kraj";498;8325;820;9145;NA;264803;1318;2020-12-31;28580
2020-12-30;"Trnavský kraj";785;5318;612;5930;NA;264803;1397;2020-12-30;27262
2020-12-29;"Trnavský kraj";322;4913;565;5478;NA;264803;887;2020-12-29;25865
2020-12-28;"Trnavský kraj";213;4900;552;5452;NA;264803;765;2020-12-28;24978
2020-12-27;"Trnavský kraj";27;20;4;24;NA;264803;31;2020-12-27;24213
2020-12-26;"Trnavský kraj";148;44;1;45;NA;264803;149;2020-12-26;24182
2020-12-25;"Trnavský kraj";65;49;5;54;NA;264803;70;2020-12-25;24033
2020-12-24;"Trnavský kraj";333;1359;117;1476;NA;264803;450;2020-12-24;23963
2020-12-23;"Trnavský kraj";210;6672;414;7086;NA;264803;624;2020-12-23;23513
2020-12-22;"Trnavský kraj";311;5427;455;5882;NA;264803;766;2020-12-22;22889
2020-12-21;"Trnavský kraj";328;4092;350;4442;NA;264803;678;2020-12-21;22123
2020-12-20;"Trnavský kraj";134;133;12;145;NA;264803;146;2020-12-20;21445
2020-12-19;"Trnavský kraj";201;1407;103;1510;NA;264803;304;2020-12-19;21299
2020-12-18;"Trnavský kraj";341;4432;334;4766;NA;264803;675;2020-12-18;20995
2020-12-17;"Trnavský kraj";375;4880;414;5294;NA;264803;789;2020-12-17;20320
2020-12-16;"Trnavský kraj";312;4945;383;5328;NA;264803;695;2020-12-16;19531
2020-12-15;"Trnavský kraj";492;6240;598;6838;NA;264803;1090;2020-12-15;18836
2020-12-14;"Trnavský kraj";161;3505;292;3797;NA;264803;453;2020-12-14;17746
2020-12-13;"Trnavský kraj";7;7;0;7;NA;264803;7;2020-12-13;17293
2020-12-12;"Trnavský kraj";254;1456;114;1570;NA;264803;368;2020-12-12;17286
2020-12-11;"Trnavský kraj";384;4289;241;4530;NA;264803;625;2020-12-11;16918
2020-12-10;"Trnavský kraj";183;5197;320;5517;NA;264803;503;2020-12-10;16293
2020-12-09;"Trnavský kraj";521;4199;317;4516;NA;264803;838;2020-12-09;15790
2020-12-08;"Trnavský kraj";281;4090;304;4394;NA;264803;585;2020-12-08;14952
2020-12-07;"Trnavský kraj";178;2895;199;3094;NA;264803;377;2020-12-07;14367
2020-12-06;"Trnavský kraj";46;0;0;0;NA;264803;46;2020-12-06;13990
2020-12-05;"Trnavský kraj";129;2218;41;2259;NA;264803;170;2020-12-05;13944
2020-12-04;"Trnavský kraj";242;3948;158;4106;NA;264803;400;2020-12-04;13774
2020-12-03;"Trnavský kraj";248;2770;190;2960;NA;264803;438;2020-12-03;13374
2020-12-02;"Trnavský kraj";284;4516;176;4692;NA;264803;460;2020-12-02;12936
2020-12-01;"Trnavský kraj";253;3190;205;3395;NA;264803;458;2020-12-01;12476
2020-11-30;"Trnavský kraj";200;7360;186;7546;NA;264803;386;2020-11-30;12018
2020-11-29;"Trnavský kraj";17;738;36;774;NA;264803;53;2020-11-29;11632
2020-11-28;"Trnavský kraj";83;1453;77;1530;NA;264803;160;2020-11-28;11579
2020-11-27;"Trnavský kraj";148;1779;85;1864;NA;264803;233;2020-11-27;11419
2020-11-26;"Trnavský kraj";234;1123;68;1191;NA;264803;302;2020-11-26;11186
2020-11-25;"Trnavský kraj";232;1168;74;1242;NA;264803;306;2020-11-25;10884
2020-11-24;"Trnavský kraj";295;1909;96;2005;NA;264803;391;2020-11-24;10578
2020-11-23;"Trnavský kraj";242;7393;129;7522;NA;264803;371;2020-11-23;10187
2020-11-22;"Trnavský kraj";10;82;9;91;NA;264803;19;2020-11-22;9816
2020-11-21;"Trnavský kraj";129;1354;36;1390;NA;264803;165;2020-11-21;9797
2020-11-20;"Trnavský kraj";246;1154;64;1218;NA;264803;310;2020-11-20;9632
2020-11-19;"Trnavský kraj";157;823;64;887;NA;264803;221;2020-11-19;9322
2020-11-18;"Trnavský kraj";235;822;82;904;NA;264803;317;2020-11-18;9101
2020-11-17;"Trnavský kraj";129;705;74;779;NA;264803;203;2020-11-17;8784
2020-11-16;"Trnavský kraj";187;732;32;764;NA;264803;219;2020-11-16;8581
2020-11-15;"Trnavský kraj";23;73;4;77;NA;264803;27;2020-11-15;8362
2020-11-14;"Trnavský kraj";86;397;12;409;NA;264803;98;2020-11-14;8335
2020-11-13;"Trnavský kraj";219;1312;21;1333;NA;264803;240;2020-11-13;8237
2020-11-12;"Trnavský kraj";162;420;18;438;NA;264803;180;2020-11-12;7997
2020-11-11;"Trnavský kraj";257;392;15;407;NA;264803;272;2020-11-11;7817
2020-11-10;"Trnavský kraj";189;889;30;919;NA;264803;219;2020-11-10;7545
2020-11-09;"Trnavský kraj";196;369;23;392;NA;264803;219;2020-11-09;7326
2020-11-08;"Trnavský kraj";55;400;4;404;NA;264803;59;2020-11-08;7107
2020-11-07;"Trnavský kraj";207;6070;74;6144;NA;264803;281;2020-11-07;7048
2020-11-06;"Trnavský kraj";260;1531;19;1550;NA;264803;279;2020-11-06;6767
2020-11-05;"Trnavský kraj";150;220;27;247;NA;264803;177;2020-11-05;6488
2020-11-04;"Trnavský kraj";188;212;10;222;NA;264803;198;2020-11-04;6311
2020-11-03;"Trnavský kraj";317;127;8;135;NA;264803;325;2020-11-03;6113
2020-11-02;"Trnavský kraj";281;1728;31;1759;NA;264803;312;2020-11-02;5788
2020-11-01;"Trnavský kraj";32;494;27;521;NA;264803;59;2020-11-01;5476
2022-04-03;"Žilinský kraj";82;188;31;219;246304;340230;113;2022-04-03;340230
2022-04-02;"Žilinský kraj";289;201;26;227;NA;340230;315;2022-04-02;340117
2022-04-01;"Žilinský kraj";592;919;54;973;NA;340230;646;2022-04-01;339802
2022-03-31;"Žilinský kraj";557;821;83;904;NA;340230;640;2022-03-31;339156
2022-03-30;"Žilinský kraj";688;1611;91;1702;NA;340230;779;2022-03-30;338516
2022-03-29;"Žilinský kraj";755;897;97;994;NA;340230;852;2022-03-29;337737
2022-03-28;"Žilinský kraj";825;1700;132;1832;NA;340230;957;2022-03-28;336885
2022-03-27;"Žilinský kraj";88;395;86;481;NA;340230;174;2022-03-27;335928
2022-03-26;"Žilinský kraj";586;213;49;262;NA;340230;635;2022-03-26;335754
2022-03-25;"Žilinský kraj";601;866;100;966;NA;340230;701;2022-03-25;335119
2022-03-24;"Žilinský kraj";697;1404;95;1499;NA;340230;792;2022-03-24;334418
2022-03-23;"Žilinský kraj";883;906;102;1008;NA;340230;985;2022-03-23;333626
2022-03-22;"Žilinský kraj";1102;2492;127;2619;NA;340230;1229;2022-03-22;332641
2022-03-21;"Žilinský kraj";969;1892;158;2050;NA;340230;1127;2022-03-21;331412
2022-03-20;"Žilinský kraj";157;419;79;498;NA;340230;236;2022-03-20;330285
2022-03-19;"Žilinský kraj";479;319;64;383;NA;340230;543;2022-03-19;330049
2022-03-18;"Žilinský kraj";864;773;119;892;NA;340230;983;2022-03-18;329506
2022-03-17;"Žilinský kraj";733;1098;148;1246;NA;340230;881;2022-03-17;328523
2022-03-16;"Žilinský kraj";995;1350;160;1510;NA;340230;1155;2022-03-16;327642
2022-03-15;"Žilinský kraj";1252;2492;206;2698;NA;340230;1458;2022-03-15;326487
2022-03-14;"Žilinský kraj";1138;1510;194;1704;NA;340230;1332;2022-03-14;325029
2022-03-13;"Žilinský kraj";226;503;104;607;NA;340230;330;2022-03-13;323697
2022-03-12;"Žilinský kraj";650;332;92;424;NA;340230;742;2022-03-12;323367
2022-03-11;"Žilinský kraj";824;1730;193;1923;NA;340230;1017;2022-03-11;322625
2022-03-10;"Žilinský kraj";1249;1494;164;1658;NA;340230;1413;2022-03-10;321608
2022-03-09;"Žilinský kraj";1713;1457;206;1663;NA;340230;1919;2022-03-09;320195
2022-03-08;"Žilinský kraj";699;2333;311;2644;NA;340230;1010;2022-03-08;318276
2022-03-07;"Žilinský kraj";1448;2192;294;2486;NA;340230;1742;2022-03-07;317266
2022-03-06;"Žilinský kraj";323;780;206;986;NA;340230;529;2022-03-06;315524
2022-03-05;"Žilinský kraj";576;551;123;674;NA;340230;699;2022-03-05;314995
2022-03-04;"Žilinský kraj";1194;1840;254;2094;NA;340230;1448;2022-03-04;314296
2022-03-03;"Žilinský kraj";1240;1825;244;2069;NA;340230;1484;2022-03-03;312848
2022-03-02;"Žilinský kraj";1194;1772;244;2016;NA;340230;1438;2022-03-02;311364
2022-03-01;"Žilinský kraj";1710;2949;340;3289;NA;340230;2050;2022-03-01;309926
2022-02-28;"Žilinský kraj";1700;2980;355;3335;NA;340230;2055;2022-02-28;307876
2022-02-27;"Žilinský kraj";224;940;221;1161;NA;340230;445;2022-02-27;305821
2022-02-26;"Žilinský kraj";1184;816;171;987;NA;340230;1355;2022-02-26;305376
2022-02-25;"Žilinský kraj";1371;2421;320;2741;NA;340230;1691;2022-02-25;304021
2022-02-24;"Žilinský kraj";1504;2589;314;2903;NA;340230;1818;2022-02-24;302330
2022-02-23;"Žilinský kraj";1766;3298;333;3631;NA;340230;2099;2022-02-23;300512
2022-02-22;"Žilinský kraj";2419;3369;406;3775;NA;340230;2825;2022-02-22;298413
2022-02-21;"Žilinský kraj";2227;4181;573;4754;NA;340230;2800;2022-02-21;295588
2022-02-20;"Žilinský kraj";541;1473;304;1777;NA;340230;845;2022-02-20;292788
2022-02-19;"Žilinský kraj";1656;944;273;1217;NA;340230;1929;2022-02-19;291943
2022-02-18;"Žilinský kraj";1994;3335;439;3774;NA;340230;2433;2022-02-18;290014
2022-02-17;"Žilinský kraj";2274;3013;424;3437;NA;340230;2698;2022-02-17;287581
2022-02-16;"Žilinský kraj";2676;3573;496;4069;NA;340230;3172;2022-02-16;284883
2022-02-15;"Žilinský kraj";2939;4226;604;4830;NA;340230;3543;2022-02-15;281711
2022-02-14;"Žilinský kraj";2955;4182;777;4959;NA;340230;3732;2022-02-14;278168
2022-02-13;"Žilinský kraj";751;1842;464;2306;NA;340230;1215;2022-02-13;274436
2022-02-12;"Žilinský kraj";1771;1431;319;1750;NA;340230;2090;2022-02-12;273221
2022-02-11;"Žilinský kraj";2856;3332;570;3902;NA;340230;3426;2022-02-11;271131
2022-02-10;"Žilinský kraj";2861;3472;583;4055;NA;340230;3444;2022-02-10;267705
2022-02-09;"Žilinský kraj";3365;3863;618;4481;NA;340230;3983;2022-02-09;264261
2022-02-08;"Žilinský kraj";3367;4866;780;5646;NA;340230;4147;2022-02-08;260278
2022-02-07;"Žilinský kraj";3242;5569;913;6482;NA;340230;4155;2022-02-07;256131
2022-02-06;"Žilinský kraj";1389;2587;529;3116;NA;340230;1918;2022-02-06;251976
2022-02-05;"Žilinský kraj";2107;1846;425;2271;NA;340230;2532;2022-02-05;250058
2022-02-04;"Žilinský kraj";3099;4389;631;5020;NA;340230;3730;2022-02-04;247526
2022-02-03;"Žilinský kraj";3201;4122;613;4735;NA;340230;3814;2022-02-03;243796
2022-02-02;"Žilinský kraj";3168;4616;666;5282;NA;340230;3834;2022-02-02;239982
2022-02-01;"Žilinský kraj";3593;5240;694;5934;NA;340230;4287;2022-02-01;236148
2022-01-31;"Žilinský kraj";2145;7492;931;8423;NA;340230;3076;2022-01-31;231861
2022-01-30;"Žilinský kraj";1487;2898;431;3329;NA;340230;1918;2022-01-30;228785
2022-01-29;"Žilinský kraj";2055;2033;365;2398;NA;340230;2420;2022-01-29;226867
2022-01-28;"Žilinský kraj";2572;4800;546;5346;NA;340230;3118;2022-01-28;224447
2022-01-27;"Žilinský kraj";2406;4038;537;4575;NA;340230;2943;2022-01-27;221329
2022-01-26;"Žilinský kraj";2693;5009;516;5525;NA;340230;3209;2022-01-26;218386
2022-01-25;"Žilinský kraj";2595;5626;416;6042;NA;340230;3011;2022-01-25;215177
2022-01-24;"Žilinský kraj";1401;7098;522;7620;NA;340230;1923;2022-01-24;212166
2022-01-23;"Žilinský kraj";654;2923;276;3199;NA;340230;930;2022-01-23;210243
2022-01-22;"Žilinský kraj";1256;1706;206;1912;NA;340230;1462;2022-01-22;209313
2022-01-21;"Žilinský kraj";1188;4187;265;4452;NA;340230;1453;2022-01-21;207851
2022-01-20;"Žilinský kraj";1288;3654;205;3859;NA;340230;1493;2022-01-20;206398
2022-01-19;"Žilinský kraj";1215;4086;206;4292;NA;340230;1421;2022-01-19;204905
2022-01-18;"Žilinský kraj";1191;4213;168;4381;NA;340230;1359;2022-01-18;203484
2022-01-17;"Žilinský kraj";675;6886;256;7142;NA;340230;931;2022-01-17;202125
2022-01-16;"Žilinský kraj";175;2418;106;2524;NA;340230;281;2022-01-16;201194
2022-01-15;"Žilinský kraj";398;1410;70;1480;NA;340230;468;2022-01-15;200913
2022-01-14;"Žilinský kraj";446;3716;106;3822;NA;340230;552;2022-01-14;200445
2022-01-13;"Žilinský kraj";295;2912;78;2990;NA;340230;373;2022-01-13;199893
2022-01-12;"Žilinský kraj";422;3168;72;3240;NA;340230;494;2022-01-12;199520
2022-01-11;"Žilinský kraj";622;4216;57;4273;NA;340230;679;2022-01-11;199026
2022-01-10;"Žilinský kraj";436;6344;102;6446;NA;340230;538;2022-01-10;198347
2022-01-09;"Žilinský kraj";95;2934;54;2988;NA;340230;149;2022-01-09;197809
2022-01-08;"Žilinský kraj";345;1650;45;1695;NA;340230;390;2022-01-08;197660
2022-01-07;"Žilinský kraj";525;4566;75;4641;NA;340230;600;2022-01-07;197270
2022-01-06;"Žilinský kraj";167;1214;40;1254;NA;340230;207;2022-01-06;196670
2022-01-05;"Žilinský kraj";471;3492;75;3567;NA;340230;546;2022-01-05;196463
2022-01-04;"Žilinský kraj";606;3762;87;3849;NA;340230;693;2022-01-04;195917
2022-01-03;"Žilinský kraj";601;6083;116;6199;NA;340230;717;2022-01-03;195224
2022-01-02;"Žilinský kraj";288;2596;85;2681;NA;340230;373;2022-01-02;194507
2022-01-01;"Žilinský kraj";14;439;15;454;NA;340230;29;2022-01-01;194134
2021-12-31;"Žilinský kraj";323;1608;70;1678;NA;340230;393;2021-12-31;194105
2021-12-30;"Žilinský kraj";492;2213;95;2308;NA;340230;587;2021-12-30;193712
2021-12-29;"Žilinský kraj";543;6864;83;6947;NA;340230;626;2021-12-29;193125
2021-12-28;"Žilinský kraj";641;3408;106;3514;NA;340230;747;2021-12-28;192499
2021-12-27;"Žilinský kraj";691;3961;145;4106;NA;340230;836;2021-12-27;191752
2021-12-26;"Žilinský kraj";242;1167;58;1225;NA;340230;300;2021-12-26;190916
2021-12-25;"Žilinský kraj";22;442;45;487;NA;340230;67;2021-12-25;190616
2021-12-24;"Žilinský kraj";98;518;21;539;NA;340230;119;2021-12-24;190549
2021-12-23;"Žilinský kraj";731;2678;105;2783;NA;340230;836;2021-12-23;190430
2021-12-22;"Žilinský kraj";510;2428;77;2505;NA;340230;587;2021-12-22;189594
2021-12-21;"Žilinský kraj";755;3641;102;3743;NA;340230;857;2021-12-21;189007
2021-12-20;"Žilinský kraj";563;4545;125;4670;NA;340230;688;2021-12-20;188150
2021-12-19;"Žilinský kraj";133;2215;90;2305;NA;340230;223;2021-12-19;187462
2021-12-18;"Žilinský kraj";417;1321;70;1391;NA;340230;487;2021-12-18;187239
2021-12-17;"Žilinský kraj";604;3895;127;4022;NA;340230;731;2021-12-17;186752
2021-12-16;"Žilinský kraj";660;3931;109;4040;NA;340230;769;2021-12-16;186021
2021-12-15;"Žilinský kraj";802;3491;122;3613;NA;340230;924;2021-12-15;185252
2021-12-14;"Žilinský kraj";798;4587;129;4716;NA;340230;927;2021-12-14;184328
2021-12-13;"Žilinský kraj";759;7755;212;7967;NA;340230;971;2021-12-13;183401
2021-12-12;"Žilinský kraj";340;2836;114;2950;NA;340230;454;2021-12-12;182430
2021-12-11;"Žilinský kraj";761;1849;112;1961;NA;340230;873;2021-12-11;181976
2021-12-10;"Žilinský kraj";638;4041;136;4177;NA;340230;774;2021-12-10;181103
2021-12-09;"Žilinský kraj";870;5842;161;6003;NA;340230;1031;2021-12-09;180329
2021-12-08;"Žilinský kraj";1018;3215;158;3373;NA;340230;1176;2021-12-08;179298
2021-12-07;"Žilinský kraj";1356;5148;160;5308;NA;340230;1516;2021-12-07;178122
2021-12-06;"Žilinský kraj";919;7441;226;7667;NA;340230;1145;2021-12-06;176606
2021-12-05;"Žilinský kraj";505;3306;134;3440;NA;340230;639;2021-12-05;175461
2021-12-04;"Žilinský kraj";704;1892;153;2045;NA;340230;857;2021-12-04;174822
2021-12-03;"Žilinský kraj";1204;4864;215;5079;NA;340230;1419;2021-12-03;173965
2021-12-02;"Žilinský kraj";1847;4131;199;4330;NA;340230;2046;2021-12-02;172546
2021-12-01;"Žilinský kraj";1183;4073;195;4268;NA;340230;1378;2021-12-01;170500
2021-11-30;"Žilinský kraj";1575;5467;252;5719;NA;340230;1827;2021-11-30;169122
2021-11-29;"Žilinský kraj";1395;9069;358;9427;NA;340230;1753;2021-11-29;167295
2021-11-28;"Žilinský kraj";625;4581;235;4816;NA;340230;860;2021-11-28;165542
2021-11-27;"Žilinský kraj";909;2557;192;2749;NA;340230;1101;2021-11-27;164682
2021-11-26;"Žilinský kraj";1195;6599;344;6943;NA;340230;1539;2021-11-26;163581
2021-11-25;"Žilinský kraj";1281;4701;331;5032;NA;340230;1612;2021-11-25;162042
2021-11-24;"Žilinský kraj";1792;4660;324;4984;NA;340230;2116;2021-11-24;160430
2021-11-23;"Žilinský kraj";1630;4654;353;5007;NA;340230;1983;2021-11-23;158314
2021-11-22;"Žilinský kraj";1126;6699;452;7151;NA;340230;1578;2021-11-22;156331
2021-11-21;"Žilinský kraj";443;2865;260;3125;NA;340230;703;2021-11-21;154753
2021-11-20;"Žilinský kraj";963;2104;241;2345;NA;340230;1204;2021-11-20;154050
2021-11-19;"Žilinský kraj";1281;4622;434;5056;NA;340230;1715;2021-11-19;152846
2021-11-18;"Žilinský kraj";1220;4432;376;4808;NA;340230;1596;2021-11-18;151131
2021-11-17;"Žilinský kraj";1001;1434;149;1583;NA;340230;1150;2021-11-17;149535
2021-11-16;"Žilinský kraj";1197;4058;323;4381;NA;340230;1520;2021-11-16;148385
2021-11-15;"Žilinský kraj";977;5050;476;5526;NA;340230;1453;2021-11-15;146865
2021-11-14;"Žilinský kraj";356;2287;262;2549;NA;340230;618;2021-11-14;145412
2021-11-13;"Žilinský kraj";652;1882;220;2102;NA;340230;872;2021-11-13;144794
2021-11-12;"Žilinský kraj";1027;4291;340;4631;NA;340230;1367;2021-11-12;143922
2021-11-11;"Žilinský kraj";924;4192;272;4464;NA;340230;1196;2021-11-11;142555
2021-11-10;"Žilinský kraj";897;4509;305;4814;NA;340230;1202;2021-11-10;141359
2021-11-09;"Žilinský kraj";1440;4619;256;4875;NA;340230;1696;2021-11-09;140157
2021-11-08;"Žilinský kraj";781;4438;425;4863;NA;340230;1206;2021-11-08;138461
2021-11-07;"Žilinský kraj";304;2130;231;2361;NA;340230;535;2021-11-07;137255
2021-11-06;"Žilinský kraj";741;2150;201;2351;NA;340230;942;2021-11-06;136720
2021-11-05;"Žilinský kraj";1064;4067;235;4302;NA;340230;1299;2021-11-05;135778
2021-11-04;"Žilinský kraj";776;3709;232;3941;NA;340230;1008;2021-11-04;134479
2021-11-03;"Žilinský kraj";1106;5550;338;5888;NA;340230;1444;2021-11-03;133471
2021-11-02;"Žilinský kraj";1136;4451;333;4784;NA;340230;1469;2021-11-02;132027
2021-11-01;"Žilinský kraj";399;1456;137;1593;NA;340230;536;2021-11-01;130558
2021-10-31;"Žilinský kraj";344;1387;145;1532;NA;340230;489;2021-10-31;130022
2021-10-30;"Žilinský kraj";571;1944;161;2105;NA;340230;732;2021-10-30;129533
2021-10-29;"Žilinský kraj";733;3339;194;3533;NA;340230;927;2021-10-29;128801
2021-10-28;"Žilinský kraj";639;4953;247;5200;NA;340230;886;2021-10-28;127874
2021-10-27;"Žilinský kraj";739;3446;173;3619;NA;340230;912;2021-10-27;126988
2021-10-26;"Žilinský kraj";945;4748;216;4964;NA;340230;1161;2021-10-26;126076
2021-10-25;"Žilinský kraj";649;5736;271;6007;NA;340230;920;2021-10-25;124915
2021-10-24;"Žilinský kraj";248;1679;107;1786;NA;340230;355;2021-10-24;123995
2021-10-23;"Žilinský kraj";399;2415;149;2564;NA;340230;548;2021-10-23;123640
2021-10-22;"Žilinský kraj";587;3898;151;4049;NA;340230;738;2021-10-22;123092
2021-10-21;"Žilinský kraj";591;3367;162;3529;NA;340230;753;2021-10-21;122354
2021-10-20;"Žilinský kraj";479;3864;154;4018;NA;340230;633;2021-10-20;121601
2021-10-19;"Žilinský kraj";675;3763;161;3924;NA;340230;836;2021-10-19;120968
2021-10-18;"Žilinský kraj";432;5160;271;5431;NA;340230;703;2021-10-18;120132
2021-10-17;"Žilinský kraj";135;1769;101;1870;NA;340230;236;2021-10-17;119429
2021-10-16;"Žilinský kraj";273;2341;100;2441;NA;340230;373;2021-10-16;119193
2021-10-15;"Žilinský kraj";347;3859;146;4005;NA;340230;493;2021-10-15;118820
2021-10-14;"Žilinský kraj";419;3035;110;3145;NA;340230;529;2021-10-14;118327
2021-10-13;"Žilinský kraj";404;3427;112;3539;NA;340230;516;2021-10-13;117798
2021-10-12;"Žilinský kraj";589;4000;141;4141;NA;340230;730;2021-10-12;117282
2021-10-11;"Žilinský kraj";323;4501;154;4655;NA;340230;477;2021-10-11;116552
2021-10-10;"Žilinský kraj";113;1577;77;1654;NA;340230;190;2021-10-10;116075
2021-10-09;"Žilinský kraj";201;1565;57;1622;NA;340230;258;2021-10-09;115885
2021-10-08;"Žilinský kraj";265;4227;99;4326;NA;340230;364;2021-10-08;115627
2021-10-07;"Žilinský kraj";338;3384;113;3497;NA;340230;451;2021-10-07;115263
2021-10-06;"Žilinský kraj";313;3901;89;3990;NA;340230;402;2021-10-06;114812
2021-10-05;"Žilinský kraj";387;4031;122;4153;NA;340230;509;2021-10-05;114410
2021-10-04;"Žilinský kraj";297;4449;121;4570;NA;340230;418;2021-10-04;113901
2021-10-03;"Žilinský kraj";22;1596;63;1659;NA;340230;85;2021-10-03;113483
2021-10-02;"Žilinský kraj";209;1990;45;2035;NA;340230;254;2021-10-02;113398
2021-10-01;"Žilinský kraj";263;4047;104;4151;NA;340230;367;2021-10-01;113144
2021-09-30;"Žilinský kraj";248;3531;71;3602;NA;340230;319;2021-09-30;112777
2021-09-29;"Žilinský kraj";285;3577;82;3659;NA;340230;367;2021-09-29;112458
2021-09-28;"Žilinský kraj";272;3656;73;3729;NA;340230;345;2021-09-28;112091
2021-09-27;"Žilinský kraj";239;4418;152;4570;NA;340230;391;2021-09-27;111746
2021-09-26;"Žilinský kraj";17;1665;42;1707;NA;340230;59;2021-09-26;111355
2021-09-25;"Žilinský kraj";111;1711;50;1761;NA;340230;161;2021-09-25;111296
2021-09-24;"Žilinský kraj";199;6127;98;6225;NA;340230;297;2021-09-24;111135
2021-09-23;"Žilinský kraj";176;2629;74;2703;NA;340230;250;2021-09-23;110838
2021-09-22;"Žilinský kraj";185;2728;77;2805;NA;340230;262;2021-09-22;110588
2021-09-21;"Žilinský kraj";250;3123;78;3201;NA;340230;328;2021-09-21;110326
2021-09-20;"Žilinský kraj";244;3231;95;3326;NA;340230;339;2021-09-20;109998
2021-09-19;"Žilinský kraj";26;1579;37;1616;NA;340230;63;2021-09-19;109659
2021-09-18;"Žilinský kraj";87;1441;45;1486;NA;340230;132;2021-09-18;109596
2021-09-17;"Žilinský kraj";192;3351;56;3407;NA;340230;248;2021-09-17;109464
2021-09-16;"Žilinský kraj";164;2744;87;2831;NA;340230;251;2021-09-16;109216
2021-09-15;"Žilinský kraj";31;555;11;566;NA;340230;42;2021-09-15;108965
2021-09-14;"Žilinský kraj";155;3268;61;3329;NA;340230;216;2021-09-14;108923
2021-09-13;"Žilinský kraj";81;3250;75;3325;NA;340230;156;2021-09-13;108707
2021-09-12;"Žilinský kraj";9;1138;24;1162;NA;340230;33;2021-09-12;108551
2021-09-11;"Žilinský kraj";47;1322;21;1343;NA;340230;68;2021-09-11;108518
2021-09-10;"Žilinský kraj";66;2439;34;2473;NA;340230;100;2021-09-10;108450
2021-09-09;"Žilinský kraj";56;2352;18;2370;NA;340230;74;2021-09-09;108350
2021-09-08;"Žilinský kraj";68;1560;24;1584;NA;340230;92;2021-09-08;108276
2021-09-07;"Žilinský kraj";72;1806;27;1833;NA;340230;99;2021-09-07;108184
2021-09-06;"Žilinský kraj";31;2381;45;2426;NA;340230;76;2021-09-06;108085
2021-09-05;"Žilinský kraj";11;785;8;793;NA;340230;19;2021-09-05;108009
2021-09-04;"Žilinský kraj";24;1080;5;1085;NA;340230;29;2021-09-04;107990
2021-09-03;"Žilinský kraj";52;2047;28;2075;NA;340230;80;2021-09-03;107961
2021-09-02;"Žilinský kraj";30;1432;22;1454;NA;340230;52;2021-09-02;107881
2021-09-01;"Žilinský kraj";5;461;6;467;NA;340230;11;2021-09-01;107829
2021-08-31;"Žilinský kraj";32;1710;15;1725;NA;340230;47;2021-08-31;107818
2021-08-30;"Žilinský kraj";7;1801;4;1805;NA;340230;11;2021-08-30;107771
2021-08-29;"Žilinský kraj";8;631;5;636;NA;340230;13;2021-08-29;107760
2021-08-28;"Žilinský kraj";2;1005;1;1006;NA;340230;3;2021-08-28;107747
2021-08-27;"Žilinský kraj";13;1765;12;1777;NA;340230;25;2021-08-27;107744
2021-08-26;"Žilinský kraj";17;1636;7;1643;NA;340230;24;2021-08-26;107719
2021-08-25;"Žilinský kraj";9;1203;11;1214;NA;340230;20;2021-08-25;107695
2021-08-24;"Žilinský kraj";6;1395;9;1404;NA;340230;15;2021-08-24;107675
2021-08-23;"Žilinský kraj";11;1877;7;1884;NA;340230;18;2021-08-23;107660
2021-08-22;"Žilinský kraj";2;733;3;736;NA;340230;5;2021-08-22;107642
2021-08-21;"Žilinský kraj";6;1183;2;1185;NA;340230;8;2021-08-21;107637
2021-08-20;"Žilinský kraj";7;2284;5;2289;NA;340230;12;2021-08-20;107629
2021-08-19;"Žilinský kraj";6;1281;3;1284;NA;340230;9;2021-08-19;107617
2021-08-18;"Žilinský kraj";4;1331;7;1338;NA;340230;11;2021-08-18;107608
2021-08-17;"Žilinský kraj";9;1219;3;1222;NA;340230;12;2021-08-17;107597
2021-08-16;"Žilinský kraj";14;1696;5;1701;NA;340230;19;2021-08-16;107585
2021-08-15;"Žilinský kraj";1;880;2;882;NA;340230;3;2021-08-15;107566
2021-08-14;"Žilinský kraj";5;1197;0;1197;NA;340230;5;2021-08-14;107563
2021-08-13;"Žilinský kraj";6;1685;0;1685;NA;340230;6;2021-08-13;107558
2021-08-12;"Žilinský kraj";4;1105;1;1106;NA;340230;5;2021-08-12;107552
2021-08-11;"Žilinský kraj";13;1250;3;1253;NA;340230;16;2021-08-11;107547
2021-08-10;"Žilinský kraj";12;1292;3;1295;NA;340230;15;2021-08-10;107531
2021-08-09;"Žilinský kraj";9;1142;1;1143;NA;340230;10;2021-08-09;107516
2021-08-08;"Žilinský kraj";1;748;5;753;NA;340230;6;2021-08-08;107506
2021-08-07;"Žilinský kraj";7;1192;1;1193;NA;340230;8;2021-08-07;107500
2021-08-06;"Žilinský kraj";1;1347;0;1347;NA;340230;1;2021-08-06;107492
2021-08-05;"Žilinský kraj";7;1148;3;1151;NA;340230;10;2021-08-05;107491
2021-08-04;"Žilinský kraj";12;895;0;895;NA;340230;12;2021-08-04;107481
2021-08-03;"Žilinský kraj";11;918;0;918;NA;340230;11;2021-08-03;107469
2021-08-02;"Žilinský kraj";5;1513;1;1514;NA;340230;6;2021-08-02;107458
2021-08-01;"Žilinský kraj";0;679;2;681;NA;340230;2;2021-08-01;107452
2021-07-31;"Žilinský kraj";4;1114;0;1114;NA;340230;4;2021-07-31;107450
2021-07-30;"Žilinský kraj";3;1671;0;1671;NA;340230;3;2021-07-30;107446
2021-07-29;"Žilinský kraj";1;1299;0;1299;NA;340230;1;2021-07-29;107443
2021-07-28;"Žilinský kraj";4;901;0;901;NA;340230;4;2021-07-28;107442
2021-07-27;"Žilinský kraj";11;1378;0;1378;NA;340230;11;2021-07-27;107438
2021-07-26;"Žilinský kraj";1;1301;1;1302;NA;340230;2;2021-07-26;107427
2021-07-25;"Žilinský kraj";2;828;2;830;NA;340230;4;2021-07-25;107425
2021-07-24;"Žilinský kraj";2;1338;2;1340;NA;340230;4;2021-07-24;107421
2021-07-23;"Žilinský kraj";4;1750;0;1750;NA;340230;4;2021-07-23;107417
2021-07-22;"Žilinský kraj";2;1207;0;1207;NA;340230;2;2021-07-22;107413
2021-07-21;"Žilinský kraj";2;1021;0;1021;NA;340230;2;2021-07-21;107411
2021-07-20;"Žilinský kraj";4;1439;0;1439;NA;340230;4;2021-07-20;107409
2021-07-19;"Žilinský kraj";4;1763;1;1764;NA;340230;5;2021-07-19;107405
2021-07-18;"Žilinský kraj";0;854;1;855;NA;340230;1;2021-07-18;107400
2021-07-17;"Žilinský kraj";0;1350;0;1350;NA;340230;0;2021-07-17;107399
2021-07-16;"Žilinský kraj";2;1767;0;1767;NA;340230;2;2021-07-16;107399
2021-07-15;"Žilinský kraj";2;1577;0;1577;NA;340230;2;2021-07-15;107397
2021-07-14;"Žilinský kraj";5;1042;1;1043;NA;340230;6;2021-07-14;107395
2021-07-13;"Žilinský kraj";3;1709;1;1710;NA;340230;4;2021-07-13;107389
2021-07-12;"Žilinský kraj";3;1325;1;1326;NA;340230;4;2021-07-12;107385
2021-07-11;"Žilinský kraj";2;989;0;989;NA;340230;2;2021-07-11;107381
2021-07-10;"Žilinský kraj";1;1511;4;1515;NA;340230;5;2021-07-10;107379
2021-07-09;"Žilinský kraj";1;2208;1;2209;NA;340230;2;2021-07-09;107374
2021-07-08;"Žilinský kraj";6;1776;3;1779;NA;340230;9;2021-07-08;107372
2021-07-07;"Žilinský kraj";1;1585;3;1588;NA;340230;4;2021-07-07;107363
2021-07-06;"Žilinský kraj";4;1956;0;1956;NA;340230;4;2021-07-06;107359
2021-07-05;"Žilinský kraj";2;1031;1;1032;NA;340230;3;2021-07-05;107355
2021-07-04;"Žilinský kraj";0;1003;0;1003;NA;340230;0;2021-07-04;107352
2021-07-03;"Žilinský kraj";1;1696;2;1698;NA;340230;3;2021-07-03;107352
2021-07-02;"Žilinský kraj";0;3356;2;3358;NA;340230;2;2021-07-02;107349
2021-07-01;"Žilinský kraj";1;1118;0;1118;NA;340230;1;2021-07-01;107347
2021-06-30;"Žilinský kraj";1;10464;6;10470;NA;340230;7;2021-06-30;107346
2021-06-29;"Žilinský kraj";10;5946;0;5946;NA;340230;10;2021-06-29;107339
2021-06-28;"Žilinský kraj";4;6245;2;6247;NA;340230;6;2021-06-28;107329
2021-06-27;"Žilinský kraj";3;4702;1;4703;NA;340230;4;2021-06-27;107323
2021-06-26;"Žilinský kraj";4;5919;0;5919;NA;340230;4;2021-06-26;107319
2021-06-25;"Žilinský kraj";8;9756;5;9761;NA;340230;13;2021-06-25;107315
2021-06-24;"Žilinský kraj";6;5657;3;5660;NA;340230;9;2021-06-24;107302
2021-06-23;"Žilinský kraj";7;5955;10;5965;NA;340230;17;2021-06-23;107293
2021-06-22;"Žilinský kraj";6;5214;8;5222;NA;340230;14;2021-06-22;107276
2021-06-21;"Žilinský kraj";6;6287;8;6295;NA;340230;14;2021-06-21;107262
2021-06-20;"Žilinský kraj";1;5531;8;5539;NA;340230;9;2021-06-20;107248
2021-06-19;"Žilinský kraj";9;8353;2;8355;NA;340230;11;2021-06-19;107239
2021-06-18;"Žilinský kraj";11;10624;12;10636;NA;340230;23;2021-06-18;107228
2021-06-17;"Žilinský kraj";10;6092;12;6104;NA;340230;22;2021-06-17;107205
2021-06-16;"Žilinský kraj";17;5786;11;5797;NA;340230;28;2021-06-16;107183
2021-06-15;"Žilinský kraj";13;5996;13;6009;NA;340230;26;2021-06-15;107155
2021-06-14;"Žilinský kraj";10;7596;21;7617;NA;340230;31;2021-06-14;107129
2021-06-13;"Žilinský kraj";2;6682;9;6691;NA;340230;11;2021-06-13;107098
2021-06-12;"Žilinský kraj";9;8634;11;8645;NA;340230;20;2021-06-12;107087
2021-06-11;"Žilinský kraj";11;11566;14;11580;NA;340230;25;2021-06-11;107067
2021-06-10;"Žilinský kraj";14;6788;14;6802;NA;340230;28;2021-06-10;107042
2021-06-09;"Žilinský kraj";23;5925;14;5939;NA;340230;37;2021-06-09;107014
2021-06-08;"Žilinský kraj";18;6615;16;6631;NA;340230;34;2021-06-08;106977
2021-06-07;"Žilinský kraj";25;8534;21;8555;NA;340230;46;2021-06-07;106943
2021-06-06;"Žilinský kraj";10;8056;27;8083;NA;340230;37;2021-06-06;106897
2021-06-05;"Žilinský kraj";8;9175;10;9185;NA;340230;18;2021-06-05;106860
2021-06-04;"Žilinský kraj";19;12260;34;12294;NA;340230;53;2021-06-04;106842
2021-06-03;"Žilinský kraj";12;7033;33;7066;NA;340230;45;2021-06-03;106789
2021-06-02;"Žilinský kraj";17;7103;28;7131;NA;340230;45;2021-06-02;106744
2021-06-01;"Žilinský kraj";38;8285;46;8331;NA;340230;84;2021-06-01;106699
2021-05-31;"Žilinský kraj";31;9616;59;9675;NA;340230;90;2021-05-31;106615
2021-05-30;"Žilinský kraj";21;9025;35;9060;NA;340230;56;2021-05-30;106525
2021-05-29;"Žilinský kraj";13;11195;23;11218;NA;340230;36;2021-05-29;106469
2021-05-28;"Žilinský kraj";28;13277;30;13307;NA;340230;58;2021-05-28;106433
2021-05-27;"Žilinský kraj";17;8267;39;8306;NA;340230;56;2021-05-27;106375
2021-05-26;"Žilinský kraj";20;8329;25;8354;NA;340230;45;2021-05-26;106319
2021-05-25;"Žilinský kraj";21;9624;38;9662;NA;340230;59;2021-05-25;106274
2021-05-24;"Žilinský kraj";36;11487;57;11544;NA;340230;93;2021-05-24;106215
2021-05-23;"Žilinský kraj";4;10923;56;10979;NA;340230;60;2021-05-23;106122
2021-05-22;"Žilinský kraj";21;11893;28;11921;NA;340230;49;2021-05-22;106062
2021-05-21;"Žilinský kraj";28;15654;50;15704;NA;340230;78;2021-05-21;106013
2021-05-20;"Žilinský kraj";30;9616;30;9646;NA;340230;60;2021-05-20;105935
2021-05-19;"Žilinský kraj";46;8693;41;8734;NA;340230;87;2021-05-19;105875
2021-05-18;"Žilinský kraj";52;10609;44;10653;NA;340230;96;2021-05-18;105788
2021-05-17;"Žilinský kraj";51;12676;84;12760;NA;340230;135;2021-05-17;105692
2021-05-16;"Žilinský kraj";13;14114;42;14156;NA;340230;55;2021-05-16;105557
2021-05-15;"Žilinský kraj";30;18404;35;18439;NA;340230;65;2021-05-15;105502
2021-05-14;"Žilinský kraj";34;21205;82;21287;NA;340230;116;2021-05-14;105437
2021-05-13;"Žilinský kraj";64;11865;51;11916;NA;340230;115;2021-05-13;105321
2021-05-12;"Žilinský kraj";57;10337;51;10388;NA;340230;108;2021-05-12;105206
2021-05-11;"Žilinský kraj";70;12174;51;12225;NA;340230;121;2021-05-11;105098
2021-05-10;"Žilinský kraj";69;16182;72;16254;NA;340230;141;2021-05-10;104977
2021-05-09;"Žilinský kraj";58;20385;77;20462;NA;340230;135;2021-05-09;104836
2021-05-08;"Žilinský kraj";0;24133;63;24196;NA;340230;63;2021-05-08;104701
2021-05-07;"Žilinský kraj";65;26522;87;26609;NA;340230;152;2021-05-07;104638
2021-05-06;"Žilinský kraj";67;16615;72;16687;NA;340230;139;2021-05-06;104486
2021-05-05;"Žilinský kraj";71;13096;73;13169;NA;340230;144;2021-05-05;104347
2021-05-04;"Žilinský kraj";81;16749;80;16829;NA;340230;161;2021-05-04;104203
2021-05-03;"Žilinský kraj";97;20391;111;20502;NA;340230;208;2021-05-03;104042
2021-05-02;"Žilinský kraj";8;28886;64;28950;NA;340230;72;2021-05-02;103834
2021-05-01;"Žilinský kraj";65;55053;105;55158;NA;340230;170;2021-05-01;103762
2021-04-30;"Žilinský kraj";84;44000;117;44117;NA;340230;201;2021-04-30;103592
2021-04-29;"Žilinský kraj";77;24566;101;24667;NA;340230;178;2021-04-29;103391
2021-04-28;"Žilinský kraj";76;19214;91;19305;NA;340230;167;2021-04-28;103213
2021-04-27;"Žilinský kraj";97;21805;110;21915;NA;340230;207;2021-04-27;103046
2021-04-26;"Žilinský kraj";114;27412;136;27548;NA;340230;250;2021-04-26;102839
2021-04-25;"Žilinský kraj";38;35750;82;35832;NA;340230;120;2021-04-25;102589
2021-04-24;"Žilinský kraj";93;78854;157;79011;NA;340230;250;2021-04-24;102469
2021-04-23;"Žilinský kraj";144;49440;153;49593;NA;340230;297;2021-04-23;102219
2021-04-22;"Žilinský kraj";110;25247;132;25379;NA;340230;242;2021-04-22;101922
2021-04-21;"Žilinský kraj";118;20616;145;20761;NA;340230;263;2021-04-21;101680
2021-04-20;"Žilinský kraj";128;23873;136;24009;NA;340230;264;2021-04-20;101417
2021-04-19;"Žilinský kraj";164;32773;210;32983;NA;340230;374;2021-04-19;101153
2021-04-18;"Žilinský kraj";18;36767;91;36858;NA;340230;109;2021-04-18;100779
2021-04-17;"Žilinský kraj";108;89377;156;89533;NA;340230;264;2021-04-17;100670
2021-04-16;"Žilinský kraj";185;47847;208;48055;NA;340230;393;2021-04-16;100406
2021-04-15;"Žilinský kraj";108;24830;130;24960;NA;340230;238;2021-04-15;100013
2021-04-14;"Žilinský kraj";135;23145;145;23290;NA;340230;280;2021-04-14;99775
2021-04-13;"Žilinský kraj";171;25050;135;25185;NA;340230;306;2021-04-13;99495
2021-04-12;"Žilinský kraj";266;30794;189;30983;NA;340230;455;2021-04-12;99189
2021-04-11;"Žilinský kraj";19;37126;107;37233;NA;340230;126;2021-04-11;98734
2021-04-10;"Žilinský kraj";111;86284;237;86521;NA;340230;348;2021-04-10;98608
2021-04-09;"Žilinský kraj";195;41973;206;42179;NA;340230;401;2021-04-09;98260
2021-04-08;"Žilinský kraj";179;24434;141;24575;NA;340230;320;2021-04-08;97859
2021-04-07;"Žilinský kraj";309;28651;174;28825;NA;340230;483;2021-04-07;97539
2021-04-06;"Žilinský kraj";308;40107;301;40408;NA;340230;609;2021-04-06;97056
2021-04-05;"Žilinský kraj";17;14747;140;14887;NA;340230;157;2021-04-05;96447
2021-04-04;"Žilinský kraj";17;16284;69;16353;NA;340230;86;2021-04-04;96290
2021-04-03;"Žilinský kraj";180;100699;403;101102;NA;340230;583;2021-04-03;96204
2021-04-02;"Žilinský kraj";73;22411;83;22494;NA;340230;156;2021-04-02;95621
2021-04-01;"Žilinský kraj";334;43264;240;43504;NA;340230;574;2021-04-01;95465
2021-03-31;"Žilinský kraj";170;31635;247;31882;NA;340230;417;2021-03-31;94891
2021-03-30;"Žilinský kraj";406;26323;243;26566;NA;340230;649;2021-03-30;94474
2021-03-29;"Žilinský kraj";297;28029;268;28297;NA;340230;565;2021-03-29;93825
2021-03-28;"Žilinský kraj";21;36206;239;36445;NA;340230;260;2021-03-28;93260
2021-03-27;"Žilinský kraj";151;89107;353;89460;NA;340230;504;2021-03-27;93000
2021-03-26;"Žilinský kraj";312;51757;330;52087;NA;340230;642;2021-03-26;92496
2021-03-25;"Žilinský kraj";281;27619;214;27833;NA;340230;495;2021-03-25;91854
2021-03-24;"Žilinský kraj";280;21268;260;21528;NA;340230;540;2021-03-24;91359
2021-03-23;"Žilinský kraj";418;23193;278;23471;NA;340230;696;2021-03-23;90819
2021-03-22;"Žilinský kraj";293;29289;314;29603;NA;340230;607;2021-03-22;90123
2021-03-21;"Žilinský kraj";32;33705;227;33932;NA;340230;259;2021-03-21;89516
2021-03-20;"Žilinský kraj";165;93015;497;93512;NA;340230;662;2021-03-20;89257
2021-03-19;"Žilinský kraj";357;51988;414;52402;NA;340230;771;2021-03-19;88595
2021-03-18;"Žilinský kraj";329;28459;294;28753;NA;340230;623;2021-03-18;87824
2021-03-17;"Žilinský kraj";395;21919;269;22188;NA;340230;664;2021-03-17;87201
2021-03-16;"Žilinský kraj";514;24341;317;24658;NA;340230;831;2021-03-16;86537
2021-03-15;"Žilinský kraj";341;29613;419;30032;NA;340230;760;2021-03-15;85706
2021-03-14;"Žilinský kraj";87;34121;267;34388;NA;340230;354;2021-03-14;84946
2021-03-13;"Žilinský kraj";113;93386;581;93967;NA;340230;694;2021-03-13;84592
2021-03-12;"Žilinský kraj";520;52329;411;52740;NA;340230;931;2021-03-12;83898
2021-03-11;"Žilinský kraj";399;28189;302;28491;NA;340230;701;2021-03-11;82967
2021-03-10;"Žilinský kraj";368;22414;378;22792;NA;340230;746;2021-03-10;82266
2021-03-09;"Žilinský kraj";537;24857;316;25173;NA;340230;853;2021-03-09;81520
2021-03-08;"Žilinský kraj";387;30873;458;31331;NA;340230;845;2021-03-08;80667
2021-03-07;"Žilinský kraj";48;33469;290;33759;NA;340230;338;2021-03-07;79822
2021-03-06;"Žilinský kraj";173;92410;589;92999;NA;340230;762;2021-03-06;79484
2021-03-05;"Žilinský kraj";369;51987;484;52471;NA;340230;853;2021-03-05;78722
2021-03-04;"Žilinský kraj";467;30037;377;30414;NA;340230;844;2021-03-04;77869
2021-03-03;"Žilinský kraj";448;26261;394;26655;NA;340230;842;2021-03-03;77025
2021-03-02;"Žilinský kraj";551;25913;378;26291;NA;340230;929;2021-03-02;76183
2021-03-01;"Žilinský kraj";375;30498;441;30939;NA;340230;816;2021-03-01;75254
2021-02-28;"Žilinský kraj";61;34802;327;35129;NA;340230;388;2021-02-28;74438
2021-02-27;"Žilinský kraj";159;83781;639;84420;NA;340230;798;2021-02-27;74050
2021-02-26;"Žilinský kraj";459;47500;508;48008;NA;340230;967;2021-02-26;73252
2021-02-25;"Žilinský kraj";347;30879;393;31272;NA;340230;740;2021-02-25;72285
2021-02-24;"Žilinský kraj";339;18760;395;19155;NA;340230;734;2021-02-24;71545
2021-02-23;"Žilinský kraj";437;22172;418;22590;NA;340230;855;2021-02-23;70811
2021-02-22;"Žilinský kraj";345;29270;438;29708;NA;340230;783;2021-02-22;69956
2021-02-21;"Žilinský kraj";36;28686;322;29008;NA;340230;358;2021-02-21;69173
2021-02-20;"Žilinský kraj";152;89944;671;90615;NA;340230;823;2021-02-20;68815
2021-02-19;"Žilinský kraj";337;45541;417;45958;NA;340230;754;2021-02-19;67992
2021-02-18;"Žilinský kraj";263;24662;337;24999;NA;340230;600;2021-02-18;67238
2021-02-17;"Žilinský kraj";269;17932;355;18287;NA;340230;624;2021-02-17;66638
2021-02-16;"Žilinský kraj";321;24298;325;24623;NA;340230;646;2021-02-16;66014
2021-02-15;"Žilinský kraj";230;30420;311;30731;NA;340230;541;2021-02-15;65368
2021-02-14;"Žilinský kraj";30;28723;231;28954;NA;340230;261;2021-02-14;64827
2021-02-13;"Žilinský kraj";91;69638;453;70091;NA;340230;544;2021-02-13;64566
2021-02-12;"Žilinský kraj";242;43338;336;43674;NA;340230;578;2021-02-12;64022
2021-02-11;"Žilinský kraj";228;23521;300;23821;NA;340230;528;2021-02-11;63444
2021-02-10;"Žilinský kraj";259;17894;267;18161;NA;340230;526;2021-02-10;62916
2021-02-09;"Žilinský kraj";377;24784;274;25058;NA;340230;651;2021-02-09;62390
2021-02-08;"Žilinský kraj";160;41375;390;41765;NA;340230;550;2021-02-08;61739
2021-02-07;"Žilinský kraj";24;46446;252;46698;NA;340230;276;2021-02-07;61189
2021-02-06;"Žilinský kraj";71;72880;367;73247;NA;340230;438;2021-02-06;60913
2021-02-05;"Žilinský kraj";248;31869;323;32192;NA;340230;571;2021-02-05;60475
2021-02-04;"Žilinský kraj";238;13240;258;13498;NA;340230;496;2021-02-04;59904
2021-02-03;"Žilinský kraj";194;9186;255;9441;NA;340230;449;2021-02-03;59408
2021-02-02;"Žilinský kraj";216;9280;272;9552;NA;340230;488;2021-02-02;58959
2021-02-01;"Žilinský kraj";220;19690;370;20060;NA;340230;590;2021-02-01;58471
2021-01-31;"Žilinský kraj";11;2652;27;2679;NA;340230;38;2021-01-31;57881
2021-01-30;"Žilinský kraj";85;18447;187;18634;NA;340230;272;2021-01-30;57843
2021-01-29;"Žilinský kraj";209;22891;304;23195;NA;340230;513;2021-01-29;57571
2021-01-28;"Žilinský kraj";240;5533;172;5705;NA;340230;412;2021-01-28;57058
2021-01-27;"Žilinský kraj";256;6725;119;6844;NA;340230;375;2021-01-27;56646
2021-01-26;"Žilinský kraj";245;49781;348;50129;NA;340230;593;2021-01-26;56271
2021-01-25;"Žilinský kraj";159;21245;150;21395;NA;340230;309;2021-01-25;55678
2021-01-24;"Žilinský kraj";22;55835;268;56103;NA;340230;290;2021-01-24;55369
2021-01-23;"Žilinský kraj";91;101730;444;102174;NA;340230;535;2021-01-23;55079
2021-01-22;"Žilinský kraj";163;32160;237;32397;NA;340230;400;2021-01-22;54544
2021-01-21;"Žilinský kraj";116;19828;181;20009;NA;340230;297;2021-01-21;54144
2021-01-20;"Žilinský kraj";236;17126;159;17285;NA;340230;395;2021-01-20;53847
2021-01-19;"Žilinský kraj";245;15730;285;16015;NA;340230;530;2021-01-19;53452
2021-01-18;"Žilinský kraj";236;12685;326;13011;NA;340230;562;2021-01-18;52922
2021-01-17;"Žilinský kraj";95;147;8;155;NA;340230;103;2021-01-17;52360
2021-01-16;"Žilinský kraj";14;516;31;547;NA;340230;45;2021-01-16;52257
2021-01-15;"Žilinský kraj";248;7486;209;7695;NA;340230;457;2021-01-15;52212
2021-01-14;"Žilinský kraj";166;5319;239;5558;NA;340230;405;2021-01-14;51755
2021-01-13;"Žilinský kraj";247;11263;557;11820;NA;340230;804;2021-01-13;51350
2021-01-12;"Žilinský kraj";376;8410;385;8795;NA;340230;761;2021-01-12;50546
2021-01-11;"Žilinský kraj";351;10058;465;10523;NA;340230;816;2021-01-11;49785
2021-01-10;"Žilinský kraj";38;229;6;235;NA;340230;44;2021-01-10;48969
2021-01-09;"Žilinský kraj";192;1282;60;1342;NA;340230;252;2021-01-09;48925
2021-01-08;"Žilinský kraj";413;8721;462;9183;NA;340230;875;2021-01-08;48673
2021-01-07;"Žilinský kraj";438;23407;1872;25279;NA;340230;2310;2021-01-07;47798
2021-01-06;"Žilinský kraj";145;1076;67;1143;NA;340230;212;2021-01-06;45488
2021-01-05;"Žilinský kraj";717;10227;796;11023;NA;340230;1513;2021-01-05;45276
2021-01-04;"Žilinský kraj";479;9313;893;10206;NA;340230;1372;2021-01-04;43763
2021-01-03;"Žilinský kraj";13;1006;107;1113;NA;340230;120;2021-01-03;42391
2021-01-02;"Žilinský kraj";98;789;91;880;NA;340230;189;2021-01-02;42271
2021-01-01;"Žilinský kraj";118;241;13;254;NA;340230;131;2021-01-01;42082
2020-12-31;"Žilinský kraj";395;9626;784;10410;NA;340230;1179;2020-12-31;41951
2020-12-30;"Žilinský kraj";1038;11781;823;12604;NA;340230;1861;2020-12-30;40772
2020-12-29;"Žilinský kraj";256;10159;979;11138;NA;340230;1235;2020-12-29;38911
2020-12-28;"Žilinský kraj";406;10704;976;11680;NA;340230;1382;2020-12-28;37676
2020-12-27;"Žilinský kraj";40;684;94;778;NA;340230;134;2020-12-27;36294
2020-12-26;"Žilinský kraj";135;593;48;641;NA;340230;183;2020-12-26;36160
2020-12-25;"Žilinský kraj";66;83;9;92;NA;340230;75;2020-12-25;35977
2020-12-24;"Žilinský kraj";643;667;55;722;NA;340230;698;2020-12-24;35902
2020-12-23;"Žilinský kraj";228;16229;975;17204;NA;340230;1203;2020-12-23;35204
2020-12-22;"Žilinský kraj";519;13483;988;14471;NA;340230;1507;2020-12-22;34001
2020-12-21;"Žilinský kraj";444;12429;1078;13507;NA;340230;1522;2020-12-21;32494
2020-12-20;"Žilinský kraj";36;598;80;678;NA;340230;116;2020-12-20;30972
2020-12-19;"Žilinský kraj";208;1678;127;1805;NA;340230;335;2020-12-19;30856
2020-12-18;"Žilinský kraj";333;6553;370;6923;NA;340230;703;2020-12-18;30521
2020-12-17;"Žilinský kraj";500;3922;262;4184;NA;340230;762;2020-12-17;29818
2020-12-16;"Žilinský kraj";333;3815;267;4082;NA;340230;600;2020-12-16;29056
2020-12-15;"Žilinský kraj";528;3729;340;4069;NA;340230;868;2020-12-15;28456
2020-12-14;"Žilinský kraj";321;3884;309;4193;NA;340230;630;2020-12-14;27588
2020-12-13;"Žilinský kraj";26;494;66;560;NA;340230;92;2020-12-13;26958
2020-12-12;"Žilinský kraj";95;767;46;813;NA;340230;141;2020-12-12;26866
2020-12-11;"Žilinský kraj";455;3938;227;4165;NA;340230;682;2020-12-11;26725
2020-12-10;"Žilinský kraj";166;9129;838;9967;NA;340230;1004;2020-12-10;26043
2020-12-09;"Žilinský kraj";392;2169;132;2301;NA;340230;524;2020-12-09;25039
2020-12-08;"Žilinský kraj";331;3127;101;3228;NA;340230;432;2020-12-08;24515
2020-12-07;"Žilinský kraj";348;2746;162;2908;NA;340230;510;2020-12-07;24083
2020-12-06;"Žilinský kraj";15;128;6;134;NA;340230;21;2020-12-06;23573
2020-12-05;"Žilinský kraj";98;781;41;822;NA;340230;139;2020-12-05;23552
2020-12-04;"Žilinský kraj";228;3091;107;3198;NA;340230;335;2020-12-04;23413
2020-12-03;"Žilinský kraj";237;1609;115;1724;NA;340230;352;2020-12-03;23078
2020-12-02;"Žilinský kraj";181;1710;94;1804;NA;340230;275;2020-12-02;22726
2020-12-01;"Žilinský kraj";209;6239;284;6523;NA;340230;493;2020-12-01;22451
2020-11-30;"Žilinský kraj";203;5326;305;5631;NA;340230;508;2020-11-30;21958
2020-11-29;"Žilinský kraj";18;81;7;88;NA;340230;25;2020-11-29;21450
2020-11-28;"Žilinský kraj";99;349;15;364;NA;340230;114;2020-11-28;21425
2020-11-27;"Žilinský kraj";218;904;46;950;NA;340230;264;2020-11-27;21311
2020-11-26;"Žilinský kraj";190;1041;54;1095;NA;340230;244;2020-11-26;21047
2020-11-25;"Žilinský kraj";225;1217;49;1266;NA;340230;274;2020-11-25;20803
2020-11-24;"Žilinský kraj";213;2139;67;2206;NA;340230;280;2020-11-24;20529
2020-11-23;"Žilinský kraj";170;759;44;803;NA;340230;214;2020-11-23;20249
2020-11-22;"Žilinský kraj";11;67;2;69;NA;340230;13;2020-11-22;20035
2020-11-21;"Žilinský kraj";61;505;20;525;NA;340230;81;2020-11-21;20022
2020-11-20;"Žilinský kraj";251;1074;45;1119;NA;340230;296;2020-11-20;19941
2020-11-19;"Žilinský kraj";252;752;61;813;NA;340230;313;2020-11-19;19645
2020-11-18;"Žilinský kraj";346;348;15;363;NA;340230;361;2020-11-18;19332
2020-11-17;"Žilinský kraj";123;490;15;505;NA;340230;138;2020-11-17;18971
2020-11-16;"Žilinský kraj";227;247;15;262;NA;340230;242;2020-11-16;18833
2020-11-15;"Žilinský kraj";63;13;0;13;NA;340230;63;2020-11-15;18591
2020-11-14;"Žilinský kraj";189;1038;11;1049;NA;340230;200;2020-11-14;18528
2020-11-13;"Žilinský kraj";181;125;9;134;NA;340230;190;2020-11-13;18328
2020-11-12;"Žilinský kraj";334;79;2;81;NA;340230;336;2020-11-12;18138
2020-11-11;"Žilinský kraj";489;147;10;157;NA;340230;499;2020-11-11;17802
2020-11-10;"Žilinský kraj";374;519;9;528;NA;340230;383;2020-11-10;17303
2020-11-09;"Žilinský kraj";143;2335;30;2365;NA;340230;173;2020-11-09;16920
2020-11-08;"Žilinský kraj";59;2538;37;2575;NA;340230;96;2020-11-08;16747
2020-11-07;"Žilinský kraj";312;8175;88;8263;NA;340230;400;2020-11-07;16651
2020-11-06;"Žilinský kraj";503;4090;38;4128;NA;340230;541;2020-11-06;16251
2020-11-05;"Žilinský kraj";473;64;4;68;NA;340230;477;2020-11-05;15710
2020-11-04;"Žilinský kraj";423;178;10;188;NA;340230;433;2020-11-04;15233
2020-11-03;"Žilinský kraj";688;889;16;905;NA;340230;704;2020-11-03;14800
2020-11-02;"Žilinský kraj";472;1043;39;1082;NA;340230;511;2020-11-02;14096
2020-11-01;"Žilinský kraj";121;5096;130;5226;NA;340230;251;2020-11-01;13585
